date,first,second,third,fourth,fiveth,sum
190930001,3,1,9,4,3,20
190930002,9,1,0,4,7,21
190930003,4,5,2,6,8,25
190930004,3,6,9,6,6,30
190930005,1,1,4,0,3,9
190930006,6,6,3,7,4,26
190930007,5,4,0,6,9,24
190930008,2,1,1,0,9,13
190930009,7,5,3,0,6,21
190930010,6,2,3,2,3,16
190930011,8,8,8,2,9,35
190930012,9,9,4,9,5,36
190930013,0,5,1,1,8,15
190930014,0,5,0,8,5,18
190930015,5,3,4,1,7,20
190930016,4,2,1,0,1,8
190930017,7,6,1,2,0,16
190930018,8,4,3,6,0,21
190930019,2,7,8,6,2,25
190930020,8,8,1,5,7,29
190930021,7,2,0,5,0,14
190930022,1,2,6,0,8,17
190930023,9,1,6,3,7,26
190930024,9,0,9,8,5,31
190930025,5,4,6,8,1,24
190930026,2,8,6,2,2,20
190930027,5,7,6,9,4,31
190930028,9,4,1,6,5,25
190930029,5,9,5,2,1,22
190930030,4,5,1,7,3,20
190930031,4,5,9,2,6,26
190930032,3,7,3,3,3,19
190930033,1,9,6,2,5,23
190930034,4,7,4,9,8,32
190930035,6,4,6,4,6,26
190930036,6,6,8,0,0,20
190930037,5,1,4,3,4,17
190930038,9,0,2,6,6,23
190930039,6,0,8,7,4,25
190930040,9,1,7,2,2,21
190930041,3,5,2,6,2,18
190930042,0,8,1,3,3,15
190930043,6,1,2,1,6,16
190930044,6,3,8,7,1,25
190930045,9,9,3,0,7,28
190930046,2,2,2,5,4,15
190930047,9,1,4,6,0,20
190930048,8,2,7,0,3,20
190930049,4,6,1,7,2,20
190930050,5,3,2,0,7,17
190930051,4,3,6,9,1,23
190930052,4,3,3,4,7,21
190930053,2,1,7,3,2,15
190930054,9,6,4,2,3,24
190930055,9,2,5,6,2,24
190930056,6,3,2,8,4,23
190930057,7,5,9,8,7,36
190930058,5,7,5,0,3,20
190930059,7,3,4,3,2,19
190930060,0,0,1,2,6,9
190930061,2,0,4,0,7,13
190930062,6,7,9,7,1,30
190930063,3,6,2,8,1,20
190930064,3,3,2,5,0,13
190930065,5,4,5,0,1,15
190930066,6,5,3,6,3,23
190930067,1,4,0,9,2,16
190930068,2,5,1,1,2,11
190930069,9,3,7,0,3,22
190930070,7,6,0,1,1,15
190930071,7,7,2,5,4,25
190930072,9,3,3,1,5,21
190930073,5,6,5,6,5,27
190930074,4,7,7,5,8,31
190930075,3,8,1,6,3,21
190930076,4,0,0,3,2,9
190930077,4,8,0,7,3,22
190930078,9,0,7,5,9,30
190930079,1,1,2,7,8,19
190930080,3,8,7,2,8,28
190930081,0,2,6,1,6,15
190930082,8,7,8,0,3,26
190930083,6,6,7,8,6,33
190930084,9,9,9,8,1,36
190930085,5,4,8,3,7,27
190930086,0,3,4,4,8,19
190930087,3,1,8,8,2,22
190930088,9,6,7,0,3,25
190930089,2,4,4,1,6,17
190930090,8,9,2,6,3,28
190930091,3,1,6,4,5,19
190930092,9,6,7,2,5,29
190930093,4,0,2,0,2,8
190930094,1,6,5,5,7,24
190930095,5,6,6,2,7,26
190930096,5,2,1,7,2,17
190930097,4,3,1,1,4,13
190930098,0,4,2,8,2,16
190930099,3,0,2,9,2,16
190930100,1,0,2,1,5,9
190930101,1,9,0,9,1,20
190930102,9,3,0,2,6,20
190930103,2,7,9,0,4,22
190930104,6,7,7,9,7,36
190930105,3,0,1,2,5,11
190930106,6,4,4,0,2,16
190930107,8,5,8,1,7,29
190930108,2,2,2,3,1,10
190930109,2,9,1,1,5,18
190930110,0,5,5,3,3,16
190930111,9,8,2,6,9,34
190930112,2,9,0,2,1,14
190930113,5,8,6,6,5,30
190930114,5,3,2,3,1,14
190930115,2,5,2,5,6,20
190930116,8,7,1,3,6,25
190930117,9,0,4,1,9,23
190930118,0,4,4,1,7,16
190930119,7,1,4,5,4,21
190930120,0,0,4,5,0,9
190930121,1,1,2,1,5,10
190930122,3,3,0,1,6,13
190930123,5,3,2,4,0,14
190930124,8,9,7,7,6,37
190930125,2,1,5,9,4,21
190930126,8,6,2,1,2,19
190930127,9,9,4,7,9,38
190930128,4,7,5,2,4,22
190930129,4,4,6,7,4,25
190930130,7,5,8,7,8,35
190930131,5,1,5,0,5,16
190930132,0,6,7,3,7,23
190930133,6,2,2,0,6,16
190930134,1,0,8,2,0,11
190930135,1,0,2,7,8,18
190930136,4,8,7,9,6,34
190930137,7,9,2,6,8,32
190930138,5,0,9,0,5,19
190930139,7,8,3,5,4,27
190930140,9,8,9,7,4,37
190930141,1,2,0,2,9,14
190930142,1,8,2,4,3,18
190930143,1,0,6,6,6,19
190930144,3,5,4,4,7,23
190930145,0,2,7,0,7,16
190930146,0,3,3,3,2,11
190930147,2,5,5,4,8,24
190930148,3,0,2,4,5,14
190930149,3,3,4,8,9,27
190930150,6,6,8,7,0,27
190930151,9,4,8,9,4,34
190930152,9,9,8,0,6,32
190930153,7,0,0,7,2,16
190930154,8,8,9,3,3,31
190930155,8,7,6,6,9,36
190930156,8,8,2,6,9,33
190930157,8,9,9,2,7,35
190930158,2,4,6,6,3,21
190930159,6,4,7,3,8,28
190930160,4,5,6,8,5,28
190930161,9,7,5,6,5,32
190930162,7,2,1,4,5,19
190930163,0,5,8,2,4,19
190930164,7,9,8,5,0,29
190930165,9,1,4,6,2,22
190930166,5,0,5,5,7,22
190930167,3,5,0,7,8,23
190930168,7,7,8,2,6,30
190930169,2,0,5,8,5,20
190930170,4,7,7,2,3,23
190930171,7,0,5,3,4,19
190930172,7,4,1,4,6,22
190930173,1,5,4,3,2,15
190930174,8,7,9,6,8,38
190930175,3,2,5,9,3,22
190930176,1,5,5,3,1,15
190930177,7,9,2,8,3,29
190930178,7,9,0,2,1,19
190930179,7,2,0,5,8,22
190930180,0,4,1,5,5,15
190930181,6,3,4,5,6,24
190930182,0,8,6,2,4,20
190930183,4,6,7,2,2,21
190930184,3,5,6,2,8,24
190930185,3,6,1,2,8,20
190930186,3,7,8,2,9,29
190930187,4,6,7,5,7,29
190930188,2,5,8,8,7,30
190930189,2,5,3,7,9,26
190930190,9,9,6,9,7,40
190930191,9,5,4,5,1,24
190930192,9,2,1,3,6,21
190930193,3,3,6,1,0,13
190930194,9,7,6,3,2,27
190930195,5,8,8,4,7,32
190930196,4,2,5,2,0,13
190930197,8,6,7,2,4,27
190930198,5,9,5,3,7,29
190930199,7,2,9,2,2,22
190930200,5,8,5,8,7,33
190930201,3,4,5,5,7,24
190930202,8,4,8,8,3,31
190930203,9,3,2,0,6,20
190930204,6,4,1,2,8,21
190930205,1,8,7,8,9,33
190930206,7,3,6,8,4,28
190930207,8,0,2,8,3,21
190930208,0,4,8,0,3,15
190930209,2,2,2,3,3,12
190930210,5,7,0,3,0,15
190930211,1,7,8,3,4,23
190930212,1,2,4,9,6,22
190930213,6,1,3,7,6,23
190930214,5,3,7,3,0,18
190930215,4,4,6,0,5,19
190930216,0,8,5,7,7,27
190930217,5,5,8,3,5,26
190930218,3,8,3,1,2,17
190930219,5,2,6,8,0,21
190930220,6,0,3,6,1,16
190930221,0,4,1,5,0,10
190930222,5,5,4,3,5,22
190930223,1,8,4,1,1,15
190930224,5,0,8,3,4,20
190930225,0,5,0,0,9,14
190930226,1,3,5,7,1,17
190930227,7,7,3,2,2,21
190930228,0,7,2,2,7,18
190930229,4,2,1,2,9,18
190930230,0,0,3,4,9,16
190930231,0,5,9,1,4,19
190930232,1,5,5,1,5,17
190930233,3,6,6,7,0,22
190930234,8,0,5,3,7,23
190930235,0,2,3,2,8,15
190930236,4,7,1,4,2,18
190930237,8,8,2,8,4,30
190930238,2,1,4,4,6,17
190930239,2,1,0,8,1,12
190930240,4,7,9,9,3,32
190930241,2,0,4,3,4,13
190930242,1,0,3,0,0,4
190930243,3,6,2,0,9,20
190930244,6,5,8,4,9,32
190930245,0,3,0,8,9,20
190930246,5,3,6,7,0,21
190930247,0,9,6,6,7,28
190930248,4,0,9,8,5,26
190930249,8,1,0,2,1,12
190930250,0,5,1,4,5,15
190930251,6,4,3,2,9,24
190930252,3,7,3,8,5,26
190930253,5,1,8,9,2,25
190930254,4,1,2,5,0,12
190930255,2,3,3,4,8,20
190930256,0,5,1,7,6,19
190930257,0,7,0,4,3,14
190930258,2,5,3,4,9,23
190930259,3,6,0,5,7,21
190930260,2,7,7,0,7,23
190930261,4,9,3,7,6,29
190930262,1,0,4,8,6,19
190930263,6,8,1,4,0,19
190930264,9,6,6,3,1,25
190930265,8,9,4,4,7,32
190930266,4,9,7,9,7,36
190930267,2,9,1,9,0,21
190930268,6,3,3,0,7,19
190930269,4,3,1,8,2,18
190930270,7,3,8,2,6,26
190930271,1,4,8,8,9,30
190930272,2,0,7,5,2,16
190930273,8,8,9,9,8,42
190930274,9,3,1,9,7,29
190930275,2,8,3,9,5,27
190930276,0,3,4,1,1,9
190930277,2,8,9,9,3,31
190930278,0,1,0,9,6,16
190930279,9,9,2,3,7,30
190930280,5,4,0,5,6,20
190930281,6,0,8,9,1,24
190930282,8,6,8,5,0,27
190930283,7,2,4,2,8,23
190930284,8,3,3,6,5,25
190930285,4,4,6,1,5,20
190930286,8,2,6,6,2,24
190930287,7,4,5,1,1,18
190930288,0,7,6,3,5,21
190930289,6,7,2,3,5,23
190930290,5,2,3,1,0,11
190930291,4,6,8,4,7,29
190930292,5,7,5,1,7,25
190930293,1,7,4,7,9,28
190930294,7,6,4,7,9,33
190930295,5,1,7,1,0,14
190930296,8,8,1,8,3,28
190930297,0,6,7,5,0,18
190930298,6,0,2,2,1,11
190930299,5,7,8,3,9,32
190930300,5,5,1,0,6,17
190930301,6,8,0,6,3,23
190930302,1,1,4,7,1,14
190930303,4,4,0,0,7,15
190930304,8,4,0,3,1,16
190930305,4,6,4,3,3,20
190930306,0,5,5,9,7,26
190930307,1,9,4,6,0,20
190930308,7,2,5,6,4,24
190930309,5,5,4,0,3,17
190930310,1,1,3,1,2,8
190930311,8,7,0,6,4,25
190930312,7,1,4,8,7,27
190930313,7,8,4,8,4,31
190930314,6,1,6,3,2,18
190930315,1,3,6,9,6,25
190930316,6,1,6,6,0,19
190930317,6,5,8,2,1,22
190930318,4,5,7,0,8,24
190930319,9,0,6,7,8,30
190930320,1,5,7,1,4,18
190930321,1,9,6,6,1,23
190930322,9,9,0,4,0,22
190930323,5,6,1,1,9,22
190930324,5,0,1,1,3,10
190930325,3,4,2,7,3,19
190930326,5,8,7,2,9,31
190930327,4,1,8,9,5,27
190930328,6,8,5,4,3,26
190930329,6,3,1,5,1,16
190930330,2,8,4,5,7,26
190930331,2,4,4,2,2,14
190930332,5,9,6,2,0,22
190930333,6,4,1,9,0,20
190930334,2,4,6,0,0,12
190930335,6,7,7,0,3,23
190930336,3,0,9,0,1,13
190930337,0,3,6,2,9,20
190930338,8,5,2,8,2,25
190930339,8,8,7,5,1,29
190930340,5,3,8,6,3,25
190930341,9,3,7,7,8,34
190930342,2,2,2,3,2,11
190930343,9,4,3,6,5,27
190930344,9,4,7,8,9,37
190930345,4,3,5,5,4,21
190930346,5,5,5,3,0,18
190930347,2,9,5,8,5,29
190930348,7,1,6,9,4,27
190930349,5,7,5,5,8,30
190930350,0,1,2,8,3,14
190930351,4,0,7,1,9,21
190930352,9,9,9,8,0,35
190930353,8,0,4,5,3,20
190930354,7,7,2,8,7,31
190930355,9,5,6,9,9,38
190930356,7,2,4,8,6,27
190930357,6,8,1,1,5,21
190930358,2,3,8,8,6,27
190930359,4,3,6,1,3,17
190930360,6,6,8,7,6,33
190930361,8,3,5,8,0,24
190930362,2,4,7,3,5,21
190930363,7,6,1,9,3,26
190930364,9,1,9,6,5,30
190930365,3,7,8,6,0,24
190930366,1,5,2,1,7,16
190930367,2,2,6,3,9,22
190930368,4,3,4,8,4,23
190930369,7,7,5,9,3,31
190930370,8,3,9,8,5,33
190930371,2,4,9,0,0,15
190930372,6,7,3,9,7,32
190930373,3,9,5,8,0,25
190930374,9,3,6,7,7,32
190930375,2,3,9,6,2,22
190930376,1,9,5,2,9,26
190930377,0,4,2,6,3,15
190930378,6,4,3,3,0,16
190930379,6,8,9,1,1,25
190930380,2,5,5,8,2,22
190930381,1,2,2,7,9,21
190930382,5,3,4,3,8,23
190930383,8,6,0,4,3,21
190930384,8,0,3,4,9,24
190930385,8,0,5,5,0,18
190930386,4,8,1,8,8,29
190930387,1,9,7,7,4,28
190930388,7,8,2,3,9,29
190930389,1,0,8,8,2,19
190930390,9,9,0,0,0,18
190930391,4,5,4,8,2,23
190930392,6,6,0,6,6,24
190930393,7,9,9,5,6,36
190930394,3,1,6,1,3,14
190930395,8,5,5,5,7,30
190930396,4,8,8,1,0,21
190930397,0,1,3,1,8,13
190930398,2,6,1,5,4,18
190930399,0,5,6,0,1,12
190930400,6,1,3,8,5,23
190930401,5,0,6,2,6,19
190930402,1,1,1,4,6,13
190930403,4,5,0,5,9,23
190930404,5,2,1,5,3,16
190930405,2,8,1,6,9,26
190930406,4,1,7,7,5,24
190930407,5,8,3,1,7,24
190930408,7,4,7,3,7,28
190930409,6,5,1,9,0,21
190930410,8,0,8,1,1,18
190930411,0,1,0,3,5,9
190930412,5,3,5,6,8,27
190930413,7,2,5,9,7,30
190930414,5,5,0,8,9,27
190930415,2,8,3,2,9,24
190930416,5,1,0,3,4,13
190930417,1,9,0,4,9,23
190930418,0,6,9,4,2,21
190930419,1,3,7,4,4,19
190930420,6,7,7,3,1,24
190930421,7,1,6,3,4,21
190930422,1,5,7,4,2,19
190930423,7,1,7,2,3,20
190930424,4,3,5,5,0,17
190930425,1,0,7,2,3,13
190930426,9,3,1,6,3,22
190930427,0,9,2,2,4,17
190930428,9,3,7,5,7,31
190930429,4,1,3,6,6,20
190930430,2,2,6,8,4,22
190930431,7,9,8,0,7,31
190930432,2,1,4,9,1,17
190930433,8,2,2,8,6,26
190930434,0,0,3,4,0,7
190930435,9,0,9,9,2,29
190930436,1,1,8,5,4,19
190930437,8,2,0,4,1,15
190930438,5,0,3,9,9,26
190930439,1,8,2,4,2,17
190930440,5,5,2,2,1,15
190930441,8,0,1,3,3,15
190930442,9,3,3,3,2,20
190930443,5,7,1,3,5,21
190930444,0,6,9,2,6,23
190930445,7,4,4,4,6,25
190930446,0,2,9,2,2,15
190930447,6,9,1,2,9,27
190930448,4,7,2,4,8,25
190930449,1,0,9,9,9,28
190930450,1,3,8,4,2,18
190930451,6,3,0,2,1,12
190930452,0,0,4,4,7,15
190930453,0,1,3,5,7,16
190930454,2,7,4,6,1,20
190930455,1,5,0,1,9,16
190930456,6,4,7,7,4,28
190930457,3,9,8,9,4,33
190930458,7,9,1,2,0,19
190930459,4,3,6,5,1,19
190930460,3,1,9,0,5,18
190930461,5,0,9,6,8,28
190930462,9,1,6,1,3,20
190930463,7,9,3,1,8,28
190930464,8,2,9,0,5,24
190930465,3,8,0,5,0,16
190930466,2,7,2,2,8,21
190930467,9,5,8,7,3,32
190930468,8,5,3,3,2,21
190930469,5,9,2,3,3,22
190930470,7,1,3,5,5,21
190930471,4,0,4,4,7,19
190930472,1,1,4,5,9,20
190930473,3,5,1,5,8,22
190930474,5,7,1,7,8,28
190930475,7,9,4,9,7,36
190930476,6,5,1,0,5,17
190930477,9,3,3,3,7,25
190930478,2,5,1,6,0,14
190930479,1,5,5,4,3,18
190930480,1,3,8,1,8,21
190930481,5,3,3,6,9,26
190930482,1,0,1,2,6,10
190930483,3,0,9,2,1,15
190930484,8,0,1,1,3,13
190930485,2,4,1,3,2,12
190930486,5,9,7,2,0,23
190930487,0,6,4,3,1,14
190930488,8,5,9,9,9,40
190930489,7,2,7,0,2,18
190930490,2,3,8,6,0,19
190930491,0,1,2,6,9,18
190930492,3,9,7,2,1,22
190930493,6,3,5,7,8,29
190930494,2,9,6,6,3,26
190930495,5,0,5,9,7,26
190930496,5,2,6,3,3,19
190930497,3,6,4,2,9,24
190930498,7,8,9,7,2,33
190930499,0,6,5,5,5,21
190930500,4,5,4,5,4,22
190930501,3,1,4,3,4,15
190930502,5,2,8,1,7,23
190930503,2,2,4,0,5,13
190930504,7,4,0,6,5,22
190930505,5,3,0,0,1,9
190930506,8,7,5,3,0,23
190930507,1,0,9,3,9,22
190930508,1,6,0,5,5,17
190930509,1,0,3,8,8,20
190930510,3,7,2,7,6,25
190930511,4,1,4,9,2,20
190930512,4,2,7,6,0,19
190930513,8,2,4,1,9,24
190930514,7,6,9,7,0,29
190930515,1,1,2,2,3,9
190930516,5,8,8,8,9,38
190930517,6,2,8,1,1,18
190930518,3,9,7,1,4,24
190930519,9,9,4,3,7,32
190930520,0,6,9,2,9,26
190930521,1,3,9,2,6,21
190930522,6,6,6,5,8,31
190930523,1,3,1,2,0,7
190930524,3,1,1,9,2,16
190930525,5,0,5,0,9,19
190930526,4,0,0,2,0,6
190930527,3,6,3,3,2,17
190930528,7,3,2,9,0,21
190930529,6,0,9,1,3,19
190930530,9,2,7,7,3,28
190930531,4,7,6,6,8,31
190930532,3,5,5,5,3,21
190930533,9,1,7,0,9,26
190930534,8,9,2,2,0,21
190930535,0,1,4,9,8,22
190930536,4,7,7,0,9,27
190930537,7,0,6,3,7,23
190930538,0,9,0,7,6,22
190930539,6,3,4,3,7,23
190930540,6,6,1,0,8,21
190930541,3,5,7,5,7,27
190930542,3,1,2,7,8,21
190930543,0,2,2,7,1,12
190930544,5,4,0,8,9,26
190930545,0,7,8,1,4,20
190930546,5,7,8,7,7,34
190930547,9,4,0,9,6,28
190930548,8,6,9,2,6,31
190930549,0,8,3,7,1,19
190930550,6,8,7,5,9,35
190930551,2,3,4,8,2,19
190930552,2,1,8,0,0,11
190930553,6,9,6,2,3,26
190930554,7,4,3,4,7,25
190930555,1,5,4,3,5,18
190930556,7,2,9,8,1,27
190930557,7,4,6,4,4,25
190930558,0,4,4,2,2,12
190930559,8,1,2,8,2,21
190930560,2,1,1,9,3,16
190930561,2,3,3,0,7,15
190930562,4,0,4,7,5,20
190930563,5,0,0,8,2,15
190930564,9,6,9,3,7,34
190930565,3,2,2,2,5,14
190930566,2,8,3,9,1,23
190930567,0,0,4,5,1,10
190930568,2,0,3,4,6,15
190930569,2,8,4,1,1,16
190930570,0,8,5,6,3,22
190930571,4,7,7,9,3,30
190930572,8,2,4,0,9,23
190930573,6,7,8,8,2,31
190930574,3,9,2,2,3,19
190930575,6,7,0,0,6,19
190930576,4,0,8,9,0,21
190930577,3,1,2,1,4,11
190930578,4,3,1,9,6,23
190930579,7,1,5,3,2,18
190930580,7,5,9,9,7,37
190930581,1,5,4,7,4,21
190930582,5,0,2,0,6,13
190930583,7,1,6,4,6,24
190930584,8,2,4,8,6,28
190930585,7,6,5,2,6,26
190930586,3,6,2,4,7,22
190930587,5,6,9,0,1,21
190930588,4,9,6,3,2,24
190930589,7,8,3,8,1,27
190930590,5,5,5,5,2,22
190930591,8,7,0,3,5,23
190930592,4,5,9,1,7,26
190930593,8,2,7,3,4,24
190930594,6,3,1,0,7,17
190930595,7,1,3,0,1,12
190930596,1,3,9,3,0,16
190930597,8,7,5,7,5,32
190930598,9,0,1,2,6,18
190930599,0,3,1,8,2,14
190930600,8,6,8,1,0,23
190930601,5,5,6,1,2,19
190930602,4,2,7,6,3,22
190930603,4,9,7,9,4,33
190930604,0,0,8,8,4,20
190930605,7,0,8,5,5,25
190930606,5,3,1,3,5,17
190930607,0,3,3,1,5,12
190930608,7,9,5,4,4,29
190930609,5,4,8,9,0,26
190930610,9,4,4,3,8,28
190930611,0,5,0,7,4,16
190930612,1,7,1,6,5,20
190930613,1,5,0,5,2,13
190930614,5,3,8,8,1,25
190930615,7,4,2,9,0,22
190930616,9,9,5,2,0,25
190930617,8,0,8,1,4,21
190930618,1,4,3,4,0,12
190930619,5,0,8,6,3,22
190930620,8,3,7,2,0,20
190930621,2,8,7,7,7,31
190930622,4,1,5,4,2,16
190930623,1,9,8,3,9,30
190930624,2,3,1,8,6,20
190930625,7,5,4,3,1,20
190930626,5,2,9,3,8,27
190930627,9,1,1,9,0,20
190930628,8,2,5,7,7,29
190930629,4,2,5,2,3,16
190930630,7,7,2,3,1,20
190930631,3,5,4,9,8,29
190930632,3,0,5,0,8,16
190930633,5,5,4,9,3,26
190930634,0,8,5,9,8,30
190930635,2,8,9,0,2,21
190930636,6,5,2,0,9,22
190930637,4,9,9,0,4,26
190930638,3,7,5,4,5,24
190930639,0,1,1,6,7,15
190930640,0,4,4,8,6,22
190930641,1,8,6,9,8,32
190930642,3,3,0,0,0,6
190930643,3,8,7,6,1,25
190930644,8,7,5,1,9,30
190930645,7,3,3,8,9,30
190930646,4,8,1,0,1,14
190930647,1,4,8,4,6,23
190930648,0,2,3,2,5,12
190930649,3,1,8,3,0,15
190930650,6,1,3,1,2,13
190930651,3,5,6,2,0,16
190930652,4,9,3,6,9,31
190930653,0,6,4,1,9,20
190930654,4,7,3,1,3,18
190930655,1,9,8,0,1,19
190930656,9,8,4,3,5,29
190930657,5,9,5,8,3,30
190930658,7,7,7,1,4,26
190930659,5,5,8,7,3,28
190930660,1,4,3,3,3,14
190930661,2,5,3,5,4,19
190930662,0,0,1,8,8,17
190930663,3,5,8,8,3,27
190930664,2,7,6,6,1,22
190930665,4,2,7,3,9,25
190930666,3,7,6,9,4,29
190930667,7,7,5,7,6,32
190930668,8,4,6,3,1,22
190930669,8,3,0,2,7,20
190930670,3,8,2,0,9,22
190930671,4,8,8,0,4,24
190930672,4,3,6,3,2,18
190930673,9,8,3,3,1,24
190930674,5,4,0,1,9,19
190930675,1,4,8,5,4,22
190930676,6,8,4,8,4,30
190930677,0,8,6,7,0,21
190930678,2,2,5,0,4,13
190930679,8,2,3,3,1,17
190930680,7,0,5,2,5,19
190930681,8,7,8,8,6,37
190930682,6,9,2,8,6,31
190930683,4,7,0,6,0,17
190930684,4,1,2,6,6,19
190930685,4,6,5,3,2,20
190930686,8,7,6,8,9,38
190930687,9,1,9,6,7,32
190930688,5,8,8,7,9,37
190930689,8,8,9,4,7,36
190930690,5,2,0,6,5,18
190930691,6,6,3,7,8,30
190930692,0,2,6,0,0,8
190930693,2,6,0,2,1,11
190930694,9,7,5,8,1,30
190930695,7,1,4,9,4,25
190930696,0,1,3,3,1,8
190930697,1,7,9,1,3,21
190930698,9,3,1,0,9,22
190930699,2,0,7,3,4,16
190930700,2,1,9,7,5,24
190930701,6,2,5,0,9,22
190930702,6,6,0,2,6,20
190930703,3,8,7,6,5,29
190930704,1,0,2,1,2,6
190930705,8,4,6,9,8,35
190930706,2,7,7,4,4,24
190930707,2,5,6,3,2,18
190930708,5,8,2,4,3,22
190930709,5,3,6,2,0,16
190930710,0,5,0,7,0,12
190930711,3,1,2,5,2,13
190930712,1,0,0,1,1,3
190930713,9,1,9,6,1,26
190930714,8,4,0,8,2,22
190930715,4,6,3,6,2,21
190930716,3,0,4,1,8,16
190930717,8,0,2,7,2,19
190930718,8,2,8,3,4,25
190930719,9,6,6,1,4,26
190930720,0,1,1,6,2,10
190930721,3,6,4,5,2,20
190930722,4,1,9,4,3,21
190930723,7,5,3,9,1,25
190930724,4,9,2,2,9,26
190930725,6,0,0,3,6,15
190930726,7,7,0,4,3,21
190930727,0,9,2,7,3,21
190930728,7,2,4,6,9,28
190930729,6,4,1,0,7,18
190930730,3,3,7,7,7,27
190930731,5,0,4,5,0,14
190930732,8,4,4,0,6,22
190930733,1,9,8,7,6,31
190930734,7,3,2,9,4,25
190930735,5,9,4,0,8,26
190930736,2,3,6,0,9,20
190930737,4,2,5,6,0,17
190930738,0,3,8,1,0,12
190930739,3,7,5,5,3,23
190930740,4,1,0,0,3,8
190930741,1,3,3,8,4,19
190930742,2,4,5,8,2,21
190930743,7,7,1,7,8,30
190930744,4,4,6,1,8,23
190930745,7,4,7,5,8,31
190930746,9,5,1,6,6,27
190930747,2,3,1,1,3,10
190930748,9,2,0,8,7,26
190930749,6,8,8,9,9,40
190930750,2,1,9,7,7,26
190930751,7,0,6,9,0,22
190930752,7,7,2,6,3,25
190930753,7,8,6,9,3,33
190930754,1,0,8,6,3,18
190930755,1,3,2,2,7,15
190930756,3,3,7,0,1,14
190930757,6,2,1,6,4,19
190930758,8,1,0,9,6,24
190930759,5,9,3,8,2,27
190930760,1,3,7,0,7,18
190930761,5,4,6,2,8,25
190930762,1,4,7,2,9,23
190930763,6,7,5,5,4,27
190930764,3,7,9,8,8,35
190930765,7,0,1,5,1,14
190930766,8,8,6,1,3,26
190930767,0,9,4,0,6,19
190930768,1,7,3,7,0,18
190930769,7,9,6,8,3,33
190930770,8,4,5,1,4,22
190930771,4,5,4,3,7,23
190930772,5,0,8,6,6,25
190930773,5,7,8,1,5,26
190930774,2,8,3,3,6,22
190930775,4,9,1,0,4,18
190930776,6,7,6,0,0,19
190930777,2,1,9,5,6,23
190930778,7,5,8,8,7,35
190930779,4,5,5,2,9,25
190930780,0,4,6,5,1,16
190930781,3,1,3,3,7,17
190930782,8,6,7,8,6,35
190930783,1,8,8,7,8,32
190930784,8,5,0,2,1,16
190930785,9,9,7,3,6,34
190930786,7,6,6,9,2,30
190930787,5,9,0,7,1,22
190930788,8,6,1,0,3,18
190930789,0,1,9,6,4,20
190930790,6,0,7,1,9,23
190930791,9,0,2,6,4,21
190930792,2,1,6,1,6,16
190930793,1,4,6,9,7,27
190930794,1,1,2,8,7,19
190930795,0,0,6,3,8,17
190930796,3,6,3,8,7,27
190930797,0,6,9,5,4,24
190930798,1,7,8,4,9,29
190930799,1,7,5,3,3,19
190930800,9,3,7,5,5,29
190930801,4,6,8,8,0,26
190930802,5,0,5,1,9,20
190930803,4,6,4,0,1,15
190930804,3,6,7,0,8,24
190930805,9,1,9,5,8,32
190930806,7,2,0,2,5,16
190930807,7,4,4,0,9,24
190930808,6,3,9,2,3,23
190930809,1,0,0,6,1,8
190930810,4,8,6,4,3,25
190930811,1,1,8,4,1,15
190930812,9,7,5,1,0,22
190930813,5,0,3,9,8,25
190930814,3,1,8,1,6,19
190930815,3,4,3,8,1,19
190930816,0,4,9,0,8,21
190930817,3,7,0,4,8,22
190930818,6,1,3,0,8,18
190930819,2,4,3,9,8,26
190930820,0,7,4,3,8,22
190930821,5,3,6,1,9,24
190930822,1,9,5,7,1,23
190930823,3,9,1,5,5,23
190930824,1,7,0,4,7,19
190930825,4,3,5,5,6,23
190930826,4,5,3,8,7,27
190930827,8,3,2,1,6,20
190930828,3,1,1,2,9,16
190930829,1,1,2,0,1,5
190930830,0,0,0,5,1,6
190930831,8,7,5,2,5,27
190930832,0,8,6,9,3,26
190930833,0,1,8,6,6,21
190930834,6,9,6,8,4,33
190930835,7,8,0,9,8,32
190930836,4,0,9,8,4,25
190930837,3,2,7,3,5,20
190930838,6,7,1,7,7,28
190930839,1,9,1,4,8,23
190930840,4,6,4,0,0,14
190930841,3,0,4,9,5,21
190930842,9,5,6,4,4,28
190930843,2,4,1,9,1,17
190930844,8,8,7,0,7,30
190930845,2,6,8,8,5,29
190930846,8,1,5,0,7,21
190930847,3,6,7,6,1,23
190930848,7,3,4,2,3,19
190930849,1,1,3,5,0,10
190930850,7,3,9,2,7,28
190930851,9,5,4,3,0,21
190930852,4,5,8,8,8,33
190930853,8,0,1,2,9,20
190930854,0,1,2,3,4,10
190930855,6,8,3,8,2,27
190930856,6,6,3,9,2,26
190930857,6,3,6,9,9,33
190930858,9,0,3,2,0,14
190930859,3,1,9,6,9,28
190930860,8,3,3,7,5,26
190930861,3,0,0,0,3,6
190930862,2,6,4,6,0,18
190930863,7,8,9,8,1,33
190930864,7,6,3,7,4,27
190930865,2,8,8,1,6,25
190930866,8,5,4,9,2,28
190930867,3,6,4,3,8,24
190930868,2,9,8,2,9,30
190930869,4,9,4,1,3,21
190930870,6,4,7,1,1,19
190930871,0,5,7,6,9,27
190930872,9,0,0,4,4,17
190930873,7,4,5,7,3,26
190930874,4,3,7,1,4,19
190930875,9,0,4,1,7,21
190930876,9,4,1,1,0,15
190930877,8,0,0,1,6,15
190930878,6,1,0,1,2,10
190930879,0,0,4,4,6,14
190930880,0,1,0,3,7,11
190930881,0,8,9,4,4,25
190930882,8,5,2,1,3,19
190930883,0,7,5,6,3,21
190930884,7,1,3,6,2,19
190930885,4,4,1,3,3,15
190930886,1,3,3,4,9,20
190930887,5,4,4,7,9,29
190930888,7,1,3,4,1,16
190930889,4,9,2,0,8,23
190930890,2,5,5,2,8,22
190930891,1,3,5,0,2,11
190930892,1,4,7,5,6,23
190930893,5,2,9,1,9,26
190930894,0,9,8,6,0,23
190930895,9,1,1,8,0,19
190930896,2,6,4,4,1,17
190930897,6,7,7,3,8,31
190930898,1,8,4,7,9,29
190930899,7,9,7,4,8,35
190930900,5,2,0,0,0,7
190930901,1,3,8,4,5,21
190930902,2,9,3,3,1,18
190930903,7,7,6,7,1,28
190930904,3,0,2,5,1,11
190930905,7,0,0,6,0,13
190930906,3,9,8,3,9,32
190930907,4,5,6,6,0,21
190930908,4,7,6,3,9,29
190930909,1,2,6,7,7,23
190930910,7,6,9,3,9,34
190930911,6,2,7,8,8,31
190930912,6,2,0,3,5,16
190930913,1,9,6,9,4,29
190930914,7,0,8,4,5,24
190930915,5,0,2,7,4,18
190930916,5,3,0,6,7,21
190930917,0,2,7,8,3,20
190930918,0,6,6,0,9,21
190930919,3,0,5,7,2,17
190930920,9,4,4,4,1,22
190930921,9,8,1,2,3,23
190930922,4,0,3,5,0,12
190930923,3,6,6,9,2,26
190930924,3,6,6,8,0,23
190930925,7,7,4,1,6,25
190930926,8,2,7,7,7,31
190930927,8,0,7,9,7,31
190930928,9,8,0,0,7,24
190930929,2,3,6,6,8,25
190930930,9,2,1,6,6,24
190930931,6,1,3,8,6,24
190930932,9,5,9,7,3,33
190930933,1,7,2,6,2,18
190930934,4,1,5,6,6,22
190930935,8,9,9,1,6,33
190930936,8,2,2,7,9,28
190930937,1,8,3,4,7,23
190930938,3,2,8,0,0,13
190930939,3,6,3,2,5,19
190930940,2,2,2,7,3,16
190930941,2,2,6,3,7,20
190930942,8,3,9,2,3,25
190930943,8,1,0,3,9,21
190930944,2,7,5,3,6,23
190930945,2,7,4,0,3,16
190930946,6,2,0,9,0,17
190930947,4,8,3,7,3,25
190930948,9,8,9,9,2,37
190930949,3,2,6,8,3,22
190930950,0,9,8,5,3,25
190930951,4,8,6,4,6,28
190930952,1,6,0,6,0,13
190930953,3,7,5,2,8,25
190930954,4,8,1,4,9,26
190930955,2,6,2,1,3,14
190930956,9,0,9,7,3,28
190930957,2,9,2,2,5,20
190930958,1,6,4,6,6,23
190930959,0,9,2,6,8,25
190930960,7,5,9,5,2,28
190930961,8,4,2,2,8,24
190930962,6,8,0,8,7,29
190930963,2,5,6,3,0,16
190930964,5,2,2,6,2,17
190930965,6,4,3,6,3,22
190930966,9,6,0,9,2,26
190930967,9,8,9,1,4,31
190930968,2,2,1,2,0,7
190930969,9,4,5,4,4,26
190930970,7,2,0,8,1,18
190930971,4,6,9,9,5,33
190930972,8,4,4,1,5,22
190930973,6,4,7,8,2,27
190930974,7,7,8,2,4,28
190930975,8,2,3,0,2,15
190930976,5,7,2,5,6,25
190930977,1,2,2,8,2,15
190930978,9,4,4,1,3,21
190930979,7,3,2,0,0,12
190930980,8,3,0,8,8,27
190930981,1,2,3,6,8,20
190930982,2,4,4,9,9,28
190930983,7,6,2,4,2,21
190930984,0,3,3,5,0,11
190930985,7,8,4,6,9,34
190930986,8,6,5,2,9,30
190930987,4,0,3,5,5,17
190930988,0,5,4,2,1,12
190930989,0,5,3,8,3,19
190930990,6,8,4,6,6,30
190930991,2,2,6,8,8,26
190930992,4,2,8,5,4,23
190930993,3,6,6,0,9,24
190930994,6,9,3,6,7,31
190930995,2,9,8,3,7,29
190930996,1,4,2,6,2,15
190930997,1,2,7,0,9,19
190930998,6,3,3,6,3,21
190930999,5,1,2,8,3,19
1909301000,9,2,5,7,3,26
1909301001,3,7,2,7,7,26
1909301002,1,7,3,3,0,14
1909301003,7,6,1,5,6,25
1909301004,4,3,9,5,9,30
1909301005,9,3,6,5,7,30
1909301006,6,9,2,5,6,28
1909301007,1,8,1,5,1,16
1909301008,0,6,0,9,7,22
1909301009,3,3,9,8,6,29
1909301010,3,1,1,4,0,9
1909301011,1,0,0,1,4,6
1909301012,7,6,4,5,1,23
1909301013,5,5,7,1,4,22
1909301014,3,6,3,6,2,20
1909301015,0,8,7,5,2,22
1909301016,8,3,6,2,0,19
1909301017,9,6,9,6,3,33
1909301018,5,7,2,3,5,22
1909301019,9,8,0,4,8,29
1909301020,3,7,3,4,9,26
1909301021,5,2,7,1,8,23
1909301022,9,7,5,7,1,29
1909301023,5,6,4,0,9,24
1909301024,4,1,3,7,8,23
1909301025,1,6,3,9,8,27
1909301026,6,0,7,8,1,22
1909301027,4,3,8,5,8,28
1909301028,1,1,4,5,4,15
1909301029,7,6,4,6,8,31
1909301030,1,2,4,3,7,17
1909301031,2,2,1,7,3,15
1909301032,5,3,7,3,3,21
1909301033,0,0,0,9,1,10
1909301034,2,1,6,0,5,14
1909301035,5,5,4,8,5,27
1909301036,8,9,5,5,6,33
1909301037,8,3,1,1,4,17
1909301038,5,5,4,4,6,24
1909301039,8,7,7,3,0,25
1909301040,9,2,5,9,0,25
1909301041,9,9,4,4,4,30
1909301042,5,2,5,7,9,28
1909301043,2,8,1,5,3,19
1909301044,9,0,5,9,3,26
1909301045,0,4,0,7,3,14
1909301046,1,8,4,8,3,24
1909301047,7,5,6,1,6,25
1909301048,0,3,0,4,1,8
1909301049,2,7,4,3,4,20
1909301050,7,4,0,2,2,15
1909301051,7,9,0,9,9,34
1909301052,3,1,4,5,4,17
1909301053,5,3,5,1,3,17
1909301054,5,1,4,7,5,22
1909301055,4,7,4,8,6,29
1909301056,0,1,5,5,5,16
1909301057,8,7,2,3,9,29
1909301058,3,8,2,7,3,23
1909301059,9,3,0,6,9,27
1909301060,5,9,0,8,0,22
1909301061,8,2,2,9,7,28
1909301062,9,7,5,6,9,36
1909301063,5,3,6,0,1,15
1909301064,0,3,8,8,5,24
1909301065,9,0,7,6,0,22
1909301066,8,0,4,0,6,18
1909301067,5,8,4,4,9,30
1909301068,7,0,7,4,9,27
1909301069,4,4,4,8,7,27
1909301070,3,3,8,9,2,25
1909301071,7,9,1,5,7,29
1909301072,0,1,8,9,2,20
1909301073,6,5,2,1,7,21
1909301074,6,5,4,8,6,29
1909301075,7,0,5,8,6,26
1909301076,7,5,8,2,3,25
1909301077,9,6,0,4,6,25
1909301078,6,0,7,1,1,15
1909301079,3,7,7,2,9,28
1909301080,6,0,3,9,2,20
1909301081,6,1,3,9,2,21
1909301082,4,5,6,2,8,25
1909301083,1,1,2,1,1,6
1909301084,1,0,2,8,1,12
1909301085,3,6,1,9,1,20
1909301086,5,9,5,0,2,21
1909301087,2,3,1,0,5,11
1909301088,0,9,4,1,1,15
1909301089,7,2,0,2,3,14
1909301090,4,1,1,7,2,15
1909301091,6,9,8,3,9,35
1909301092,5,2,0,1,0,8
1909301093,7,9,4,8,7,35
1909301094,6,4,7,4,6,27
1909301095,4,3,1,7,9,24
1909301096,2,6,0,0,0,8
1909301097,8,7,8,0,2,25
1909301098,6,8,6,3,8,31
1909301099,8,1,3,1,7,20
1909301100,9,5,4,1,6,25
1909301101,8,0,0,5,2,15
1909301102,3,3,7,0,0,13
1909301103,5,1,6,3,6,21
1909301104,9,1,2,1,0,13
1909301105,8,9,8,5,1,31
191001001,3,3,0,5,5,16
191001002,1,1,7,5,1,15
191001003,1,1,7,6,9,24
191001004,7,0,5,5,2,19
191001005,4,6,0,6,1,17
191001006,9,5,4,8,6,32
191001007,8,2,6,8,7,31
191001008,5,7,3,7,7,29
191001009,4,9,5,2,1,21
191001010,7,6,6,2,1,22
191001011,4,6,2,1,9,22
191001012,1,0,8,8,7,24
191001013,1,2,4,3,2,12
191001014,0,0,9,6,1,16
191001015,9,8,0,0,5,22
191001016,8,9,9,2,6,34
191001017,2,7,3,3,9,24
191001018,9,2,6,7,5,29
191001019,1,6,2,0,0,9
191001020,5,4,6,7,9,31
191001021,4,7,8,4,9,32
191001022,2,9,6,2,6,25
191001023,0,6,7,0,9,22
191001024,9,1,9,4,0,23
191001025,5,1,1,8,4,19
191001026,7,9,0,6,4,26
191001027,2,2,1,4,4,13
191001028,6,4,0,8,0,18
191001029,4,7,9,8,4,32
191001030,2,7,6,6,5,26
191001031,2,4,1,8,3,18
191001032,9,4,6,3,1,23
191001033,1,5,7,2,7,22
191001034,9,4,3,6,9,31
191001035,6,8,3,9,4,30
191001036,2,6,4,7,9,28
191001037,5,5,5,5,4,24
191001038,6,6,9,6,8,35
191001039,9,1,6,5,5,26
191001040,0,0,5,2,5,12
191001041,2,5,8,5,7,27
191001042,1,3,5,9,6,24
191001043,4,8,2,8,1,23
191001044,4,2,9,4,1,20
191001045,9,5,5,5,4,28
191001046,4,3,2,0,3,12
191001047,6,6,2,2,9,25
191001048,0,7,5,3,8,23
191001049,7,8,8,4,1,28
191001050,8,3,2,0,7,20
191001051,3,4,9,1,9,26
191001052,1,3,3,0,5,12
191001053,8,4,5,9,5,31
191001054,3,6,1,8,2,20
191001055,9,2,4,1,9,25
191001056,8,4,8,9,2,31
191001057,8,6,3,2,4,23
191001058,7,6,1,2,2,18
191001059,8,7,1,0,1,17
191001060,9,7,6,0,0,22
191001061,1,1,9,7,3,21
191001062,2,8,2,8,3,23
191001063,3,3,4,9,4,23
191001064,3,2,7,4,7,23
191001065,1,0,0,7,2,10
191001066,3,0,1,0,5,9
191001067,5,0,2,8,3,18
191001068,2,4,7,9,6,28
191001069,2,1,4,8,3,18
191001070,0,6,1,3,6,16
191001071,5,3,7,7,8,30
191001072,5,9,1,4,5,24
191001073,0,7,7,7,8,29
191001074,3,2,9,5,4,23
191001075,2,3,7,1,5,18
191001076,3,5,8,2,9,27
191001077,4,3,7,5,3,22
191001078,2,5,9,1,4,21
191001079,7,3,9,8,7,34
191001080,0,9,0,8,0,17
191001081,9,3,0,9,5,26
191001082,1,3,5,0,0,9
191001083,0,8,8,5,5,26
191001084,7,9,3,0,9,28
191001085,1,9,5,8,0,23
191001086,4,7,3,4,7,25
191001087,4,3,8,5,9,29
191001088,0,0,9,3,5,17
191001089,9,0,5,8,0,22
191001090,2,0,3,0,6,11
191001091,2,1,3,2,2,10
191001092,2,3,6,3,0,14
191001093,4,7,2,6,6,25
191001094,3,0,4,0,3,10
191001095,7,7,3,7,6,30
191001096,0,0,7,3,2,12
191001097,2,8,2,1,3,16
191001098,6,0,6,1,8,21
191001099,1,2,3,4,2,12
191001100,2,7,5,1,6,21
191001101,3,3,5,4,0,15
191001102,8,9,4,8,2,31
191001103,6,4,7,4,9,30
191001104,0,7,1,6,3,17
191001105,6,0,1,9,2,18
191001106,1,6,9,8,3,27
191001107,0,5,1,3,0,9
191001108,3,4,3,8,4,22
191001109,6,2,2,3,4,17
191001110,1,7,8,8,2,26
191001111,7,8,0,5,9,29
191001112,1,6,1,0,3,11
191001113,8,1,9,8,5,31
191001114,8,9,6,7,4,34
191001115,9,2,4,3,9,27
191001116,1,5,1,9,9,25
191001117,8,3,4,1,0,16
191001118,2,6,3,8,4,23
191001119,9,6,5,5,6,31
191001120,6,1,6,0,0,13
191001121,2,7,1,8,4,22
191001122,9,6,9,9,6,39
191001123,1,0,3,6,2,12
191001124,3,5,5,8,1,22
191001125,1,5,6,8,8,28
191001126,1,9,3,0,5,18
191001127,2,1,7,2,8,20
191001128,8,6,0,0,0,14
191001129,7,4,7,6,5,29
191001130,1,4,6,4,3,18
191001131,5,3,2,7,8,25
191001132,0,3,1,9,1,14
191001133,4,6,9,9,4,32
191001134,8,3,7,7,0,25
191001135,9,5,9,2,8,33
191001136,5,7,7,3,9,31
191001137,5,8,7,1,7,28
191001138,6,7,0,0,1,14
191001139,9,3,4,6,8,30
191001140,9,4,9,9,7,38
191001141,0,2,5,5,4,16
191001142,6,4,7,8,9,34
191001143,5,7,7,7,7,33
191001144,2,5,6,6,3,22
191001145,6,8,6,0,2,22
191001146,1,5,2,1,2,11
191001147,6,1,9,2,1,19
191001148,7,7,1,0,4,19
191001149,6,7,0,7,9,29
191001150,8,8,7,4,3,30
191001151,5,9,7,2,1,24
191001152,8,5,5,4,0,22
191001153,0,2,1,2,6,11
191001154,7,3,5,9,4,28
191001155,9,1,6,2,2,20
191001156,9,7,6,2,4,28
191001157,5,5,3,3,8,24
191001158,2,4,5,5,2,18
191001159,5,9,0,0,3,17
191001160,7,2,8,7,2,26
191001161,4,9,6,9,8,36
191001162,4,5,1,7,6,23
191001163,6,9,4,6,2,27
191001164,6,3,3,7,6,25
191001165,8,6,3,2,6,25
191001166,3,9,6,5,6,29
191001167,0,0,9,0,7,16
191001168,8,7,3,2,2,22
191001169,0,5,6,5,6,22
191001170,0,5,1,2,9,17
191001171,3,2,5,5,9,24
191001172,5,2,8,1,4,20
191001173,8,3,7,9,1,28
191001174,9,9,8,3,2,31
191001175,8,5,5,5,6,29
191001176,8,0,4,3,8,23
191001177,6,0,0,9,4,19
191001178,5,6,0,3,6,20
191001179,9,2,3,6,2,22
191001180,1,3,4,5,0,13
191001181,9,3,9,6,8,35
191001182,6,8,1,2,7,24
191001183,7,3,5,8,5,28
191001184,2,9,7,5,5,28
191001185,6,9,8,1,7,31
191001186,0,8,2,9,6,25
191001187,8,4,2,3,8,25
191001188,9,7,9,3,6,34
191001189,3,5,8,2,5,23
191001190,8,5,6,7,8,34
191001191,0,6,1,9,1,17
191001192,8,0,6,2,8,24
191001193,5,5,2,9,3,24
191001194,5,2,4,7,9,27
191001195,3,5,4,7,6,25
191001196,4,0,0,7,7,18
191001197,4,0,7,9,7,27
191001198,3,0,3,5,5,16
191001199,8,4,0,4,7,23
191001200,2,3,3,5,4,17
191001201,4,7,6,8,1,26
191001202,7,6,7,6,1,27
191001203,2,5,4,4,2,17
191001204,2,6,5,9,3,25
191001205,8,8,8,5,4,33
191001206,4,2,8,0,4,18
191001207,1,0,1,4,5,11
191001208,0,0,9,8,3,20
191001209,8,0,4,2,2,16
191001210,8,8,6,0,1,23
191001211,9,3,6,9,7,34
191001212,5,3,9,4,1,22
191001213,4,0,0,7,4,15
191001214,4,6,0,1,3,14
191001215,0,1,9,1,8,19
191001216,9,0,9,8,1,27
191001217,0,8,3,9,0,20
191001218,1,3,8,8,8,28
191001219,4,2,2,4,9,21
191001220,7,6,5,6,5,29
191001221,4,6,5,0,7,22
191001222,1,9,9,8,2,29
191001223,1,2,7,3,2,15
191001224,5,1,2,2,5,15
191001225,5,7,9,3,6,30
191001226,0,3,6,4,3,16
191001227,9,3,8,6,1,27
191001228,7,9,1,1,4,22
191001229,1,6,1,4,1,13
191001230,1,7,6,2,6,22
191001231,4,2,9,6,7,28
191001232,1,6,2,3,2,14
191001233,8,1,8,2,5,24
191001234,4,3,1,3,1,12
191001235,4,3,1,4,4,16
191001236,5,7,2,6,2,22
191001237,6,9,6,1,8,30
191001238,1,4,6,4,4,19
191001239,4,8,8,7,5,32
191001240,2,7,4,9,1,23
191001241,3,4,2,9,2,20
191001242,2,3,3,2,6,16
191001243,9,1,7,6,6,29
191001244,7,9,0,6,8,30
191001245,0,8,4,5,5,22
191001246,5,3,3,7,9,27
191001247,8,1,5,3,4,21
191001248,7,2,7,9,0,25
191001249,0,5,5,2,5,17
191001250,7,0,9,0,5,21
191001251,1,0,2,8,6,17
191001252,9,0,9,5,5,28
191001253,1,8,9,2,0,20
191001254,6,8,8,9,4,35
191001255,0,9,4,9,6,28
191001256,1,4,0,4,4,13
191001257,7,5,6,8,9,35
191001258,8,7,7,2,1,25
191001259,2,2,4,2,6,16
191001260,8,6,9,1,6,30
191001261,2,6,8,9,9,34
191001262,1,9,0,4,7,21
191001263,8,9,5,8,6,36
191001264,6,7,6,6,6,31
191001265,7,4,7,2,2,22
191001266,5,6,4,5,2,22
191001267,4,6,6,0,8,24
191001268,2,4,4,8,2,20
191001269,8,6,9,1,9,33
191001270,7,6,0,6,7,26
191001271,6,7,9,1,1,24
191001272,6,3,3,6,7,25
191001273,4,5,6,4,4,23
191001274,8,8,8,3,5,32
191001275,6,2,1,7,5,21
191001276,2,4,3,0,8,17
191001277,2,5,0,0,2,9
191001278,6,5,7,3,7,28
191001279,7,4,7,7,1,26
191001280,4,8,9,0,7,28
191001281,3,3,6,7,5,24
191001282,3,2,5,1,7,18
191001283,9,6,7,2,0,24
191001284,5,9,7,1,3,25
191001285,9,2,3,2,9,25
191001286,4,2,4,4,3,17
191001287,6,3,9,6,5,29
191001288,3,5,0,4,8,20
191001289,1,0,8,7,6,22
191001290,9,2,2,3,2,18
191001291,7,3,0,7,0,17
191001292,7,3,6,5,2,23
191001293,1,5,6,0,9,21
191001294,6,8,0,7,1,22
191001295,9,7,5,4,9,34
191001296,0,1,0,7,0,8
191001297,3,1,3,8,3,18
191001298,1,7,5,0,1,14
191001299,5,6,3,2,3,19
191001300,5,1,6,6,6,24
191001301,1,6,4,6,7,24
191001302,0,4,6,4,3,17
191001303,0,6,4,5,5,20
191001304,5,0,7,8,4,24
191001305,7,6,1,5,7,26
191001306,1,6,2,4,0,13
191001307,6,0,1,7,4,18
191001308,4,5,6,4,8,27
191001309,6,3,6,5,4,24
191001310,8,7,4,5,2,26
191001311,6,6,4,0,7,23
191001312,2,1,4,4,3,14
191001313,3,1,6,6,7,23
191001314,3,1,1,5,0,10
191001315,1,1,2,0,7,11
191001316,8,0,4,3,4,19
191001317,5,9,1,0,9,24
191001318,0,1,2,2,6,11
191001319,0,9,8,6,5,28
191001320,3,9,4,2,5,23
191001321,3,3,5,9,5,25
191001322,4,0,8,8,9,29
191001323,0,7,7,3,8,25
191001324,7,0,0,5,4,16
191001325,0,8,6,1,5,20
191001326,5,9,1,6,2,23
191001327,3,9,2,5,1,20
191001328,7,3,4,5,3,22
191001329,6,8,0,8,3,25
191001330,7,2,2,2,2,15
191001331,9,5,0,2,4,20
191001332,0,0,1,3,9,13
191001333,7,9,7,6,2,31
191001334,7,6,8,6,2,29
191001335,3,4,6,2,4,19
191001336,1,7,6,7,0,21
191001337,1,8,8,6,9,32
191001338,6,9,5,1,2,23
191001339,0,2,0,6,0,8
191001340,3,5,4,5,8,25
191001341,2,2,8,7,2,21
191001342,9,1,0,1,4,15
191001343,3,3,7,9,2,24
191001344,4,8,8,8,5,33
191001345,2,2,8,9,7,28
191001346,5,0,2,1,0,8
191001347,2,6,3,9,4,24
191001348,4,5,7,2,5,23
191001349,9,5,5,5,9,33
191001350,5,2,5,6,9,27
191001351,8,4,3,6,5,26
191001352,7,7,7,2,8,31
191001353,9,7,5,9,3,33
191001354,5,6,9,0,8,28
191001355,2,2,5,1,5,15
191001356,1,2,6,4,3,16
191001357,9,1,2,1,3,16
191001358,9,1,7,2,6,25
191001359,7,1,7,0,5,20
191001360,7,0,9,0,0,16
191001361,8,9,5,7,5,34
191001362,9,4,1,7,3,24
191001363,4,6,3,4,1,18
191001364,3,5,9,1,8,26
191001365,6,0,4,2,2,14
191001366,8,0,3,3,1,15
191001367,3,1,5,3,2,14
191001368,3,8,5,2,8,26
191001369,8,1,6,0,7,22
191001370,1,9,9,4,6,29
191001371,1,5,9,1,7,23
191001372,4,2,9,3,4,22
191001373,4,4,3,9,9,29
191001374,9,8,8,1,2,28
191001375,8,5,9,9,4,35
191001376,0,8,5,1,5,19
191001377,0,9,0,4,7,20
191001378,8,4,6,6,2,26
191001379,2,1,9,0,9,21
191001380,3,5,3,6,0,17
191001381,2,2,2,4,1,11
191001382,8,6,7,3,7,31
191001383,1,6,8,4,5,24
191001384,2,3,7,6,6,24
191001385,7,4,6,9,7,33
191001386,9,9,6,9,6,39
191001387,7,9,0,5,6,27
191001388,1,3,6,7,1,18
191001389,7,4,0,8,9,28
191001390,4,3,0,2,8,17
191001391,8,2,2,8,7,27
191001392,8,0,5,8,5,26
191001393,8,9,1,4,3,25
191001394,7,2,7,3,9,28
191001395,0,4,0,1,2,7
191001396,6,0,7,9,7,29
191001397,0,2,7,7,3,19
191001398,6,0,5,2,6,19
191001399,0,5,7,3,9,24
191001400,5,0,4,1,2,12
191001401,3,4,7,4,4,22
191001402,9,4,3,5,3,24
191001403,0,4,7,2,2,15
191001404,4,6,6,6,0,22
191001405,3,7,6,6,1,23
191001406,1,9,4,5,3,22
191001407,3,4,5,9,5,26
191001408,7,9,4,7,7,34
191001409,7,4,5,6,0,22
191001410,3,8,0,3,4,18
191001411,7,1,6,3,9,26
191001412,8,5,4,0,0,17
191001413,1,0,8,7,3,19
191001414,2,3,0,8,2,15
191001415,0,7,7,6,7,27
191001416,1,4,7,2,3,17
191001417,0,0,9,5,8,22
191001418,6,9,4,0,8,27
191001419,3,4,9,5,0,21
191001420,6,8,5,4,5,28
191001421,5,9,0,5,0,19
191001422,0,4,2,2,0,8
191001423,9,2,8,4,6,29
191001424,5,2,1,5,9,22
191001425,9,8,2,5,0,24
191001426,6,0,7,0,8,21
191001427,9,3,5,4,5,26
191001428,8,7,0,7,2,24
191001429,8,2,6,7,6,29
191001430,2,6,1,6,1,16
191001431,1,0,9,9,5,24
191001432,8,0,2,9,0,19
191001433,1,4,7,8,7,27
191001434,8,6,7,5,2,28
191001435,5,2,0,3,2,12
191001436,5,1,0,3,3,12
191001437,5,7,3,2,3,20
191001438,7,1,6,6,1,21
191001439,9,1,7,1,7,25
191001440,9,8,8,1,6,32
191001441,6,6,2,5,6,25
191001442,9,7,2,9,1,28
191001443,6,6,7,4,0,23
191001444,2,2,9,1,9,23
191001445,9,4,5,7,3,28
191001446,5,2,1,4,1,13
191001447,2,7,8,9,0,26
191001448,2,9,6,4,9,30
191001449,6,4,5,9,6,30
191001450,1,2,1,9,3,16
191001451,0,5,7,9,9,30
191001452,6,3,4,2,6,21
191001453,3,0,3,8,6,20
191001454,4,3,0,8,9,24
191001455,1,8,8,1,2,20
191001456,6,0,7,6,3,22
191001457,5,8,4,9,5,31
191001458,1,4,4,6,7,22
191001459,3,7,8,1,6,25
191001460,1,1,1,7,3,13
191001461,6,5,4,5,1,21
191001462,7,9,5,3,7,31
191001463,1,9,0,8,1,19
191001464,4,3,1,7,2,17
191001465,9,6,1,8,4,28
191001466,6,7,5,5,1,24
191001467,3,6,7,4,7,27
191001468,0,6,7,9,2,24
191001469,5,4,1,4,7,21
191001470,3,5,6,0,8,22
191001471,1,5,0,8,5,19
191001472,9,3,3,8,6,29
191001473,6,4,1,9,8,28
191001474,1,7,5,0,5,18
191001475,7,5,6,0,4,22
191001476,6,9,2,9,0,26
191001477,4,1,9,5,0,19
191001478,4,2,8,8,3,25
191001479,7,9,9,8,8,41
191001480,2,3,4,4,9,22
191001481,2,9,1,7,9,28
191001482,0,4,9,0,5,18
191001483,7,9,9,7,6,38
191001484,7,7,8,8,4,34
191001485,6,8,8,8,6,36
191001486,9,6,7,7,9,38
191001487,3,0,2,5,5,15
191001488,0,8,0,1,1,10
191001489,9,5,3,8,4,29
191001490,5,8,8,4,3,28
191001491,0,1,3,7,2,13
191001492,3,2,2,2,8,17
191001493,6,3,9,0,0,18
191001494,6,4,3,7,9,29
191001495,6,3,8,6,9,32
191001496,0,0,9,6,8,23
191001497,5,1,4,2,0,12
191001498,2,4,6,0,5,17
191001499,2,0,0,2,1,5
191001500,9,0,8,9,4,30
191001501,3,0,4,2,6,15
191001502,8,1,7,5,2,23
191001503,0,1,4,8,9,22
191001504,2,0,4,8,7,21
191001505,6,2,9,7,8,32
191001506,7,0,5,6,7,25
191001507,2,7,9,1,2,21
191001508,8,6,8,9,1,32
191001509,4,5,6,1,8,24
191001510,5,9,7,5,7,33
191001511,0,5,2,8,2,17
191001512,4,9,5,5,4,27
191001513,7,0,8,8,1,24
191001514,7,3,6,9,6,31
191001515,1,4,5,5,2,17
191001516,9,8,7,2,0,26
191001517,4,3,4,0,9,20
191001518,5,7,2,8,5,27
191001519,0,6,9,6,0,21
191001520,5,2,2,9,1,19
191001521,0,8,0,2,6,16
191001522,6,1,2,7,9,25
191001523,8,8,8,2,2,28
191001524,8,4,1,9,1,23
191001525,7,8,7,0,9,31
191001526,5,4,2,5,2,18
191001527,4,9,9,2,6,30
191001528,1,9,2,4,1,17
191001529,9,2,9,1,2,23
191001530,1,1,4,9,7,22
191001531,6,5,5,5,9,30
191001532,9,4,6,7,4,30
191001533,4,2,7,1,2,16
191001534,2,8,8,0,5,23
191001535,5,2,2,3,9,21
191001536,1,0,0,0,5,6
191001537,4,9,0,1,5,19
191001538,7,2,1,4,8,22
191001539,6,7,8,0,6,27
191001540,0,7,7,5,7,26
191001541,4,0,8,4,1,17
191001542,6,9,9,6,4,34
191001543,6,6,5,1,6,24
191001544,9,1,9,3,0,22
191001545,9,9,2,8,7,35
191001546,4,2,8,4,8,26
191001547,7,0,5,0,9,21
191001548,8,8,6,5,8,35
191001549,8,7,9,4,1,29
191001550,2,1,4,6,2,15
191001551,8,0,0,5,4,17
191001552,0,3,2,9,5,19
191001553,8,7,3,9,2,29
191001554,8,5,2,8,9,32
191001555,5,7,7,9,3,31
191001556,7,0,6,4,6,23
191001557,4,7,4,3,6,24
191001558,3,1,9,0,9,22
191001559,4,3,7,0,8,22
191001560,5,4,9,4,0,22
191001561,5,1,6,4,7,23
191001562,5,4,3,5,1,18
191001563,0,0,8,4,2,14
191001564,3,1,0,7,7,18
191001565,5,6,6,7,8,32
191001566,9,7,4,4,6,30
191001567,7,6,0,7,0,20
191001568,8,4,0,0,9,21
191001569,9,5,3,7,0,24
191001570,2,5,0,2,5,14
191001571,5,3,0,3,1,12
191001572,8,8,6,0,5,27
191001573,9,3,6,8,6,32
191001574,9,9,4,4,1,27
191001575,7,4,3,5,5,24
191001576,7,5,9,0,9,30
191001577,8,7,6,1,0,22
191001578,2,1,6,3,7,19
191001579,8,6,6,3,6,29
191001580,9,0,7,5,7,28
191001581,3,4,6,4,6,23
191001582,6,8,1,0,3,18
191001583,4,8,6,6,8,32
191001584,2,1,0,6,8,17
191001585,8,7,4,0,4,23
191001586,8,4,8,2,1,23
191001587,6,8,7,4,6,31
191001588,3,3,1,7,8,22
191001589,0,9,3,3,3,18
191001590,1,4,2,8,0,15
191001591,0,0,5,2,0,7
191001592,9,7,6,2,3,27
191001593,9,8,6,6,9,38
191001594,9,5,7,1,3,25
191001595,7,3,5,7,5,27
191001596,8,5,3,6,4,26
191001597,4,6,0,2,6,18
191001598,0,4,1,2,9,16
191001599,8,2,4,4,2,20
191001600,4,6,7,4,4,25
191001601,0,3,1,4,2,10
191001602,1,3,1,1,1,7
191001603,7,5,2,9,4,27
191001604,1,3,3,1,2,10
191001605,2,7,8,8,8,33
191001606,8,3,8,2,5,26
191001607,1,9,6,4,6,26
191001608,2,2,5,9,4,22
191001609,5,1,6,9,2,23
191001610,7,3,2,9,1,22
191001611,5,0,6,8,1,20
191001612,7,7,3,0,9,26
191001613,0,2,7,2,3,14
191001614,9,7,8,9,4,37
191001615,8,7,0,8,1,24
191001616,5,0,7,2,0,14
191001617,4,0,6,3,1,14
191001618,7,9,4,5,2,27
191001619,4,8,9,7,7,35
191001620,8,2,8,9,2,29
191001621,1,5,8,7,2,23
191001622,7,3,3,9,4,26
191001623,6,0,4,6,0,16
191001624,4,1,8,5,5,23
191001625,5,2,0,4,1,12
191001626,1,4,1,3,2,11
191001627,5,3,8,7,3,26
191001628,3,2,2,6,3,16
191001629,6,4,5,9,1,25
191001630,6,7,6,1,2,22
191001631,0,6,2,5,6,19
191001632,1,4,4,8,2,19
191001633,7,8,6,1,5,27
191001634,9,2,0,1,8,20
191001635,6,1,7,0,9,23
191001636,1,9,1,3,5,19
191001637,5,5,1,7,3,21
191001638,9,7,5,7,9,37
191001639,4,3,9,4,4,24
191001640,7,9,3,6,2,27
191001641,3,8,0,5,1,17
191001642,0,1,2,8,7,18
191001643,9,3,1,2,5,20
191001644,7,4,4,9,1,25
191001645,9,1,2,3,7,22
191001646,0,8,0,8,3,19
191001647,6,9,9,0,9,33
191001648,2,0,4,9,5,20
191001649,2,8,0,3,7,20
191001650,2,3,6,2,6,19
191001651,2,3,5,3,7,20
191001652,7,3,3,7,3,23
191001653,4,4,3,8,7,26
191001654,7,8,1,7,6,29
191001655,7,5,3,2,1,18
191001656,7,4,4,0,0,15
191001657,1,2,5,3,6,17
191001658,0,6,6,6,4,22
191001659,1,0,6,1,9,17
191001660,8,6,4,5,2,25
191001661,0,8,9,1,4,22
191001662,1,2,0,4,5,12
191001663,0,9,8,7,5,29
191001664,6,6,8,3,2,25
191001665,7,6,8,7,5,33
191001666,2,4,4,9,1,20
191001667,4,0,8,6,9,27
191001668,9,2,0,0,5,16
191001669,2,5,0,6,3,16
191001670,6,9,1,3,3,22
191001671,7,2,4,8,2,23
191001672,4,1,8,7,0,20
191001673,9,5,9,9,9,41
191001674,0,9,6,1,5,21
191001675,4,6,0,1,1,12
191001676,2,2,8,9,8,29
191001677,8,6,1,5,8,28
191001678,8,3,9,9,4,33
191001679,4,1,7,9,0,21
191001680,9,9,6,9,2,35
191001681,4,6,4,3,8,25
191001682,0,4,5,1,3,13
191001683,1,6,3,3,2,15
191001684,0,1,5,6,2,14
191001685,7,9,3,9,5,33
191001686,9,2,1,5,8,25
191001687,3,3,1,1,0,8
191001688,9,7,2,3,0,21
191001689,0,6,3,4,7,20
191001690,9,4,4,0,5,22
191001691,6,9,7,9,3,34
191001692,2,0,5,9,5,21
191001693,3,1,8,8,6,26
191001694,4,4,3,5,9,25
191001695,3,4,4,0,9,20
191001696,3,8,5,7,6,29
191001697,2,2,5,9,0,18
191001698,0,5,2,0,4,11
191001699,8,2,7,8,8,33
191001700,8,0,7,1,0,16
191001701,8,6,3,6,5,28
191001702,7,9,6,7,0,29
191001703,0,8,3,8,0,19
191001704,6,9,1,8,3,27
191001705,6,9,9,0,4,28
191001706,4,4,8,4,7,27
191001707,6,6,7,3,8,30
191001708,3,7,6,1,4,21
191001709,0,2,3,5,4,14
191001710,4,4,7,0,1,16
191001711,4,7,3,9,0,23
191001712,5,8,7,2,2,24
191001713,5,0,9,4,1,19
191001714,0,2,4,1,0,7
191001715,4,3,9,8,9,33
191001716,6,8,7,5,4,30
191001717,5,2,6,1,0,14
191001718,9,6,4,0,4,23
191001719,2,0,0,8,5,15
191001720,7,9,1,2,9,28
191001721,1,5,6,5,5,22
191001722,4,8,1,6,3,22
191001723,3,0,5,3,5,16
191001724,8,5,1,6,9,29
191001725,7,7,8,8,6,36
191001726,3,1,8,7,6,25
191001727,1,5,4,8,6,24
191001728,0,8,0,6,8,22
191001729,7,4,1,2,4,18
191001730,3,0,2,0,9,14
191001731,4,2,2,0,6,14
191001732,4,9,1,1,1,16
191001733,9,5,3,0,3,20
191001734,0,5,5,9,8,27
191001735,1,9,3,6,6,25
191001736,3,5,1,5,2,16
191001737,8,2,8,0,9,27
191001738,0,1,7,9,7,24
191001739,8,4,0,0,0,12
191001740,6,7,9,2,8,32
191001741,5,6,2,2,0,15
191001742,9,4,0,0,5,18
191001743,1,7,4,2,5,19
191001744,1,3,2,6,7,19
191001745,3,9,3,8,4,27
191001746,1,9,2,0,6,18
191001747,9,9,3,7,0,28
191001748,5,8,1,8,7,29
191001749,8,2,3,5,0,18
191001750,1,0,5,2,3,11
191001751,6,0,4,9,9,28
191001752,0,7,2,6,1,16
191001753,7,3,8,8,4,30
191001754,2,7,9,9,7,34
191001755,0,7,3,9,3,22
191001756,5,5,2,4,5,21
191001757,9,7,5,2,4,27
191001758,2,5,6,0,8,21
191001759,0,2,4,6,6,18
191001760,6,1,2,4,3,16
191001761,4,0,0,6,1,11
191001762,1,6,4,8,5,24
191001763,3,9,4,0,6,22
191001764,8,7,8,1,6,30
191001765,2,4,8,4,8,26
191001766,1,6,7,2,4,20
191001767,7,4,7,4,0,22
191001768,8,5,2,1,2,18
191001769,7,9,6,9,8,39
191001770,8,7,1,8,4,28
191001771,8,5,7,1,5,26
191001772,0,1,4,5,5,15
191001773,9,3,5,8,7,32
191001774,6,8,9,0,2,25
191001775,0,9,2,5,0,16
191001776,6,5,5,1,2,19
191001777,6,8,4,5,2,25
191001778,0,0,6,9,8,23
191001779,0,3,5,3,8,19
191001780,0,7,0,1,5,13
191001781,8,4,0,9,9,30
191001782,9,7,1,3,8,28
191001783,8,8,4,7,3,30
191001784,9,3,8,4,9,33
191001785,2,6,9,1,8,26
191001786,6,5,5,9,7,32
191001787,8,6,8,0,1,23
191001788,2,7,8,5,9,31
191001789,6,6,3,0,3,18
191001790,3,1,8,5,7,24
191001791,3,2,3,4,5,17
191001792,7,1,7,5,4,24
191001793,0,0,1,7,6,14
191001794,8,0,7,9,0,24
191001795,7,2,7,2,8,26
191001796,6,9,0,3,6,24
191001797,0,4,9,2,3,18
191001798,3,6,5,8,1,23
191001799,5,8,4,8,0,25
191001800,0,6,0,8,3,17
191001801,7,8,9,9,3,36
191001802,2,8,2,2,5,19
191001803,1,5,0,7,1,14
191001804,9,7,7,2,0,25
191001805,9,0,5,4,3,21
191001806,0,3,0,3,9,15
191001807,5,4,0,6,7,22
191001808,8,3,5,4,4,24
191001809,0,9,1,3,8,21
191001810,1,2,7,3,5,18
191001811,0,7,5,6,6,24
191001812,4,1,0,8,8,21
191001813,7,0,9,4,7,27
191001814,6,6,7,8,8,35
191001815,8,9,0,2,2,21
191001816,6,7,1,5,6,25
191001817,6,6,4,4,5,25
191001818,2,3,9,5,9,28
191001819,2,8,7,8,2,27
191001820,7,2,0,4,3,16
191001821,3,8,9,7,4,31
191001822,7,0,8,4,0,19
191001823,2,8,2,0,5,17
191001824,0,1,4,4,2,11
191001825,1,5,8,1,4,19
191001826,1,8,7,1,5,22
191001827,6,4,5,2,7,24
191001828,1,9,2,3,1,16
191001829,9,8,1,0,4,22
191001830,2,4,1,2,8,17
191001831,6,6,9,4,5,30
191001832,6,1,0,1,9,17
191001833,8,2,6,0,2,18
191001834,5,0,3,7,6,21
191001835,0,7,4,2,4,17
191001836,5,8,8,8,8,37
191001837,6,2,2,5,2,17
191001838,3,8,0,4,1,16
191001839,0,9,5,6,6,26
191001840,4,7,7,2,1,21
191001841,0,0,0,1,3,4
191001842,1,6,9,3,8,27
191001843,5,6,9,4,1,25
191001844,5,2,0,9,1,17
191001845,1,2,1,4,9,17
191001846,4,6,6,0,6,22
191001847,5,5,5,6,1,22
191001848,5,2,9,0,7,23
191001849,7,4,6,5,8,30
191001850,4,8,0,6,8,26
191001851,8,5,5,3,5,26
191001852,9,6,1,7,5,28
191001853,7,1,2,3,5,18
191001854,2,5,8,1,5,21
191001855,1,9,2,3,7,22
191001856,9,8,7,8,6,38
191001857,6,1,1,7,2,17
191001858,1,0,0,9,3,13
191001859,9,5,0,4,4,22
191001860,2,6,0,2,3,13
191001861,5,5,0,5,6,21
191001862,1,9,8,8,8,34
191001863,5,1,8,3,0,17
191001864,3,9,8,5,3,28
191001865,6,8,7,8,5,34
191001866,9,9,9,7,9,43
191001867,1,4,4,3,1,13
191001868,2,4,3,8,5,22
191001869,2,9,3,4,6,24
191001870,0,4,5,2,8,19
191001871,6,5,0,5,2,18
191001872,2,2,8,7,7,26
191001873,4,5,3,3,7,22
191001874,6,3,2,1,8,20
191001875,2,5,8,9,6,30
191001876,3,3,2,0,1,9
191001877,9,2,2,1,7,21
191001878,3,0,8,9,1,21
191001879,3,3,2,9,2,19
191001880,8,6,7,6,3,30
191001881,3,8,6,4,5,26
191001882,7,0,5,9,3,24
191001883,1,8,7,7,5,28
191001884,3,1,5,4,4,17
191001885,6,6,4,5,4,25
191001886,0,5,1,3,1,10
191001887,0,7,4,0,1,12
191001888,7,8,9,6,3,33
191001889,4,5,8,6,7,30
191001890,9,6,7,2,9,33
191001891,4,9,1,7,7,28
191001892,6,2,8,8,0,24
191001893,0,9,7,3,9,28
191001894,4,4,3,6,0,17
191001895,7,6,4,2,0,19
191001896,2,0,0,7,6,15
191001897,0,5,3,1,2,11
191001898,8,1,5,6,2,22
191001899,0,8,0,5,5,18
191001900,8,8,5,2,3,26
191001901,2,7,4,9,8,30
191001902,3,9,4,8,0,24
191001903,8,5,2,6,1,22
191001904,2,4,4,4,5,19
191001905,7,8,4,7,2,28
191001906,7,6,9,6,2,30
191001907,1,4,1,7,4,17
191001908,0,2,8,6,0,16
191001909,2,3,0,4,6,15
191001910,4,0,1,8,6,19
191001911,2,4,2,9,0,17
191001912,8,2,7,6,6,29
191001913,3,1,7,4,8,23
191001914,1,7,0,5,2,15
191001915,3,6,8,6,4,27
191001916,2,2,5,8,0,17
191001917,8,2,9,8,3,30
191001918,6,8,2,5,3,24
191001919,4,0,1,6,7,18
191001920,6,4,3,2,0,15
191001921,7,8,2,4,7,28
191001922,7,6,0,2,2,17
191001923,0,9,4,7,9,29
191001924,2,5,5,4,2,18
191001925,0,0,2,0,9,11
191001926,2,5,1,7,7,22
191001927,1,5,1,8,2,17
191001928,0,5,1,9,3,18
191001929,0,7,4,9,2,22
191001930,7,0,5,5,3,20
191001931,9,5,6,5,6,31
191001932,2,1,2,5,5,15
191001933,4,1,0,9,5,19
191001934,2,3,7,9,1,22
191001935,3,8,6,2,7,26
191001936,6,4,2,3,3,18
191001937,3,3,5,8,4,23
191001938,0,0,8,6,6,20
191001939,7,0,6,7,8,28
191001940,6,1,7,3,0,17
191001941,7,7,2,7,0,23
191001942,1,4,3,8,6,22
191001943,5,1,0,0,3,9
191001944,6,9,5,0,8,28
191001945,4,7,8,3,5,27
191001946,8,5,6,6,5,30
191001947,3,1,3,2,4,13
191001948,6,4,1,9,4,24
191001949,0,5,3,3,2,13
191001950,7,6,3,7,3,26
191001951,8,3,8,6,6,31
191001952,7,3,3,6,8,27
191001953,3,3,7,7,8,28
191001954,4,9,6,1,9,29
191001955,0,0,7,6,2,15
191001956,2,4,3,1,9,19
191001957,7,6,4,8,9,34
191001958,1,9,1,7,4,22
191001959,2,3,9,1,7,22
191001960,6,9,3,7,6,31
191001961,1,5,4,4,9,23
191001962,0,8,7,9,6,30
191001963,2,1,8,8,4,23
191001964,3,7,4,0,1,15
191001965,0,4,7,7,2,20
191001966,2,2,9,9,8,30
191001967,4,8,4,9,3,28
191001968,2,0,3,8,9,22
191001969,5,2,7,1,9,24
191001970,7,2,3,2,9,23
191001971,0,6,5,5,4,20
191001972,0,4,9,1,8,22
191001973,9,2,3,5,4,23
191001974,4,9,0,9,8,30
191001975,3,5,9,0,7,24
191001976,0,4,3,7,3,17
191001977,4,9,7,3,8,31
191001978,8,9,5,7,1,30
191001979,6,4,0,5,1,16
191001980,8,0,2,9,4,23
191001981,4,0,3,9,0,16
191001982,6,2,4,0,1,13
191001983,1,6,6,7,9,29
191001984,8,6,1,7,1,23
191001985,4,9,0,9,3,25
191001986,8,1,0,2,6,17
191001987,4,0,4,8,5,21
191001988,3,4,3,4,4,18
191001989,0,4,5,3,7,19
191001990,8,4,9,3,5,29
191001991,8,3,2,6,8,27
191001992,2,3,7,9,2,23
191001993,5,7,5,7,4,28
191001994,7,7,6,5,0,25
191001995,9,9,4,4,2,28
191001996,4,3,9,5,7,28
191001997,5,1,2,3,1,12
191001998,0,5,1,7,7,20
191001999,0,6,3,7,4,20
1910011000,3,0,2,6,0,11
1910011001,9,2,1,9,2,23
1910011002,6,9,9,2,6,32
1910011003,1,8,7,8,0,24
1910011004,7,9,2,5,7,30
1910011005,1,8,7,3,8,27
1910011006,7,6,7,3,7,30
1910011007,0,8,7,5,7,27
1910011008,1,6,8,9,3,27
1910011009,0,3,9,4,6,22
1910011010,3,6,3,1,4,17
1910011011,3,9,4,7,1,24
1910011012,8,4,2,2,2,18
1910011013,4,6,3,2,5,20
1910011014,2,7,9,8,8,34
1910011015,8,4,6,1,1,20
1910011016,8,9,3,3,1,24
1910011017,5,1,1,9,4,20
1910011018,7,8,2,3,1,21
1910011019,5,0,4,4,6,19
1910011020,5,2,0,2,4,13
1910011021,2,4,2,2,0,10
1910011022,0,1,3,4,9,17
1910011023,2,8,1,4,9,24
1910011024,7,1,0,7,3,18
1910011025,0,2,2,2,8,14
1910011026,2,7,8,4,4,25
1910011027,4,3,2,5,2,16
1910011028,9,7,4,6,7,33
1910011029,3,8,4,6,2,23
1910011030,3,6,1,0,4,14
1910011031,6,2,1,1,5,15
1910011032,0,4,3,0,2,9
1910011033,1,6,3,8,8,26
1910011034,6,1,0,8,9,24
1910011035,4,1,1,7,8,21
1910011036,5,8,4,0,3,20
1910011037,1,9,4,6,8,28
1910011038,1,5,2,9,6,23
1910011039,8,3,9,1,1,22
1910011040,1,3,9,2,4,19
1910011041,3,6,4,2,4,19
1910011042,5,2,9,5,8,29
1910011043,9,2,1,3,5,20
1910011044,6,4,5,6,5,26
1910011045,2,9,9,6,5,31
1910011046,2,1,1,7,7,18
1910011047,8,0,6,4,6,24
1910011048,3,3,1,5,1,13
1910011049,8,3,0,3,5,19
1910011050,0,2,7,3,2,14
1910011051,6,5,6,9,2,28
1910011052,1,0,2,0,8,11
1910011053,4,9,4,5,9,31
1910011054,8,8,7,5,8,36
1910011055,1,8,7,8,3,27
1910011056,3,8,8,1,2,22
1910011057,6,4,7,9,0,26
1910011058,0,3,7,3,2,15
1910011059,0,5,7,0,1,13
1910011060,2,6,7,7,7,29
1910011061,3,4,4,8,9,28
1910011062,9,4,0,2,3,18
1910011063,6,6,8,2,5,27
1910011064,1,4,4,8,4,21
1910011065,0,4,6,2,0,12
1910011066,7,4,5,7,4,27
1910011067,3,8,1,7,9,28
1910011068,4,1,3,8,4,20
1910011069,4,3,7,2,6,22
1910011070,8,6,7,9,5,35
1910011071,2,4,5,7,3,21
1910011072,3,2,4,0,4,13
1910011073,2,0,8,0,6,16
1910011074,9,7,5,7,7,35
1910011075,2,5,0,3,0,10
1910011076,9,2,5,7,0,23
1910011077,6,6,3,7,0,22
1910011078,2,0,1,0,4,7
1910011079,5,3,6,0,3,17
1910011080,5,2,1,5,0,13
1910011081,5,2,9,9,9,34
1910011082,1,7,5,9,1,23
1910011083,2,7,5,0,8,22
1910011084,0,0,1,1,1,3
1910011085,4,3,3,4,0,14
1910011086,4,3,3,5,9,24
1910011087,9,8,6,1,8,32
1910011088,7,8,9,0,6,30
1910011089,2,2,3,1,8,16
1910011090,9,4,0,1,7,21
1910011091,1,2,7,5,1,16
1910011092,1,1,3,4,5,14
1910011093,2,1,7,8,2,20
1910011094,2,7,8,7,6,30
1910011095,0,6,7,7,1,21
1910011096,5,1,7,8,9,30
1910011097,7,2,4,5,2,20
1910011098,5,5,6,3,2,21
1910011099,7,9,3,6,3,28
1910011100,4,9,8,3,6,30
1910011101,3,5,4,0,5,17
1910011102,6,6,1,2,2,17
1910011103,7,4,2,8,4,25
1910011104,6,7,8,8,7,36
1910011105,7,7,5,6,6,31
191002001,9,3,8,0,6,26
191002002,2,4,6,4,5,21
191002003,5,3,3,3,6,20
191002004,4,9,7,2,3,25
191002005,3,3,3,9,7,25
191002006,8,2,7,6,3,26
191002007,5,9,2,0,3,19
191002008,4,2,1,7,7,21
191002009,3,3,0,0,6,12
191002010,2,5,6,8,8,29
191002011,1,2,4,0,9,16
191002012,0,0,6,1,4,11
191002013,9,5,2,3,9,28
191002014,5,0,1,9,0,15
191002015,1,6,7,3,5,22
191002016,1,5,9,9,2,26
191002017,2,5,5,2,4,18
191002018,0,7,9,3,0,19
191002019,9,7,7,6,3,32
191002020,1,5,4,5,8,23
191002021,9,0,6,5,8,28
191002022,2,4,9,9,5,29
191002023,9,1,2,7,1,20
191002024,7,9,8,0,6,30
191002025,6,5,3,9,5,28
191002026,6,5,5,8,6,30
191002027,7,8,2,0,6,23
191002028,9,3,1,7,5,25
191002029,2,9,8,4,0,23
191002030,4,5,6,7,9,31
191002031,1,3,4,8,8,24
191002032,6,1,7,7,2,23
191002033,1,5,3,5,7,21
191002034,4,5,2,3,4,18
191002035,5,7,4,6,9,31
191002036,7,9,7,2,2,27
191002037,9,1,6,8,7,31
191002038,0,6,1,8,4,19
191002039,0,6,6,6,2,20
191002040,6,4,8,9,9,36
191002041,9,7,6,0,5,27
191002042,9,4,6,8,3,30
191002043,1,3,4,5,7,20
191002044,4,4,3,2,0,13
191002045,9,6,9,5,3,32
191002046,6,8,9,8,7,38
191002047,2,6,3,7,1,19
191002048,4,3,7,9,1,24
191002049,6,0,7,9,4,26
191002050,4,5,2,5,0,16
191002051,5,5,7,8,3,28
191002052,6,0,2,6,0,14
191002053,6,7,6,1,8,28
191002054,3,2,7,4,2,18
191002055,6,4,3,1,8,22
191002056,8,9,1,4,7,29
191002057,5,6,2,6,1,20
191002058,2,4,3,4,7,20
191002059,4,0,2,6,4,16
191002060,8,5,0,6,1,20
191002061,7,9,4,8,8,36
191002062,4,6,7,6,0,23
191002063,6,4,7,4,2,23
191002064,8,5,1,4,9,27
191002065,5,9,9,6,8,37
191002066,3,5,9,3,8,28
191002067,1,3,9,6,0,19
191002068,5,5,6,8,0,24
191002069,7,7,9,5,9,37
191002070,9,8,3,1,5,26
191002071,8,0,6,0,1,15
191002072,6,2,8,4,1,21
191002073,2,3,7,1,6,19
191002074,1,9,2,8,8,28
191002075,7,9,1,9,8,34
191002076,4,4,5,7,1,21
191002077,3,6,6,9,9,33
191002078,7,7,6,3,5,28
191002079,6,5,6,0,5,22
191002080,8,0,4,3,6,21
191002081,3,5,9,4,2,23
191002082,1,7,7,9,9,33
191002083,6,2,4,6,7,25
191002084,0,9,4,5,9,27
191002085,8,0,2,5,0,15
191002086,7,1,0,8,7,23
191002087,3,1,5,2,0,11
191002088,0,7,3,3,0,13
191002089,9,5,3,5,6,28
191002090,5,9,0,9,4,27
191002091,7,0,1,5,6,19
191002092,0,7,2,4,9,22
191002093,9,4,9,1,1,24
191002094,9,1,8,9,2,29
191002095,5,2,7,8,6,28
191002096,1,6,8,8,0,23
191002097,0,5,5,0,8,18
191002098,6,6,4,6,0,22
191002099,2,7,6,1,9,25
191002100,4,3,6,2,2,17
191002101,8,7,3,3,8,29
191002102,6,1,5,4,9,25
191002103,4,2,0,4,5,15
191002104,0,2,5,4,2,13
191002105,0,1,4,7,9,21
191002106,8,2,0,2,7,19
191002107,8,0,7,4,3,22
191002108,0,6,5,1,8,20
191002109,1,0,6,1,1,9
191002110,8,2,3,5,7,25
191002111,7,5,0,8,8,28
191002112,6,2,4,9,9,30
191002113,8,7,4,1,2,22
191002114,9,7,0,3,0,19
191002115,4,4,6,5,0,19
191002116,4,1,9,1,0,15
191002117,9,0,4,5,9,27
191002118,9,6,5,0,8,28
191002119,5,3,1,7,1,17
191002120,8,4,4,9,0,25
191002121,3,3,5,0,4,15
191002122,3,5,1,1,8,18
191002123,9,5,7,4,9,34
191002124,4,7,0,0,5,16
191002125,4,4,8,1,3,20
191002126,7,0,4,6,0,17
191002127,9,8,0,1,5,23
191002128,8,2,1,1,9,21
191002129,5,3,1,4,2,15
191002130,9,3,4,1,3,20
191002131,2,0,9,1,8,20
191002132,6,8,9,4,0,27
191002133,0,7,1,1,8,17
191002134,4,1,8,0,6,19
191002135,5,8,8,4,2,27
191002136,4,5,2,6,4,21
191002137,1,4,6,8,4,23
191002138,1,2,3,3,4,13
191002139,4,2,2,2,4,14
191002140,3,2,5,1,8,19
191002141,5,0,5,3,4,17
191002142,8,8,0,6,0,22
191002143,8,3,5,1,1,18
191002144,6,3,5,6,8,28
191002145,5,4,6,8,1,24
191002146,8,7,8,9,5,37
191002147,3,9,2,1,1,16
191002148,3,8,3,1,8,23
191002149,8,0,5,1,1,15
191002150,4,6,2,6,8,26
191002151,9,9,4,9,0,31
191002152,6,2,4,1,0,13
191002153,7,1,0,4,4,16
191002154,2,4,6,5,1,18
191002155,3,3,3,4,1,14
191002156,9,7,0,8,7,31
191002157,4,3,2,8,9,26
191002158,8,3,3,8,4,26
191002159,3,2,6,0,3,14
191002160,9,1,9,3,1,23
191002161,1,4,4,6,6,21
191002162,5,1,1,3,4,14
191002163,4,4,8,6,7,29
191002164,2,6,0,4,6,18
191002165,3,9,9,0,4,25
191002166,2,4,9,8,3,26
191002167,0,3,7,7,8,25
191002168,1,1,7,9,2,20
191002169,7,2,8,0,9,26
191002170,3,3,2,1,6,15
191002171,5,1,3,1,8,18
191002172,7,3,1,8,2,21
191002173,5,9,2,5,4,25
191002174,7,6,2,5,2,22
191002175,9,4,3,8,0,24
191002176,8,6,4,9,7,34
191002177,0,5,3,4,5,17
191002178,0,3,9,7,9,28
191002179,5,5,3,3,9,25
191002180,6,6,3,3,4,22
191002181,1,1,6,9,4,21
191002182,0,2,3,4,2,11
191002183,7,2,1,5,9,24
191002184,4,0,5,4,8,21
191002185,8,8,6,6,6,34
191002186,9,0,3,8,3,23
191002187,2,0,2,1,5,10
191002188,2,5,6,5,2,20
191002189,2,8,6,6,3,25
191002190,0,3,7,1,6,17
191002191,8,6,4,2,8,28
191002192,6,2,8,2,7,25
191002193,3,5,3,4,9,24
191002194,0,3,8,4,3,18
191002195,6,6,0,0,1,13
191002196,0,9,3,2,7,21
191002197,1,8,0,6,1,16
191002198,1,0,7,0,3,11
191002199,0,6,1,6,8,21
191002200,8,1,7,2,8,26
191002201,1,2,7,4,2,16
191002202,2,5,8,5,2,22
191002203,1,0,1,9,5,16
191002204,0,2,9,7,8,26
191002205,2,2,1,4,8,17
191002206,5,2,2,9,9,27
191002207,1,2,2,5,5,15
191002208,4,7,0,5,5,21
191002209,7,6,7,1,9,30
191002210,4,2,2,0,7,15
191002211,0,5,2,9,7,23
191002212,5,2,6,7,1,21
191002213,6,7,9,2,7,31
191002214,6,0,8,4,9,27
191002215,3,4,5,9,8,29
191002216,1,6,8,8,1,24
191002217,9,5,9,8,0,31
191002218,6,6,6,1,9,28
191002219,0,6,1,5,0,12
191002220,6,0,0,8,2,16
191002221,6,6,7,4,7,30
191002222,6,4,2,2,8,22
191002223,5,1,6,6,9,27
191002224,2,8,3,2,4,19
191002225,1,4,2,3,6,16
191002226,9,1,0,5,1,16
191002227,7,7,0,1,2,17
191002228,6,9,2,1,1,19
191002229,4,0,2,8,3,17
191002230,0,1,5,0,1,7
191002231,2,7,5,6,8,28
191002232,6,1,6,9,7,29
191002233,7,2,9,2,9,29
191002234,4,5,5,3,7,24
191002235,2,7,8,2,7,26
191002236,1,0,5,4,7,17
191002237,0,9,0,6,6,21
191002238,5,9,8,9,4,35
191002239,5,0,3,2,8,18
191002240,0,0,6,6,2,14
191002241,6,9,2,9,2,28
191002242,8,5,6,1,5,25
191002243,1,3,5,2,7,18
191002244,3,7,4,7,6,27
191002245,5,3,3,6,6,23
191002246,2,6,0,8,6,22
191002247,6,7,5,3,6,27
191002248,1,5,5,2,1,14
191002249,6,4,7,4,3,24
191002250,9,9,2,5,3,28
191002251,4,2,6,5,8,25
191002252,6,8,8,8,4,34
191002253,9,9,7,7,7,39
191002254,1,2,3,5,2,13
191002255,6,6,7,3,0,22
191002256,2,1,5,7,3,18
191002257,9,7,4,8,4,32
191002258,3,6,0,0,1,10
191002259,4,4,4,1,2,15
191002260,7,0,1,4,2,14
191002261,0,0,7,4,7,18
191002262,6,2,9,3,4,24
191002263,2,6,8,1,7,24
191002264,7,2,8,6,7,30
191002265,6,4,2,3,0,15
191002266,2,5,8,2,9,26
191002267,7,2,3,5,4,21
191002268,9,3,5,8,1,26
191002269,8,2,8,3,7,28
191002270,6,7,9,0,9,31
191002271,4,1,1,8,5,19
191002272,2,9,3,6,6,26
191002273,7,4,3,1,2,17
191002274,0,6,1,8,2,17
191002275,9,1,3,1,6,20
191002276,9,3,6,3,0,21
191002277,5,5,5,9,8,32
191002278,6,6,1,5,0,18
191002279,8,3,9,5,4,29
191002280,3,0,6,7,0,16
191002281,8,2,6,3,5,24
191002282,3,7,2,7,8,27
191002283,2,5,5,5,9,26
191002284,1,1,0,6,0,8
191002285,8,5,2,1,1,17
191002286,7,1,6,5,3,22
191002287,1,4,7,3,2,17
191002288,9,9,6,8,4,36
191002289,6,9,1,4,1,21
191002290,2,0,0,6,7,15
191002291,7,6,1,0,5,19
191002292,2,0,6,7,8,23
191002293,2,1,9,8,4,24
191002294,8,3,3,4,9,27
191002295,6,6,2,7,5,26
191002296,2,6,8,6,9,31
191002297,2,0,5,5,8,20
191002298,5,3,5,9,3,25
191002299,6,5,1,6,0,18
191002300,4,9,9,8,8,38
191002301,6,2,5,7,5,25
191002302,4,5,0,9,2,20
191002303,2,6,2,3,4,17
191002304,2,4,1,6,7,20
191002305,3,9,8,8,0,28
191002306,6,1,9,8,2,26
191002307,8,4,8,1,3,24
191002308,4,7,6,2,1,20
191002309,9,0,1,7,3,20
191002310,8,1,5,9,8,31
191002311,6,8,3,6,2,25
191002312,4,9,1,9,2,25
191002313,7,1,3,3,7,21
191002314,1,8,4,1,6,20
191002315,0,5,1,9,4,19
191002316,9,0,0,8,6,23
191002317,8,7,6,3,8,32
191002318,3,1,9,3,0,16
191002319,7,8,9,0,2,26
191002320,4,4,6,8,7,29
191002321,7,5,8,2,5,27
191002322,2,0,7,6,9,24
191002323,4,1,4,4,3,16
191002324,9,7,5,5,1,27
191002325,9,3,3,9,5,29
191002326,3,3,8,4,0,18
191002327,6,9,9,8,0,32
191002328,5,8,5,4,1,23
191002329,6,9,2,7,0,24
191002330,1,8,9,0,0,18
191002331,5,9,3,7,3,27
191002332,8,8,0,6,5,27
191002333,6,1,8,5,1,21
191002334,9,1,6,7,1,24
191002335,9,3,5,9,6,32
191002336,4,0,4,9,9,26
191002337,9,5,2,9,0,25
191002338,6,3,1,3,4,17
191002339,8,6,8,9,3,34
191002340,0,2,3,9,4,18
191002341,4,6,4,8,7,29
191002342,4,0,6,8,5,23
191002343,9,0,3,7,5,24
191002344,8,3,4,5,3,23
191002345,1,7,9,4,9,30
191002346,4,4,8,0,0,16
191002347,7,0,2,6,0,15
191002348,4,9,0,7,2,22
191002349,6,4,5,7,7,29
191002350,3,0,6,6,7,22
191002351,6,0,3,8,7,24
191002352,2,1,7,0,2,12
191002353,9,1,9,1,9,29
191002354,3,3,6,2,7,21
191002355,1,8,4,7,8,28
191002356,1,7,1,4,5,18
191002357,6,7,3,8,1,25
191002358,8,5,8,7,5,33
191002359,0,6,2,6,0,14
191002360,0,4,2,5,4,15
191002361,2,6,6,0,7,21
191002362,5,5,0,4,8,22
191002363,0,9,1,2,6,18
191002364,6,1,0,1,1,9
191002365,3,0,9,6,1,19
191002366,1,4,5,5,8,23
191002367,7,4,6,2,0,19
191002368,7,7,4,2,8,28
191002369,1,7,8,8,9,33
191002370,0,1,0,5,8,14
191002371,0,7,2,8,8,25
191002372,5,1,4,1,8,19
191002373,4,1,4,1,8,18
191002374,9,2,8,3,2,24
191002375,6,2,6,3,4,21
191002376,6,8,6,9,2,31
191002377,3,0,5,1,5,14
191002378,3,6,9,4,0,22
191002379,5,3,6,3,5,22
191002380,1,6,1,1,2,11
191002381,2,0,7,8,1,18
191002382,9,7,8,5,2,31
191002383,1,1,9,3,4,18
191002384,2,1,4,8,0,15
191002385,2,8,6,1,7,24
191002386,1,9,1,6,6,23
191002387,8,8,4,6,9,35
191002388,7,8,8,1,9,33
191002389,0,0,4,1,6,11
191002390,6,5,6,3,4,24
191002391,0,8,2,2,8,20
191002392,9,2,2,2,4,19
191002393,2,3,6,4,9,24
191002394,4,6,6,5,2,23
191002395,9,4,9,6,4,32
191002396,4,8,1,2,5,20
191002397,2,9,9,4,9,33
191002398,9,6,7,4,3,29
191002399,9,6,6,1,9,31
191002400,4,1,1,8,6,20
191002401,7,3,3,6,6,25
191002402,8,3,7,2,1,21
191002403,3,0,3,7,3,16
191002404,1,5,3,2,5,16
191002405,3,3,5,5,7,23
191002406,3,3,2,7,1,16
191002407,2,4,0,2,3,11
191002408,4,2,9,8,1,24
191002409,0,8,9,4,3,24
191002410,2,0,8,1,9,20
191002411,7,4,7,1,3,22
191002412,1,1,5,5,6,18
191002413,8,2,5,7,0,22
191002414,0,7,1,6,5,19
191002415,4,1,1,9,0,15
191002416,3,7,0,8,3,21
191002417,6,8,2,2,6,24
191002418,9,7,3,1,7,27
191002419,3,1,9,8,0,21
191002420,6,8,4,1,6,25
191002421,6,0,0,3,1,10
191002422,4,5,1,9,5,24
191002423,5,1,3,3,0,12
191002424,5,4,3,6,4,22
191002425,3,3,4,6,1,17
191002426,5,5,0,6,3,19
191002427,0,0,6,0,9,15
191002428,3,1,5,4,7,20
191002429,6,9,8,1,5,29
191002430,4,7,8,1,9,29
191002431,8,0,3,6,5,22
191002432,8,4,1,5,0,18
191002433,0,0,8,7,5,20
191002434,7,3,3,0,9,22
191002435,9,6,2,6,6,29
191002436,4,1,2,7,3,17
191002437,4,7,1,1,9,22
191002438,8,9,8,7,2,34
191002439,4,6,7,5,9,31
191002440,7,1,9,1,5,23
191002441,5,0,5,8,1,19
191002442,7,1,0,7,9,24
191002443,8,1,1,6,4,20
191002444,7,6,3,3,2,21
191002445,7,0,6,7,2,22
191002446,0,0,2,3,0,5
191002447,1,1,5,1,8,16
191002448,7,4,8,0,9,28
191002449,3,7,1,2,9,22
191002450,0,5,6,8,8,27
191002451,0,2,9,0,3,14
191002452,1,3,6,9,3,22
191002453,9,0,8,6,8,31
191002454,8,7,3,4,6,28
191002455,7,3,5,7,6,28
191002456,8,9,6,1,3,27
191002457,0,4,3,6,7,20
191002458,2,8,7,3,8,28
191002459,7,6,1,5,1,20
191002460,6,3,3,5,0,17
191002461,3,1,5,0,8,17
191002462,7,8,9,7,8,39
191002463,4,5,5,9,7,30
191002464,3,4,3,3,2,15
191002465,8,3,3,5,5,24
191002466,5,5,0,9,2,21
191002467,2,2,1,5,5,15
191002468,4,1,1,2,8,16
191002469,5,9,9,1,3,27
191002470,6,6,5,5,1,23
191002471,8,5,7,6,1,27
191002472,3,7,7,7,5,29
191002473,6,5,1,2,5,19
191002474,2,2,7,1,6,18
191002475,4,7,6,3,1,21
191002476,1,1,0,6,8,16
191002477,2,5,9,6,3,25
191002478,8,4,7,4,3,26
191002479,4,6,3,9,2,24
191002480,5,9,4,7,0,25
191002481,3,8,1,2,1,15
191002482,7,0,9,4,5,25
191002483,6,0,3,5,7,21
191002484,9,2,4,8,1,24
191002485,8,4,8,5,4,29
191002486,4,6,5,0,2,17
191002487,5,7,8,2,1,23
191002488,9,6,5,8,7,35
191002489,6,7,2,3,5,23
191002490,9,6,8,0,6,29
191002491,5,8,6,4,4,27
191002492,0,7,2,5,5,19
191002493,4,7,3,4,9,27
191002494,0,8,5,8,9,30
191002495,2,1,3,4,9,19
191002496,6,1,5,1,6,19
191002497,1,0,0,5,4,10
191002498,7,5,4,8,8,32
191002499,3,6,0,0,4,13
191002500,5,8,4,2,9,28
191002501,7,4,9,8,6,34
191002502,0,4,9,9,6,28
191002503,8,6,8,8,3,33
191002504,0,5,0,0,1,6
191002505,1,2,3,5,0,11
191002506,9,3,8,3,1,24
191002507,8,6,6,4,1,25
191002508,0,5,7,5,8,25
191002509,8,3,0,7,3,21
191002510,6,9,7,2,5,29
191002511,7,5,1,5,3,21
191002512,4,7,3,5,0,19
191002513,9,5,3,9,6,32
191002514,7,2,2,3,1,15
191002515,6,7,1,7,5,26
191002516,5,7,4,3,1,20
191002517,7,7,2,7,1,24
191002518,0,0,5,5,4,14
191002519,4,7,2,0,7,20
191002520,8,7,4,0,1,20
191002521,6,2,7,8,2,25
191002522,2,1,6,5,8,22
191002523,5,6,8,8,6,33
191002524,8,9,9,4,2,32
191002525,3,9,2,4,1,19
191002526,2,7,6,6,0,21
191002527,7,6,6,5,5,29
191002528,7,3,7,0,0,17
191002529,6,8,4,0,2,20
191002530,9,3,9,0,6,27
191002531,3,4,0,5,4,16
191002532,0,7,0,4,6,17
191002533,9,3,1,3,7,23
191002534,2,4,9,9,4,28
191002535,3,0,9,9,7,28
191002536,2,3,1,5,6,17
191002537,2,9,2,7,7,27
191002538,0,4,0,0,0,4
191002539,1,0,3,7,5,16
191002540,7,4,3,2,7,23
191002541,0,1,4,7,5,17
191002542,2,9,5,1,8,25
191002543,2,4,4,6,3,19
191002544,3,3,4,3,2,15
191002545,1,1,4,1,0,7
191002546,2,8,6,7,7,30
191002547,1,5,0,7,6,19
191002548,1,4,4,2,1,12
191002549,9,0,8,2,8,27
191002550,0,4,9,4,4,21
191002551,2,6,2,0,4,14
191002552,6,3,6,5,5,25
191002553,0,2,0,8,3,13
191002554,2,4,7,1,8,22
191002555,7,2,1,4,2,16
191002556,1,2,5,2,0,10
191002557,5,5,8,6,2,26
191002558,2,9,6,2,1,20
191002559,5,6,1,7,9,28
191002560,2,5,3,2,6,18
191002561,8,1,4,5,8,26
191002562,9,7,8,3,1,28
191002563,3,3,2,9,1,18
191002564,3,4,1,6,1,15
191002565,2,4,8,8,0,22
191002566,3,8,3,5,8,27
191002567,6,0,3,2,9,20
191002568,0,9,4,0,7,20
191002569,3,4,4,2,5,18
191002570,8,7,9,0,4,28
191002571,8,9,1,1,8,27
191002572,3,1,1,0,8,13
191002573,6,9,4,9,6,34
191002574,4,3,5,8,3,23
191002575,3,7,2,1,1,14
191002576,9,1,6,0,7,23
191002577,9,6,1,0,6,22
191002578,5,2,7,8,8,30
191002579,5,3,0,7,9,24
191002580,1,5,2,9,8,25
191002581,3,7,3,9,8,30
191002582,9,6,2,7,9,33
191002583,0,8,7,7,3,25
191002584,3,5,0,0,6,14
191002585,2,7,3,3,5,20
191002586,3,6,6,0,0,15
191002587,8,9,6,1,7,31
191002588,2,7,2,2,9,22
191002589,3,0,8,8,1,20
191002590,3,9,1,6,9,28
191002591,6,7,5,4,7,29
191002592,2,4,8,0,4,18
191002593,6,0,3,7,8,24
191002594,0,4,0,0,9,13
191002595,8,4,8,8,4,32
191002596,7,3,2,6,3,21
191002597,4,0,1,2,1,8
191002598,0,4,4,4,0,12
191002599,4,7,7,6,8,32
191002600,2,7,1,6,7,23
191002601,7,7,8,6,2,30
191002602,5,3,5,3,0,16
191002603,0,6,0,8,8,22
191002604,4,3,0,0,5,12
191002605,1,0,0,2,0,3
191002606,7,6,6,1,8,28
191002607,5,3,3,9,9,29
191002608,8,2,4,1,4,19
191002609,3,8,9,6,0,26
191002610,1,6,3,4,9,23
191002611,6,4,7,2,7,26
191002612,8,4,1,1,1,15
191002613,4,2,8,2,4,20
191002614,7,7,3,3,4,24
191002615,6,7,8,3,1,25
191002616,2,0,9,0,5,16
191002617,4,8,9,8,9,38
191002618,6,4,5,0,3,18
191002619,7,0,0,9,3,19
191002620,7,5,5,6,3,26
191002621,0,1,6,9,0,16
191002622,3,8,4,1,3,19
191002623,8,9,4,6,6,33
191002624,3,1,1,8,2,15
191002625,2,0,8,5,6,21
191002626,7,4,8,0,1,20
191002627,2,9,7,2,9,29
191002628,6,9,3,5,5,28
191002629,6,7,5,1,9,28
191002630,0,6,6,1,8,21
191002631,2,7,5,9,9,32
191002632,7,3,4,6,9,29
191002633,3,3,9,4,7,26
191002634,6,6,1,4,1,18
191002635,7,1,8,3,9,28
191002636,7,8,0,3,4,22
191002637,1,5,5,0,4,15
191002638,9,1,5,3,7,25
191002639,9,4,1,1,9,24
191002640,9,7,0,8,1,25
191002641,6,4,5,6,3,24
191002642,7,4,8,5,1,25
191002643,1,4,5,0,5,15
191002644,8,0,9,5,6,28
191002645,0,3,3,1,7,14
191002646,2,0,5,4,3,14
191002647,8,1,6,1,3,19
191002648,7,1,1,2,7,18
191002649,4,4,7,1,3,19
191002650,5,8,5,3,9,30
191002651,1,2,8,2,2,15
191002652,1,1,3,5,2,12
191002653,4,3,0,4,1,12
191002654,1,3,5,3,2,14
191002655,7,7,7,5,5,31
191002656,6,5,4,2,4,21
191002657,7,5,1,0,2,15
191002658,6,8,9,3,6,32
191002659,8,3,3,9,2,25
191002660,0,3,1,2,3,9
191002661,5,5,6,3,0,19
191002662,0,8,5,8,4,25
191002663,3,2,3,3,7,18
191002664,2,0,3,5,7,17
191002665,9,3,0,1,6,19
191002666,2,4,0,5,7,18
191002667,3,5,5,6,2,21
191002668,6,0,1,0,6,13
191002669,9,1,0,7,4,21
191002670,8,2,7,6,0,23
191002671,3,9,9,1,0,22
191002672,3,4,8,5,9,29
191002673,9,0,4,7,8,28
191002674,5,6,1,6,7,25
191002675,3,6,9,1,3,22
191002676,9,1,0,1,8,19
191002677,5,3,5,3,6,22
191002678,9,0,6,2,3,20
191002679,2,5,6,2,4,19
191002680,2,5,5,6,0,18
191002681,3,5,9,8,4,29
191002682,2,4,8,7,9,30
191002683,9,9,9,5,2,34
191002684,9,2,5,4,0,20
191002685,7,1,1,8,8,25
191002686,6,4,1,8,8,27
191002687,6,3,5,1,8,23
191002688,1,2,3,5,4,15
191002689,0,6,7,9,1,23
191002690,8,4,4,1,1,18
191002691,1,8,7,9,7,32
191002692,9,8,3,6,1,27
191002693,6,4,7,1,4,22
191002694,6,3,8,9,8,34
191002695,5,3,0,6,5,19
191002696,2,0,5,9,9,25
191002697,4,0,8,6,2,20
191002698,8,2,9,2,3,24
191002699,3,9,7,5,0,24
191002700,7,9,6,2,6,30
191002701,9,0,6,3,5,23
191002702,9,3,9,5,2,28
191002703,7,0,2,1,4,14
191002704,9,3,1,1,3,17
191002705,3,4,2,7,0,16
191002706,8,6,9,9,4,36
191002707,5,3,3,9,0,20
191002708,0,5,3,7,5,20
191002709,4,2,4,0,3,13
191002710,0,3,5,9,7,24
191002711,8,8,5,1,0,22
191002712,2,8,4,1,6,21
191002713,9,0,4,1,9,23
191002714,9,9,2,2,8,30
191002715,1,0,3,6,8,18
191002716,3,3,7,9,7,29
191002717,8,6,8,4,6,32
191002718,0,7,1,8,9,25
191002719,1,2,3,7,5,18
191002720,3,1,9,3,8,24
191002721,8,1,9,9,7,34
191002722,5,3,9,0,2,19
191002723,3,6,4,0,1,14
191002724,3,1,7,1,0,12
191002725,2,9,4,8,5,28
191002726,4,3,4,7,2,20
191002727,7,1,8,0,5,21
191002728,2,3,9,4,9,27
191002729,2,7,3,6,1,19
191002730,2,7,4,0,7,20
191002731,8,2,3,3,1,17
191002732,4,3,1,2,2,12
191002733,4,4,8,6,9,31
191002734,0,3,0,3,7,13
191002735,9,2,4,1,1,17
191002736,0,6,7,9,5,27
191002737,3,5,0,0,7,15
191002738,5,2,8,4,4,23
191002739,0,8,0,3,0,11
191002740,9,3,9,0,8,29
191002741,3,0,2,5,0,10
191002742,6,8,4,3,7,28
191002743,0,2,3,4,9,18
191002744,8,4,9,3,4,28
191002745,2,7,7,7,9,32
191002746,1,0,5,8,0,14
191002747,9,5,3,8,3,28
191002748,5,1,2,4,0,12
191002749,2,0,9,6,1,18
191002750,6,3,3,4,5,21
191002751,0,0,0,8,2,10
191002752,5,0,2,3,6,16
191002753,4,9,3,8,4,28
191002754,5,2,9,0,3,19
191002755,0,6,3,6,6,21
191002756,0,7,4,6,3,20
191002757,3,2,2,9,6,22
191002758,7,8,8,7,5,35
191002759,8,6,8,3,4,29
191002760,8,8,1,2,9,28
191002761,7,3,0,3,9,22
191002762,6,5,8,2,8,29
191002763,0,8,8,1,2,19
191002764,1,6,6,5,5,23
191002765,9,4,6,0,7,26
191002766,5,6,9,4,7,31
191002767,6,7,3,5,9,30
191002768,4,2,5,0,6,17
191002769,8,1,6,6,1,22
191002770,4,5,1,7,8,25
191002771,2,8,9,8,0,27
191002772,1,1,2,9,7,20
191002773,1,3,4,2,4,14
191002774,3,2,6,1,6,18
191002775,0,7,1,4,8,20
191002776,9,9,8,2,2,30
191002777,4,8,3,6,3,24
191002778,8,7,4,5,8,32
191002779,7,0,3,0,6,16
191002780,7,0,6,0,5,18
191002781,1,5,8,9,6,29
191002782,2,9,5,0,7,23
191002783,7,2,0,2,2,13
191002784,7,2,7,6,3,25
191002785,2,1,5,8,4,20
191002786,3,7,5,2,7,24
191002787,0,2,1,2,7,12
191002788,9,1,6,4,3,23
191002789,0,3,1,5,2,11
191002790,1,4,3,2,2,12
191002791,8,5,7,0,6,26
191002792,6,2,2,8,4,22
191002793,6,1,9,0,9,25
191002794,1,5,3,7,5,21
191002795,2,6,5,4,6,23
191002796,0,8,8,6,6,28
191002797,6,6,3,3,0,18
191002798,6,0,3,8,4,21
191002799,5,2,1,7,1,16
191002800,7,1,3,4,9,24
191002801,1,5,0,5,6,17
191002802,4,0,3,6,2,15
191002803,4,9,2,7,0,22
191002804,1,4,6,7,9,27
191002805,2,0,8,9,1,20
191002806,0,9,0,5,6,20
191002807,4,2,1,7,8,22
191002808,0,1,3,1,5,10
191002809,7,2,7,4,7,27
191002810,4,6,5,8,3,26
191002811,4,7,3,1,0,15
191002812,5,1,0,6,3,15
191002813,7,1,0,7,1,16
191002814,8,2,7,2,0,19
191002815,8,0,5,3,1,17
191002816,4,8,6,2,6,26
191002817,6,1,4,8,1,20
191002818,5,8,6,2,0,21
191002819,2,2,8,5,1,18
191002820,6,4,6,9,4,29
191002821,6,9,1,6,3,25
191002822,5,4,7,1,8,25
191002823,8,6,1,4,6,25
191002824,2,7,2,5,8,24
191002825,8,9,4,4,0,25
191002826,8,3,6,1,3,21
191002827,6,1,8,8,0,23
191002828,1,6,8,2,9,26
191002829,6,1,0,3,7,17
191002830,8,6,0,6,3,23
191002831,5,0,3,1,9,18
191002832,6,1,3,6,8,24
191002833,9,4,4,9,2,28
191002834,8,7,5,3,1,24
191002835,7,9,3,7,4,30
191002836,2,0,0,2,5,9
191002837,8,3,8,7,5,31
191002838,6,7,1,0,4,18
191002839,4,6,3,7,0,20
191002840,8,2,1,8,6,25
191002841,7,7,8,9,2,33
191002842,6,1,7,1,6,21
191002843,8,4,1,7,9,29
191002844,2,0,1,0,9,12
191002845,4,7,2,2,3,18
191002846,9,4,9,8,9,39
191002847,5,4,8,8,3,28
191002848,4,3,6,4,8,25
191002849,8,2,9,0,1,20
191002850,7,6,2,7,1,23
191002851,2,8,3,4,1,18
191002852,4,9,2,1,7,23
191002853,8,1,9,8,3,29
191002854,2,7,2,5,7,23
191002855,6,5,1,7,2,21
191002856,9,6,7,9,1,32
191002857,2,8,6,4,1,21
191002858,6,2,9,2,3,22
191002859,9,5,5,9,6,34
191002860,1,3,4,7,7,22
191002861,0,8,4,9,4,25
191002862,7,5,4,7,2,25
191002863,4,6,3,1,1,15
191002864,9,8,6,8,2,33
191002865,0,5,2,6,5,18
191002866,5,8,7,3,9,32
191002867,6,4,6,9,6,31
191002868,3,5,2,6,8,24
191002869,3,0,4,2,9,18
191002870,7,4,3,3,5,22
191002871,2,5,4,9,8,28
191002872,0,8,9,0,8,25
191002873,6,2,3,4,7,22
191002874,2,0,8,0,9,19
191002875,5,0,2,7,9,23
191002876,2,6,5,7,8,28
191002877,8,0,8,5,1,22
191002878,9,1,0,3,6,19
191002879,5,0,3,7,5,20
191002880,5,9,8,8,5,35
191002881,8,9,7,4,4,32
191002882,2,6,1,4,9,22
191002883,8,5,8,7,7,35
191002884,7,5,9,4,0,25
191002885,0,4,6,9,9,28
191002886,8,4,8,6,5,31
191002887,5,5,4,4,1,19
191002888,8,9,0,4,6,27
191002889,8,3,6,6,8,31
191002890,6,7,2,2,1,18
191002891,0,0,3,6,2,11
191002892,4,6,9,6,5,30
191002893,1,0,8,3,0,12
191002894,0,1,0,9,1,11
191002895,4,7,3,4,4,22
191002896,3,3,8,4,6,24
191002897,7,8,2,9,5,31
191002898,4,2,6,1,1,14
191002899,2,9,9,0,1,21
191002900,8,6,9,1,0,24
191002901,3,4,5,0,3,15
191002902,8,2,2,5,6,23
191002903,1,8,8,8,1,26
191002904,7,7,7,1,5,27
191002905,3,4,6,3,5,21
191002906,8,3,9,2,5,27
191002907,3,7,8,7,6,31
191002908,8,7,3,5,6,29
191002909,9,5,3,0,8,25
191002910,2,7,9,1,4,23
191002911,7,8,0,1,4,20
191002912,8,6,8,1,9,32
191002913,2,2,5,4,4,17
191002914,0,4,1,1,4,10
191002915,4,2,1,1,3,11
191002916,9,9,0,3,8,29
191002917,7,9,3,3,2,24
191002918,4,7,2,6,4,23
191002919,2,2,9,1,0,14
191002920,5,6,2,1,4,18
191002921,1,4,1,9,6,21
191002922,0,1,2,2,2,7
191002923,1,1,5,4,1,12
191002924,4,2,0,5,2,13
191002925,2,7,6,2,9,26
191002926,7,6,8,8,8,37
191002927,2,4,2,0,0,8
191002928,5,9,6,6,8,34
191002929,2,5,9,4,7,27
191002930,8,8,2,6,9,33
191002931,5,1,4,0,1,11
191002932,3,7,1,3,7,21
191002933,7,8,8,0,6,29
191002934,6,6,0,1,5,18
191002935,0,1,3,5,9,18
191002936,7,0,8,4,5,24
191002937,9,8,0,3,4,24
191002938,4,3,0,8,7,22
191002939,7,5,4,9,8,33
191002940,1,6,1,1,4,13
191002941,3,6,2,7,9,27
191002942,0,3,9,4,3,19
191002943,6,0,3,6,8,23
191002944,4,5,5,4,7,25
191002945,4,9,4,0,9,26
191002946,5,3,6,8,5,27
191002947,3,6,9,6,7,31
191002948,8,0,2,8,3,21
191002949,1,4,9,8,7,29
191002950,2,2,9,9,4,26
191002951,5,3,7,9,4,28
191002952,9,9,9,5,6,38
191002953,6,5,1,4,4,20
191002954,2,9,5,9,0,25
191002955,6,6,3,4,4,23
191002956,4,4,7,1,6,22
191002957,8,2,0,4,7,21
191002958,9,0,7,6,6,28
191002959,9,4,7,8,0,28
191002960,9,4,1,4,9,27
191002961,9,8,7,4,7,35
191002962,3,1,0,1,3,8
191002963,2,8,4,0,2,16
191002964,1,1,3,8,0,13
191002965,2,3,1,0,9,15
191002966,2,4,5,5,7,23
191002967,5,8,4,7,6,30
191002968,4,4,6,5,6,25
191002969,4,8,5,0,3,20
191002970,0,2,4,1,6,13
191002971,8,9,5,5,1,28
191002972,9,9,4,8,0,30
191002973,7,5,6,8,7,33
191002974,2,1,7,9,5,24
191002975,3,4,8,9,8,32
191002976,2,7,2,3,0,14
191002977,2,9,0,9,0,20
191002978,2,4,8,7,3,24
191002979,0,0,5,7,4,16
191002980,7,5,8,6,4,30
191002981,4,5,6,0,9,24
191002982,4,9,0,8,5,26
191002983,9,7,3,6,6,31
191002984,1,8,7,3,5,24
191002985,3,3,0,6,4,16
191002986,8,3,8,4,2,25
191002987,8,9,5,9,8,39
191002988,9,1,9,4,5,28
191002989,7,3,5,9,7,31
191002990,8,6,6,6,8,34
191002991,1,2,4,2,6,15
191002992,1,9,4,9,8,31
191002993,1,8,8,3,1,21
191002994,3,1,1,3,4,12
191002995,9,0,6,8,4,27
191002996,6,6,9,3,4,28
191002997,0,7,0,1,0,8
191002998,7,3,9,6,4,29
191002999,2,4,4,3,3,16
1910021000,7,9,0,9,7,32
1910021001,6,4,9,8,0,27
1910021002,1,5,8,9,3,26
1910021003,5,9,3,9,3,29
1910021004,3,5,4,4,8,24
1910021005,7,5,4,7,7,30
1910021006,5,3,6,2,9,25
1910021007,9,5,9,2,4,29
1910021008,4,2,4,3,5,18
1910021009,1,6,0,0,6,13
1910021010,0,0,1,9,6,16
1910021011,4,7,2,6,7,26
1910021012,9,4,4,5,7,29
1910021013,1,3,3,4,8,19
1910021014,5,8,0,0,1,14
1910021015,3,1,3,1,6,14
1910021016,2,8,3,9,3,25
1910021017,0,0,8,7,3,18
1910021018,4,3,8,6,0,21
1910021019,2,9,2,1,0,14
1910021020,9,4,5,2,1,21
1910021021,7,2,4,0,1,14
1910021022,5,2,7,1,0,15
1910021023,2,8,2,5,3,20
1910021024,3,8,2,0,6,19
1910021025,1,2,8,0,0,11
1910021026,4,4,4,7,3,22
1910021027,9,8,3,4,2,26
1910021028,2,3,6,0,6,17
1910021029,1,6,6,3,6,22
1910021030,8,8,6,0,8,30
1910021031,9,3,1,9,6,28
1910021032,9,2,9,9,6,35
1910021033,2,8,5,1,9,25
1910021034,9,1,8,2,2,22
1910021035,2,9,0,7,2,20
1910021036,1,3,1,7,5,17
1910021037,5,9,5,2,7,28
1910021038,6,0,3,3,2,14
1910021039,7,2,4,3,4,20
1910021040,7,6,8,9,1,31
1910021041,0,7,1,2,8,18
1910021042,8,1,7,1,9,26
1910021043,1,4,4,1,0,10
1910021044,7,4,1,6,9,27
1910021045,4,7,7,9,8,35
1910021046,3,8,2,8,1,22
1910021047,1,3,9,0,9,22
1910021048,0,1,3,6,1,11
1910021049,7,5,2,4,7,25
1910021050,0,5,9,0,0,14
1910021051,9,9,2,1,7,28
1910021052,8,5,2,7,1,23
1910021053,8,5,5,4,1,23
1910021054,1,6,1,9,0,17
1910021055,0,3,8,0,5,16
1910021056,8,7,8,4,8,35
1910021057,4,3,9,7,7,30
1910021058,3,6,7,7,2,25
1910021059,9,8,5,4,4,30
1910021060,7,5,1,7,1,21
1910021061,9,4,2,8,1,24
1910021062,5,3,5,0,5,18
1910021063,8,9,3,0,4,24
1910021064,2,7,6,7,2,24
1910021065,3,5,6,2,7,23
1910021066,3,1,3,3,1,11
1910021067,2,1,1,8,6,18
1910021068,3,9,2,3,4,21
1910021069,6,4,5,4,4,23
1910021070,4,0,4,5,6,19
1910021071,9,0,6,2,6,23
1910021072,8,7,2,4,9,30
1910021073,7,9,7,0,9,32
1910021074,7,0,2,8,6,23
1910021075,9,1,1,7,6,24
1910021076,1,8,0,1,5,15
1910021077,0,1,5,6,8,20
1910021078,5,6,4,9,7,31
1910021079,2,7,6,9,0,24
1910021080,1,9,2,5,6,23
1910021081,4,7,0,6,0,17
1910021082,8,0,2,2,7,19
1910021083,4,0,1,7,3,15
1910021084,3,8,3,7,7,28
1910021085,0,4,8,5,5,22
1910021086,0,6,4,3,1,14
1910021087,5,7,0,2,3,17
1910021088,6,9,1,8,0,24
1910021089,7,4,0,5,4,20
1910021090,6,1,1,3,8,19
1910021091,6,0,7,8,3,24
1910021092,5,6,5,9,9,34
1910021093,3,9,8,2,0,22
1910021094,0,8,4,8,6,26
1910021095,9,8,1,4,1,23
1910021096,1,7,4,0,1,13
1910021097,5,6,6,4,5,26
1910021098,3,5,5,2,2,17
1910021099,6,0,6,4,2,18
1910021100,5,9,3,1,6,24
1910021101,2,6,2,6,8,24
1910021102,1,8,2,7,6,24
1910021103,1,4,2,9,6,22
1910021104,8,1,9,0,8,26
1910021105,7,3,7,8,9,34
191003001,1,8,7,3,7,26
191003002,7,5,9,0,3,24
191003003,6,6,7,9,1,29
191003004,9,3,7,9,8,36
191003005,9,3,0,6,7,25
191003006,6,8,9,0,9,32
191003007,0,9,9,8,5,31
191003008,3,6,5,5,8,27
191003009,6,2,8,2,2,20
191003010,4,0,7,6,3,20
191003011,3,9,4,2,2,20
191003012,8,4,2,9,2,25
191003013,3,7,3,0,3,16
191003014,5,1,5,4,9,24
191003015,6,7,3,9,7,32
191003016,6,6,3,6,6,27
191003017,8,2,3,3,7,23
191003018,4,7,6,2,7,26
191003019,5,8,9,1,6,29
191003020,9,5,2,1,5,22
191003021,7,9,5,9,6,36
191003022,3,6,4,4,0,17
191003023,7,9,3,6,0,25
191003024,4,9,5,5,9,32
191003025,4,4,2,8,1,19
191003026,8,0,2,2,4,16
191003027,5,1,9,6,9,30
191003028,5,5,8,4,3,25
191003029,2,0,1,9,6,18
191003030,2,6,2,2,6,18
191003031,5,3,0,4,9,21
191003032,6,6,9,6,9,36
191003033,6,7,2,8,3,26
191003034,3,0,6,4,1,14
191003035,0,3,6,0,9,18
191003036,1,6,2,9,7,25
191003037,2,2,5,0,8,17
191003038,0,3,9,0,7,19
191003039,7,2,9,5,4,27
191003040,9,0,4,9,9,31
191003041,8,2,0,8,1,19
191003042,7,8,2,2,9,28
191003043,5,3,1,2,4,15
191003044,8,0,6,9,5,28
191003045,0,3,8,2,7,20
191003046,7,1,0,9,3,20
191003047,6,9,0,1,3,19
191003048,6,4,9,2,7,28
191003049,3,3,0,5,9,20
191003050,7,3,4,6,8,28
191003051,7,2,0,3,4,16
191003052,5,7,2,6,7,27
191003053,3,9,0,9,3,24
191003054,9,4,6,9,4,32
191003055,5,6,4,2,4,21
191003056,8,5,5,8,1,27
191003057,2,1,6,0,5,14
191003058,8,6,1,0,3,18
191003059,9,2,0,4,5,20
191003060,6,9,2,9,1,27
191003061,0,7,1,8,4,20
191003062,3,6,6,4,9,28
191003063,8,6,1,6,1,22
191003064,7,2,1,1,3,14
191003065,5,5,3,4,3,20
191003066,9,8,3,7,6,33
191003067,2,8,1,9,3,23
191003068,2,6,1,0,4,13
191003069,2,1,7,5,5,20
191003070,5,6,9,6,5,31
191003071,2,7,9,9,2,29
191003072,3,1,3,4,6,17
191003073,0,8,1,2,1,12
191003074,1,4,5,8,6,24
191003075,7,4,7,8,3,29
191003076,4,5,3,6,5,23
191003077,5,5,6,9,4,29
191003078,5,4,6,3,1,19
191003079,9,7,9,6,8,39
191003080,1,5,2,9,4,21
191003081,7,5,7,2,7,28
191003082,4,6,0,3,2,15
191003083,7,4,2,3,0,16
191003084,0,1,7,6,1,15
191003085,7,5,9,1,5,27
191003086,3,0,1,2,7,13
191003087,0,4,2,9,7,22
191003088,5,5,8,9,0,27
191003089,3,4,3,6,7,23
191003090,9,7,2,0,4,22
191003091,4,7,8,4,0,23
191003092,6,7,6,4,0,23
191003093,6,9,2,7,3,27
191003094,9,2,0,4,9,24
191003095,3,2,8,0,2,15
191003096,8,9,0,2,1,20
191003097,8,1,2,0,8,19
191003098,0,4,7,9,9,29
191003099,5,3,5,8,3,24
191003100,0,2,2,6,8,18
191003101,7,3,7,7,6,30
191003102,1,3,9,5,2,20
191003103,3,7,6,9,4,29
191003104,7,9,2,6,1,25
191003105,1,9,2,0,2,14
191003106,4,2,6,8,6,26
191003107,9,7,0,6,4,26
191003108,2,8,5,9,4,28
191003109,5,8,8,0,1,22
191003110,4,8,3,4,4,23
191003111,9,5,0,7,6,27
191003112,3,3,5,8,1,20
191003113,1,3,1,8,2,15
191003114,8,4,1,5,7,25
191003115,7,5,7,7,8,34
191003116,4,2,8,7,6,27
191003117,6,5,0,4,0,15
191003118,7,7,0,6,3,23
191003119,1,0,6,3,4,14
191003120,0,8,8,0,2,18
191003121,9,7,7,5,2,30
191003122,8,5,2,1,8,24
191003123,5,1,6,9,4,25
191003124,3,6,9,8,3,29
191003125,4,7,0,7,5,23
191003126,9,7,5,7,4,32
191003127,7,3,7,1,0,18
191003128,2,8,8,1,5,24
191003129,3,2,8,9,7,29
191003130,0,2,2,4,5,13
191003131,3,5,8,5,0,21
191003132,6,2,0,9,9,26
191003133,7,0,4,9,2,22
191003134,4,9,5,5,8,31
191003135,2,9,9,5,9,34
191003136,0,9,8,5,8,30
191003137,9,9,6,0,2,26
191003138,6,0,8,8,5,27
191003139,6,3,5,9,9,32
191003140,6,1,4,5,1,17
191003141,4,2,2,9,0,17
191003142,1,5,2,4,7,19
191003143,0,7,4,7,7,25
191003144,5,8,0,1,0,14
191003145,7,3,7,7,8,32
191003146,6,6,6,7,2,27
191003147,1,0,9,6,6,22
191003148,3,8,8,2,0,21
191003149,9,0,0,3,4,16
191003150,2,2,2,7,8,21
191003151,7,0,7,0,9,23
191003152,8,5,7,3,3,26
191003153,5,5,2,1,5,18
191003154,1,3,1,2,8,15
191003155,4,6,0,3,5,18
191003156,4,6,7,0,9,26
191003157,5,9,7,6,0,27
191003158,1,1,2,4,7,15
191003159,2,6,0,5,0,13
191003160,0,3,6,7,6,22
191003161,2,3,0,4,5,14
191003162,3,2,4,1,8,18
191003163,8,2,4,8,6,28
191003164,9,3,8,1,2,23
191003165,4,6,6,6,1,23
191003166,8,6,6,9,3,32
191003167,9,9,5,5,1,29
191003168,1,1,7,9,6,24
191003169,8,7,5,8,9,37
191003170,9,3,9,6,0,27
191003171,3,3,7,1,2,16
191003172,4,3,8,4,8,27
191003173,8,4,5,9,4,30
191003174,7,3,4,9,6,29
191003175,7,6,4,9,1,27
191003176,3,5,3,9,3,23
191003177,3,2,8,5,6,24
191003178,8,1,2,7,1,19
191003179,6,7,1,9,0,23
191003180,2,8,4,0,6,20
191003181,4,9,5,6,7,31
191003182,2,4,6,3,2,17
191003183,5,1,9,0,0,15
191003184,8,3,8,8,5,32
191003185,8,6,3,7,7,31
191003186,2,2,7,0,3,14
191003187,6,7,8,4,0,25
191003188,3,4,6,1,4,18
191003189,4,6,1,6,5,22
191003190,7,1,1,9,3,21
191003191,6,9,8,1,2,26
191003192,1,6,3,8,5,23
191003193,3,6,0,2,9,20
191003194,7,6,9,7,3,32
191003195,1,7,6,0,2,16
191003196,7,4,2,2,6,21
191003197,9,3,3,3,5,23
191003198,5,6,0,1,2,14
191003199,6,5,3,4,9,27
191003200,2,9,3,2,1,17
191003201,2,2,2,8,2,16
191003202,3,8,7,5,6,29
191003203,5,8,8,9,5,35
191003204,6,4,0,6,4,20
191003205,5,5,5,8,5,28
191003206,8,0,9,0,8,25
191003207,1,6,4,1,6,18
191003208,0,5,4,2,4,15
191003209,9,9,0,8,4,30
191003210,8,5,0,3,1,17
191003211,4,8,6,1,4,23
191003212,9,8,4,2,3,26
191003213,7,9,6,6,9,37
191003214,9,5,3,5,8,30
191003215,4,6,1,4,9,24
191003216,0,5,4,7,7,23
191003217,6,8,6,2,9,31
191003218,4,3,1,7,3,18
191003219,2,3,3,9,1,18
191003220,6,7,1,8,2,24
191003221,9,1,8,1,6,25
191003222,2,7,4,3,5,21
191003223,9,9,6,2,0,26
191003224,2,5,5,1,5,18
191003225,4,0,8,0,1,13
191003226,7,3,7,3,4,24
191003227,6,9,5,5,0,25
191003228,4,6,7,5,1,23
191003229,9,5,5,0,6,25
191003230,8,9,4,3,4,28
191003231,5,6,5,9,3,28
191003232,4,4,7,4,2,21
191003233,4,1,2,0,3,10
191003234,9,0,6,4,2,21
191003235,3,6,3,0,8,20
191003236,5,0,1,0,0,6
191003237,6,0,9,7,0,22
191003238,9,6,4,1,0,20
191003239,6,6,1,4,5,22
191003240,2,3,7,4,2,18
191003241,7,8,8,3,4,30
191003242,2,8,9,4,7,30
191003243,3,7,0,1,8,19
191003244,2,1,0,4,3,10
191003245,5,8,8,9,1,31
191003246,6,0,7,2,4,19
191003247,7,0,9,2,1,19
191003248,0,7,7,6,9,29
191003249,5,3,9,0,5,22
191003250,6,0,8,1,1,16
191003251,2,8,3,4,0,17
191003252,1,2,7,8,7,25
191003253,9,0,1,4,2,16
191003254,6,0,9,0,1,16
191003255,8,3,6,6,2,25
191003256,0,9,7,7,8,31
191003257,9,4,5,0,3,21
191003258,6,2,7,1,6,22
191003259,1,8,8,0,9,26
191003260,2,9,9,6,2,28
191003261,6,9,2,1,3,21
191003262,6,9,6,6,7,34
191003263,4,3,4,7,0,18
191003264,4,1,0,0,5,10
191003265,0,5,2,0,9,16
191003266,2,0,5,6,7,20
191003267,8,0,7,2,8,25
191003268,0,9,7,9,6,31
191003269,9,7,1,7,1,25
191003270,5,5,3,1,7,21
191003271,3,7,0,4,6,20
191003272,4,6,3,4,8,25
191003273,2,1,0,8,2,13
191003274,8,4,7,4,5,28
191003275,9,2,6,8,7,32
191003276,5,6,2,4,3,20
191003277,3,2,0,6,5,16
191003278,3,7,5,5,1,21
191003279,9,3,0,5,1,18
191003280,6,3,1,3,6,19
191003281,3,0,3,6,3,15
191003282,3,1,2,0,2,8
191003283,9,1,9,4,7,30
191003284,2,2,4,0,8,16
191003285,9,0,9,5,7,30
191003286,2,5,4,2,2,15
191003287,0,0,5,7,5,17
191003288,7,1,4,8,3,23
191003289,2,1,1,2,3,9
191003290,6,2,4,7,0,19
191003291,8,3,5,3,3,22
191003292,0,3,3,2,0,8
191003293,0,6,9,9,6,30
191003294,6,6,0,2,9,23
191003295,7,2,9,7,2,27
191003296,0,3,4,0,0,7
191003297,3,2,2,6,7,20
191003298,4,4,8,7,2,25
191003299,2,0,4,2,4,12
191003300,2,4,2,3,5,16
191003301,6,7,1,0,5,19
191003302,3,9,0,3,5,20
191003303,1,7,9,9,5,31
191003304,2,3,1,0,5,11
191003305,8,9,8,3,6,34
191003306,7,7,4,0,8,26
191003307,8,1,5,4,3,21
191003308,2,5,4,1,1,13
191003309,2,4,2,9,9,26
191003310,8,0,2,2,6,18
191003311,3,0,7,5,1,16
191003312,6,3,6,0,2,17
191003313,0,7,8,1,7,23
191003314,3,3,3,9,9,27
191003315,8,5,0,1,9,23
191003316,6,9,8,1,6,30
191003317,7,8,0,1,7,23
191003318,3,2,8,6,1,20
191003319,7,8,0,0,4,19
191003320,4,2,4,2,6,18
191003321,3,4,0,0,9,16
191003322,4,8,1,2,4,19
191003323,4,4,0,7,4,19
191003324,6,1,9,4,8,28
191003325,6,2,5,1,7,21
191003326,2,4,9,6,0,21
191003327,8,3,2,4,3,20
191003328,5,1,2,4,4,16
191003329,2,3,7,7,3,22
191003330,8,4,1,3,6,22
191003331,9,2,5,2,0,18
191003332,7,1,0,8,8,24
191003333,3,1,3,8,5,20
191003334,7,2,9,0,5,23
191003335,7,5,5,8,5,30
191003336,9,7,7,0,5,28
191003337,9,0,8,3,0,20
191003338,0,4,3,3,3,13
191003339,3,9,7,2,8,29
191003340,0,1,7,7,2,17
191003341,0,9,2,2,2,15
191003342,7,5,7,4,4,27
191003343,2,9,3,1,5,20
191003344,2,8,1,1,4,16
191003345,4,9,7,0,3,23
191003346,1,0,8,4,6,19
191003347,2,8,8,6,9,33
191003348,1,1,0,9,9,20
191003349,4,4,1,6,1,16
191003350,9,0,3,1,5,18
191003351,1,4,9,9,8,31
191003352,9,9,5,4,3,30
191003353,2,3,2,2,7,16
191003354,6,4,5,1,8,24
191003355,3,0,8,6,6,23
191003356,3,9,9,1,1,23
191003357,4,2,0,0,2,8
191003358,0,6,5,2,2,15
191003359,1,8,4,4,8,25
191003360,7,9,7,0,4,27
191003361,3,3,0,4,6,16
191003362,0,1,4,0,9,14
191003363,7,5,6,3,8,29
191003364,5,8,2,1,8,24
191003365,4,0,2,0,7,13
191003366,6,5,9,7,1,28
191003367,0,9,6,5,8,28
191003368,0,8,2,3,7,20
191003369,0,9,2,7,1,19
191003370,5,0,1,4,2,12
191003371,2,7,5,6,2,22
191003372,2,4,8,6,5,25
191003373,8,7,6,0,2,23
191003374,8,3,6,6,3,26
191003375,4,7,6,1,5,23
191003376,5,8,8,3,1,25
191003377,4,7,1,9,9,30
191003378,2,0,7,8,3,20
191003379,8,4,3,9,6,30
191003380,6,6,1,8,7,28
191003381,2,9,0,5,5,21
191003382,8,8,9,5,4,34
191003383,0,8,1,3,9,21
191003384,1,0,0,3,9,13
191003385,5,5,7,1,5,23
191003386,1,0,4,7,9,21
191003387,4,7,8,5,6,30
191003388,5,8,3,9,6,31
191003389,8,4,9,2,2,25
191003390,2,8,1,4,6,21
191003391,6,2,0,7,1,16
191003392,5,6,5,8,0,24
191003393,0,4,6,4,0,14
191003394,5,6,7,6,3,27
191003395,2,5,8,3,2,20
191003396,3,5,4,3,0,15
191003397,8,3,9,5,1,26
191003398,4,0,2,7,9,22
191003399,1,4,9,7,8,29
191003400,0,3,4,7,8,22
191003401,7,3,7,5,6,28
191003402,3,1,5,0,1,10
191003403,3,2,4,0,3,12
191003404,3,6,7,6,3,25
191003405,4,9,7,7,9,36
191003406,8,5,1,8,9,31
191003407,9,8,0,2,5,24
191003408,8,4,4,5,0,21
191003409,6,7,6,2,7,28
191003410,3,3,3,5,8,22
191003411,2,5,3,0,5,15
191003412,6,9,1,4,5,25
191003413,5,3,2,0,6,16
191003414,0,4,7,4,3,18
191003415,7,5,2,7,5,26
191003416,5,1,6,7,3,22
191003417,2,9,6,5,6,28
191003418,3,0,2,4,3,12
191003419,2,0,7,3,1,13
191003420,7,6,3,4,3,23
191003421,6,0,5,7,8,26
191003422,6,0,6,9,8,29
191003423,5,9,1,3,1,19
191003424,3,9,2,7,5,26
191003425,3,5,1,6,3,18
191003426,9,0,9,5,8,31
191003427,1,4,7,7,2,21
191003428,6,2,5,1,5,19
191003429,4,6,0,2,9,21
191003430,5,5,6,4,6,26
191003431,1,7,5,7,2,22
191003432,5,9,8,7,5,34
191003433,6,3,8,5,9,31
191003434,8,0,9,3,9,29
191003435,4,5,5,7,5,26
191003436,7,2,1,1,5,16
191003437,2,3,8,6,0,19
191003438,6,6,2,6,5,25
191003439,5,3,4,4,6,22
191003440,9,7,7,8,9,40
191003441,3,0,7,7,8,25
191003442,0,1,1,7,0,9
191003443,3,6,6,0,3,18
191003444,7,6,4,3,0,20
191003445,7,5,8,0,1,21
191003446,8,6,0,2,6,22
191003447,8,5,0,6,5,24
191003448,0,9,8,6,7,30
191003449,5,2,7,6,9,29
191003450,9,9,6,6,8,38
191003451,5,8,6,5,3,27
191003452,7,3,8,3,0,21
191003453,4,3,7,5,8,27
191003454,2,9,6,0,4,21
191003455,6,4,0,2,5,17
191003456,0,9,7,1,3,20
191003457,8,0,8,9,2,27
191003458,5,0,1,7,6,19
191003459,3,0,8,3,8,22
191003460,8,1,8,7,8,32
191003461,2,9,5,9,3,28
191003462,9,5,9,8,6,37
191003463,4,5,0,3,1,13
191003464,6,1,1,5,7,20
191003465,3,7,7,4,4,25
191003466,3,2,9,6,2,22
191003467,1,7,3,2,2,15
191003468,9,1,0,7,6,23
191003469,3,8,1,8,8,28
191003470,7,7,0,4,1,19
191003471,6,5,2,7,2,22
191003472,2,0,2,3,4,11
191003473,8,0,4,6,2,20
191003474,1,3,0,1,2,7
191003475,6,0,1,5,7,19
191003476,0,2,7,5,1,15
191003477,3,2,1,0,3,9
191003478,0,8,2,9,0,19
191003479,3,5,0,7,2,17
191003480,9,6,6,7,7,35
191003481,5,4,5,1,6,21
191003482,1,9,2,7,0,19
191003483,5,9,1,8,8,31
191003484,5,5,9,7,6,32
191003485,9,1,3,6,3,22
191003486,2,6,4,5,5,22
191003487,6,5,3,9,8,31
191003488,9,4,7,9,1,30
191003489,4,3,4,7,3,21
191003490,5,2,3,7,5,22
191003491,8,5,4,0,6,23
191003492,4,0,6,8,3,21
191003493,3,6,5,3,7,24
191003494,8,0,7,9,2,26
191003495,2,4,5,9,8,28
191003496,9,5,1,3,3,21
191003497,0,5,1,9,8,23
191003498,2,3,8,9,8,30
191003499,4,6,9,8,9,36
191003500,5,4,1,1,0,11
191003501,5,3,7,3,8,26
191003502,5,9,5,0,5,24
191003503,0,2,2,8,6,18
191003504,1,9,2,8,3,23
191003505,3,9,3,6,6,27
191003506,7,2,3,2,4,18
191003507,4,7,0,5,6,22
191003508,7,2,6,5,4,24
191003509,2,2,5,1,5,15
191003510,8,8,5,9,4,34
191003511,4,1,2,7,6,20
191003512,1,0,1,6,7,15
191003513,6,9,5,0,6,26
191003514,1,3,0,3,7,14
191003515,7,0,5,0,8,20
191003516,6,2,6,8,7,29
191003517,6,8,0,7,6,27
191003518,0,8,0,3,1,12
191003519,4,6,8,8,3,29
191003520,5,2,9,1,3,20
191003521,4,1,2,6,1,14
191003522,1,8,9,8,3,29
191003523,4,7,9,0,3,23
191003524,3,7,2,6,1,19
191003525,7,9,1,5,8,30
191003526,7,4,3,9,5,28
191003527,6,4,1,9,5,25
191003528,1,0,1,9,0,11
191003529,0,6,8,0,1,15
191003530,0,3,6,2,2,13
191003531,2,2,4,2,1,11
191003532,8,4,6,0,8,26
191003533,0,6,7,0,7,20
191003534,5,7,1,2,3,18
191003535,7,4,2,6,9,28
191003536,1,4,6,6,8,25
191003537,4,3,5,8,7,27
191003538,2,1,5,3,5,16
191003539,8,7,3,1,9,28
191003540,3,0,7,3,0,13
191003541,1,6,7,0,1,15
191003542,7,9,5,5,3,29
191003543,6,6,5,4,1,22
191003544,8,3,0,6,0,17
191003545,9,3,3,5,7,27
191003546,9,8,4,7,0,28
191003547,0,5,2,0,8,15
191003548,8,7,1,3,1,20
191003549,5,9,9,9,0,32
191003550,9,1,6,4,6,26
191003551,8,0,4,8,8,28
191003552,4,9,2,4,1,20
191003553,5,4,8,1,0,18
191003554,4,4,8,5,1,22
191003555,8,0,3,6,0,17
191003556,4,6,1,1,7,19
191003557,9,2,5,5,9,30
191003558,0,5,8,0,4,17
191003559,2,3,8,9,4,26
191003560,7,5,6,3,9,30
191003561,5,8,1,5,4,23
191003562,4,7,1,2,1,15
191003563,3,9,5,0,4,21
191003564,2,9,8,9,2,30
191003565,9,2,0,0,7,18
191003566,6,0,2,6,3,17
191003567,4,1,5,4,6,20
191003568,2,9,1,0,5,17
191003569,9,8,3,4,3,27
191003570,5,1,8,7,7,28
191003571,3,5,3,4,7,22
191003572,8,9,4,2,8,31
191003573,5,9,7,3,5,29
191003574,4,5,6,0,3,18
191003575,9,9,5,9,5,37
191003576,5,6,8,9,9,37
191003577,6,2,9,7,9,33
191003578,6,5,4,5,4,24
191003579,2,8,2,2,2,16
191003580,3,7,1,4,4,19
191003581,0,2,0,6,7,15
191003582,3,6,4,3,8,24
191003583,9,0,9,3,8,29
191003584,6,3,9,1,4,23
191003585,2,5,8,9,9,33
191003586,1,8,5,0,2,16
191003587,3,6,8,9,8,34
191003588,0,9,1,0,2,12
191003589,3,8,6,2,4,23
191003590,0,3,1,6,9,19
191003591,0,7,6,5,9,27
191003592,4,0,6,0,9,19
191003593,7,5,0,2,1,15
191003594,9,6,7,2,3,27
191003595,5,4,3,9,0,21
191003596,1,4,6,0,5,16
191003597,3,7,9,8,1,28
191003598,8,6,3,1,6,24
191003599,5,0,6,9,5,25
191003600,1,5,1,5,4,16
191003601,5,7,9,7,3,31
191003602,5,9,0,3,2,19
191003603,8,3,2,2,2,17
191003604,3,7,1,7,2,20
191003605,0,3,0,8,1,12
191003606,8,2,1,5,9,25
191003607,3,2,4,8,1,18
191003608,5,2,4,2,8,21
191003609,4,8,5,5,2,24
191003610,8,1,6,3,2,20
191003611,3,4,0,3,2,12
191003612,1,2,0,8,2,13
191003613,8,5,6,7,2,28
191003614,8,5,0,0,2,15
191003615,4,2,4,6,9,25
191003616,7,3,8,0,1,19
191003617,1,4,0,2,9,16
191003618,1,1,0,0,1,3
191003619,1,5,8,4,8,26
191003620,3,3,8,1,8,23
191003621,6,3,3,4,6,22
191003622,1,0,4,1,7,13
191003623,8,1,6,9,3,27
191003624,2,3,8,0,6,19
191003625,2,6,6,9,0,23
191003626,7,5,6,9,9,36
191003627,4,5,3,2,8,22
191003628,9,4,5,3,8,29
191003629,3,1,5,9,3,21
191003630,3,5,1,9,9,27
191003631,2,5,6,7,4,24
191003632,8,4,8,8,7,35
191003633,3,6,4,4,2,19
191003634,6,4,5,0,1,16
191003635,7,6,4,3,6,26
191003636,8,7,1,3,7,26
191003637,1,6,6,4,3,20
191003638,5,6,3,5,5,24
191003639,5,0,2,9,3,19
191003640,6,3,8,3,2,22
191003641,3,9,0,3,1,16
191003642,2,9,9,6,1,27
191003643,5,1,7,6,4,23
191003644,5,1,2,6,6,20
191003645,9,9,1,1,4,24
191003646,9,8,5,8,9,39
191003647,7,9,0,7,0,23
191003648,2,3,5,7,1,18
191003649,7,7,4,8,0,26
191003650,5,5,3,2,0,15
191003651,6,7,8,7,0,28
191003652,8,6,8,9,8,39
191003653,9,1,1,2,6,19
191003654,6,4,0,4,1,15
191003655,9,2,6,3,1,21
191003656,6,3,9,0,2,20
191003657,1,3,0,0,9,13
191003658,0,7,0,5,3,15
191003659,1,2,4,8,2,17
191003660,9,0,0,6,5,20
191003661,2,2,6,1,5,16
191003662,4,2,5,7,9,27
191003663,5,8,2,6,5,26
191003664,3,7,9,4,5,28
191003665,2,2,6,1,6,17
191003666,0,8,8,6,0,22
191003667,4,9,9,5,8,35
191003668,7,1,0,9,5,22
191003669,5,7,8,1,8,29
191003670,1,9,5,4,3,22
191003671,6,1,1,4,3,15
191003672,4,4,3,5,6,22
191003673,6,4,0,1,2,13
191003674,4,7,2,2,8,23
191003675,5,8,1,1,8,23
191003676,6,5,8,7,5,31
191003677,2,7,9,0,5,23
191003678,1,0,5,5,3,14
191003679,6,2,4,5,7,24
191003680,1,2,2,8,4,17
191003681,0,4,6,5,3,18
191003682,6,2,2,9,2,21
191003683,6,1,9,0,4,20
191003684,3,7,4,0,0,14
191003685,7,0,7,5,1,20
191003686,8,2,9,4,6,29
191003687,0,0,6,4,7,17
191003688,2,1,0,9,1,13
191003689,4,6,4,5,6,25
191003690,9,3,5,7,8,32
191003691,2,3,1,6,1,13
191003692,9,9,5,8,2,33
191003693,5,3,2,8,3,21
191003694,6,2,1,8,3,20
191003695,5,3,5,2,3,18
191003696,6,4,4,5,9,28
191003697,0,0,0,4,2,6
191003698,3,7,6,4,6,26
191003699,5,9,0,1,0,15
191003700,3,8,6,1,6,24
191003701,7,1,4,4,9,25
191003702,0,7,2,7,3,19
191003703,2,8,7,1,0,18
191003704,3,0,2,4,8,17
191003705,9,1,0,6,2,18
191003706,0,0,3,1,9,13
191003707,3,8,5,4,3,23
191003708,9,8,2,4,6,29
191003709,8,5,8,1,0,22
191003710,6,7,5,8,4,30
191003711,2,1,5,4,8,20
191003712,6,3,7,4,6,26
191003713,1,6,5,7,3,22
191003714,1,6,6,3,3,19
191003715,3,9,8,3,8,31
191003716,0,4,1,8,6,19
191003717,7,3,9,5,8,32
191003718,9,8,8,3,8,36
191003719,5,0,5,6,1,17
191003720,5,4,0,0,3,12
191003721,9,3,8,7,3,30
191003722,6,5,4,0,2,17
191003723,7,7,8,5,1,28
191003724,9,5,4,8,4,30
191003725,7,0,8,3,3,21
191003726,7,5,9,3,5,29
191003727,6,7,1,7,8,29
191003728,6,6,3,7,2,24
191003729,5,1,0,8,5,19
191003730,3,9,7,3,7,29
191003731,3,9,1,1,6,20
191003732,4,9,0,5,2,20
191003733,3,3,3,7,5,21
191003734,1,4,3,2,4,14
191003735,5,7,7,3,2,24
191003736,5,9,6,0,9,29
191003737,3,2,6,6,8,25
191003738,0,9,4,2,2,17
191003739,1,9,6,8,9,33
191003740,8,4,3,3,9,27
191003741,4,4,8,8,1,25
191003742,7,8,6,1,6,28
191003743,8,1,6,3,3,21
191003744,3,9,8,0,7,27
191003745,0,8,8,2,0,18
191003746,1,6,6,5,8,26
191003747,1,4,8,5,8,26
191003748,4,4,4,8,1,21
191003749,8,4,6,5,5,28
191003750,4,2,0,7,6,19
191003751,1,7,9,4,3,24
191003752,9,3,4,2,3,21
191003753,4,7,8,8,6,33
191003754,9,9,4,9,3,34
191003755,7,5,6,8,2,28
191003756,2,3,2,2,3,12
191003757,2,9,1,8,6,26
191003758,7,0,5,4,4,20
191003759,1,2,6,1,0,10
191003760,7,1,1,5,8,22
191003761,6,0,0,3,0,9
191003762,8,2,7,0,7,24
191003763,2,3,9,4,4,22
191003764,9,5,3,6,5,28
191003765,9,0,6,1,6,22
191003766,7,2,0,5,6,20
191003767,0,2,4,4,3,13
191003768,9,4,4,6,9,32
191003769,5,7,0,0,5,17
191003770,3,9,7,2,4,25
191003771,1,3,3,5,5,17
191003772,1,8,6,2,2,19
191003773,3,3,1,7,8,22
191003774,4,1,2,3,0,10
191003775,1,5,3,3,4,16
191003776,2,4,1,8,2,17
191003777,5,8,9,3,8,33
191003778,1,8,5,0,3,17
191003779,6,2,0,6,9,23
191003780,9,8,6,4,8,35
191003781,4,2,3,9,7,25
191003782,3,6,9,3,1,22
191003783,2,7,5,3,3,20
191003784,6,5,8,4,2,25
191003785,4,0,3,1,1,9
191003786,0,1,1,1,1,4
191003787,7,6,1,7,5,26
191003788,0,1,4,3,0,8
191003789,5,7,9,2,2,25
191003790,4,4,0,2,4,14
191003791,1,3,3,2,8,17
191003792,5,3,9,8,4,29
191003793,8,0,3,2,1,14
191003794,1,2,3,8,0,14
191003795,5,7,5,3,3,23
191003796,6,6,7,5,2,26
191003797,3,0,1,9,1,14
191003798,5,8,2,3,5,23
191003799,1,1,7,1,2,12
191003800,3,4,7,5,8,27
191003801,6,1,7,1,7,22
191003802,7,6,2,4,5,24
191003803,3,9,9,3,8,32
191003804,4,4,3,3,0,14
191003805,7,4,2,3,3,19
191003806,3,1,0,8,4,16
191003807,1,4,5,4,6,20
191003808,0,7,1,9,1,18
191003809,4,2,1,2,2,11
191003810,1,8,8,2,6,25
191003811,2,4,5,0,8,19
191003812,1,4,6,6,3,20
191003813,3,7,8,9,3,30
191003814,2,2,1,3,3,11
191003815,9,2,3,4,6,24
191003816,0,7,9,0,8,24
191003817,2,9,4,9,4,28
191003818,1,5,7,0,1,14
191003819,5,9,3,0,6,23
191003820,4,1,5,7,7,24
191003821,1,8,6,1,7,23
191003822,3,5,9,4,0,21
191003823,3,0,3,0,0,6
191003824,9,6,3,9,9,36
191003825,5,9,4,1,5,24
191003826,5,1,0,6,8,20
191003827,8,9,5,5,3,30
191003828,4,9,7,6,7,33
191003829,6,5,0,6,4,21
191003830,6,5,3,0,2,16
191003831,4,9,1,4,3,21
191003832,6,5,7,8,9,35
191003833,2,3,8,4,2,19
191003834,5,9,1,9,8,32
191003835,1,6,5,3,9,24
191003836,3,3,6,0,3,15
191003837,9,6,0,3,1,19
191003838,5,1,9,0,4,19
191003839,3,8,1,8,4,24
191003840,7,6,9,4,3,29
191003841,8,8,3,1,0,20
191003842,6,5,1,1,0,13
191003843,4,9,4,1,0,18
191003844,5,7,3,9,8,32
191003845,0,9,2,8,6,25
191003846,1,9,6,2,0,18
191003847,1,9,8,5,4,27
191003848,3,6,2,8,7,26
191003849,5,2,2,2,2,13
191003850,9,5,0,4,6,24
191003851,0,6,6,3,2,17
191003852,0,0,3,8,9,20
191003853,8,8,4,8,9,37
191003854,8,3,1,0,2,14
191003855,2,8,5,6,9,30
191003856,7,1,3,3,6,20
191003857,1,4,4,1,1,11
191003858,8,4,5,7,1,25
191003859,5,3,0,2,3,13
191003860,2,6,9,5,1,23
191003861,2,2,2,9,8,23
191003862,7,2,4,9,7,29
191003863,3,7,0,0,3,13
191003864,5,7,0,9,6,27
191003865,4,5,6,3,9,27
191003866,6,9,1,7,9,32
191003867,3,7,1,8,4,23
191003868,3,3,2,8,7,23
191003869,3,8,6,5,4,26
191003870,8,2,5,4,7,26
191003871,0,7,6,9,9,31
191003872,1,7,7,6,9,30
191003873,7,6,7,2,6,28
191003874,9,7,2,7,0,25
191003875,5,2,5,2,7,21
191003876,0,2,3,2,3,10
191003877,0,7,1,0,6,14
191003878,5,4,7,8,7,31
191003879,7,7,3,3,5,25
191003880,1,9,9,7,8,34
191003881,2,1,0,5,9,17
191003882,5,6,3,3,3,20
191003883,1,7,1,5,5,19
191003884,4,3,2,4,7,20
191003885,9,2,8,7,2,28
191003886,4,4,9,0,3,20
191003887,3,6,7,3,0,19
191003888,8,5,0,2,8,23
191003889,8,9,6,4,5,32
191003890,6,8,7,7,1,29
191003891,6,9,5,8,2,30
191003892,6,2,0,5,4,17
191003893,1,4,9,9,4,27
191003894,1,3,3,8,5,20
191003895,6,6,6,0,6,24
191003896,9,3,7,8,9,36
191003897,2,8,4,3,3,20
191003898,5,0,1,5,8,19
191003899,4,0,5,2,8,19
191003900,4,9,7,0,0,20
191003901,6,3,8,2,1,20
191003902,5,8,0,8,8,29
191003903,9,9,1,8,0,27
191003904,7,1,1,3,4,16
191003905,6,4,4,8,9,31
191003906,3,5,6,0,3,17
191003907,2,9,1,8,5,25
191003908,8,2,4,9,8,31
191003909,3,0,3,6,6,18
191003910,9,7,6,6,8,36
191003911,0,6,6,7,3,22
191003912,1,4,5,2,5,17
191003913,5,4,7,0,4,20
191003914,3,7,5,4,8,27
191003915,3,2,9,5,2,21
191003916,3,6,4,2,3,18
191003917,2,4,6,7,0,19
191003918,9,7,8,5,6,35
191003919,3,1,1,2,2,9
191003920,6,8,9,9,0,32
191003921,3,0,6,2,0,11
191003922,7,4,7,8,8,34
191003923,8,1,4,4,6,23
191003924,6,4,9,9,6,34
191003925,2,4,9,5,4,24
191003926,3,7,8,2,8,28
191003927,9,3,7,4,5,28
191003928,1,8,0,9,8,26
191003929,7,6,2,4,1,20
191003930,5,9,0,9,2,25
191003931,5,2,0,0,4,11
191003932,3,0,1,8,9,21
191003933,2,3,0,9,6,20
191003934,3,6,4,5,5,23
191003935,0,5,1,8,0,14
191003936,7,2,1,5,0,15
191003937,5,2,7,7,0,21
191003938,4,4,1,4,6,19
191003939,7,6,7,8,4,32
191003940,4,6,8,8,7,33
191003941,9,5,4,9,9,36
191003942,4,3,7,4,1,19
191003943,6,2,3,8,0,19
191003944,6,2,9,9,3,29
191003945,3,8,0,4,7,22
191003946,3,7,5,0,2,17
191003947,1,2,8,9,4,24
191003948,4,9,5,6,2,26
191003949,7,6,7,3,0,23
191003950,4,1,7,4,4,20
191003951,7,6,8,7,9,37
191003952,6,8,0,7,8,29
191003953,2,9,3,8,8,30
191003954,9,3,1,6,0,19
191003955,1,1,7,6,8,23
191003956,4,9,3,8,1,25
191003957,6,7,7,5,0,25
191003958,7,6,5,3,0,21
191003959,1,7,6,5,6,25
191003960,0,3,0,3,8,14
191003961,1,9,3,1,0,14
191003962,8,0,4,2,3,17
191003963,7,6,3,6,6,28
191003964,1,5,2,6,2,16
191003965,9,6,6,4,3,28
191003966,8,3,4,7,0,22
191003967,3,3,5,7,1,19
191003968,6,2,4,0,5,17
191003969,8,6,9,8,9,40
191003970,1,7,9,8,8,33
191003971,1,4,8,3,5,21
191003972,1,4,4,2,8,19
191003973,8,2,3,4,9,26
191003974,0,6,2,8,5,21
191003975,7,6,3,7,5,28
191003976,6,4,0,8,5,23
191003977,8,9,3,5,3,28
191003978,6,9,3,3,7,28
191003979,7,2,9,6,7,31
191003980,6,3,8,7,2,26
191003981,9,5,3,4,2,23
191003982,3,4,8,0,9,24
191003983,7,6,8,3,0,24
191003984,3,3,4,2,9,21
191003985,1,5,8,2,1,17
191003986,0,6,5,4,5,20
191003987,2,3,5,9,7,26
191003988,3,2,5,3,1,14
191003989,2,0,4,1,8,15
191003990,2,6,3,9,2,22
191003991,9,1,2,5,5,22
191003992,2,2,9,8,1,22
191003993,5,8,4,8,6,31
191003994,6,5,6,0,4,21
191003995,7,1,8,8,9,33
191003996,0,9,5,9,4,27
191003997,3,7,2,4,4,20
191003998,4,1,7,7,8,27
191003999,2,3,0,1,8,14
1910031000,9,3,1,9,5,27
1910031001,6,1,8,2,0,17
1910031002,4,1,3,9,7,24
1910031003,3,7,4,9,8,31
1910031004,3,5,5,5,8,26
1910031005,3,8,5,5,9,30
1910031006,2,7,8,5,9,31
1910031007,5,5,5,2,7,24
1910031008,7,4,3,2,3,19
1910031009,8,2,7,9,1,27
1910031010,4,4,2,5,2,17
1910031011,5,2,3,1,5,16
1910031012,1,7,2,5,5,20
1910031013,8,9,8,2,8,35
1910031014,1,6,9,4,2,22
1910031015,4,0,0,8,6,18
1910031016,8,4,7,6,0,25
1910031017,8,1,7,1,7,24
1910031018,6,1,8,0,9,24
1910031019,3,3,4,4,9,23
1910031020,7,3,0,0,3,13
1910031021,4,5,8,7,2,26
1910031022,8,5,5,6,1,25
1910031023,4,4,2,4,6,20
1910031024,0,2,8,8,9,27
1910031025,5,8,2,7,5,27
1910031026,1,5,6,2,9,23
1910031027,3,2,2,0,0,7
1910031028,7,9,7,5,9,37
1910031029,0,8,3,5,7,23
1910031030,9,9,6,7,5,36
1910031031,4,0,8,0,0,12
1910031032,1,2,3,5,1,12
1910031033,6,7,8,0,2,23
1910031034,7,1,6,7,0,21
1910031035,8,4,3,8,4,27
1910031036,9,5,6,9,0,29
1910031037,6,2,0,5,9,22
1910031038,8,4,0,8,4,24
1910031039,2,2,3,7,7,21
1910031040,2,7,9,3,7,28
1910031041,7,2,0,3,9,21
1910031042,1,3,9,3,5,21
1910031043,6,5,3,7,8,29
1910031044,8,8,3,3,3,25
1910031045,2,8,2,9,2,23
1910031046,2,3,3,7,5,20
1910031047,8,9,3,3,7,30
1910031048,0,4,2,4,9,19
1910031049,3,6,0,2,5,16
1910031050,6,8,4,5,5,28
1910031051,5,4,4,5,7,25
1910031052,7,8,5,4,0,24
1910031053,2,5,9,7,2,25
1910031054,5,9,7,9,9,39
1910031055,3,2,3,1,8,17
1910031056,7,7,6,2,4,26
1910031057,5,8,8,6,4,31
1910031058,6,9,4,1,1,21
1910031059,6,4,9,6,0,25
1910031060,4,9,0,4,4,21
1910031061,6,2,3,4,8,23
1910031062,7,1,3,0,0,11
1910031063,6,3,9,9,4,31
1910031064,7,2,0,4,0,13
1910031065,3,3,6,3,6,21
1910031066,1,1,4,2,7,15
1910031067,4,3,3,6,1,17
1910031068,1,5,5,4,0,15
1910031069,5,1,2,5,3,16
1910031070,5,4,4,9,9,31
1910031071,3,9,0,9,1,22
1910031072,0,9,4,3,7,23
1910031073,5,5,1,1,6,18
1910031074,4,5,4,9,8,30
1910031075,5,7,6,8,8,34
1910031076,3,0,7,7,3,20
1910031077,1,2,3,1,1,8
1910031078,2,5,7,0,5,19
1910031079,8,5,0,7,1,21
1910031080,9,5,9,8,8,39
1910031081,2,6,4,2,8,22
1910031082,1,0,1,1,0,3
1910031083,3,3,5,0,0,11
1910031084,1,4,1,9,1,16
1910031085,4,0,8,1,7,20
1910031086,7,6,8,1,9,31
1910031087,7,4,5,2,1,19
1910031088,2,1,6,3,0,12
1910031089,6,5,6,6,4,27
1910031090,5,9,6,3,5,28
1910031091,1,0,1,0,7,9
1910031092,8,9,3,4,5,29
1910031093,6,8,8,1,7,30
1910031094,3,2,0,0,4,9
1910031095,8,8,9,3,3,31
1910031096,8,4,7,2,6,27
1910031097,8,1,0,6,8,23
1910031098,0,1,9,6,5,21
1910031099,3,7,6,4,1,21
1910031100,8,4,2,5,4,23
1910031101,3,8,8,3,6,28
1910031102,6,3,8,9,1,27
1910031103,0,6,4,5,5,20
1910031104,0,9,6,7,1,23
1910031105,2,5,9,6,1,23
191004001,9,2,4,8,6,29
191004002,7,3,5,5,3,23
191004003,4,5,4,7,5,25
191004004,2,8,0,6,3,19
191004005,1,1,2,7,8,19
191004006,6,1,3,7,0,17
191004007,8,3,6,9,9,35
191004008,0,1,3,9,3,16
191004009,2,2,5,2,0,11
191004010,1,3,6,1,9,20
191004011,7,2,3,5,3,20
191004012,3,2,1,0,0,6
191004013,3,6,4,3,7,23
191004014,6,0,7,0,1,14
191004015,1,8,7,0,3,19
191004016,2,0,3,6,7,18
191004017,2,1,7,9,8,27
191004018,4,0,9,3,3,19
191004019,2,4,1,5,8,20
191004020,5,3,0,9,4,21
191004021,3,7,2,6,6,24
191004022,7,9,0,5,0,21
191004023,3,9,2,4,9,27
191004024,2,7,2,9,9,29
191004025,7,9,0,2,3,21
191004026,6,0,5,6,7,24
191004027,3,4,7,0,0,14
191004028,7,8,8,3,9,35
191004029,1,9,7,0,0,17
191004030,1,1,5,2,3,12
191004031,6,2,7,0,0,15
191004032,4,1,0,5,5,15
191004033,9,3,9,3,7,31
191004034,3,6,3,7,1,20
191004035,1,8,0,8,6,23
191004036,1,3,0,5,6,15
191004037,2,7,4,2,2,17
191004038,2,8,6,9,9,34
191004039,7,0,7,6,6,26
191004040,6,3,9,8,4,30
191004041,7,8,0,3,2,20
191004042,3,3,2,7,3,18
191004043,8,8,7,5,4,32
191004044,6,3,4,6,9,28
191004045,2,4,2,5,3,16
191004046,1,9,7,2,3,22
191004047,2,2,5,1,4,14
191004048,8,7,6,3,4,28
191004049,1,2,5,7,3,18
191004050,3,7,5,8,7,30
191004051,3,3,1,3,5,15
191004052,7,5,8,7,5,32
191004053,9,3,5,7,7,31
191004054,3,0,9,7,4,23
191004055,0,9,9,0,0,18
191004056,8,4,0,3,2,17
191004057,3,6,2,3,4,18
191004058,1,8,8,9,0,26
191004059,5,1,5,6,8,25
191004060,1,7,6,7,9,30
191004061,7,5,6,0,6,24
191004062,8,9,7,2,1,27
191004063,8,3,6,7,8,32
191004064,5,2,8,5,2,22
191004065,8,1,7,3,0,19
191004066,4,3,5,7,3,22
191004067,4,0,2,5,7,18
191004068,6,0,8,4,8,26
191004069,0,9,3,5,2,19
191004070,1,9,4,7,2,23
191004071,6,6,7,0,5,24
191004072,2,1,4,2,0,9
191004073,1,2,2,0,3,8
191004074,2,9,1,9,9,30
191004075,2,9,3,7,7,28
191004076,6,1,7,8,2,24
191004077,9,5,0,9,8,31
191004078,6,1,0,6,2,15
191004079,6,7,7,2,1,23
191004080,3,8,1,4,2,18
191004081,9,0,1,0,1,11
191004082,3,9,3,1,5,21
191004083,8,1,1,9,4,23
191004084,1,6,1,0,6,14
191004085,2,7,0,2,9,20
191004086,6,8,1,8,0,23
191004087,5,2,0,2,1,10
191004088,9,6,2,6,8,31
191004089,2,0,9,7,6,24
191004090,3,9,0,5,8,25
191004091,6,8,4,7,4,29
191004092,3,7,0,9,2,21
191004093,1,4,9,7,0,21
191004094,7,8,3,2,1,21
191004095,7,5,4,2,6,24
191004096,0,9,1,1,9,20
191004097,2,8,1,6,0,17
191004098,0,4,4,5,6,19
191004099,5,7,2,0,5,19
191004100,2,6,3,2,3,16
191004101,1,3,9,5,8,26
191004102,3,3,0,1,4,11
191004103,9,6,8,8,7,38
191004104,6,2,5,9,7,29
191004105,5,1,4,2,3,15
191004106,1,3,8,8,3,23
191004107,1,2,7,7,6,23
191004108,6,2,8,5,6,27
191004109,0,9,5,8,6,28
191004110,8,1,5,5,2,21
191004111,2,7,8,8,6,31
191004112,3,1,8,5,7,24
191004113,6,5,9,6,2,28
191004114,1,5,7,5,8,26
191004115,8,2,2,2,3,17
191004116,3,9,3,8,4,27
191004117,1,8,2,8,0,19
191004118,8,4,4,5,5,26
191004119,8,0,4,8,2,22
191004120,9,5,1,9,3,27
191004121,4,3,1,3,4,15
191004122,2,0,7,4,1,14
191004123,4,8,3,1,5,21
191004124,4,8,5,4,3,24
191004125,1,0,3,2,2,8
191004126,4,7,5,0,2,18
191004127,5,1,2,8,2,18
191004128,9,2,7,1,7,26
191004129,6,7,8,0,1,22
191004130,2,4,2,3,7,18
191004131,9,6,3,3,8,29
191004132,6,1,9,2,9,27
191004133,9,3,7,6,2,27
191004134,4,2,7,3,4,20
191004135,1,0,2,8,8,19
191004136,7,7,8,9,9,40
191004137,0,2,5,9,1,17
191004138,1,6,0,8,9,24
191004139,6,5,5,5,4,25
191004140,6,1,6,0,1,14
191004141,3,6,5,5,4,23
191004142,1,1,8,3,2,15
191004143,3,0,6,9,6,24
191004144,1,8,5,5,6,25
191004145,0,0,5,9,6,20
191004146,4,0,5,3,0,12
191004147,4,6,2,7,5,24
191004148,8,6,9,2,4,29
191004149,9,6,1,1,3,20
191004150,8,2,7,9,8,34
191004151,4,0,9,6,8,27
191004152,1,3,6,1,3,14
191004153,3,7,8,2,7,27
191004154,5,2,8,7,7,29
191004155,2,7,5,8,6,28
191004156,7,6,8,4,2,27
191004157,4,5,2,0,2,13
191004158,5,0,8,2,1,16
191004159,6,7,9,0,1,23
191004160,2,4,0,3,8,17
191004161,3,6,8,5,2,24
191004162,0,6,3,4,4,17
191004163,2,2,8,8,6,26
191004164,2,3,5,2,5,17
191004165,5,0,1,3,4,13
191004166,8,9,9,3,1,30
191004167,4,4,0,1,8,17
191004168,3,1,5,5,6,20
191004169,3,2,6,1,2,14
191004170,8,7,4,2,2,23
191004171,0,2,7,8,8,25
191004172,0,2,1,3,3,9
191004173,4,8,9,1,8,30
191004174,5,4,4,9,1,23
191004175,3,7,1,3,9,23
191004176,5,0,6,4,5,20
191004177,7,2,7,1,2,19
191004178,9,9,5,6,1,30
191004179,2,4,3,0,0,9
191004180,8,4,0,6,3,21
191004181,1,3,8,3,9,24
191004182,8,2,0,7,2,19
191004183,1,1,0,0,7,9
191004184,8,3,1,4,8,24
191004185,2,8,9,6,0,25
191004186,3,4,5,1,5,18
191004187,1,2,7,9,5,24
191004188,0,0,3,7,9,19
191004189,4,6,5,2,9,26
191004190,1,8,5,7,5,26
191004191,7,4,3,4,4,22
191004192,7,5,7,2,4,25
191004193,5,0,9,4,3,21
191004194,3,1,0,9,0,13
191004195,3,3,3,8,0,17
191004196,9,6,4,5,2,26
191004197,9,8,1,3,2,23
191004198,7,5,2,4,5,23
191004199,2,4,8,0,6,20
191004200,9,0,4,4,7,24
191004201,9,8,1,6,2,26
191004202,8,2,9,0,3,22
191004203,7,9,3,5,0,24
191004204,8,9,8,3,5,33
191004205,2,2,7,9,2,22
191004206,4,6,9,9,3,31
191004207,5,6,3,2,8,24
191004208,3,8,9,4,3,27
191004209,2,5,8,7,6,28
191004210,5,8,4,6,4,27
191004211,4,2,6,6,1,19
191004212,7,7,6,1,9,30
191004213,0,5,4,5,5,19
191004214,0,4,3,2,6,15
191004215,9,0,1,9,9,28
191004216,8,9,2,9,0,28
191004217,7,9,0,8,8,32
191004218,8,4,0,8,0,20
191004219,9,5,8,2,1,25
191004220,4,3,0,6,4,17
191004221,4,8,5,4,1,22
191004222,0,0,1,5,3,9
191004223,2,8,4,7,5,26
191004224,8,6,7,2,2,25
191004225,0,1,7,0,4,12
191004226,6,1,6,3,1,17
191004227,0,4,1,7,6,18
191004228,6,5,4,1,5,21
191004229,8,1,1,3,9,22
191004230,4,3,4,5,8,24
191004231,8,0,4,4,5,21
191004232,6,5,5,2,3,21
191004233,3,3,5,1,3,15
191004234,2,3,5,2,4,16
191004235,6,2,9,7,2,26
191004236,8,5,2,1,2,18
191004237,4,2,5,1,0,12
191004238,5,7,0,7,1,20
191004239,8,5,0,1,0,14
191004240,9,7,5,7,2,30
191004241,8,6,1,7,2,24
191004242,4,5,2,3,0,14
191004243,8,7,2,1,8,26
191004244,7,4,4,4,0,19
191004245,9,1,5,2,2,19
191004246,8,8,7,6,3,32
191004247,0,8,8,2,4,22
191004248,7,8,1,1,4,21
191004249,7,0,8,8,5,28
191004250,7,4,5,2,2,20
191004251,4,8,1,7,4,24
191004252,1,1,5,2,0,9
191004253,2,8,1,8,2,21
191004254,5,2,9,1,1,18
191004255,1,1,1,9,0,12
191004256,1,0,1,4,1,7
191004257,1,9,9,7,1,27
191004258,1,8,7,8,4,28
191004259,3,0,7,4,9,23
191004260,1,1,0,2,9,13
191004261,1,6,0,9,1,17
191004262,3,3,2,9,0,17
191004263,5,6,7,2,3,23
191004264,5,8,8,7,4,32
191004265,8,1,7,7,7,30
191004266,5,5,1,1,7,19
191004267,7,3,1,8,6,25
191004268,5,1,4,0,3,13
191004269,0,0,1,2,7,10
191004270,8,6,6,3,3,26
191004271,0,5,3,2,3,13
191004272,9,0,0,5,9,23
191004273,8,5,2,3,6,24
191004274,9,7,9,5,4,34
191004275,1,2,9,6,3,21
191004276,3,3,8,5,5,24
191004277,8,9,2,4,6,29
191004278,5,8,0,4,0,17
191004279,3,3,7,3,0,16
191004280,8,0,0,9,0,17
191004281,2,5,4,4,0,15
191004282,2,2,1,4,4,13
191004283,1,0,8,2,6,17
191004284,9,4,3,1,3,20
191004285,4,7,0,9,1,21
191004286,7,7,3,3,2,22
191004287,0,3,6,9,2,20
191004288,2,1,0,0,7,10
191004289,8,9,1,8,0,26
191004290,4,6,8,7,9,34
191004291,8,5,8,2,2,25
191004292,8,2,8,3,2,23
191004293,6,3,9,1,8,27
191004294,9,5,5,9,2,30
191004295,9,6,6,2,1,24
191004296,5,3,2,4,1,15
191004297,8,8,0,9,3,28
191004298,5,4,7,7,4,27
191004299,6,1,3,8,1,19
191004300,4,2,2,3,3,14
191004301,4,5,8,3,4,24
191004302,1,4,1,5,9,20
191004303,9,7,9,4,8,37
191004304,9,8,5,4,1,27
191004305,8,8,6,2,3,27
191004306,0,4,6,5,5,20
191004307,6,3,3,4,7,23
191004308,2,3,0,4,3,12
191004309,8,5,1,5,4,23
191004310,8,7,0,0,5,20
191004311,7,3,4,3,0,17
191004312,6,1,8,0,1,16
191004313,4,9,2,3,0,18
191004314,1,0,2,1,1,5
191004315,2,3,3,8,7,23
191004316,6,4,1,4,8,23
191004317,1,1,9,6,8,25
191004318,8,3,8,2,8,29
191004319,0,2,8,5,9,24
191004320,5,8,2,3,3,21
191004321,6,5,2,3,8,24
191004322,1,3,8,5,5,22
191004323,0,2,9,6,3,20
191004324,8,2,7,0,5,22
191004325,5,9,9,9,4,36
191004326,2,9,4,7,6,28
191004327,9,1,0,7,1,18
191004328,8,5,8,1,3,25
191004329,3,4,0,7,6,20
191004330,3,1,4,7,7,22
191004331,7,8,8,3,3,29
191004332,9,2,9,3,8,31
191004333,5,4,4,3,5,21
191004334,0,8,4,0,6,18
191004335,4,1,0,8,4,17
191004336,2,8,8,1,3,22
191004337,2,5,0,4,7,18
191004338,2,6,3,8,6,25
191004339,1,7,9,4,7,28
191004340,5,8,1,2,3,19
191004341,2,4,1,6,4,17
191004342,7,1,6,9,7,30
191004343,4,0,0,4,1,9
191004344,6,2,2,4,9,23
191004345,0,9,5,0,6,20
191004346,2,6,5,8,5,26
191004347,4,4,5,9,1,23
191004348,4,9,2,9,3,27
191004349,7,8,0,1,5,21
191004350,6,6,8,4,9,33
191004351,2,2,1,8,7,20
191004352,9,0,8,9,1,27
191004353,5,7,8,3,9,32
191004354,6,4,4,0,3,17
191004355,6,6,5,8,5,30
191004356,3,0,1,0,8,12
191004357,5,2,0,3,0,10
191004358,9,4,1,4,7,25
191004359,0,9,2,6,2,19
191004360,4,2,2,5,1,14
191004361,4,1,5,4,9,23
191004362,0,6,4,4,1,15
191004363,4,0,4,1,9,18
191004364,9,6,5,9,3,32
191004365,2,1,4,8,4,19
191004366,5,8,0,4,9,26
191004367,2,3,3,3,8,19
191004368,4,4,1,0,8,17
191004369,8,4,0,1,6,19
191004370,4,7,1,9,7,28
191004371,9,4,9,3,2,27
191004372,3,9,9,8,7,36
191004373,1,3,2,7,1,14
191004374,9,6,5,5,6,31
191004375,3,8,6,7,1,25
191004376,2,3,0,0,7,12
191004377,0,2,0,8,1,11
191004378,2,6,9,0,6,23
191004379,4,6,8,1,9,28
191004380,9,0,9,2,1,21
191004381,1,5,5,3,2,16
191004382,0,2,4,4,8,18
191004383,1,4,9,6,9,29
191004384,7,5,5,2,8,27
191004385,5,2,2,9,6,24
191004386,7,9,2,7,9,34
191004387,2,2,7,8,6,25
191004388,6,3,2,4,9,24
191004389,2,9,0,3,6,20
191004390,5,7,1,1,2,16
191004391,5,3,9,4,9,30
191004392,5,2,1,6,9,23
191004393,0,9,9,4,7,29
191004394,0,5,4,5,2,16
191004395,9,9,2,6,1,27
191004396,4,0,8,4,3,19
191004397,6,7,1,9,9,32
191004398,4,2,4,9,4,23
191004399,1,7,8,4,9,29
191004400,7,7,3,7,0,24
191004401,5,8,3,2,2,20
191004402,1,4,5,4,0,14
191004403,5,5,4,0,4,18
191004404,5,4,9,7,2,27
191004405,4,6,0,8,5,23
191004406,6,6,0,8,2,22
191004407,3,7,3,1,5,19
191004408,9,4,8,0,6,27
191004409,8,3,1,2,6,20
191004410,1,7,6,0,6,20
191004411,0,4,3,1,2,10
191004412,8,3,8,3,0,22
191004413,8,4,2,8,0,22
191004414,7,4,3,9,2,25
191004415,8,0,4,8,6,26
191004416,8,1,7,3,6,25
191004417,5,3,4,9,9,30
191004418,6,2,4,7,4,23
191004419,0,5,5,6,9,25
191004420,3,0,2,8,5,18
191004421,6,3,4,3,0,16
191004422,7,8,4,7,9,35
191004423,1,4,2,6,5,18
191004424,6,4,4,8,6,28
191004425,3,1,6,0,2,12
191004426,0,3,8,8,2,21
191004427,0,7,8,8,7,30
191004428,0,9,2,3,2,16
191004429,5,5,7,3,7,27
191004430,3,8,6,7,8,32
191004431,4,3,2,2,1,12
191004432,7,5,2,1,1,16
191004433,9,8,1,9,6,33
191004434,0,5,1,9,5,20
191004435,7,8,4,6,6,31
191004436,3,9,3,8,6,29
191004437,9,3,9,2,9,32
191004438,4,6,6,7,0,23
191004439,2,2,2,3,0,9
191004440,7,4,7,9,2,29
191004441,0,7,8,6,5,26
191004442,9,5,4,6,4,28
191004443,9,6,0,8,9,32
191004444,4,7,4,2,7,24
191004445,4,7,5,5,0,21
191004446,9,4,2,8,2,25
191004447,9,6,1,3,3,22
191004448,5,3,8,9,4,29
191004449,2,1,5,3,0,11
191004450,2,0,2,2,2,8
191004451,4,8,4,8,0,24
191004452,5,4,3,3,1,16
191004453,6,9,2,1,6,24
191004454,5,7,7,1,6,26
191004455,1,1,4,3,8,17
191004456,7,7,6,5,8,33
191004457,6,3,1,9,6,25
191004458,3,7,9,0,7,26
191004459,7,1,1,3,8,20
191004460,8,9,9,2,1,29
191004461,5,7,3,1,5,21
191004462,7,7,5,0,6,25
191004463,3,3,7,6,1,20
191004464,4,7,9,0,9,29
191004465,4,8,5,5,1,23
191004466,7,7,0,2,7,23
191004467,3,9,9,6,0,27
191004468,8,9,5,5,2,29
191004469,2,6,2,1,4,15
191004470,2,4,6,1,5,18
191004471,5,0,5,9,8,27
191004472,0,4,6,0,7,17
191004473,9,9,9,2,0,29
191004474,1,9,0,3,5,18
191004475,2,0,9,4,7,22
191004476,7,7,2,3,8,27
191004477,1,2,6,9,4,22
191004478,1,0,9,9,8,27
191004479,6,0,9,8,3,26
191004480,6,1,1,6,6,20
191004481,2,4,8,1,2,17
191004482,2,2,9,8,8,29
191004483,3,6,5,9,9,32
191004484,3,3,8,0,8,22
191004485,4,8,7,5,2,26
191004486,2,7,2,3,6,20
191004487,5,7,9,7,8,36
191004488,1,6,9,1,9,26
191004489,9,8,9,1,7,34
191004490,9,2,9,8,3,31
191004491,1,4,7,2,5,19
191004492,2,8,4,2,2,18
191004493,4,6,9,0,1,20
191004494,5,2,2,9,8,26
191004495,4,1,5,9,5,24
191004496,3,6,8,3,1,21
191004497,2,1,9,7,1,20
191004498,6,2,2,9,1,20
191004499,5,3,5,6,9,28
191004500,8,2,1,7,7,25
191004501,6,8,7,9,2,32
191004502,0,7,6,9,7,29
191004503,2,5,5,1,2,15
191004504,6,2,4,5,9,26
191004505,1,7,2,7,4,21
191004506,4,4,8,1,0,17
191004507,0,3,0,4,3,10
191004508,3,2,9,4,1,19
191004509,7,6,1,8,5,27
191004510,4,6,9,5,5,29
191004511,6,7,8,3,0,24
191004512,3,8,6,6,7,30
191004513,9,4,7,0,3,23
191004514,5,4,9,4,7,29
191004515,2,7,9,6,0,24
191004516,0,9,7,2,7,25
191004517,8,3,4,9,4,28
191004518,0,4,4,0,9,17
191004519,5,4,7,3,5,24
191004520,4,4,6,3,9,26
191004521,2,3,6,9,9,29
191004522,9,2,9,2,3,25
191004523,1,7,5,4,9,26
191004524,3,8,1,9,4,25
191004525,0,3,7,6,0,16
191004526,3,7,2,7,1,20
191004527,9,2,3,4,7,25
191004528,9,0,4,5,6,24
191004529,7,2,6,1,6,22
191004530,5,2,6,2,6,21
191004531,3,9,0,0,2,14
191004532,9,1,5,5,3,23
191004533,9,0,9,2,3,23
191004534,3,6,8,3,7,27
191004535,2,4,0,0,3,9
191004536,9,5,1,5,7,27
191004537,3,8,5,0,6,22
191004538,9,5,2,7,9,32
191004539,0,5,3,6,6,20
191004540,6,7,5,7,6,31
191004541,6,6,5,0,9,26
191004542,5,9,9,2,8,33
191004543,0,7,1,2,4,14
191004544,5,2,0,5,8,20
191004545,4,3,3,1,5,16
191004546,5,6,0,7,0,18
191004547,0,3,1,8,1,13
191004548,0,6,3,5,9,23
191004549,9,3,8,1,0,21
191004550,2,7,9,9,8,35
191004551,6,1,5,8,6,26
191004552,3,3,5,1,7,19
191004553,2,4,6,0,4,16
191004554,0,8,6,0,0,14
191004555,8,0,0,6,5,19
191004556,7,1,0,0,4,12
191004557,7,2,2,1,0,12
191004558,6,8,6,0,5,25
191004559,1,5,0,8,5,19
191004560,8,3,1,8,4,24
191004561,7,3,1,3,8,22
191004562,4,9,3,1,9,26
191004563,9,2,4,3,2,20
191004564,1,9,0,4,5,19
191004565,0,2,2,4,7,15
191004566,2,1,8,1,9,21
191004567,1,8,6,3,8,26
191004568,2,3,9,2,7,23
191004569,1,9,4,5,5,24
191004570,3,3,4,2,5,17
191004571,8,2,2,5,3,20
191004572,0,0,8,1,8,17
191004573,6,9,7,2,6,30
191004574,8,8,4,0,3,23
191004575,9,5,2,6,3,25
191004576,7,7,3,0,1,18
191004577,3,0,2,1,3,9
191004578,1,1,3,9,9,23
191004579,6,6,1,6,2,21
191004580,0,3,4,1,8,16
191004581,8,4,7,3,1,23
191004582,5,1,5,9,0,20
191004583,4,5,8,3,8,28
191004584,0,9,7,2,1,19
191004585,6,6,5,6,7,30
191004586,1,4,7,2,9,23
191004587,8,2,6,5,9,30
191004588,7,4,8,7,1,27
191004589,0,6,1,5,9,21
191004590,2,4,0,5,9,20
191004591,3,4,5,8,5,25
191004592,8,1,2,5,8,24
191004593,9,7,0,3,1,20
191004594,7,2,2,7,3,21
191004595,5,0,7,3,9,24
191004596,6,1,3,6,1,17
191004597,3,7,7,8,4,29
191004598,8,9,6,6,6,35
191004599,5,0,6,8,1,20
191004600,2,5,8,7,3,25
191004601,2,0,1,6,2,11
191004602,2,7,8,1,1,19
191004603,0,8,2,1,1,12
191004604,9,4,1,4,2,20
191004605,5,4,7,6,6,28
191004606,9,6,7,7,0,29
191004607,3,1,3,6,1,14
191004608,9,9,1,2,6,27
191004609,4,8,3,3,6,24
191004610,1,1,4,5,4,15
191004611,5,2,9,8,2,26
191004612,0,9,0,6,8,23
191004613,3,6,6,9,0,24
191004614,6,5,0,4,1,16
191004615,0,8,7,6,6,27
191004616,3,3,7,8,4,25
191004617,7,1,4,5,0,17
191004618,0,8,6,8,8,30
191004619,0,3,4,8,5,20
191004620,9,0,7,3,3,22
191004621,8,6,3,1,2,20
191004622,1,3,6,7,5,22
191004623,9,4,7,7,7,34
191004624,4,0,2,1,4,11
191004625,3,9,7,3,8,30
191004626,9,1,9,9,2,30
191004627,3,0,7,2,3,15
191004628,0,1,9,9,7,26
191004629,7,9,8,8,2,34
191004630,7,7,4,9,0,27
191004631,2,2,2,0,2,8
191004632,2,3,7,4,1,17
191004633,5,6,8,3,3,25
191004634,9,3,0,1,5,18
191004635,4,3,5,9,6,27
191004636,7,8,3,0,8,26
191004637,6,7,4,8,2,27
191004638,1,9,5,7,0,22
191004639,7,3,9,2,5,26
191004640,0,1,6,1,6,14
191004641,1,0,6,6,4,17
191004642,9,2,0,0,9,20
191004643,6,5,1,2,5,19
191004644,7,3,4,7,2,23
191004645,2,2,3,8,1,16
191004646,1,0,4,8,8,21
191004647,7,0,0,5,0,12
191004648,7,5,7,0,1,20
191004649,0,5,5,8,2,20
191004650,1,9,7,9,9,35
191004651,5,9,3,5,9,31
191004652,9,9,5,2,8,33
191004653,3,4,9,5,8,29
191004654,4,3,0,4,3,14
191004655,4,6,7,1,3,21
191004656,7,2,1,9,0,19
191004657,4,3,5,3,1,16
191004658,3,5,8,9,9,34
191004659,3,9,2,3,7,24
191004660,1,0,0,9,0,10
191004661,0,6,2,0,9,17
191004662,0,3,9,8,0,20
191004663,7,6,2,3,0,18
191004664,7,2,7,8,1,25
191004665,3,4,8,7,4,26
191004666,7,0,1,3,3,14
191004667,8,0,5,8,1,22
191004668,8,3,2,3,8,24
191004669,0,9,3,7,3,22
191004670,0,8,4,8,0,20
191004671,8,6,1,2,6,23
191004672,0,8,1,1,9,19
191004673,0,4,0,5,0,9
191004674,8,0,6,0,6,20
191004675,4,1,0,0,7,12
191004676,4,3,2,7,4,20
191004677,3,2,8,3,0,16
191004678,6,3,2,1,4,16
191004679,5,5,9,3,0,22
191004680,7,2,8,6,9,32
191004681,8,4,2,1,9,24
191004682,1,3,6,9,8,27
191004683,9,3,5,5,9,31
191004684,6,2,5,6,9,28
191004685,9,3,0,4,6,22
191004686,0,6,0,7,3,16
191004687,6,9,7,9,9,40
191004688,8,2,2,8,5,25
191004689,5,0,4,0,5,14
191004690,0,6,2,5,5,18
191004691,4,9,3,4,7,27
191004692,8,2,7,4,7,28
191004693,6,4,1,7,6,24
191004694,3,2,6,4,1,16
191004695,8,0,5,8,8,29
191004696,1,8,2,9,5,25
191004697,4,1,4,3,1,13
191004698,4,4,8,4,1,21
191004699,8,2,7,0,2,19
191004700,9,3,2,7,5,26
191004701,2,1,7,5,6,21
191004702,6,1,7,2,8,24
191004703,8,5,9,2,8,32
191004704,6,8,3,4,6,27
191004705,0,3,7,2,5,17
191004706,6,6,3,0,2,17
191004707,0,5,1,1,9,16
191004708,2,0,6,5,2,15
191004709,3,2,0,0,2,7
191004710,6,0,3,8,9,26
191004711,8,2,1,3,7,21
191004712,3,6,5,1,0,15
191004713,0,3,2,2,6,13
191004714,6,5,5,3,6,25
191004715,3,3,9,7,7,29
191004716,4,8,3,7,1,23
191004717,9,8,1,3,8,29
191004718,0,4,7,2,2,15
191004719,8,0,3,0,6,17
191004720,8,6,5,2,5,26
191004721,8,9,3,7,1,28
191004722,2,4,6,3,7,22
191004723,9,3,9,8,0,29
191004724,5,4,4,5,1,19
191004725,6,8,4,0,5,23
191004726,9,4,1,9,0,23
191004727,0,5,2,9,7,23
191004728,6,0,7,5,5,23
191004729,5,5,0,2,8,20
191004730,9,8,1,9,0,27
191004731,5,9,4,3,8,29
191004732,3,1,5,3,8,20
191004733,2,2,4,8,6,22
191004734,0,9,7,3,7,26
191004735,1,1,9,0,4,15
191004736,8,0,6,4,0,18
191004737,8,0,8,4,0,20
191004738,5,3,3,2,9,22
191004739,9,0,3,4,9,25
191004740,9,8,2,3,3,25
191004741,1,1,1,8,2,13
191004742,1,9,2,9,9,30
191004743,6,4,8,2,5,25
191004744,9,5,0,4,7,25
191004745,2,2,2,8,7,21
191004746,6,5,8,2,3,24
191004747,9,6,5,1,9,30
191004748,7,2,0,6,2,17
191004749,8,0,4,3,9,24
191004750,6,6,8,9,9,38
191004751,0,2,7,1,1,11
191004752,2,5,6,3,1,17
191004753,9,8,0,9,2,28
191004754,0,8,1,8,7,24
191004755,7,0,5,0,2,14
191004756,2,3,1,6,4,16
191004757,2,4,0,9,6,21
191004758,3,4,4,5,6,22
191004759,5,7,9,7,9,37
191004760,1,9,7,4,2,23
191004761,6,6,8,1,7,28
191004762,6,4,1,2,7,20
191004763,9,1,4,5,2,21
191004764,4,6,3,7,8,28
191004765,9,4,5,4,2,24
191004766,4,1,1,4,6,16
191004767,3,9,4,8,6,30
191004768,8,9,8,7,6,38
191004769,4,1,0,9,7,21
191004770,0,5,2,9,0,16
191004771,4,3,8,9,6,30
191004772,3,1,1,9,0,14
191004773,4,7,0,4,3,18
191004774,1,8,4,7,6,26
191004775,2,1,4,4,0,11
191004776,5,5,4,3,0,17
191004777,2,3,3,1,8,17
191004778,6,7,0,8,4,25
191004779,8,3,8,0,8,27
191004780,0,7,8,0,8,23
191004781,2,5,0,9,2,18
191004782,6,9,9,7,8,39
191004783,3,9,9,0,1,22
191004784,7,3,4,7,3,24
191004785,1,8,0,4,8,21
191004786,1,7,0,7,6,21
191004787,5,3,1,0,3,12
191004788,6,0,2,2,6,16
191004789,7,4,2,4,2,19
191004790,8,6,4,4,8,30
191004791,7,9,3,6,9,34
191004792,7,3,2,5,4,21
191004793,5,2,4,8,4,23
191004794,1,3,3,2,5,14
191004795,2,5,2,4,2,15
191004796,8,1,0,5,9,23
191004797,4,0,8,8,4,24
191004798,9,6,9,0,7,31
191004799,5,8,0,9,0,22
191004800,8,5,2,6,3,24
191004801,1,2,5,4,0,12
191004802,4,4,6,6,7,27
191004803,5,2,1,8,9,25
191004804,5,3,9,6,2,25
191004805,4,6,8,4,0,22
191004806,6,4,7,9,7,33
191004807,4,4,8,4,5,25
191004808,0,8,1,1,4,14
191004809,9,6,5,9,5,34
191004810,4,0,8,5,1,18
191004811,0,3,4,9,5,21
191004812,8,5,1,3,3,20
191004813,2,8,7,9,0,26
191004814,2,9,1,2,2,16
191004815,4,1,4,9,5,23
191004816,6,1,2,3,4,16
191004817,6,9,6,9,0,30
191004818,6,9,9,1,2,27
191004819,5,9,9,7,6,36
191004820,7,4,6,6,9,32
191004821,6,1,8,1,7,23
191004822,3,7,8,8,1,27
191004823,0,9,2,0,3,14
191004824,7,0,2,8,1,18
191004825,3,7,1,1,4,16
191004826,1,7,5,4,0,17
191004827,3,1,8,7,9,28
191004828,9,3,4,0,1,17
191004829,5,0,5,0,8,18
191004830,1,4,9,7,7,28
191004831,0,1,5,2,8,16
191004832,3,9,0,1,7,20
191004833,3,3,7,0,7,20
191004834,6,4,3,4,6,23
191004835,1,3,9,2,5,20
191004836,3,7,9,0,2,21
191004837,6,8,5,5,0,24
191004838,2,2,4,0,9,17
191004839,2,6,0,4,4,16
191004840,3,8,0,7,4,22
191004841,0,5,1,3,2,11
191004842,6,1,4,8,6,25
191004843,9,5,4,2,0,20
191004844,9,0,1,6,0,16
191004845,5,3,8,3,6,25
191004846,6,0,4,1,9,20
191004847,8,0,2,2,0,12
191004848,2,2,0,5,6,15
191004849,8,2,5,4,5,24
191004850,3,0,7,2,2,14
191004851,7,7,9,1,8,32
191004852,6,3,4,1,7,21
191004853,9,9,7,2,1,28
191004854,3,0,9,4,5,21
191004855,6,4,4,9,1,24
191004856,1,5,9,6,2,23
191004857,5,4,0,6,3,18
191004858,6,4,4,3,6,23
191004859,1,2,2,4,5,14
191004860,7,0,6,3,6,22
191004861,1,6,5,0,2,14
191004862,0,2,6,5,4,17
191004863,2,6,1,3,0,12
191004864,7,4,6,4,8,29
191004865,9,0,8,7,9,33
191004866,4,6,4,5,1,20
191004867,8,9,1,3,7,28
191004868,6,8,7,2,7,30
191004869,3,0,7,7,9,26
191004870,9,2,4,2,7,24
191004871,0,6,9,1,3,19
191004872,9,4,4,9,0,26
191004873,9,2,5,8,5,29
191004874,4,9,8,6,2,29
191004875,3,6,8,7,5,29
191004876,7,1,0,8,2,18
191004877,9,6,1,8,5,29
191004878,4,7,5,0,6,22
191004879,4,2,1,7,4,18
191004880,4,8,2,0,3,17
191004881,2,0,4,5,4,15
191004882,6,5,4,3,4,22
191004883,0,6,0,2,0,8
191004884,9,2,2,1,6,20
191004885,9,0,2,9,2,22
191004886,1,9,7,2,0,19
191004887,5,9,5,5,3,27
191004888,2,3,4,0,8,17
191004889,2,6,6,7,6,27
191004890,3,4,5,1,6,19
191004891,1,7,4,6,2,20
191004892,5,6,0,0,7,18
191004893,7,0,3,0,2,12
191004894,8,5,4,5,7,29
191004895,5,3,1,3,2,14
191004896,4,3,5,3,8,23
191004897,7,9,7,8,6,37
191004898,6,0,3,7,9,25
191004899,4,4,0,3,0,11
191004900,2,1,0,5,8,16
191004901,9,9,7,7,9,41
191004902,7,7,7,2,9,32
191004903,4,3,5,7,9,28
191004904,6,8,6,2,2,24
191004905,6,2,1,6,0,15
191004906,3,0,4,8,7,22
191004907,2,7,5,4,2,20
191004908,2,1,5,3,1,12
191004909,4,2,0,2,7,15
191004910,1,0,1,7,3,12
191004911,4,5,3,9,9,30
191004912,2,5,5,3,2,17
191004913,2,1,8,9,9,29
191004914,7,3,7,1,2,20
191004915,6,6,8,3,1,24
191004916,9,5,8,7,4,33
191004917,6,8,5,2,9,30
191004918,3,7,1,9,4,24
191004919,1,2,7,3,0,13
191004920,7,1,5,3,9,25
191004921,6,8,4,7,2,27
191004922,4,2,6,2,1,15
191004923,0,3,0,1,8,12
191004924,7,9,9,4,7,36
191004925,7,2,6,6,3,24
191004926,1,9,2,6,5,23
191004927,4,3,8,0,9,24
191004928,3,2,6,9,7,27
191004929,3,7,3,2,0,15
191004930,6,0,3,0,2,11
191004931,4,4,7,5,8,28
191004932,7,0,1,1,5,14
191004933,1,6,0,5,2,14
191004934,4,6,3,6,4,23
191004935,1,5,3,7,9,25
191004936,4,7,7,5,9,32
191004937,7,7,6,4,8,32
191004938,9,2,1,4,6,22
191004939,2,3,6,3,1,15
191004940,1,8,1,3,0,13
191004941,2,5,0,9,1,17
191004942,7,8,8,3,5,31
191004943,4,5,0,8,0,17
191004944,0,1,5,7,3,16
191004945,5,3,3,3,2,16
191004946,9,0,5,6,8,28
191004947,7,3,9,3,4,26
191004948,6,9,9,6,0,30
191004949,5,6,5,1,0,17
191004950,1,3,6,7,3,20
191004951,3,0,9,3,9,24
191004952,8,8,6,0,6,28
191004953,9,0,5,3,4,21
191004954,4,2,2,2,9,19
191004955,8,4,2,6,1,21
191004956,4,2,8,6,9,29
191004957,4,4,9,9,1,27
191004958,5,9,1,5,9,29
191004959,3,8,7,7,9,34
191004960,2,7,4,4,6,23
191004961,4,9,5,6,8,32
191004962,2,6,8,7,0,23
191004963,8,1,1,2,2,14
191004964,6,2,1,4,2,15
191004965,0,8,1,9,2,20
191004966,8,6,6,7,0,27
191004967,5,5,9,4,1,24
191004968,4,4,0,4,5,17
191004969,5,3,3,6,6,23
191004970,1,7,7,2,2,19
191004971,5,9,5,9,3,31
191004972,4,3,9,6,4,26
191004973,8,2,1,6,0,17
191004974,5,0,6,0,7,18
191004975,5,9,6,4,0,24
191004976,7,8,2,8,4,29
191004977,0,7,7,6,3,23
191004978,1,3,9,5,5,23
191004979,2,9,5,0,9,25
191004980,6,8,5,9,7,35
191004981,7,3,3,5,9,27
191004982,1,3,3,8,9,24
191004983,6,4,3,0,4,17
191004984,6,9,4,6,3,28
191004985,7,5,0,8,3,23
191004986,4,3,0,6,0,13
191004987,7,3,9,5,5,29
191004988,1,6,3,2,8,20
191004989,9,0,4,9,1,23
191004990,1,2,7,7,9,26
191004991,9,6,6,6,2,29
191004992,4,1,6,3,6,20
191004993,8,5,7,8,2,30
191004994,5,5,4,5,9,28
191004995,6,7,4,0,0,17
191004996,9,0,5,8,4,26
191004997,9,2,1,1,3,16
191004998,7,1,7,7,8,30
191004999,3,1,1,7,3,15
1910041000,2,7,6,8,6,29
1910041001,3,3,5,0,9,20
1910041002,2,5,8,8,4,27
1910041003,0,6,4,6,2,18
1910041004,6,2,9,7,1,25
1910041005,2,5,2,9,2,20
1910041006,6,5,9,7,4,31
1910041007,4,9,4,7,6,30
1910041008,7,5,6,7,4,29
1910041009,7,4,1,5,7,24
1910041010,6,0,0,7,2,15
1910041011,7,7,5,0,1,20
1910041012,3,7,1,7,1,19
1910041013,4,4,7,1,9,25
1910041014,8,8,5,2,8,31
1910041015,9,8,4,6,0,27
1910041016,1,5,8,8,6,28
1910041017,6,7,1,9,7,30
1910041018,5,4,6,6,2,23
1910041019,9,6,5,9,1,30
1910041020,7,3,2,0,7,19
1910041021,8,1,8,0,2,19
1910041022,3,3,5,4,4,19
1910041023,1,6,6,3,2,18
1910041024,9,9,2,4,1,25
1910041025,2,7,9,6,3,27
1910041026,5,5,0,2,5,17
1910041027,6,4,0,3,1,14
1910041028,8,7,6,9,9,39
1910041029,5,0,6,9,9,29
1910041030,0,3,6,0,3,12
1910041031,1,8,9,2,3,23
1910041032,6,1,2,4,9,22
1910041033,5,0,0,5,3,13
1910041034,1,9,2,2,1,15
1910041035,2,8,0,4,0,14
1910041036,2,2,4,2,8,18
1910041037,6,7,4,4,3,24
1910041038,0,4,5,6,4,19
1910041039,0,9,2,8,2,21
1910041040,0,8,0,1,5,14
1910041041,9,1,2,4,0,16
1910041042,1,0,4,6,5,16
1910041043,0,6,3,9,6,24
1910041044,1,1,8,1,4,15
1910041045,0,4,4,7,1,16
1910041046,6,7,1,6,2,22
1910041047,7,8,7,9,3,34
1910041048,6,9,9,9,2,35
1910041049,5,7,2,9,0,23
1910041050,0,8,8,5,1,22
1910041051,4,8,0,0,4,16
1910041052,1,6,9,5,4,25
1910041053,8,2,7,4,5,26
1910041054,0,4,6,9,3,22
1910041055,1,6,8,3,2,20
1910041056,1,0,7,1,4,13
1910041057,6,3,7,0,9,25
1910041058,4,6,3,2,8,23
1910041059,0,6,4,1,3,14
1910041060,5,4,1,9,8,27
1910041061,0,7,6,7,5,25
1910041062,6,9,3,5,1,24
1910041063,5,6,7,2,2,22
1910041064,1,5,6,3,6,21
1910041065,2,6,5,0,0,13
1910041066,1,2,8,8,8,27
1910041067,9,0,5,6,1,21
1910041068,7,5,6,6,6,30
1910041069,7,4,6,8,5,30
1910041070,8,2,6,1,6,23
1910041071,6,9,1,8,8,32
1910041072,8,7,2,7,1,25
1910041073,6,3,9,1,7,26
1910041074,1,7,6,8,1,23
1910041075,5,7,0,2,2,16
1910041076,4,1,4,7,4,20
1910041077,4,0,4,8,2,18
1910041078,7,7,4,9,9,36
1910041079,8,1,1,8,6,24
1910041080,8,8,3,3,0,22
1910041081,2,0,1,2,9,14
1910041082,7,1,6,4,5,23
1910041083,3,1,5,5,3,17
1910041084,4,9,7,3,9,32
1910041085,3,8,6,1,5,23
1910041086,0,2,7,4,8,21
1910041087,1,4,0,9,6,20
1910041088,0,1,2,6,5,14
1910041089,1,0,5,6,4,16
1910041090,0,6,4,9,0,19
1910041091,4,1,3,1,1,10
1910041092,4,4,9,1,8,26
1910041093,3,3,2,1,8,17
1910041094,9,5,5,8,6,33
1910041095,1,1,9,1,4,16
1910041096,5,2,4,8,2,21
1910041097,7,0,4,0,0,11
1910041098,2,6,0,8,7,23
1910041099,6,3,7,8,8,32
1910041100,5,6,7,6,8,32
1910041101,1,3,4,3,8,19
1910041102,1,4,7,2,6,20
1910041103,9,8,9,5,6,37
1910041104,4,7,4,6,1,22
1910041105,4,1,9,4,3,21
191005001,4,3,6,0,4,17
191005002,9,7,5,1,8,30
191005003,5,2,4,0,1,12
191005004,1,3,5,8,9,26
191005005,4,1,5,1,4,15
191005006,3,2,2,6,9,22
191005007,4,9,5,2,0,20
191005008,2,7,9,9,4,31
191005009,5,2,0,3,7,17
191005010,2,5,6,8,1,22
191005011,7,5,1,1,9,23
191005012,3,1,6,0,8,18
191005013,3,3,6,7,7,26
191005014,9,2,0,3,6,20
191005015,9,2,5,3,7,26
191005016,1,1,9,4,5,20
191005017,0,3,9,6,0,18
191005018,2,8,4,0,1,15
191005019,6,2,3,5,3,19
191005020,2,9,2,5,9,27
191005021,7,4,3,9,1,24
191005022,3,3,7,1,8,22
191005023,0,3,5,1,3,12
191005024,0,3,3,7,0,13
191005025,8,9,6,7,2,32
191005026,8,4,7,3,8,30
191005027,5,2,1,4,4,16
191005028,4,3,4,7,9,27
191005029,6,6,8,6,5,31
191005030,7,5,5,7,6,30
191005031,1,7,6,7,2,23
191005032,4,4,6,7,7,28
191005033,2,4,8,7,8,29
191005034,8,3,3,1,2,17
191005035,1,1,6,3,5,16
191005036,9,0,6,3,1,19
191005037,0,4,4,3,3,14
191005038,4,6,2,3,5,20
191005039,2,6,7,1,6,22
191005040,6,7,3,5,0,21
191005041,5,0,9,4,5,23
191005042,0,5,6,2,6,19
191005043,8,0,4,2,4,18
191005044,9,9,1,4,8,31
191005045,9,6,3,8,2,28
191005046,5,5,0,3,4,17
191005047,2,8,5,3,3,21
191005048,1,0,5,4,5,15
191005049,1,8,3,5,5,22
191005050,9,5,8,3,6,31
191005051,4,5,1,6,5,21
191005052,9,9,7,9,2,36
191005053,5,7,8,0,5,25
191005054,9,9,9,8,5,40
191005055,2,1,8,1,7,19
191005056,1,1,3,0,8,13
191005057,7,4,4,0,1,16
191005058,6,1,7,4,5,23
191005059,3,8,1,0,4,16
191005060,9,0,7,5,3,24
191005061,9,9,8,0,3,29
191005062,0,9,6,1,1,17
191005063,5,6,4,6,6,27
191005064,4,3,1,6,8,22
191005065,1,1,8,9,8,27
191005066,4,1,2,0,1,8
191005067,0,4,2,1,9,16
191005068,2,3,7,6,0,18
191005069,8,6,5,0,3,22
191005070,4,2,3,8,0,17
191005071,9,1,0,8,4,22
191005072,5,4,3,8,3,23
191005073,5,3,0,0,2,10
191005074,3,7,4,0,6,20
191005075,3,6,0,1,5,15
191005076,0,2,2,0,6,10
191005077,1,3,4,9,2,19
191005078,5,8,8,7,7,35
191005079,9,6,8,7,5,35
191005080,2,1,7,4,6,20
191005081,3,3,5,2,0,13
191005082,1,7,7,2,5,22
191005083,3,1,2,0,5,11
191005084,1,7,0,3,9,20
191005085,1,9,0,3,9,22
191005086,9,7,5,5,1,27
191005087,2,7,5,1,1,16
191005088,8,9,2,3,8,30
191005089,2,4,5,0,4,15
191005090,6,3,1,5,0,15
191005091,7,5,6,7,6,31
191005092,3,4,5,0,2,14
191005093,2,4,7,6,8,27
191005094,5,2,7,0,2,16
191005095,3,8,8,4,8,31
191005096,9,4,1,6,8,28
191005097,6,3,5,7,9,30
191005098,0,9,7,3,4,23
191005099,3,2,7,1,7,20
191005100,5,1,8,5,5,24
191005101,0,0,0,0,9,9
191005102,7,5,5,5,2,24
191005103,4,3,1,0,8,16
191005104,2,9,9,4,5,29
191005105,4,3,6,2,1,16
191005106,0,2,0,5,3,10
191005107,0,3,7,5,9,24
191005108,7,1,8,3,4,23
191005109,9,0,5,0,1,15
191005110,4,5,0,5,9,23
191005111,6,4,3,4,4,21
191005112,2,7,2,0,6,17
191005113,9,5,6,1,0,21
191005114,0,3,0,7,7,17
191005115,8,5,1,2,5,21
191005116,4,9,6,0,2,21
191005117,0,0,8,0,4,12
191005118,5,8,7,2,9,31
191005119,1,4,7,8,3,23
191005120,5,2,3,0,1,11
191005121,8,0,8,0,6,22
191005122,8,9,2,8,6,33
191005123,1,2,2,1,0,6
191005124,8,1,4,8,7,28
191005125,5,1,2,5,4,17
191005126,0,4,5,1,5,15
191005127,4,9,9,9,2,33
191005128,4,8,0,0,8,20
191005129,4,0,1,8,2,15
191005130,4,6,2,7,3,22
191005131,7,4,4,1,3,19
191005132,5,4,0,4,9,22
191005133,9,5,2,4,7,27
191005134,6,9,2,9,1,27
191005135,4,9,3,0,8,24
191005136,9,7,2,1,6,25
191005137,5,1,9,3,7,25
191005138,2,8,5,7,2,24
191005139,5,0,3,0,4,12
191005140,4,6,1,1,3,15
191005141,4,4,1,4,7,20
191005142,5,9,0,1,4,19
191005143,7,2,2,9,9,29
191005144,5,3,3,0,5,16
191005145,6,3,7,9,7,32
191005146,3,1,9,1,3,17
191005147,5,6,3,0,0,14
191005148,0,2,2,4,2,10
191005149,2,6,6,5,9,28
191005150,0,1,4,4,7,16
191005151,6,9,3,8,0,26
191005152,3,2,8,6,0,19
191005153,0,1,3,1,8,13
191005154,0,0,8,4,3,15
191005155,9,9,2,8,8,36
191005156,2,7,3,8,9,29
191005157,2,1,3,5,1,12
191005158,9,4,3,3,9,28
191005159,1,3,1,2,6,13
191005160,2,5,4,4,6,21
191005161,7,6,0,5,9,27
191005162,3,5,9,8,3,28
191005163,4,8,7,5,1,25
191005164,8,9,4,0,7,28
191005165,1,7,0,6,7,21
191005166,1,5,3,9,7,25
191005167,4,7,9,0,2,22
191005168,9,4,0,5,0,18
191005169,4,7,4,8,4,27
191005170,9,7,9,0,4,29
191005171,6,1,3,6,6,22
191005172,0,6,3,3,6,18
191005173,2,0,2,0,4,8
191005174,5,1,7,0,3,16
191005175,8,5,5,7,1,26
191005176,4,0,3,2,4,13
191005177,6,9,2,0,9,26
191005178,4,1,6,7,0,18
191005179,5,6,2,4,4,21
191005180,2,8,5,3,7,25
191005181,4,2,6,8,9,29
191005182,4,3,4,2,6,19
191005183,9,5,5,4,2,25
191005184,1,3,8,1,8,21
191005185,7,7,1,6,5,26
191005186,0,9,2,3,0,14
191005187,4,3,1,2,1,11
191005188,7,3,6,3,0,19
191005189,5,1,2,1,8,17
191005190,6,8,2,7,7,30
191005191,5,7,8,3,5,28
191005192,5,8,3,3,3,22
191005193,2,2,5,0,1,10
191005194,8,7,1,4,1,21
191005195,0,0,6,3,4,13
191005196,9,6,3,6,8,32
191005197,2,6,0,0,6,14
191005198,2,4,2,2,8,18
191005199,8,3,8,3,8,30
191005200,8,2,9,0,7,26
191005201,7,0,6,6,3,22
191005202,8,9,6,6,9,38
191005203,1,1,4,9,8,23
191005204,4,5,3,0,2,14
191005205,1,6,0,2,6,15
191005206,4,0,1,2,0,7
191005207,8,5,5,2,3,23
191005208,1,5,6,0,4,16
191005209,2,0,2,1,7,12
191005210,1,0,1,4,5,11
191005211,6,8,8,9,6,37
191005212,0,3,9,3,0,15
191005213,1,1,9,3,0,14
191005214,2,3,7,5,2,19
191005215,1,4,2,5,1,13
191005216,9,0,4,8,3,24
191005217,6,5,2,1,1,15
191005218,9,1,3,5,4,22
191005219,1,4,0,6,8,19
191005220,6,7,9,7,4,33
191005221,0,5,6,4,6,21
191005222,8,0,6,8,1,23
191005223,8,1,4,8,9,30
191005224,2,5,7,8,8,30
191005225,8,7,0,8,0,23
191005226,6,2,4,2,7,21
191005227,1,0,7,2,8,18
191005228,7,1,0,0,8,16
191005229,1,7,5,7,9,29
191005230,2,6,5,7,9,29
191005231,4,3,7,5,9,28
191005232,4,9,5,9,5,32
191005233,3,9,4,0,9,25
191005234,2,1,8,4,4,19
191005235,1,9,7,7,7,31
191005236,9,0,8,4,7,28
191005237,4,1,9,8,9,31
191005238,6,1,1,6,1,15
191005239,0,3,6,6,4,19
191005240,5,0,5,8,3,21
191005241,7,3,3,6,5,24
191005242,4,0,1,5,5,15
191005243,0,2,5,2,7,16
191005244,9,5,0,9,7,30
191005245,1,0,1,7,2,11
191005246,7,6,8,0,8,29
191005247,1,8,8,3,6,26
191005248,9,9,2,4,9,33
191005249,2,9,3,8,6,28
191005250,0,7,9,3,2,21
191005251,3,3,2,0,7,15
191005252,4,4,5,7,7,27
191005253,4,6,3,8,2,23
191005254,7,2,1,7,0,17
191005255,7,7,8,6,5,33
191005256,8,3,1,4,5,21
191005257,8,1,3,6,9,27
191005258,8,4,8,9,8,37
191005259,6,3,7,9,3,28
191005260,8,8,9,4,4,33
191005261,5,8,7,4,1,25
191005262,8,7,6,4,7,32
191005263,9,5,3,9,3,29
191005264,1,4,5,9,8,27
191005265,1,9,1,9,0,20
191005266,8,5,5,1,0,19
191005267,1,0,7,9,5,22
191005268,2,7,5,8,7,29
191005269,7,1,9,3,3,23
191005270,9,9,8,1,5,32
191005271,0,0,6,8,8,22
191005272,8,2,5,4,9,28
191005273,6,6,1,9,8,30
191005274,0,0,6,2,3,11
191005275,7,9,8,7,8,39
191005276,6,9,2,9,3,29
191005277,3,9,1,7,9,29
191005278,8,0,3,4,0,15
191005279,2,2,3,2,8,17
191005280,3,7,4,3,4,21
191005281,4,3,3,5,4,19
191005282,5,4,2,8,1,20
191005283,0,1,0,6,0,7
191005284,2,3,7,0,4,16
191005285,4,1,1,4,3,13
191005286,7,2,7,6,2,24
191005287,2,0,8,4,9,23
191005288,5,6,4,1,5,21
191005289,6,3,5,9,4,27
191005290,0,4,3,3,6,16
191005291,9,3,1,9,2,24
191005292,7,9,6,1,0,23
191005293,1,5,7,6,5,24
191005294,9,8,5,5,1,28
191005295,2,4,4,5,2,17
191005296,4,4,6,1,9,24
191005297,9,1,9,5,9,33
191005298,4,9,6,4,6,29
191005299,3,5,1,8,2,19
191005300,0,7,6,3,7,23
191005301,5,0,6,2,9,22
191005302,9,0,9,7,7,32
191005303,6,6,3,0,0,15
191005304,4,7,3,9,9,32
191005305,9,6,2,0,4,21
191005306,5,5,6,0,9,25
191005307,4,8,5,6,1,24
191005308,8,5,2,7,9,31
191005309,4,4,7,0,0,15
191005310,7,3,9,7,7,33
191005311,8,9,7,5,5,34
191005312,4,7,5,9,0,25
191005313,7,1,3,5,1,17
191005314,0,7,8,7,1,23
191005315,4,6,6,3,5,24
191005316,9,8,7,9,1,34
191005317,9,8,7,1,7,32
191005318,9,6,5,8,6,34
191005319,4,8,6,7,2,27
191005320,3,3,5,6,5,22
191005321,3,1,4,8,4,20
191005322,4,1,1,4,5,15
191005323,8,2,3,2,5,20
191005324,4,1,0,7,6,18
191005325,0,4,9,5,8,26
191005326,4,1,3,7,0,15
191005327,8,1,9,0,5,23
191005328,3,6,3,9,0,21
191005329,5,1,1,9,0,16
191005330,3,2,5,9,5,24
191005331,1,0,4,9,2,16
191005332,8,8,8,8,0,32
191005333,0,3,9,5,3,20
191005334,9,3,5,6,6,29
191005335,5,8,9,9,3,34
191005336,8,7,3,2,7,27
191005337,8,4,4,1,1,18
191005338,4,2,6,9,5,26
191005339,6,6,8,2,9,31
191005340,1,0,4,2,2,9
191005341,9,7,5,9,4,34
191005342,7,5,8,9,7,36
191005343,4,6,3,2,4,19
191005344,0,0,8,7,8,23
191005345,5,9,5,1,2,22
191005346,0,7,0,7,2,16
191005347,5,3,1,2,0,11
191005348,2,0,9,9,2,22
191005349,5,2,9,3,9,28
191005350,5,0,5,2,0,12
191005351,0,7,3,7,3,20
191005352,6,9,2,0,1,18
191005353,6,6,8,2,0,22
191005354,8,8,1,6,8,31
191005355,1,0,5,0,8,14
191005356,3,9,8,0,3,23
191005357,6,9,2,5,0,22
191005358,9,1,3,5,0,18
191005359,8,0,1,2,5,16
191005360,9,4,7,4,6,30
191005361,8,0,3,2,0,13
191005362,0,7,9,8,9,33
191005363,1,1,4,3,0,9
191005364,9,7,0,9,7,32
191005365,8,2,6,3,5,24
191005366,3,1,1,1,5,11
191005367,7,8,9,2,8,34
191005368,1,6,4,1,8,20
191005369,3,4,0,3,0,10
191005370,0,6,4,7,7,24
191005371,7,9,6,7,3,32
191005372,8,4,4,1,2,19
191005373,3,3,9,8,8,31
191005374,1,5,8,6,4,24
191005375,7,7,6,3,6,29
191005376,7,6,5,3,8,29
191005377,4,7,4,3,8,26
191005378,9,1,6,2,5,23
191005379,1,4,2,5,7,19
191005380,0,7,3,9,7,26
191005381,2,9,1,8,1,21
191005382,1,1,9,0,7,18
191005383,4,2,6,5,7,24
191005384,7,9,3,0,8,27
191005385,8,2,3,5,8,26
191005386,6,1,3,8,9,27
191005387,8,9,4,5,9,35
191005388,7,2,0,8,5,22
191005389,2,4,5,6,7,24
191005390,7,8,3,5,2,25
191005391,4,2,7,0,4,17
191005392,2,6,2,2,6,18
191005393,4,2,4,3,4,17
191005394,3,2,3,3,8,19
191005395,3,0,6,2,9,20
191005396,0,2,3,3,3,11
191005397,2,6,4,6,9,27
191005398,0,7,9,6,7,29
191005399,8,3,1,2,8,22
191005400,2,2,6,5,4,19
191005401,5,3,7,9,5,29
191005402,1,8,0,5,4,18
191005403,7,4,8,3,0,22
191005404,5,9,6,9,5,34
191005405,4,6,5,8,8,31
191005406,8,8,4,4,9,33
191005407,0,0,6,4,9,19
191005408,1,7,8,6,6,28
191005409,3,5,1,8,9,26
191005410,6,2,1,1,0,10
191005411,7,9,7,9,0,32
191005412,7,6,5,8,8,34
191005413,5,8,0,2,5,20
191005414,9,5,1,3,5,23
191005415,7,1,0,0,5,13
191005416,2,3,1,1,3,10
191005417,9,2,2,9,1,23
191005418,5,2,7,7,3,24
191005419,9,2,5,7,7,30
191005420,1,6,2,9,5,23
191005421,8,8,0,1,1,18
191005422,3,0,2,0,6,11
191005423,5,8,2,6,3,24
191005424,2,8,9,1,0,20
191005425,5,6,7,7,4,29
191005426,2,9,1,9,5,26
191005427,6,0,6,2,4,18
191005428,2,3,2,1,2,10
191005429,0,1,9,3,7,20
191005430,9,2,3,7,1,22
191005431,7,8,0,8,6,29
191005432,5,2,4,3,4,18
191005433,3,6,7,7,1,24
191005434,2,6,4,0,9,21
191005435,3,8,4,2,3,20
191005436,1,9,4,1,4,19
191005437,8,2,4,7,0,21
191005438,0,3,7,9,5,24
191005439,5,1,0,4,6,16
191005440,3,1,4,2,3,13
191005441,4,5,2,7,5,23
191005442,4,7,5,9,6,31
191005443,8,9,8,5,4,34
191005444,5,5,3,6,4,23
191005445,8,1,3,1,3,16
191005446,1,7,7,4,5,24
191005447,1,9,5,0,3,18
191005448,2,8,8,8,2,28
191005449,6,2,0,6,3,17
191005450,7,3,8,3,2,23
191005451,4,8,4,0,3,19
191005452,7,4,5,6,6,28
191005453,7,6,6,2,5,26
191005454,5,4,7,9,6,31
191005455,1,7,1,6,5,20
191005456,1,9,7,3,2,22
191005457,7,7,3,1,6,24
191005458,3,1,8,6,5,23
191005459,5,1,3,7,2,18
191005460,8,4,8,1,4,25
191005461,2,0,2,2,5,11
191005462,6,2,3,0,5,16
191005463,0,3,6,5,1,15
191005464,4,9,3,7,0,23
191005465,7,5,5,0,8,25
191005466,9,8,8,8,4,37
191005467,6,4,5,3,5,23
191005468,7,0,2,6,4,19
191005469,0,6,5,5,4,20
191005470,8,3,3,2,6,22
191005471,6,0,5,9,5,25
191005472,7,9,3,4,8,31
191005473,6,9,6,2,9,32
191005474,0,5,0,9,3,17
191005475,3,4,8,6,9,30
191005476,8,5,8,2,0,23
191005477,7,4,1,2,6,20
191005478,9,5,8,8,1,31
191005479,3,6,3,0,7,19
191005480,6,2,0,8,1,17
191005481,4,2,0,9,3,18
191005482,8,0,4,7,4,23
191005483,8,6,1,1,4,20
191005484,4,3,7,8,6,28
191005485,8,8,4,9,3,32
191005486,3,5,4,6,9,27
191005487,0,9,5,3,5,22
191005488,3,4,9,3,9,28
191005489,6,7,8,0,3,24
191005490,0,0,3,7,7,17
191005491,5,6,4,7,1,23
191005492,0,4,9,8,4,25
191005493,4,8,4,3,0,19
191005494,8,8,8,6,0,30
191005495,1,2,5,5,7,20
191005496,7,8,5,6,4,30
191005497,3,8,6,4,8,29
191005498,9,3,2,5,3,22
191005499,8,7,3,7,7,32
191005500,0,7,3,5,9,24
191005501,9,5,0,3,3,20
191005502,7,2,4,7,6,26
191005503,3,7,5,5,9,29
191005504,7,3,7,9,8,34
191005505,2,2,4,5,7,20
191005506,1,7,1,6,9,24
191005507,8,7,1,0,3,19
191005508,3,6,1,2,1,13
191005509,1,2,9,2,0,14
191005510,3,0,5,8,9,25
191005511,8,8,7,8,2,33
191005512,4,7,5,4,2,22
191005513,2,6,6,2,6,22
191005514,3,9,1,6,3,22
191005515,5,5,5,8,3,26
191005516,3,0,5,4,5,17
191005517,9,7,8,5,4,33
191005518,8,7,8,6,8,37
191005519,6,2,5,0,8,21
191005520,6,5,8,6,2,27
191005521,3,6,3,1,0,13
191005522,2,7,6,9,7,31
191005523,1,7,3,6,5,22
191005524,3,3,8,7,0,21
191005525,5,7,0,5,1,18
191005526,5,5,8,6,3,27
191005527,5,8,6,0,5,24
191005528,0,3,3,3,8,17
191005529,9,8,5,3,0,25
191005530,9,3,3,1,7,23
191005531,9,9,5,4,6,33
191005532,0,3,4,7,0,14
191005533,4,5,6,9,3,27
191005534,6,2,1,2,9,20
191005535,3,2,3,7,6,21
191005536,7,0,2,9,9,27
191005537,0,3,5,2,4,14
191005538,3,2,5,3,5,18
191005539,7,8,1,5,5,26
191005540,2,4,4,5,8,23
191005541,6,7,9,6,5,33
191005542,6,5,3,8,7,29
191005543,6,3,2,7,8,26
191005544,9,3,4,1,6,23
191005545,0,4,3,4,9,20
191005546,7,7,9,4,0,27
191005547,2,4,9,3,8,26
191005548,7,2,0,7,3,19
191005549,2,2,9,1,7,21
191005550,3,6,8,2,0,19
191005551,0,0,2,8,2,12
191005552,9,5,3,6,4,27
191005553,3,2,3,2,4,14
191005554,4,7,7,9,8,35
191005555,9,5,7,0,7,28
191005556,5,6,2,1,2,16
191005557,8,8,1,2,7,26
191005558,4,9,5,5,2,25
191005559,5,7,4,8,7,31
191005560,9,5,0,5,2,21
191005561,3,8,3,7,7,28
191005562,4,0,6,8,1,19
191005563,3,3,1,6,6,19
191005564,6,8,4,2,6,26
191005565,5,7,1,4,7,24
191005566,8,5,2,3,4,22
191005567,0,4,9,2,4,19
191005568,5,4,8,1,6,24
191005569,2,2,3,0,4,11
191005570,8,8,8,7,9,40
191005571,8,5,9,4,4,30
191005572,3,4,9,1,8,25
191005573,3,4,3,4,9,23
191005574,3,0,6,2,7,18
191005575,1,1,6,6,9,23
191005576,5,2,9,2,7,25
191005577,8,2,0,6,3,19
191005578,0,1,8,5,6,20
191005579,7,3,6,5,9,30
191005580,6,5,2,7,8,28
191005581,2,5,8,6,2,23
191005582,2,1,5,7,7,22
191005583,3,8,4,8,1,24
191005584,6,9,8,4,1,28
191005585,9,2,0,0,3,14
191005586,1,2,4,8,3,18
191005587,3,5,0,6,4,18
191005588,0,2,6,8,3,19
191005589,5,4,7,1,2,19
191005590,1,2,1,7,5,16
191005591,7,2,6,0,2,17
191005592,5,5,7,1,7,25
191005593,6,4,5,4,9,28
191005594,9,8,8,2,3,30
191005595,7,8,2,5,8,30
191005596,8,6,2,0,8,24
191005597,7,2,9,8,2,28
191005598,2,9,5,2,6,24
191005599,5,1,3,6,3,18
191005600,5,6,8,8,6,33
191005601,5,8,2,9,0,24
191005602,1,5,2,1,0,9
191005603,4,9,2,5,7,27
191005604,1,7,7,9,3,27
191005605,6,3,5,3,2,19
191005606,5,4,6,5,9,29
191005607,4,4,4,5,8,25
191005608,4,1,1,2,0,8
191005609,1,4,3,9,0,17
191005610,6,6,6,5,1,24
191005611,0,7,9,2,4,22
191005612,1,4,3,6,9,23
191005613,4,0,0,9,2,15
191005614,5,8,9,0,7,29
191005615,1,2,4,9,4,20
191005616,3,7,3,1,6,20
191005617,2,1,7,7,6,23
191005618,7,2,3,9,4,25
191005619,3,0,3,8,6,20
191005620,3,3,9,8,5,28
191005621,5,6,5,5,3,24
191005622,7,3,9,7,4,30
191005623,1,0,4,6,8,19
191005624,3,4,6,5,0,18
191005625,9,3,1,2,5,20
191005626,8,8,7,0,8,31
191005627,0,0,9,3,5,17
191005628,4,2,9,6,9,30
191005629,5,3,3,8,0,19
191005630,2,3,3,7,4,19
191005631,8,1,6,7,7,29
191005632,1,6,3,1,5,16
191005633,7,8,9,9,4,37
191005634,6,9,8,3,9,35
191005635,3,3,1,0,2,9
191005636,1,8,8,5,7,29
191005637,8,3,6,9,3,29
191005638,5,9,3,2,9,28
191005639,8,7,2,2,6,25
191005640,7,1,1,4,7,20
191005641,0,9,1,0,8,18
191005642,9,8,3,9,7,36
191005643,4,2,1,4,9,20
191005644,6,3,5,4,3,21
191005645,0,7,4,2,5,18
191005646,7,0,4,6,6,23
191005647,1,1,8,1,8,19
191005648,2,4,9,0,3,18
191005649,6,0,7,1,4,18
191005650,0,9,8,4,1,22
191005651,9,9,0,3,2,23
191005652,5,4,0,5,7,21
191005653,0,4,5,4,5,18
191005654,5,7,0,2,0,14
191005655,4,4,5,9,8,30
191005656,0,8,1,8,9,26
191005657,0,7,5,1,9,22
191005658,2,6,6,6,0,20
191005659,8,8,5,0,4,25
191005660,2,7,3,8,1,21
191005661,2,2,0,7,5,16
191005662,3,3,8,7,5,26
191005663,7,4,9,7,6,33
191005664,0,2,1,4,0,7
191005665,9,9,3,9,0,30
191005666,4,5,4,9,3,25
191005667,8,3,3,3,6,23
191005668,5,9,5,0,3,22
191005669,1,0,8,4,0,13
191005670,4,3,1,8,4,20
191005671,6,4,2,5,1,18
191005672,1,4,2,4,7,18
191005673,8,1,2,2,9,22
191005674,4,6,5,0,9,24
191005675,6,8,6,1,2,23
191005676,8,1,7,9,6,31
191005677,9,8,8,7,9,41
191005678,7,0,6,6,1,20
191005679,2,9,7,5,9,32
191005680,0,1,8,8,2,19
191005681,6,7,2,5,8,28
191005682,0,7,0,0,9,16
191005683,8,4,9,5,3,29
191005684,4,4,1,7,4,20
191005685,0,7,6,0,5,18
191005686,1,5,8,1,2,17
191005687,6,8,2,0,7,23
191005688,4,3,7,0,7,21
191005689,3,7,6,3,3,22
191005690,0,9,8,8,6,31
191005691,8,7,1,0,1,17
191005692,0,4,6,7,7,24
191005693,5,4,4,9,5,27
191005694,1,5,4,6,4,20
191005695,6,6,1,3,1,17
191005696,1,4,5,3,4,17
191005697,2,1,6,7,6,22
191005698,9,4,7,5,1,26
191005699,4,3,4,3,4,18
191005700,0,0,7,7,0,14
191005701,3,1,6,8,1,19
191005702,7,4,7,0,5,23
191005703,5,3,8,0,5,21
191005704,3,7,8,5,4,27
191005705,6,6,6,5,0,23
191005706,5,3,5,8,5,26
191005707,9,8,1,9,1,28
191005708,1,3,1,8,1,14
191005709,0,4,0,1,4,9
191005710,9,6,1,1,9,26
191005711,6,5,2,2,8,23
191005712,1,8,5,3,6,23
191005713,2,6,4,0,1,13
191005714,4,9,1,8,9,31
191005715,0,2,9,1,6,18
191005716,0,7,2,5,6,20
191005717,3,1,7,0,0,11
191005718,5,5,7,5,2,24
191005719,6,5,7,4,8,30
191005720,0,4,1,0,5,10
191005721,3,3,2,9,7,24
191005722,2,9,7,7,5,30
191005723,5,2,6,0,7,20
191005724,9,5,3,0,6,23
191005725,9,5,6,6,2,28
191005726,8,4,8,3,2,25
191005727,2,0,8,0,9,19
191005728,6,2,1,3,8,20
191005729,2,5,4,8,4,23
191005730,4,8,0,5,9,26
191005731,5,7,0,5,0,17
191005732,8,7,7,5,4,31
191005733,8,0,6,8,0,22
191005734,7,9,0,5,6,27
191005735,6,2,5,6,7,26
191005736,9,6,1,6,4,26
191005737,3,6,9,7,8,33
191005738,1,6,5,9,8,29
191005739,8,7,1,5,0,21
191005740,3,5,5,5,3,21
191005741,7,6,9,6,8,36
191005742,3,0,7,5,2,17
191005743,8,1,1,8,8,26
191005744,5,4,7,8,2,26
191005745,2,7,8,5,0,22
191005746,9,2,2,8,5,26
191005747,1,3,5,6,2,17
191005748,1,2,3,7,2,15
191005749,1,9,3,5,9,27
191005750,9,6,8,3,9,35
191005751,7,1,0,7,9,24
191005752,8,1,2,0,5,16
191005753,8,1,5,2,4,20
191005754,3,2,7,5,8,25
191005755,0,7,9,6,1,23
191005756,7,2,6,9,2,26
191005757,3,6,2,5,9,25
191005758,6,1,1,3,1,12
191005759,9,3,6,9,8,35
191005760,3,7,7,4,7,28
191005761,0,3,3,9,8,23
191005762,3,3,3,1,7,17
191005763,8,0,2,4,3,17
191005764,5,8,5,0,7,25
191005765,7,7,7,8,6,35
191005766,9,7,7,0,6,29
191005767,6,9,7,2,2,26
191005768,6,2,0,8,2,18
191005769,1,4,8,1,2,16
191005770,5,9,6,5,7,32
191005771,8,7,9,8,8,40
191005772,1,9,2,0,0,12
191005773,0,4,1,7,0,12
191005774,6,1,7,8,8,30
191005775,6,0,6,5,3,20
191005776,3,8,9,9,5,34
191005777,6,8,7,7,3,31
191005778,4,0,8,3,6,21
191005779,3,5,7,3,8,26
191005780,5,8,3,7,9,32
191005781,4,7,6,9,3,29
191005782,0,7,3,4,2,16
191005783,9,7,7,8,1,32
191005784,6,1,9,4,3,23
191005785,4,8,9,6,4,31
191005786,5,5,8,2,4,24
191005787,8,2,8,6,5,29
191005788,7,5,1,6,8,27
191005789,1,9,6,8,4,28
191005790,4,3,1,2,7,17
191005791,7,6,1,4,8,26
191005792,3,2,8,5,5,23
191005793,4,6,1,9,8,28
191005794,2,6,7,3,8,26
191005795,2,6,0,2,5,15
191005796,1,7,0,4,6,18
191005797,3,6,1,0,1,11
191005798,8,0,8,8,7,31
191005799,4,3,6,5,8,26
191005800,8,7,5,2,1,23
191005801,7,0,4,8,2,21
191005802,4,2,1,2,6,15
191005803,5,4,7,9,3,28
191005804,0,4,6,3,0,13
191005805,4,5,8,9,6,32
191005806,2,7,2,7,9,27
191005807,5,9,2,2,5,23
191005808,1,4,1,7,3,16
191005809,2,4,8,2,6,22
191005810,9,9,6,2,0,26
191005811,9,4,4,0,0,17
191005812,9,5,5,0,6,25
191005813,5,8,4,0,5,22
191005814,1,4,5,3,0,13
191005815,1,5,5,0,8,19
191005816,8,9,0,7,2,26
191005817,3,3,6,2,5,19
191005818,0,4,3,8,0,15
191005819,9,3,0,6,2,20
191005820,5,6,7,6,6,30
191005821,1,2,8,9,2,22
191005822,8,0,0,6,6,20
191005823,2,9,5,9,6,31
191005824,2,8,8,8,7,33
191005825,5,0,8,3,0,16
191005826,3,0,2,6,7,18
191005827,5,8,2,4,2,21
191005828,1,5,7,9,8,30
191005829,6,0,8,7,9,30
191005830,4,8,6,6,1,25
191005831,7,3,1,1,3,15
191005832,0,4,9,0,8,21
191005833,6,5,1,1,7,20
191005834,5,4,5,3,0,17
191005835,6,5,0,7,8,26
191005836,6,5,7,4,6,28
191005837,9,8,7,3,9,36
191005838,3,8,2,8,1,22
191005839,3,2,4,5,7,21
191005840,0,1,1,2,7,11
191005841,2,0,7,9,2,20
191005842,9,5,0,4,0,18
191005843,7,0,7,3,2,19
191005844,9,2,2,3,5,21
191005845,9,2,6,9,2,28
191005846,4,3,0,2,2,11
191005847,3,0,6,7,0,16
191005848,7,8,0,0,5,20
191005849,9,9,4,1,1,24
191005850,8,6,9,9,1,33
191005851,5,2,2,1,6,16
191005852,7,3,6,8,2,26
191005853,2,1,1,2,8,14
191005854,0,9,6,9,3,27
191005855,3,0,9,5,2,19
191005856,2,1,9,6,7,25
191005857,8,1,5,5,6,25
191005858,1,8,3,0,9,21
191005859,2,5,3,1,9,20
191005860,6,5,3,6,8,28
191005861,5,8,0,5,2,20
191005862,2,3,3,1,6,15
191005863,7,9,7,3,7,33
191005864,1,5,6,6,8,26
191005865,8,8,9,1,8,34
191005866,3,6,9,7,1,26
191005867,1,4,0,0,5,10
191005868,7,2,4,9,4,26
191005869,2,5,6,0,0,13
191005870,6,2,3,9,4,24
191005871,6,1,9,8,1,25
191005872,1,3,0,7,8,19
191005873,2,8,3,2,3,18
191005874,2,4,7,0,0,13
191005875,5,6,9,9,3,32
191005876,7,7,2,2,0,18
191005877,3,9,3,1,1,17
191005878,2,9,4,7,5,27
191005879,7,8,0,0,0,15
191005880,7,6,2,0,9,24
191005881,6,1,8,4,5,24
191005882,2,5,1,8,2,18
191005883,8,3,7,4,3,25
191005884,1,0,6,6,7,20
191005885,6,0,6,4,1,17
191005886,9,5,2,6,8,30
191005887,7,9,7,4,5,32
191005888,0,5,4,4,0,13
191005889,3,2,0,0,5,10
191005890,0,1,3,6,8,18
191005891,4,3,6,9,6,28
191005892,1,6,4,5,0,16
191005893,4,0,3,1,7,15
191005894,2,9,7,1,4,23
191005895,1,9,7,2,8,27
191005896,3,3,7,6,5,24
191005897,0,0,7,6,7,20
191005898,5,0,9,7,2,23
191005899,0,4,4,7,9,24
191005900,9,3,5,0,0,17
191005901,3,0,0,7,4,14
191005902,4,1,7,9,7,28
191005903,5,8,1,2,9,25
191005904,0,5,2,3,0,10
191005905,3,0,9,2,4,18
191005906,6,2,6,4,5,23
191005907,7,2,0,9,8,26
191005908,3,9,3,9,6,30
191005909,6,2,3,4,2,17
191005910,9,2,0,7,3,21
191005911,9,7,0,1,5,22
191005912,3,7,1,3,8,22
191005913,3,2,1,4,8,18
191005914,2,0,4,5,1,12
191005915,6,9,7,8,4,34
191005916,9,3,5,6,5,28
191005917,0,9,8,3,6,26
191005918,2,1,4,8,2,17
191005919,9,8,1,8,6,32
191005920,9,2,3,7,0,21
191005921,2,7,0,1,8,18
191005922,3,0,3,2,7,15
191005923,3,1,2,2,8,16
191005924,2,1,2,9,4,18
191005925,0,4,9,3,0,16
191005926,2,5,2,9,1,19
191005927,6,0,1,6,6,19
191005928,0,4,2,7,3,16
191005929,2,2,3,9,4,20
191005930,2,7,5,9,4,27
191005931,3,0,9,9,5,26
191005932,6,8,1,3,0,18
191005933,3,2,1,3,1,10
191005934,6,8,8,4,4,30
191005935,7,4,3,8,0,22
191005936,9,4,9,3,8,33
191005937,1,5,7,2,5,20
191005938,0,6,4,7,1,18
191005939,1,6,8,8,0,23
191005940,4,2,8,1,3,18
191005941,2,6,6,6,5,25
191005942,5,3,9,0,5,22
191005943,9,0,6,2,3,20
191005944,9,4,7,5,6,31
191005945,3,5,5,9,6,28
191005946,8,3,0,5,6,22
191005947,5,2,2,6,4,19
191005948,2,7,3,2,1,15
191005949,2,5,4,0,6,17
191005950,0,4,8,0,4,16
191005951,5,7,7,0,0,19
191005952,0,8,4,6,2,20
191005953,9,5,3,2,2,21
191005954,5,1,6,4,7,23
191005955,9,0,3,7,9,28
191005956,6,3,9,2,3,23
191005957,3,6,1,0,8,18
191005958,1,7,9,8,0,25
191005959,0,0,5,3,6,14
191005960,8,2,7,7,5,29
191005961,3,2,4,3,3,15
191005962,7,4,5,7,6,29
191005963,7,5,8,6,8,34
191005964,7,0,4,0,8,19
191005965,8,9,6,4,5,32
191005966,8,6,7,6,7,34
191005967,5,8,3,9,4,29
191005968,1,9,6,4,2,22
191005969,0,3,4,8,7,22
191005970,4,7,2,3,9,25
191005971,4,0,0,3,0,7
191005972,7,9,8,2,9,35
191005973,2,1,1,4,9,17
191005974,5,3,9,0,8,25
191005975,1,2,4,8,0,15
191005976,2,1,9,0,7,19
191005977,4,7,7,2,2,22
191005978,5,6,3,9,3,26
191005979,7,6,6,8,8,35
191005980,9,6,3,8,1,27
191005981,7,4,4,9,1,25
191005982,5,4,7,2,0,18
191005983,1,4,1,4,7,17
191005984,0,7,9,4,3,23
191005985,7,4,1,2,4,18
191005986,6,1,2,7,0,16
191005987,4,1,3,1,8,17
191005988,3,3,0,8,4,18
191005989,3,6,2,1,9,21
191005990,7,2,6,2,8,25
191005991,4,4,0,8,5,21
191005992,7,6,3,6,4,26
191005993,6,1,5,2,1,15
191005994,1,5,3,3,5,17
191005995,3,9,4,9,6,31
191005996,3,1,8,0,6,18
191005997,7,9,5,3,5,29
191005998,8,1,1,3,3,16
191005999,4,4,7,8,1,24
1910051000,0,2,4,7,3,16
1910051001,6,6,8,1,4,25
1910051002,0,2,3,6,6,17
1910051003,2,8,0,2,7,19
1910051004,0,4,9,4,5,22
1910051005,0,2,1,5,3,11
1910051006,8,1,4,4,4,21
1910051007,1,4,9,2,7,23
1910051008,6,0,5,1,6,18
1910051009,6,9,9,4,1,29
1910051010,1,8,4,1,8,22
1910051011,6,9,9,4,0,28
1910051012,0,6,4,3,3,16
1910051013,0,5,3,0,2,10
1910051014,9,7,4,9,5,34
1910051015,5,9,7,3,3,27
1910051016,9,6,0,7,7,29
1910051017,8,0,3,1,6,18
1910051018,2,6,8,8,4,28
1910051019,4,4,4,0,2,14
1910051020,4,4,5,6,9,28
1910051021,3,8,2,7,8,28
1910051022,7,5,3,4,4,23
1910051023,2,7,8,8,3,28
1910051024,8,6,9,5,0,28
1910051025,5,3,0,8,5,21
1910051026,0,5,9,9,7,30
1910051027,5,0,8,3,7,23
1910051028,2,0,9,3,4,18
1910051029,5,4,3,1,9,22
1910051030,1,3,1,1,2,8
1910051031,0,9,1,1,2,13
1910051032,3,1,0,5,5,14
1910051033,4,0,6,5,7,22
1910051034,6,1,2,2,4,15
1910051035,4,3,3,4,1,15
1910051036,1,9,6,6,8,30
1910051037,2,3,7,9,8,29
1910051038,0,0,8,9,3,20
1910051039,4,4,7,9,2,26
1910051040,9,7,9,6,0,31
1910051041,3,1,4,9,1,18
1910051042,1,8,8,2,0,19
1910051043,2,7,4,0,4,17
1910051044,9,9,7,0,5,30
1910051045,3,7,5,4,9,28
1910051046,7,6,7,4,1,25
1910051047,3,9,2,2,7,23
1910051048,9,2,7,5,9,32
1910051049,1,4,5,0,5,15
1910051050,4,6,8,0,3,21
1910051051,0,8,4,9,6,27
1910051052,0,2,1,1,7,11
1910051053,6,0,4,0,1,11
1910051054,6,5,2,1,6,20
1910051055,3,8,8,4,0,23
1910051056,0,3,7,5,1,16
1910051057,8,6,5,5,2,26
1910051058,1,1,9,6,6,23
1910051059,3,1,4,9,9,26
1910051060,7,5,9,9,9,39
1910051061,0,2,0,5,5,12
1910051062,7,2,4,8,6,27
1910051063,8,0,2,8,5,23
1910051064,6,6,4,2,4,22
1910051065,6,2,7,1,6,22
1910051066,7,6,5,3,0,21
1910051067,4,3,5,8,0,20
1910051068,4,6,0,7,8,25
1910051069,5,4,0,0,1,10
1910051070,9,2,4,0,6,21
1910051071,3,4,2,5,1,15
1910051072,4,2,5,7,2,20
1910051073,3,7,8,5,5,28
1910051074,1,3,4,7,0,15
1910051075,5,9,5,6,2,27
1910051076,1,2,6,8,4,21
1910051077,3,5,3,3,6,20
1910051078,1,6,9,4,0,20
1910051079,9,8,7,9,3,36
1910051080,5,2,0,7,7,21
1910051081,2,0,1,8,8,19
1910051082,9,8,4,5,5,31
1910051083,9,8,6,3,1,27
1910051084,5,7,6,1,9,28
1910051085,8,5,4,9,6,32
1910051086,9,6,9,6,3,33
1910051087,9,6,3,7,6,31
1910051088,3,9,3,1,9,25
1910051089,7,3,6,9,0,25
1910051090,6,5,9,9,3,32
1910051091,9,0,7,6,5,27
1910051092,0,0,1,1,6,8
1910051093,4,4,8,7,5,28
1910051094,8,1,3,4,5,21
1910051095,5,3,1,7,9,25
1910051096,1,6,4,7,7,25
1910051097,5,9,8,5,1,28
1910051098,3,2,5,8,7,25
1910051099,9,0,2,1,8,20
1910051100,2,7,5,7,2,23
1910051101,4,1,7,9,2,23
1910051102,7,3,2,9,9,30
1910051103,4,3,5,2,6,20
1910051104,5,5,2,0,5,17
1910051105,9,5,5,6,6,31
191006001,6,9,9,8,4,36
191006002,3,4,4,5,1,17
191006003,8,5,6,7,0,26
191006004,3,7,2,6,3,21
191006005,6,3,0,4,3,16
191006006,2,4,1,3,7,17
191006007,4,2,9,3,8,26
191006008,1,2,3,6,7,19
191006009,2,7,9,1,9,28
191006010,1,3,7,9,8,28
191006011,9,8,4,9,6,36
191006012,8,4,8,8,8,36
191006013,1,1,6,2,7,17
191006014,2,5,6,2,7,22
191006015,7,1,5,1,3,17
191006016,9,4,6,4,5,28
191006017,9,0,0,6,5,20
191006018,5,2,1,0,9,17
191006019,3,6,5,4,6,24
191006020,1,4,2,1,8,16
191006021,6,6,2,5,7,26
191006022,7,2,6,3,8,26
191006023,2,4,3,3,8,20
191006024,6,5,8,0,6,25
191006025,8,1,4,7,4,24
191006026,0,5,5,2,7,19
191006027,9,4,5,8,5,31
191006028,4,6,0,2,6,18
191006029,0,9,3,1,3,16
191006030,2,6,0,7,8,23
191006031,4,4,8,3,6,25
191006032,8,8,4,2,2,24
191006033,2,0,8,6,2,18
191006034,3,9,2,3,1,18
191006035,3,5,2,0,3,13
191006036,8,6,7,5,6,32
191006037,9,1,9,4,9,32
191006038,1,6,5,0,1,13
191006039,0,7,8,8,0,23
191006040,9,3,1,1,5,19
191006041,8,7,3,1,0,19
191006042,0,4,8,0,8,20
191006043,6,3,8,6,8,31
191006044,6,2,8,1,7,24
191006045,4,5,7,7,6,29
191006046,9,9,4,4,9,35
191006047,8,1,6,1,7,23
191006048,2,5,3,0,6,16
191006049,9,7,6,4,9,35
191006050,4,9,2,9,7,31
191006051,3,7,4,5,6,25
191006052,3,6,4,8,8,29
191006053,0,4,9,8,8,29
191006054,8,3,7,3,8,29
191006055,6,5,7,5,2,25
191006056,4,0,0,9,4,17
191006057,2,0,0,7,5,14
191006058,1,3,4,1,3,12
191006059,4,7,7,6,9,33
191006060,5,7,1,0,2,15
191006061,8,4,7,1,1,21
191006062,3,8,9,9,7,36
191006063,8,2,9,9,7,35
191006064,5,7,3,3,1,19
191006065,1,7,2,4,5,19
191006066,3,8,8,8,5,32
191006067,2,4,3,7,1,17
191006068,6,5,8,1,9,29
191006069,6,6,5,3,3,23
191006070,1,3,3,8,1,16
191006071,4,3,3,8,9,27
191006072,2,3,9,0,2,16
191006073,4,6,8,7,4,29
191006074,3,0,4,9,1,17
191006075,6,0,6,6,6,24
191006076,1,7,9,1,4,22
191006077,1,4,6,2,9,22
191006078,0,1,8,3,4,16
191006079,1,9,8,6,7,31
191006080,3,2,9,9,3,26
191006081,6,6,7,2,8,29
191006082,3,8,9,4,9,33
191006083,0,6,9,5,4,24
191006084,4,7,3,1,3,18
191006085,4,3,1,8,8,24
191006086,7,5,2,3,4,21
191006087,8,1,9,0,0,18
191006088,6,9,3,2,9,29
191006089,9,5,1,6,2,23
191006090,4,7,0,2,6,19
191006091,1,5,2,6,3,17
191006092,1,9,0,5,8,23
191006093,3,4,6,7,8,28
191006094,9,4,5,0,0,18
191006095,3,7,8,6,4,28
191006096,3,4,0,4,7,18
191006097,8,8,1,8,0,25
191006098,9,9,4,2,3,27
191006099,0,5,1,4,6,16
191006100,7,9,4,2,0,22
191006101,3,8,3,5,6,25
191006102,0,7,8,4,8,27
191006103,7,8,0,5,5,25
191006104,8,4,5,7,2,26
191006105,1,4,2,7,3,17
191006106,0,1,3,8,8,20
191006107,6,6,8,1,3,24
191006108,8,5,2,7,4,26
191006109,3,3,2,3,7,18
191006110,1,4,1,9,7,22
191006111,8,9,2,6,1,26
191006112,7,9,1,4,9,30
191006113,4,4,6,8,7,29
191006114,6,1,6,0,6,19
191006115,9,2,0,8,0,19
191006116,3,9,3,2,7,24
191006117,2,1,0,5,5,13
191006118,5,5,4,3,4,21
191006119,4,9,4,1,3,21
191006120,3,2,1,2,9,17
191006121,6,2,7,0,1,16
191006122,2,5,1,3,9,20
191006123,1,9,0,4,9,23
191006124,7,8,5,9,4,33
191006125,7,6,9,2,6,30
191006126,1,9,9,9,2,30
191006127,1,1,9,3,1,15
191006128,1,4,3,7,5,20
191006129,2,0,8,0,1,11
191006130,8,1,7,3,7,26
191006131,4,1,2,6,9,22
191006132,5,4,5,4,9,27
191006133,9,3,4,4,6,26
191006134,8,5,5,6,6,30
191006135,4,8,1,5,6,24
191006136,9,3,1,1,1,15
191006137,9,9,4,9,2,33
191006138,5,6,0,1,4,16
191006139,1,2,9,9,9,30
191006140,2,7,6,6,7,28
191006141,6,9,9,4,3,31
191006142,2,3,3,4,8,20
191006143,2,6,9,2,3,22
191006144,5,3,7,2,5,22
191006145,1,5,5,5,5,21
191006146,2,7,2,4,9,24
191006147,4,3,5,3,9,24
191006148,5,5,5,4,4,23
191006149,2,5,4,3,2,16
191006150,5,2,1,6,3,17
191006151,2,9,2,7,3,23
191006152,1,6,6,1,4,18
191006153,2,4,5,2,5,18
191006154,7,5,5,0,3,20
191006155,8,3,3,7,7,28
191006156,8,4,8,7,7,34
191006157,0,6,1,5,3,15
191006158,6,3,8,0,3,20
191006159,0,1,8,5,8,22
191006160,1,0,9,2,7,19
191006161,2,8,5,5,1,21
191006162,3,3,5,1,2,14
191006163,6,6,2,9,3,26
191006164,1,4,6,7,5,23
191006165,6,0,2,8,1,17
191006166,3,5,1,9,2,20
191006167,7,9,7,8,0,31
191006168,9,0,4,3,6,22
191006169,1,0,6,4,3,14
191006170,8,5,8,6,8,35
191006171,4,5,8,4,7,28
191006172,2,4,8,1,9,24
191006173,7,5,4,1,1,18
191006174,5,5,9,4,6,29
191006175,2,3,8,4,0,17
191006176,3,2,5,6,9,25
191006177,1,1,3,3,9,17
191006178,8,5,9,6,9,37
191006179,8,5,8,9,9,39
191006180,1,3,3,1,8,16
191006181,8,3,8,1,6,26
191006182,3,7,4,1,6,21
191006183,5,8,5,9,9,36
191006184,5,4,0,6,6,21
191006185,7,2,8,2,1,20
191006186,0,6,2,9,8,25
191006187,6,5,4,9,3,27
191006188,8,2,8,0,6,24
191006189,3,8,4,2,7,24
191006190,6,5,7,9,4,31
191006191,2,8,2,6,7,25
191006192,1,7,6,0,2,16
191006193,1,5,6,1,5,18
191006194,1,6,6,3,4,20
191006195,0,1,9,6,8,24
191006196,7,3,2,6,1,19
191006197,2,1,2,8,3,16
191006198,9,0,4,2,4,19
191006199,5,2,2,2,0,11
191006200,1,6,5,2,9,23
191006201,2,3,7,8,2,22
191006202,3,6,5,9,6,29
191006203,6,6,6,5,9,32
191006204,6,3,0,2,9,20
191006205,2,8,3,0,5,18
191006206,1,4,4,3,0,12
191006207,8,4,7,8,1,28
191006208,8,3,0,4,8,23
191006209,9,1,9,6,4,29
191006210,2,5,1,0,1,9
191006211,6,8,7,2,6,29
191006212,0,3,6,0,5,14
191006213,9,8,5,8,0,30
191006214,2,6,1,0,3,12
191006215,8,4,2,7,6,27
191006216,2,0,5,3,1,11
191006217,9,3,7,3,4,26
191006218,0,6,3,7,1,17
191006219,1,5,8,6,3,23
191006220,7,2,4,3,6,22
191006221,9,0,6,8,5,28
191006222,1,9,5,1,7,23
191006223,0,4,2,6,7,19
191006224,9,9,5,2,4,29
191006225,1,7,2,6,4,20
191006226,3,4,2,0,5,14
191006227,2,0,9,8,7,26
191006228,0,4,5,8,8,25
191006229,5,0,5,4,9,23
191006230,4,9,1,2,6,22
191006231,2,5,5,2,0,14
191006232,0,3,4,1,1,9
191006233,7,4,4,9,5,29
191006234,5,3,1,7,7,23
191006235,5,3,3,6,2,19
191006236,2,8,1,6,4,21
191006237,3,3,2,2,2,12
191006238,3,4,4,8,4,23
191006239,1,1,3,1,2,8
191006240,0,6,2,5,4,17
191006241,9,7,9,7,9,41
191006242,1,4,1,8,4,18
191006243,5,3,5,0,8,21
191006244,0,4,8,9,8,29
191006245,1,4,4,3,2,14
191006246,0,8,5,0,7,20
191006247,8,8,4,4,6,30
191006248,5,5,4,8,0,22
191006249,5,5,4,4,1,19
191006250,0,7,4,1,4,16
191006251,8,0,2,6,0,16
191006252,5,2,6,5,6,24
191006253,5,8,1,3,7,24
191006254,4,7,3,8,1,23
191006255,1,7,2,9,9,28
191006256,1,4,1,0,2,8
191006257,9,3,9,6,9,36
191006258,1,1,4,8,3,17
191006259,2,1,0,4,4,11
191006260,4,1,1,6,6,18
191006261,0,7,3,0,6,16
191006262,4,3,3,8,6,24
191006263,4,0,3,6,6,19
191006264,1,9,6,6,7,29
191006265,8,3,1,9,4,25
191006266,8,1,5,3,2,19
191006267,3,8,7,1,0,19
191006268,1,0,5,4,0,10
191006269,1,0,1,9,3,14
191006270,6,7,8,6,0,27
191006271,3,6,2,7,2,20
191006272,4,8,5,7,3,27
191006273,0,8,4,1,8,21
191006274,1,5,3,0,2,11
191006275,1,8,9,3,7,28
191006276,1,6,8,7,0,22
191006277,4,0,7,4,0,15
191006278,7,8,1,9,5,30
191006279,7,6,6,6,3,28
191006280,1,4,3,8,4,20
191006281,9,3,7,9,2,30
191006282,7,0,2,7,7,23
191006283,9,9,1,6,1,26
191006284,1,0,4,6,4,15
191006285,4,3,7,4,7,25
191006286,0,0,2,9,2,13
191006287,1,3,2,0,0,6
191006288,4,9,0,6,0,19
191006289,4,4,1,1,4,14
191006290,4,5,9,0,2,20
191006291,2,7,3,5,9,26
191006292,4,7,1,5,5,22
191006293,2,9,9,0,4,24
191006294,0,7,5,7,1,20
191006295,4,7,1,1,4,17
191006296,2,3,4,6,4,19
191006297,5,4,5,0,8,22
191006298,7,7,0,6,3,23
191006299,8,7,3,9,0,27
191006300,9,2,6,5,1,23
191006301,1,5,5,8,8,27
191006302,0,0,9,1,7,17
191006303,2,9,7,8,1,27
191006304,3,6,4,5,5,23
191006305,3,0,0,9,6,18
191006306,9,0,9,1,8,27
191006307,0,1,4,9,7,21
191006308,6,9,2,2,1,20
191006309,4,9,9,2,4,28
191006310,8,6,5,0,4,23
191006311,4,4,1,0,3,12
191006312,8,7,0,0,5,20
191006313,1,2,8,3,7,21
191006314,2,7,5,1,5,20
191006315,8,8,2,5,6,29
191006316,6,1,6,8,6,27
191006317,1,1,0,4,3,9
191006318,8,0,5,2,1,16
191006319,0,2,4,0,1,7
191006320,3,3,4,7,9,26
191006321,9,6,6,0,1,22
191006322,1,7,9,9,8,34
191006323,7,1,5,9,3,25
191006324,1,8,4,4,0,17
191006325,0,2,2,7,0,11
191006326,4,0,5,5,1,15
191006327,8,7,9,0,9,33
191006328,6,2,9,1,4,22
191006329,6,5,6,0,9,26
191006330,3,2,9,8,9,31
191006331,4,7,7,9,9,36
191006332,1,3,6,3,2,15
191006333,1,6,1,2,0,10
191006334,7,2,3,1,1,14
191006335,2,5,7,0,2,16
191006336,4,6,5,7,9,31
191006337,2,2,6,4,1,15
191006338,1,2,9,9,7,28
191006339,5,0,1,2,8,16
191006340,7,4,0,2,5,18
191006341,2,7,5,9,6,29
191006342,7,8,8,9,2,34
191006343,8,9,5,9,3,34
191006344,4,8,9,7,9,37
191006345,3,3,2,6,8,22
191006346,4,5,9,3,3,24
191006347,4,1,1,7,3,16
191006348,4,9,7,4,3,27
191006349,5,7,0,5,5,22
191006350,2,3,1,8,0,14
191006351,4,4,1,6,6,21
191006352,2,5,1,7,3,18
191006353,2,2,8,9,3,24
191006354,2,4,9,7,4,26
191006355,6,2,5,5,2,20
191006356,4,6,0,7,5,22
191006357,7,7,9,3,8,34
191006358,3,2,1,3,7,16
191006359,3,1,0,2,7,13
191006360,9,5,5,5,0,24
191006361,1,7,0,4,7,19
191006362,7,8,8,7,8,38
191006363,4,2,7,4,8,25
191006364,5,8,3,9,8,33
191006365,2,3,9,1,1,16
191006366,4,4,6,5,5,24
191006367,6,1,2,5,4,18
191006368,5,9,4,8,9,35
191006369,9,2,1,3,7,22
191006370,3,7,0,3,0,13
191006371,2,4,2,6,1,15
191006372,5,2,8,0,1,16
191006373,0,1,5,4,5,15
191006374,8,8,6,3,4,29
191006375,7,4,2,8,1,22
191006376,9,2,1,9,0,21
191006377,4,9,4,6,2,25
191006378,7,8,3,9,0,27
191006379,6,2,7,3,0,18
191006380,2,7,0,1,6,16
191006381,1,0,6,0,9,16
191006382,4,6,0,2,5,17
191006383,1,0,8,2,0,11
191006384,2,5,2,7,3,19
191006385,2,9,5,9,9,34
191006386,7,4,6,7,5,29
191006387,7,6,3,8,2,26
191006388,1,5,1,0,0,7
191006389,9,4,9,5,1,28
191006390,9,6,5,2,6,28
191006391,7,1,1,9,3,21
191006392,4,6,6,5,6,27
191006393,2,3,4,4,0,13
191006394,8,7,1,6,0,22
191006395,5,4,8,2,1,20
191006396,4,6,4,4,6,24
191006397,7,8,3,0,5,23
191006398,4,3,4,0,5,16
191006399,8,5,5,3,8,29
191006400,0,0,3,9,6,18
191006401,5,9,1,8,7,30
191006402,6,7,0,9,8,30
191006403,6,9,2,7,0,24
191006404,7,9,5,2,3,26
191006405,5,1,2,8,4,20
191006406,6,2,4,3,6,21
191006407,4,6,9,8,8,35
191006408,6,0,0,3,5,14
191006409,5,0,7,1,9,22
191006410,2,6,4,3,5,20
191006411,3,3,3,6,2,17
191006412,2,8,8,5,8,31
191006413,6,8,8,5,4,31
191006414,4,4,6,4,6,24
191006415,5,1,9,0,7,22
191006416,3,2,5,8,0,18
191006417,4,5,6,7,5,27
191006418,5,0,1,8,6,20
191006419,4,5,2,0,6,17
191006420,5,0,1,4,5,15
191006421,6,1,8,5,1,21
191006422,6,5,5,4,0,20
191006423,6,6,2,0,0,14
191006424,4,0,0,6,4,14
191006425,2,8,5,8,2,25
191006426,4,3,7,3,7,24
191006427,9,9,2,3,5,28
191006428,5,0,8,3,1,17
191006429,3,7,5,9,1,25
191006430,3,5,7,4,0,19
191006431,7,0,2,1,1,11
191006432,0,0,4,8,6,18
191006433,0,2,6,6,8,22
191006434,4,2,5,3,8,22
191006435,4,5,6,5,5,25
191006436,9,3,6,3,1,22
191006437,4,7,0,3,7,21
191006438,5,9,3,9,1,27
191006439,7,0,8,3,2,20
191006440,6,2,2,7,4,21
191006441,5,5,1,0,9,20
191006442,2,0,2,4,6,14
191006443,2,0,7,3,3,15
191006444,9,9,4,8,9,39
191006445,3,8,3,5,7,26
191006446,8,1,2,1,8,20
191006447,6,0,1,4,5,16
191006448,1,5,7,2,2,17
191006449,1,7,1,3,7,19
191006450,9,6,4,3,0,22
191006451,7,6,5,8,4,30
191006452,2,8,0,1,2,13
191006453,5,3,7,4,1,20
191006454,0,5,6,6,5,22
191006455,0,2,3,9,6,20
191006456,1,0,6,3,7,17
191006457,9,9,5,8,8,39
191006458,7,0,4,5,1,17
191006459,1,8,2,2,8,21
191006460,7,1,1,8,4,21
191006461,9,8,2,8,6,33
191006462,5,3,5,8,8,29
191006463,3,6,5,8,3,25
191006464,1,8,0,1,7,17
191006465,2,3,1,7,0,13
191006466,4,3,7,0,8,22
191006467,8,8,0,4,5,25
191006468,8,2,4,4,4,22
191006469,4,0,6,6,8,24
191006470,0,6,2,3,6,17
191006471,0,1,6,9,4,20
191006472,9,0,8,5,2,24
191006473,0,1,5,5,3,14
191006474,2,4,1,9,5,21
191006475,9,7,2,5,1,24
191006476,5,7,6,0,1,19
191006477,1,6,3,3,2,15
191006478,5,1,9,0,9,24
191006479,4,2,7,6,4,23
191006480,5,5,1,2,8,21
191006481,1,8,3,5,7,24
191006482,3,4,5,4,7,23
191006483,8,0,5,7,7,27
191006484,4,1,1,5,1,12
191006485,5,0,0,4,4,13
191006486,5,8,8,5,2,28
191006487,9,9,6,4,8,36
191006488,4,9,9,7,0,29
191006489,0,4,6,3,4,17
191006490,2,9,1,5,1,18
191006491,9,2,9,1,2,23
191006492,8,5,9,0,2,24
191006493,6,0,3,3,0,12
191006494,7,6,4,0,4,21
191006495,9,0,6,6,9,30
191006496,0,4,7,6,5,22
191006497,9,3,8,2,9,31
191006498,2,2,0,0,5,9
191006499,4,6,4,5,0,19
191006500,3,2,9,6,3,23
191006501,8,4,9,0,8,29
191006502,8,6,7,9,1,31
191006503,1,8,2,6,6,23
191006504,6,9,7,7,5,34
191006505,2,0,4,8,9,23
191006506,2,4,2,1,8,17
191006507,6,1,4,3,4,18
191006508,6,7,2,6,6,27
191006509,0,7,8,1,9,25
191006510,7,7,8,5,8,35
191006511,3,9,0,2,8,22
191006512,3,7,7,7,1,25
191006513,4,3,2,1,4,14
191006514,3,5,6,5,5,24
191006515,9,6,0,5,3,23
191006516,8,5,8,8,6,35
191006517,5,2,0,6,1,14
191006518,8,2,3,0,5,18
191006519,4,2,0,5,9,20
191006520,9,4,4,2,4,23
191006521,2,2,5,4,3,16
191006522,6,0,1,4,0,11
191006523,8,0,9,9,8,34
191006524,0,7,5,9,1,22
191006525,0,9,5,3,8,25
191006526,6,1,0,5,6,18
191006527,0,4,3,2,2,11
191006528,8,6,6,6,1,27
191006529,8,2,4,3,1,18
191006530,6,3,0,3,8,20
191006531,0,4,7,6,4,21
191006532,0,6,5,7,1,19
191006533,9,6,5,0,2,22
191006534,0,0,6,4,6,16
191006535,8,6,0,2,7,23
191006536,4,9,1,0,6,20
191006537,4,0,8,7,6,25
191006538,0,4,9,3,5,21
191006539,4,4,8,0,5,21
191006540,3,8,0,0,3,14
191006541,2,8,3,5,9,27
191006542,9,3,7,5,6,30
191006543,4,0,0,1,7,12
191006544,0,6,4,8,4,22
191006545,9,8,6,5,8,36
191006546,7,0,5,4,9,25
191006547,0,6,4,8,7,25
191006548,0,4,2,5,2,13
191006549,9,0,8,8,5,30
191006550,6,5,0,5,1,17
191006551,5,6,4,5,7,27
191006552,1,9,8,1,2,21
191006553,7,4,0,1,7,19
191006554,0,0,3,1,9,13
191006555,7,0,7,2,3,19
191006556,9,6,4,0,6,25
191006557,2,5,3,5,8,23
191006558,1,7,4,6,6,24
191006559,5,6,1,7,3,22
191006560,1,2,0,5,5,13
191006561,3,5,9,0,7,24
191006562,1,2,2,3,0,8
191006563,8,8,6,9,9,40
191006564,7,3,7,5,2,24
191006565,2,3,9,6,6,26
191006566,4,6,4,1,2,17
191006567,7,7,8,0,6,28
191006568,2,6,5,9,6,28
191006569,3,8,4,0,4,19
191006570,1,4,3,0,6,14
191006571,2,7,6,3,1,19
191006572,0,6,7,6,8,27
191006573,0,8,7,1,3,19
191006574,7,4,9,8,7,35
191006575,5,7,3,2,1,18
191006576,1,7,3,2,4,17
191006577,7,4,6,5,4,26
191006578,7,0,8,4,4,23
191006579,1,2,5,2,4,14
191006580,4,5,8,1,3,21
191006581,0,5,8,0,4,17
191006582,8,8,6,7,4,33
191006583,9,7,6,0,3,25
191006584,3,6,9,1,8,27
191006585,6,8,5,5,4,28
191006586,7,4,3,3,1,18
191006587,7,9,1,2,4,23
191006588,1,0,7,1,3,12
191006589,5,2,1,8,4,20
191006590,4,5,4,8,4,25
191006591,8,1,1,7,4,21
191006592,5,9,3,5,3,25
191006593,5,5,5,7,8,30
191006594,0,9,4,2,9,24
191006595,2,0,6,3,3,14
191006596,7,1,7,5,6,26
191006597,9,9,3,0,8,29
191006598,5,2,1,3,2,13
191006599,2,8,4,0,5,19
191006600,8,8,3,4,4,27
191006601,5,6,1,5,4,21
191006602,2,3,0,7,4,16
191006603,9,0,9,8,4,30
191006604,9,8,2,2,0,21
191006605,6,8,8,2,0,24
191006606,0,8,0,9,3,20
191006607,7,4,1,4,4,20
191006608,9,7,0,0,0,16
191006609,6,8,8,5,6,33
191006610,1,1,0,2,0,4
191006611,6,2,2,0,8,18
191006612,3,5,7,0,1,16
191006613,8,0,4,1,2,15
191006614,1,2,5,8,6,22
191006615,9,9,6,5,7,36
191006616,4,7,5,7,9,32
191006617,0,6,0,4,7,17
191006618,9,1,0,5,7,22
191006619,2,6,5,8,5,26
191006620,4,1,9,0,7,21
191006621,8,7,7,1,8,31
191006622,1,1,3,6,2,13
191006623,5,7,5,0,9,26
191006624,9,4,2,6,1,22
191006625,2,2,1,5,4,14
191006626,5,4,4,1,8,22
191006627,4,1,8,8,0,21
191006628,4,4,9,0,4,21
191006629,1,0,1,3,1,6
191006630,8,6,0,9,4,27
191006631,5,2,4,4,6,21
191006632,6,8,7,8,8,37
191006633,2,9,2,6,0,19
191006634,2,9,0,8,7,26
191006635,8,1,8,9,7,33
191006636,7,0,1,9,6,23
191006637,0,8,6,9,9,32
191006638,7,1,3,4,5,20
191006639,7,5,5,6,5,28
191006640,8,8,9,3,1,29
191006641,8,6,8,6,8,36
191006642,9,1,7,6,1,24
191006643,6,9,2,4,6,27
191006644,3,6,8,7,1,25
191006645,0,2,1,8,2,13
191006646,4,8,7,2,6,27
191006647,5,2,7,8,3,25
191006648,7,3,4,7,5,26
191006649,6,5,8,1,7,27
191006650,4,7,1,8,4,24
191006651,7,3,6,9,6,31
191006652,0,0,8,9,9,26
191006653,2,5,2,7,4,20
191006654,0,5,3,7,1,16
191006655,1,6,0,6,1,14
191006656,1,2,0,9,5,17
191006657,9,9,1,7,9,35
191006658,2,3,3,4,4,16
191006659,6,3,5,7,0,21
191006660,6,1,7,3,5,22
191006661,7,0,8,8,0,23
191006662,2,4,3,7,4,20
191006663,6,3,4,4,0,17
191006664,2,6,1,9,0,18
191006665,7,8,0,9,7,31
191006666,2,5,5,7,2,21
191006667,0,2,6,2,9,19
191006668,3,1,1,2,5,12
191006669,3,1,2,6,5,17
191006670,8,1,5,4,4,22
191006671,1,9,6,2,9,27
191006672,2,0,9,7,7,25
191006673,6,0,6,7,2,21
191006674,0,9,6,0,8,23
191006675,0,9,3,5,7,24
191006676,4,5,5,3,8,25
191006677,4,0,3,8,1,16
191006678,2,3,5,5,3,18
191006679,6,3,0,6,8,23
191006680,3,5,3,5,3,19
191006681,1,8,3,9,1,22
191006682,5,1,7,1,5,19
191006683,6,4,2,8,2,22
191006684,3,9,6,9,4,31
191006685,4,8,5,4,6,27
191006686,1,8,1,6,6,22
191006687,2,7,9,4,0,22
191006688,9,7,3,6,6,31
191006689,4,9,9,9,6,37
191006690,6,5,6,4,5,26
191006691,5,8,8,4,2,27
191006692,5,6,6,0,1,18
191006693,9,2,7,8,1,27
191006694,1,5,8,5,9,28
191006695,3,6,6,5,1,21
191006696,8,2,5,0,3,18
191006697,2,2,5,4,8,21
191006698,1,4,4,3,9,21
191006699,6,3,1,9,6,25
191006700,0,7,8,4,6,25
191006701,0,4,8,2,6,20
191006702,0,0,4,1,8,13
191006703,9,1,4,6,7,27
191006704,2,3,9,4,8,26
191006705,2,4,1,5,6,18
191006706,3,7,6,9,7,32
191006707,6,5,3,3,1,18
191006708,1,3,7,3,6,20
191006709,1,5,2,3,2,13
191006710,7,1,3,6,0,17
191006711,8,0,7,5,9,29
191006712,3,5,3,1,4,16
191006713,1,8,2,4,8,23
191006714,6,7,1,7,3,24
191006715,9,7,9,8,5,38
191006716,8,6,9,7,9,39
191006717,3,9,0,6,5,23
191006718,4,0,1,2,5,12
191006719,8,4,9,5,0,26
191006720,3,6,3,3,9,24
191006721,7,1,6,5,7,26
191006722,2,0,8,4,3,17
191006723,9,7,8,6,2,32
191006724,0,1,0,1,3,5
191006725,2,5,6,8,7,28
191006726,6,2,6,1,7,22
191006727,3,9,9,8,2,31
191006728,8,4,0,2,7,21
191006729,0,0,1,6,0,7
191006730,1,3,6,8,3,21
191006731,5,0,5,9,2,21
191006732,2,3,3,7,1,16
191006733,5,5,6,8,0,24
191006734,0,3,5,5,3,16
191006735,4,3,7,3,1,18
191006736,7,1,9,2,0,19
191006737,6,7,5,3,1,22
191006738,5,1,3,4,7,20
191006739,3,0,2,0,9,14
191006740,3,8,6,9,5,31
191006741,3,6,6,9,1,25
191006742,4,4,7,8,9,32
191006743,6,9,5,8,7,35
191006744,6,4,8,0,7,25
191006745,1,4,4,7,6,22
191006746,9,6,9,1,2,27
191006747,8,1,8,7,1,25
191006748,7,9,2,1,0,19
191006749,7,5,3,0,3,18
191006750,2,1,6,1,3,13
191006751,7,2,1,1,1,12
191006752,8,6,4,3,4,25
191006753,3,9,0,3,2,17
191006754,1,3,0,4,8,16
191006755,2,2,4,0,0,8
191006756,6,0,9,5,2,22
191006757,6,8,5,9,3,31
191006758,0,2,8,7,9,26
191006759,8,9,0,8,6,31
191006760,2,5,3,3,7,20
191006761,9,2,5,3,6,25
191006762,6,2,9,4,3,24
191006763,6,3,2,1,3,15
191006764,6,2,4,7,6,25
191006765,7,5,9,2,2,25
191006766,9,2,5,1,9,26
191006767,8,9,5,6,7,35
191006768,3,3,2,8,2,18
191006769,4,1,0,0,8,13
191006770,4,5,1,5,7,22
191006771,5,3,4,6,0,18
191006772,1,9,5,4,2,21
191006773,0,4,7,1,4,16
191006774,1,7,5,3,4,20
191006775,3,9,0,6,2,20
191006776,0,8,0,4,6,18
191006777,8,5,0,5,5,23
191006778,1,1,2,7,0,11
191006779,8,4,1,5,8,26
191006780,9,4,2,8,4,27
191006781,7,3,7,4,8,29
191006782,4,7,5,3,9,28
191006783,1,8,2,6,0,17
191006784,4,4,6,2,1,17
191006785,6,6,8,1,1,22
191006786,4,3,7,9,5,28
191006787,3,1,2,2,5,13
191006788,9,8,0,8,4,29
191006789,6,5,5,6,1,23
191006790,8,8,3,0,4,23
191006791,3,5,4,2,2,16
191006792,1,6,8,1,6,22
191006793,1,6,1,8,3,19
191006794,9,9,3,3,9,33
191006795,4,7,2,6,0,19
191006796,8,0,0,5,8,21
191006797,7,3,1,3,6,20
191006798,5,1,7,8,8,29
191006799,9,9,8,4,6,36
191006800,2,3,9,7,6,27
191006801,0,4,5,5,4,18
191006802,8,7,9,6,9,39
191006803,3,5,6,2,6,22
191006804,7,9,4,7,0,27
191006805,0,8,8,5,2,23
191006806,1,9,5,7,7,29
191006807,1,1,5,5,2,14
191006808,1,6,6,5,8,26
191006809,7,1,5,7,9,29
191006810,6,5,0,9,4,24
191006811,9,0,5,3,5,22
191006812,0,0,7,5,9,21
191006813,1,1,4,3,6,15
191006814,6,0,5,7,0,18
191006815,4,9,6,8,2,29
191006816,2,3,5,5,0,15
191006817,2,5,4,9,9,29
191006818,1,0,3,8,6,18
191006819,8,4,2,5,9,28
191006820,6,6,7,5,4,28
191006821,2,1,2,5,3,13
191006822,3,4,8,0,6,21
191006823,9,6,1,7,1,24
191006824,3,1,9,5,5,23
191006825,7,9,4,4,8,32
191006826,5,7,9,2,4,27
191006827,4,4,2,6,2,18
191006828,1,6,5,9,7,28
191006829,0,4,9,1,4,18
191006830,6,7,2,0,5,20
191006831,1,7,2,1,7,18
191006832,7,0,0,5,3,15
191006833,5,4,4,4,8,25
191006834,0,4,7,4,5,20
191006835,2,3,3,5,0,13
191006836,8,8,5,2,0,23
191006837,2,8,1,7,4,22
191006838,9,4,4,6,0,23
191006839,7,7,5,5,0,24
191006840,8,7,3,4,7,29
191006841,4,9,0,4,9,26
191006842,3,2,4,5,2,16
191006843,5,0,8,2,4,19
191006844,9,6,3,7,7,32
191006845,6,5,2,8,8,29
191006846,9,6,2,0,8,25
191006847,8,0,5,2,9,24
191006848,0,3,4,6,2,15
191006849,4,8,8,3,3,26
191006850,4,2,6,4,1,17
191006851,5,5,2,3,6,21
191006852,8,2,2,0,1,13
191006853,6,3,4,4,8,25
191006854,6,2,1,6,8,23
191006855,6,0,7,9,0,22
191006856,8,8,1,1,5,23
191006857,1,5,0,5,1,12
191006858,2,5,0,3,1,11
191006859,9,3,6,0,1,19
191006860,1,4,3,0,8,16
191006861,7,9,4,2,5,27
191006862,2,7,9,3,0,21
191006863,7,3,3,5,2,20
191006864,6,0,8,6,0,20
191006865,1,5,0,8,3,17
191006866,7,6,8,5,4,30
191006867,9,1,9,1,9,29
191006868,8,8,3,4,8,31
191006869,3,0,2,9,9,23
191006870,4,4,3,8,2,21
191006871,5,3,4,3,6,21
191006872,9,6,9,3,4,31
191006873,4,2,4,0,6,16
191006874,3,6,8,2,6,25
191006875,9,3,8,2,3,25
191006876,7,5,6,8,5,31
191006877,1,0,2,5,2,10
191006878,0,7,2,3,0,12
191006879,0,5,1,0,8,14
191006880,0,2,7,6,4,19
191006881,2,1,7,0,8,18
191006882,0,9,0,1,8,18
191006883,1,4,6,6,3,20
191006884,5,7,0,2,8,22
191006885,0,5,3,4,1,13
191006886,6,8,2,0,1,17
191006887,3,8,7,7,6,31
191006888,1,6,8,1,4,20
191006889,9,9,9,7,8,42
191006890,7,0,3,3,9,22
191006891,7,3,4,4,6,24
191006892,5,7,1,5,3,21
191006893,4,1,4,0,7,16
191006894,8,5,5,7,6,31
191006895,3,7,9,1,4,24
191006896,4,6,4,7,2,23
191006897,4,8,4,0,0,16
191006898,9,8,0,7,4,28
191006899,1,8,7,7,3,26
191006900,4,4,7,6,7,28
191006901,3,3,1,9,7,23
191006902,0,3,0,7,8,18
191006903,1,2,7,3,4,17
191006904,7,6,4,0,6,23
191006905,1,7,9,4,7,28
191006906,0,1,0,1,5,7
191006907,8,0,1,5,2,16
191006908,0,1,8,4,1,14
191006909,5,1,6,4,2,18
191006910,6,1,1,9,3,20
191006911,7,8,9,6,9,39
191006912,0,4,0,4,0,8
191006913,2,6,7,0,6,21
191006914,5,5,8,6,0,24
191006915,5,0,3,5,4,17
191006916,7,6,6,7,2,28
191006917,2,3,2,7,0,14
191006918,7,6,3,7,3,26
191006919,4,2,6,6,9,27
191006920,2,7,1,1,7,18
191006921,1,7,1,1,4,14
191006922,7,3,2,6,8,26
191006923,4,5,3,0,0,12
191006924,4,7,8,2,6,27
191006925,5,0,0,5,1,11
191006926,5,0,5,3,1,14
191006927,6,0,1,8,6,21
191006928,5,7,6,1,0,19
191006929,7,6,9,7,3,32
191006930,7,2,3,3,9,24
191006931,3,3,6,5,1,18
191006932,6,1,1,7,8,23
191006933,1,0,5,7,5,18
191006934,9,9,1,7,5,31
191006935,0,7,7,7,4,25
191006936,7,2,0,2,7,18
191006937,3,8,3,7,1,22
191006938,6,9,0,2,5,22
191006939,8,4,5,1,4,22
191006940,7,8,4,1,9,29
191006941,5,6,0,4,6,21
191006942,8,4,1,9,4,26
191006943,4,2,7,1,5,19
191006944,9,2,6,2,2,21
191006945,7,7,5,4,2,25
191006946,5,2,4,3,9,23
191006947,9,4,2,1,1,17
191006948,1,4,7,2,3,17
191006949,5,6,6,7,3,27
191006950,3,8,2,0,2,15
191006951,2,0,9,4,1,16
191006952,4,0,1,2,8,15
191006953,2,6,2,3,1,14
191006954,0,9,4,8,5,26
191006955,6,6,5,0,7,24
191006956,9,3,9,4,6,31
191006957,8,4,4,3,2,21
191006958,9,1,2,3,5,20
191006959,2,9,2,8,4,25
191006960,8,3,8,9,7,35
191006961,3,3,9,5,1,21
191006962,9,5,6,9,2,31
191006963,3,8,8,7,6,32
191006964,3,1,3,8,4,19
191006965,3,2,2,4,7,18
191006966,7,2,4,3,0,16
191006967,9,5,2,6,9,31
191006968,6,3,8,9,5,31
191006969,8,3,4,0,2,17
191006970,5,2,4,4,4,19
191006971,9,2,9,3,9,32
191006972,2,8,7,5,8,30
191006973,1,0,2,7,2,12
191006974,8,1,9,7,6,31
191006975,8,8,2,1,2,21
191006976,0,1,9,6,7,23
191006977,3,9,3,9,8,32
191006978,7,8,5,0,5,25
191006979,6,3,3,8,4,24
191006980,9,8,6,2,9,34
191006981,2,8,1,4,6,21
191006982,5,2,3,9,8,27
191006983,2,0,8,4,2,16
191006984,4,4,2,3,6,19
191006985,7,4,2,4,1,18
191006986,6,3,7,7,4,27
191006987,3,0,6,8,8,25
191006988,6,9,1,4,6,26
191006989,4,2,6,2,9,23
191006990,4,1,0,1,4,10
191006991,3,4,3,3,9,22
191006992,2,0,0,8,7,17
191006993,7,8,7,5,2,29
191006994,1,4,6,4,0,15
191006995,9,1,4,9,9,32
191006996,4,3,9,3,5,24
191006997,2,0,2,8,1,13
191006998,6,2,2,7,8,25
191006999,9,9,9,8,6,41
1910061000,0,2,3,9,1,15
1910061001,3,7,9,8,8,35
1910061002,3,4,2,9,8,26
1910061003,3,7,1,9,3,23
1910061004,5,1,0,4,4,14
1910061005,6,7,3,8,7,31
1910061006,5,3,7,3,9,27
1910061007,6,4,7,3,2,22
1910061008,2,6,9,9,1,27
1910061009,3,6,3,4,9,25
1910061010,5,4,9,2,2,22
1910061011,9,5,3,3,3,23
1910061012,0,9,1,8,5,23
1910061013,9,1,6,0,1,17
1910061014,2,3,3,5,1,14
1910061015,1,5,5,9,0,20
1910061016,0,6,0,7,4,17
1910061017,5,3,6,5,4,23
1910061018,9,1,1,7,3,21
1910061019,7,8,5,1,2,23
1910061020,3,5,6,7,1,22
1910061021,1,6,9,7,1,24
1910061022,0,0,1,1,7,9
1910061023,3,8,9,2,2,24
1910061024,6,5,0,7,3,21
1910061025,9,7,8,3,0,27
1910061026,4,2,1,3,3,13
1910061027,5,2,6,5,3,21
1910061028,9,4,2,5,5,25
1910061029,9,1,9,3,1,23
1910061030,6,1,1,6,7,21
1910061031,7,1,4,5,3,20
1910061032,0,5,2,7,9,23
1910061033,7,9,7,4,0,27
1910061034,7,8,0,3,7,25
1910061035,3,5,0,0,2,10
1910061036,6,6,8,9,2,31
1910061037,7,0,6,9,4,26
1910061038,0,8,6,4,1,19
1910061039,7,4,6,3,2,22
1910061040,1,6,3,1,2,13
1910061041,8,9,7,2,3,29
1910061042,2,4,9,9,6,30
1910061043,2,2,5,2,5,16
1910061044,7,7,3,2,6,25
1910061045,2,6,2,9,4,23
1910061046,8,7,7,5,7,34
1910061047,3,8,5,2,1,19
1910061048,3,3,8,5,3,22
1910061049,6,5,8,9,6,34
1910061050,0,8,6,3,7,24
1910061051,3,9,9,4,3,28
1910061052,1,1,4,4,5,15
1910061053,0,2,8,8,6,24
1910061054,1,8,0,5,6,20
1910061055,8,8,8,9,4,37
1910061056,9,1,2,8,2,22
1910061057,9,7,8,2,2,28
1910061058,9,6,7,9,3,34
1910061059,8,5,8,4,3,28
1910061060,4,7,6,7,4,28
1910061061,9,5,5,9,7,35
1910061062,2,8,9,7,1,27
1910061063,3,6,1,2,6,18
1910061064,0,4,1,9,2,16
1910061065,2,2,8,1,4,17
1910061066,5,5,0,8,0,18
1910061067,0,8,1,5,8,22
1910061068,2,8,5,5,5,25
1910061069,0,1,2,3,7,13
1910061070,9,0,2,9,7,27
1910061071,4,0,2,0,1,7
1910061072,7,0,5,9,5,26
1910061073,2,4,8,1,7,22
1910061074,0,9,4,6,7,26
1910061075,8,9,2,9,7,35
1910061076,9,5,2,2,0,18
1910061077,7,3,2,5,8,25
1910061078,6,7,7,8,6,34
1910061079,0,1,5,1,9,16
1910061080,4,3,4,3,8,22
1910061081,1,8,8,9,6,32
1910061082,4,4,6,6,0,20
1910061083,8,2,3,5,3,21
1910061084,4,8,7,9,7,35
1910061085,8,7,3,3,2,23
1910061086,1,3,4,4,8,20
1910061087,2,6,1,4,1,14
1910061088,0,6,9,5,8,28
1910061089,2,9,5,1,3,20
1910061090,8,4,1,3,0,16
1910061091,3,4,7,5,6,25
1910061092,6,8,2,4,0,20
1910061093,2,9,2,7,4,24
1910061094,8,6,1,9,2,26
1910061095,1,9,7,3,9,29
1910061096,5,5,2,6,1,19
1910061097,2,4,6,3,2,17
1910061098,8,7,1,2,0,18
1910061099,3,8,7,3,5,26
1910061100,4,5,5,7,7,28
1910061101,2,3,1,5,6,17
1910061102,9,1,5,0,7,22
1910061103,8,6,2,4,0,20
1910061104,3,1,9,6,3,22
1910061105,9,3,8,4,2,26
191007001,7,0,4,9,0,20
191007002,9,0,9,8,8,34
191007003,6,9,2,5,4,26
191007004,9,1,7,4,3,24
191007005,4,9,2,6,7,28
191007006,4,2,7,5,6,24
191007007,5,0,1,7,2,15
191007008,9,9,2,1,5,26
191007009,0,2,9,9,5,25
191007010,4,3,0,2,1,10
191007011,7,1,8,8,0,24
191007012,8,5,4,8,6,31
191007013,3,2,7,3,0,15
191007014,2,1,9,3,9,24
191007015,1,0,5,9,0,15
191007016,1,4,5,5,6,21
191007017,8,8,6,1,6,29
191007018,4,7,1,5,8,25
191007019,0,8,9,8,5,30
191007020,0,5,9,7,5,26
191007021,3,6,0,1,9,19
191007022,9,1,0,6,2,18
191007023,7,3,8,1,3,22
191007024,0,4,4,5,4,17
191007025,1,3,2,9,3,18
191007026,1,9,5,5,1,21
191007027,2,4,0,5,7,18
191007028,5,2,5,7,7,26
191007029,5,0,9,7,3,24
191007030,2,4,1,3,6,16
191007031,7,4,0,7,8,26
191007032,6,4,6,9,6,31
191007033,6,7,6,9,8,36
191007034,4,8,5,4,3,24
191007035,5,2,9,0,8,24
191007036,1,2,3,1,5,12
191007037,4,1,1,4,8,18
191007038,3,7,9,2,3,24
191007039,1,7,6,2,0,16
191007040,6,0,0,5,9,20
191007041,1,4,0,5,6,16
191007042,8,5,8,8,2,31
191007043,2,2,8,9,7,28
191007044,9,8,7,4,5,33
191007045,4,7,0,8,0,19
191007046,9,4,1,4,0,18
191007047,1,0,0,7,2,10
191007048,8,5,3,8,7,31
191007049,9,8,5,6,4,32
191007050,8,6,5,6,8,33
191007051,1,5,3,4,5,18
191007052,1,3,5,3,2,14
191007053,4,4,9,3,9,29
191007054,1,8,1,1,7,18
191007055,1,2,4,6,7,20
191007056,6,1,9,4,4,24
191007057,1,2,5,7,8,23
191007058,4,8,6,4,6,28
191007059,8,5,4,3,6,26
191007060,9,1,3,0,3,16
191007061,9,1,2,9,6,27
191007062,3,8,6,3,4,24
191007063,7,7,8,5,2,29
191007064,4,0,1,8,9,22
191007065,7,1,6,2,4,20
191007066,5,5,7,9,9,35
191007067,9,7,5,2,7,30
191007068,4,7,6,9,7,33
191007069,2,8,9,4,0,23
191007070,9,8,4,2,2,25
191007071,6,1,3,4,1,15
191007072,3,7,4,7,0,21
191007073,0,8,9,4,7,28
191007074,0,8,9,2,6,25
191007075,4,1,2,0,5,12
191007076,0,3,7,1,3,14
191007077,1,7,9,0,7,24
191007078,6,6,8,5,3,28
191007079,4,4,8,6,2,24
191007080,4,4,8,7,7,30
191007081,1,3,6,3,9,22
191007082,8,3,8,8,2,29
191007083,6,8,8,5,0,27
191007084,8,9,3,5,4,29
191007085,9,5,4,6,1,25
191007086,8,0,1,9,5,23
191007087,1,6,7,1,7,22
191007088,0,9,6,3,1,19
191007089,8,9,1,6,8,32
191007090,1,3,6,7,0,17
191007091,7,4,6,4,6,27
191007092,1,5,0,4,8,18
191007093,0,9,5,7,9,30
191007094,9,5,0,0,0,14
191007095,9,2,6,1,5,23
191007096,1,4,6,7,9,27
191007097,4,9,4,3,4,24
191007098,1,1,5,7,9,23
191007099,5,6,4,7,5,27
191007100,7,2,6,9,1,25
191007101,6,4,1,7,0,18
191007102,8,4,0,7,2,21
191007103,0,2,3,7,8,20
191007104,7,0,0,6,2,15
191007105,2,4,8,4,3,21
191007106,2,1,1,6,3,13
191007107,7,2,4,6,5,24
191007108,2,3,9,2,1,17
191007109,1,4,8,8,6,27
191007110,4,2,4,6,7,23
191007111,7,3,8,1,8,27
191007112,1,8,9,7,9,34
191007113,5,9,6,5,6,31
191007114,2,2,0,5,4,13
191007115,0,6,6,3,9,24
191007116,3,6,9,6,4,28
191007117,1,9,1,4,1,16
191007118,6,1,9,5,1,22
191007119,5,0,8,7,5,25
191007120,1,7,0,7,2,17
191007121,5,5,7,9,8,34
191007122,2,2,1,4,9,18
191007123,7,5,1,4,4,21
191007124,0,1,1,9,9,20
191007125,9,8,7,7,9,40
191007126,2,5,4,7,8,26
191007127,6,5,9,9,0,29
191007128,7,6,5,4,7,29
191007129,4,2,6,5,1,18
191007130,3,8,8,2,0,21
191007131,0,0,0,4,2,6
191007132,6,0,8,3,0,17
191007133,2,2,6,4,5,19
191007134,7,3,4,5,0,19
191007135,1,7,7,1,7,23
191007136,6,6,7,6,3,28
191007137,8,0,8,5,9,30
191007138,9,9,9,8,2,37
191007139,5,6,6,3,0,20
191007140,0,3,9,2,3,17
191007141,5,8,5,0,2,20
191007142,9,1,8,1,5,24
191007143,7,3,4,2,9,25
191007144,9,6,8,8,2,33
191007145,2,7,5,0,2,16
191007146,9,4,2,9,3,27
191007147,5,9,6,4,3,27
191007148,4,7,5,3,3,22
191007149,6,5,3,8,9,31
191007150,1,4,0,4,7,16
191007151,8,1,4,5,0,18
191007152,3,5,1,1,8,18
191007153,2,5,1,2,2,12
191007154,7,5,6,6,8,32
191007155,7,4,5,1,7,24
191007156,9,6,8,4,8,35
191007157,4,7,4,5,3,23
191007158,7,3,3,9,3,25
191007159,5,2,2,4,4,17
191007160,7,7,1,9,1,25
191007161,9,4,4,2,3,22
191007162,0,9,8,9,7,33
191007163,5,3,1,5,4,18
191007164,9,8,9,7,7,40
191007165,4,3,6,8,5,26
191007166,2,1,2,3,0,8
191007167,8,5,4,1,2,20
191007168,5,0,1,7,4,17
191007169,4,9,3,8,1,25
191007170,4,2,2,9,9,26
191007171,7,2,3,7,6,25
191007172,4,8,8,7,4,31
191007173,0,0,1,8,8,17
191007174,2,8,1,7,5,23
191007175,7,3,4,2,4,20
191007176,9,6,0,9,5,29
191007177,2,2,2,4,5,15
191007178,5,7,5,1,4,22
191007179,5,1,6,4,8,24
191007180,9,2,0,8,2,21
191007181,8,8,1,7,9,33
191007182,9,2,2,9,5,27
191007183,1,5,5,6,5,22
191007184,8,1,0,5,8,22
191007185,9,9,4,5,6,33
191007186,2,9,2,6,2,21
191007187,8,7,8,7,5,35
191007188,8,5,0,4,8,25
191007189,3,4,9,2,7,25
191007190,3,9,9,6,6,33
191007191,5,4,8,0,0,17
191007192,0,5,8,1,3,17
191007193,7,3,3,2,0,15
191007194,5,8,9,9,9,40
191007195,2,3,1,9,2,17
191007196,2,5,4,0,1,12
191007197,5,9,2,5,0,21
191007198,6,8,0,3,6,23
191007199,1,6,7,1,1,16
191007200,6,9,9,3,1,28
191007201,0,8,9,3,6,26
191007202,7,5,4,5,0,21
191007203,0,1,6,2,6,15
191007204,8,0,5,3,4,20
191007205,4,8,2,9,0,23
191007206,2,5,1,9,5,22
191007207,9,5,3,2,0,19
191007208,7,7,2,0,7,23
191007209,8,4,5,8,5,30
191007210,2,4,8,4,1,19
191007211,1,6,7,4,8,26
191007212,4,7,1,6,7,25
191007213,4,6,9,1,7,27
191007214,7,0,9,7,2,25
191007215,9,4,6,7,7,33
191007216,1,7,4,3,3,18
191007217,4,2,2,8,3,19
191007218,7,4,3,5,3,22
191007219,9,4,3,2,8,26
191007220,2,9,9,0,7,27
191007221,8,5,6,8,0,27
191007222,8,9,6,4,3,30
191007223,5,2,1,4,7,19
191007224,7,8,7,9,0,31
191007225,4,9,1,8,2,24
191007226,6,8,6,2,3,25
191007227,8,5,9,5,7,34
191007228,6,0,1,3,6,16
191007229,4,0,6,7,4,21
191007230,8,8,3,9,1,29
191007231,2,4,5,3,4,18
191007232,8,0,8,1,8,25
191007233,5,5,3,3,9,25
191007234,1,9,8,2,7,27
191007235,7,3,1,8,2,21
191007236,6,4,4,9,5,28
191007237,3,8,3,1,7,22
191007238,7,4,1,9,5,26
191007239,7,6,9,4,6,32
191007240,5,3,5,2,1,16
191007241,6,8,9,2,2,27
191007242,2,8,7,1,3,21
191007243,0,4,2,9,5,20
191007244,2,3,7,4,7,23
191007245,8,0,0,4,2,14
191007246,2,5,3,3,6,19
191007247,1,2,0,3,4,10
191007248,6,3,1,9,9,28
191007249,1,2,5,9,6,23
191007250,9,1,2,9,1,22
191007251,5,0,6,1,0,12
191007252,8,3,0,2,6,19
191007253,6,6,3,6,2,23
191007254,3,8,6,0,6,23
191007255,0,4,5,4,1,14
191007256,3,9,7,8,0,27
191007257,2,3,0,4,0,9
191007258,1,6,8,3,3,21
191007259,6,0,6,1,6,19
191007260,2,2,9,7,6,26
191007261,6,2,8,4,5,25
191007262,7,3,4,2,0,16
191007263,1,9,6,6,1,23
191007264,5,1,9,2,6,23
191007265,8,4,9,8,3,32
191007266,3,6,9,2,2,22
191007267,2,9,4,4,6,25
191007268,2,2,1,1,2,8
191007269,3,3,7,9,7,29
191007270,0,4,3,8,9,24
191007271,5,3,0,9,0,17
191007272,6,0,4,7,7,24
191007273,8,5,6,6,2,27
191007274,5,3,9,8,9,34
191007275,8,0,2,6,8,24
191007276,6,6,0,9,4,25
191007277,9,8,3,0,5,25
191007278,7,2,4,5,8,26
191007279,8,8,4,3,8,31
191007280,1,8,4,3,4,20
191007281,2,7,3,1,4,17
191007282,0,9,8,2,8,27
191007283,7,3,2,5,3,20
191007284,3,8,6,9,7,33
191007285,8,7,1,9,6,31
191007286,5,3,2,4,6,20
191007287,3,4,0,1,0,8
191007288,9,3,7,5,7,31
191007289,3,8,1,9,3,24
191007290,0,7,5,6,5,23
191007291,6,9,1,6,2,24
191007292,9,9,4,1,8,31
191007293,8,1,3,3,5,20
191007294,9,5,0,6,8,28
191007295,1,5,0,6,9,21
191007296,1,8,4,0,1,14
191007297,5,8,8,4,6,31
191007298,2,2,4,4,1,13
191007299,5,0,6,7,5,23
191007300,7,1,9,9,8,34
191007301,1,3,0,1,4,9
191007302,5,0,1,7,3,16
191007303,5,7,4,6,1,23
191007304,5,3,1,0,2,11
191007305,6,7,6,2,8,29
191007306,9,1,0,5,6,21
191007307,2,4,5,6,0,17
191007308,8,7,9,8,5,37
191007309,7,0,3,2,5,17
191007310,5,5,3,7,6,26
191007311,6,8,0,1,6,21
191007312,2,4,7,1,0,14
191007313,0,9,0,7,6,22
191007314,3,3,5,3,4,18
191007315,4,8,1,8,3,24
191007316,5,3,5,4,2,19
191007317,5,7,5,4,5,26
191007318,2,1,2,7,4,16
191007319,2,6,4,9,7,28
191007320,1,8,5,7,2,23
191007321,1,2,7,4,7,21
191007322,1,6,2,1,4,14
191007323,8,3,9,0,6,26
191007324,9,0,5,0,7,21
191007325,3,9,0,5,4,21
191007326,7,2,1,1,3,14
191007327,6,2,0,1,9,18
191007328,6,8,0,1,8,23
191007329,3,3,8,3,2,19
191007330,6,3,8,7,2,26
191007331,1,4,4,6,2,17
191007332,2,8,3,3,5,21
191007333,5,3,0,3,8,19
191007334,3,4,3,7,0,17
191007335,6,5,4,5,1,21
191007336,9,9,7,2,7,34
191007337,6,9,3,8,0,26
191007338,2,7,9,0,5,23
191007339,3,4,5,0,5,17
191007340,9,8,8,3,5,33
191007341,5,4,0,4,5,18
191007342,7,9,7,6,9,38
191007343,1,0,5,6,4,16
191007344,6,0,1,6,1,14
191007345,5,6,2,3,9,25
191007346,7,2,6,4,0,19
191007347,7,8,3,7,7,32
191007348,4,1,6,0,9,20
191007349,9,8,5,1,4,27
191007350,4,2,5,9,2,22
191007351,8,3,3,6,5,25
191007352,4,4,8,6,9,31
191007353,9,7,4,2,7,29
191007354,1,2,5,6,0,14
191007355,2,1,1,5,1,10
191007356,3,8,6,7,0,24
191007357,5,4,3,9,9,30
191007358,2,9,1,6,3,21
191007359,0,6,4,4,4,18
191007360,2,8,7,2,7,26
191007361,3,8,6,0,5,22
191007362,0,4,9,2,0,15
191007363,1,7,7,3,2,20
191007364,7,8,8,1,1,25
191007365,3,6,7,0,8,24
191007366,3,9,3,4,9,28
191007367,1,7,6,2,1,17
191007368,2,2,5,6,1,16
191007369,6,9,8,1,7,31
191007370,8,6,3,3,9,29
191007371,7,6,5,3,6,27
191007372,9,8,9,6,4,36
191007373,5,7,6,7,2,27
191007374,3,5,0,2,1,11
191007375,5,0,4,4,7,20
191007376,9,3,3,3,0,18
191007377,1,1,2,4,5,13
191007378,1,1,8,2,6,18
191007379,6,1,5,0,4,16
191007380,6,1,0,0,8,15
191007381,8,4,6,4,5,27
191007382,5,5,8,4,0,22
191007383,3,0,8,1,7,19
191007384,0,1,5,0,6,12
191007385,6,4,9,1,7,27
191007386,2,5,6,5,0,18
191007387,6,8,6,8,3,31
191007388,2,9,8,5,2,26
191007389,6,7,2,4,5,24
191007390,7,5,4,2,0,18
191007391,7,6,3,9,1,26
191007392,5,2,7,0,9,23
191007393,1,2,2,5,2,12
191007394,8,5,2,1,2,18
191007395,6,7,8,6,4,31
191007396,3,4,2,4,2,15
191007397,2,7,4,6,1,20
191007398,0,2,2,8,4,16
191007399,2,4,6,4,9,25
191007400,9,0,6,4,0,19
191007401,1,9,9,7,6,32
191007402,8,2,7,8,8,33
191007403,2,5,4,2,6,19
191007404,3,7,6,7,8,31
191007405,5,1,7,7,8,28
191007406,6,6,0,7,1,20
191007407,4,7,2,0,9,22
191007408,6,6,4,2,1,19
191007409,6,1,5,0,3,15
191007410,9,3,9,3,5,29
191007411,7,9,7,2,4,29
191007412,2,9,6,0,0,17
191007413,1,3,7,8,6,25
191007414,5,6,9,7,6,33
191007415,6,4,9,3,9,31
191007416,9,4,2,9,0,24
191007417,3,3,5,4,5,20
191007418,9,3,1,0,4,17
191007419,4,9,6,6,8,33
191007420,2,3,1,2,0,8
191007421,5,4,0,8,2,19
191007422,9,8,3,5,5,30
191007423,8,5,7,8,6,34
191007424,6,7,3,1,4,21
191007425,4,7,1,7,4,23
191007426,6,2,6,3,3,20
191007427,3,4,1,8,9,25
191007428,4,8,7,3,7,29
191007429,9,2,6,7,0,24
191007430,1,2,3,6,0,12
191007431,0,2,5,4,4,15
191007432,5,0,0,2,8,15
191007433,3,3,5,8,2,21
191007434,6,0,1,8,3,18
191007435,9,5,4,9,5,32
191007436,5,7,7,7,4,30
191007437,5,0,1,1,5,12
191007438,6,6,6,9,1,28
191007439,4,1,0,7,4,16
191007440,4,0,1,2,0,7
191007441,1,8,9,7,1,26
191007442,8,7,8,2,8,33
191007443,6,4,7,3,4,24
191007444,0,1,6,4,2,13
191007445,4,0,6,6,5,21
191007446,1,3,4,8,2,18
191007447,2,8,1,9,9,29
191007448,0,2,5,8,1,16
191007449,5,8,6,5,4,28
191007450,8,2,9,0,1,20
191007451,4,7,3,9,1,24
191007452,3,7,8,9,7,34
191007453,9,3,2,2,2,18
191007454,8,0,8,8,0,24
191007455,1,6,3,5,4,19
191007456,2,3,8,3,5,21
191007457,9,0,7,8,1,25
191007458,8,2,2,3,4,19
191007459,3,6,9,6,2,26
191007460,3,3,8,5,7,26
191007461,0,8,5,7,9,29
191007462,7,3,5,6,4,25
191007463,2,2,7,3,1,15
191007464,5,1,7,1,3,17
191007465,8,9,7,1,6,31
191007466,5,9,6,9,9,38
191007467,8,1,7,0,0,16
191007468,0,9,5,9,2,25
191007469,5,9,6,1,5,26
191007470,3,6,5,4,3,21
191007471,1,8,0,2,0,11
191007472,3,2,1,9,6,21
191007473,2,0,9,0,7,18
191007474,2,6,1,6,6,21
191007475,4,3,0,8,9,24
191007476,8,6,9,3,6,32
191007477,3,0,5,4,0,12
191007478,0,7,8,0,3,18
191007479,6,6,8,8,2,30
191007480,0,9,0,5,9,23
191007481,6,9,5,7,7,34
191007482,5,4,2,9,7,27
191007483,4,0,8,6,4,22
191007484,4,7,9,6,6,32
191007485,5,1,0,9,1,16
191007486,9,1,6,7,8,31
191007487,3,6,2,1,1,13
191007488,6,5,3,9,0,23
191007489,4,5,8,4,8,29
191007490,1,9,1,1,7,19
191007491,8,4,0,5,9,26
191007492,8,7,4,7,7,33
191007493,7,9,5,3,8,32
191007494,4,2,0,4,8,18
191007495,4,9,0,2,9,24
191007496,8,7,8,6,3,32
191007497,2,2,4,6,1,15
191007498,9,9,3,7,1,29
191007499,4,9,2,5,9,29
191007500,2,1,1,2,9,15
191007501,0,8,1,4,1,14
191007502,3,0,5,4,3,15
191007503,2,2,9,9,5,27
191007504,3,1,7,3,5,19
191007505,4,5,9,0,3,21
191007506,7,6,1,6,7,27
191007507,1,2,0,4,0,7
191007508,9,7,5,2,4,27
191007509,0,3,0,0,6,9
191007510,7,4,6,1,9,27
191007511,3,1,9,1,7,21
191007512,8,8,6,1,7,30
191007513,8,8,8,4,5,33
191007514,5,5,5,1,4,20
191007515,8,5,4,3,9,29
191007516,3,7,1,7,5,23
191007517,7,1,7,1,6,22
191007518,4,3,6,2,1,16
191007519,8,2,3,7,0,20
191007520,1,2,5,7,3,18
191007521,9,2,8,1,5,25
191007522,6,5,1,2,6,20
191007523,6,9,0,4,1,20
191007524,0,6,7,1,8,22
191007525,1,7,1,1,9,19
191007526,1,3,0,1,6,11
191007527,3,9,0,1,1,14
191007528,8,3,1,6,9,27
191007529,4,4,0,7,0,15
191007530,0,6,5,9,9,29
191007531,2,6,3,0,4,15
191007532,4,8,3,5,2,22
191007533,4,1,4,8,8,25
191007534,4,1,8,1,7,21
191007535,2,3,7,5,0,17
191007536,0,1,5,7,2,15
191007537,3,7,8,8,1,27
191007538,3,6,9,0,1,19
191007539,8,1,7,5,8,29
191007540,0,1,8,8,9,26
191007541,1,8,6,9,7,31
191007542,4,2,6,9,3,24
191007543,8,6,5,9,7,35
191007544,3,8,5,5,7,28
191007545,6,5,0,3,2,16
191007546,3,5,7,1,8,24
191007547,4,6,9,8,9,36
191007548,1,0,4,3,2,10
191007549,5,9,5,5,2,26
191007550,4,9,1,6,1,21
191007551,3,2,0,7,3,15
191007552,8,0,7,8,8,31
191007553,6,0,0,5,6,17
191007554,4,4,2,3,0,13
191007555,4,4,1,1,6,16
191007556,5,1,2,8,6,22
191007557,3,3,9,5,5,25
191007558,3,3,9,9,8,32
191007559,4,4,9,5,0,22
191007560,7,9,2,1,6,25
191007561,9,6,2,6,9,32
191007562,9,9,4,2,4,28
191007563,9,9,6,7,1,32
191007564,6,8,1,4,4,23
191007565,5,4,2,3,3,17
191007566,8,8,3,6,7,32
191007567,0,9,7,6,5,27
191007568,9,3,2,7,9,30
191007569,0,3,9,4,3,19
191007570,5,0,2,2,1,10
191007571,3,9,4,0,8,24
191007572,1,9,3,1,3,17
191007573,5,3,9,6,9,32
191007574,4,5,5,1,1,16
191007575,2,3,8,9,2,24
191007576,1,3,9,5,5,23
191007577,2,5,6,9,0,22
191007578,8,7,5,8,0,28
191007579,7,9,8,5,6,35
191007580,2,3,3,5,7,20
191007581,1,7,9,9,1,27
191007582,4,5,5,6,1,21
191007583,9,7,0,0,2,18
191007584,8,7,1,5,5,26
191007585,9,2,6,2,3,22
191007586,6,2,3,1,7,19
191007587,6,8,2,0,9,25
191007588,8,6,7,7,6,34
191007589,1,9,4,5,8,27
191007590,4,0,7,6,9,26
191007591,6,4,6,2,3,21
191007592,0,4,3,1,2,10
191007593,6,0,0,6,6,18
191007594,4,2,9,3,5,23
191007595,2,1,2,2,1,8
191007596,7,0,6,3,8,24
191007597,9,4,8,0,7,28
191007598,7,0,2,0,9,18
191007599,7,8,2,0,6,23
191007600,5,7,2,8,1,23
191007601,3,5,9,8,8,33
191007602,1,9,7,9,2,28
191007603,3,9,4,2,7,25
191007604,6,5,3,8,6,28
191007605,7,9,7,4,6,33
191007606,9,5,1,4,1,20
191007607,4,5,3,2,9,23
191007608,1,6,0,7,9,23
191007609,0,7,0,1,1,9
191007610,8,5,9,2,3,27
191007611,8,4,3,5,6,26
191007612,1,2,8,7,3,21
191007613,7,6,9,0,0,22
191007614,3,2,1,5,0,11
191007615,0,5,7,5,3,20
191007616,6,3,9,4,1,23
191007617,1,2,7,0,3,13
191007618,4,8,8,4,8,32
191007619,4,7,0,6,9,26
191007620,2,3,5,6,5,21
191007621,1,8,6,2,0,17
191007622,1,2,3,0,1,7
191007623,9,6,9,9,2,35
191007624,6,1,5,6,3,21
191007625,7,6,7,9,8,37
191007626,3,0,9,0,9,21
191007627,3,5,4,4,1,17
191007628,5,1,8,9,4,27
191007629,6,8,1,4,1,20
191007630,4,3,6,4,8,25
191007631,5,7,1,9,8,30
191007632,5,9,9,4,5,32
191007633,7,9,9,0,0,25
191007634,8,9,5,0,9,31
191007635,5,7,5,2,6,25
191007636,0,4,9,4,3,20
191007637,6,7,2,4,6,25
191007638,4,0,5,9,5,23
191007639,0,9,4,1,6,20
191007640,7,3,7,2,4,23
191007641,7,5,2,4,4,22
191007642,7,5,3,7,2,24
191007643,9,4,0,9,0,22
191007644,7,2,5,2,9,25
191007645,7,3,1,9,3,23
191007646,6,5,7,9,7,34
191007647,5,7,5,5,0,22
191007648,0,6,4,6,9,25
191007649,4,5,5,0,1,15
191007650,0,5,0,2,3,10
191007651,5,1,9,4,2,21
191007652,8,8,2,5,8,31
191007653,0,8,4,3,0,15
191007654,2,4,6,1,0,13
191007655,6,2,5,4,6,23
191007656,3,4,0,8,9,24
191007657,7,2,6,2,0,17
191007658,6,7,8,8,4,33
191007659,8,1,0,7,2,18
191007660,9,4,3,7,1,24
191007661,8,9,1,1,9,28
191007662,1,2,1,0,1,5
191007663,1,3,9,7,9,29
191007664,7,2,2,1,2,14
191007665,8,4,9,8,2,31
191007666,9,2,2,8,9,30
191007667,4,4,4,4,3,19
191007668,1,6,2,5,2,16
191007669,3,3,9,4,0,19
191007670,4,4,6,2,0,16
191007671,9,4,2,8,3,26
191007672,6,2,4,5,1,18
191007673,2,1,6,4,8,21
191007674,8,9,5,2,5,29
191007675,0,2,6,9,1,18
191007676,5,2,0,7,5,19
191007677,7,3,1,6,8,25
191007678,5,9,1,3,7,25
191007679,3,6,3,5,6,23
191007680,1,9,7,4,2,23
191007681,0,7,8,3,8,26
191007682,9,8,5,8,8,38
191007683,4,4,3,3,4,18
191007684,9,1,0,8,1,19
191007685,3,9,1,4,9,26
191007686,0,2,2,5,0,9
191007687,0,9,8,7,3,27
191007688,1,1,6,9,7,24
191007689,0,5,6,7,3,21
191007690,1,8,2,8,7,26
191007691,4,5,9,1,1,20
191007692,0,8,4,3,6,21
191007693,1,2,7,7,9,26
191007694,7,2,8,1,1,19
191007695,0,3,1,9,6,19
191007696,8,3,8,0,2,21
191007697,6,8,2,2,2,20
191007698,0,5,0,7,4,16
191007699,6,3,3,9,3,24
191007700,0,7,2,7,6,22
191007701,3,0,5,6,5,19
191007702,7,0,4,8,3,22
191007703,0,5,3,1,8,17
191007704,4,7,2,4,1,18
191007705,5,0,4,9,6,24
191007706,6,6,2,9,6,29
191007707,2,1,9,0,9,21
191007708,2,1,2,7,6,18
191007709,8,5,2,2,7,24
191007710,0,0,7,3,2,12
191007711,2,9,0,6,5,22
191007712,6,6,4,4,4,24
191007713,3,2,3,7,7,22
191007714,1,9,8,2,8,28
191007715,0,4,1,2,1,8
191007716,4,0,6,8,0,18
191007717,8,3,3,2,3,19
191007718,1,6,4,0,2,13
191007719,2,1,9,1,2,15
191007720,9,3,4,2,7,25
191007721,9,4,3,8,8,32
191007722,3,1,8,2,2,16
191007723,9,1,7,1,0,18
191007724,0,6,1,8,1,16
191007725,0,6,4,8,2,20
191007726,7,5,5,5,4,26
191007727,8,1,8,7,6,30
191007728,3,2,9,7,5,26
191007729,3,9,2,9,2,25
191007730,7,5,9,7,4,32
191007731,2,9,4,3,6,24
191007732,1,4,0,7,5,17
191007733,8,0,3,9,7,27
191007734,8,7,9,7,6,37
191007735,7,7,1,3,8,26
191007736,0,8,4,2,3,17
191007737,5,1,9,5,5,25
191007738,4,9,8,8,9,38
191007739,2,1,5,2,4,14
191007740,6,9,3,9,9,36
191007741,1,5,3,2,1,12
191007742,7,1,7,4,6,25
191007743,2,0,7,5,8,22
191007744,1,4,1,0,9,15
191007745,6,4,6,1,9,26
191007746,0,4,8,0,7,19
191007747,2,7,7,7,1,24
191007748,6,8,7,5,5,31
191007749,3,1,5,7,5,21
191007750,3,7,3,2,4,19
191007751,8,7,1,4,1,21
191007752,1,9,5,6,6,27
191007753,7,4,9,9,9,38
191007754,5,0,1,0,5,11
191007755,8,1,9,9,6,33
191007756,2,1,8,4,5,20
191007757,0,1,0,4,1,6
191007758,2,1,8,4,1,16
191007759,9,8,1,0,1,19
191007760,7,9,8,0,6,30
191007761,0,2,3,2,9,16
191007762,3,1,0,9,2,15
191007763,0,6,5,2,4,17
191007764,9,7,9,8,8,41
191007765,3,3,2,8,3,19
191007766,7,9,5,5,0,26
191007767,9,6,7,6,4,32
191007768,7,8,4,8,5,32
191007769,6,8,9,3,5,31
191007770,5,7,0,8,1,21
191007771,2,4,2,5,4,17
191007772,0,6,2,7,5,20
191007773,9,9,8,0,5,31
191007774,5,3,1,9,8,26
191007775,3,9,3,8,6,29
191007776,3,3,7,6,8,27
191007777,6,2,8,1,1,18
191007778,1,5,9,8,0,23
191007779,7,2,9,2,4,24
191007780,1,9,0,7,2,19
191007781,4,8,7,7,8,34
191007782,6,3,0,9,4,22
191007783,2,1,1,0,7,11
191007784,8,2,3,0,1,14
191007785,8,5,6,6,3,28
191007786,3,9,4,2,2,20
191007787,0,6,7,9,8,30
191007788,9,5,7,3,6,30
191007789,5,7,1,8,3,24
191007790,6,5,7,0,6,24
191007791,8,3,7,5,6,29
191007792,4,1,7,5,7,24
191007793,1,0,2,8,9,20
191007794,3,7,7,5,4,26
191007795,8,6,0,8,7,29
191007796,3,5,6,9,2,25
191007797,9,7,6,8,3,33
191007798,4,8,0,4,6,22
191007799,9,3,8,4,9,33
191007800,1,4,5,9,3,22
191007801,0,6,8,3,2,19
191007802,2,6,2,6,5,21
191007803,0,7,8,8,1,24
191007804,7,4,3,0,2,16
191007805,5,8,7,2,5,27
191007806,5,5,2,6,4,22
191007807,0,7,2,0,7,16
191007808,6,5,3,5,1,20
191007809,4,2,6,7,7,26
191007810,8,9,6,8,3,34
191007811,1,2,5,9,5,22
191007812,8,2,8,3,8,29
191007813,6,1,8,0,6,21
191007814,5,4,7,9,3,28
191007815,8,5,7,6,2,28
191007816,3,2,1,0,0,6
191007817,8,1,4,2,1,16
191007818,5,7,0,8,7,27
191007819,3,0,7,4,3,17
191007820,1,9,6,1,9,26
191007821,5,8,4,1,7,25
191007822,7,2,9,1,6,25
191007823,8,7,9,1,0,25
191007824,6,2,6,5,0,19
191007825,4,1,7,5,0,17
191007826,8,0,4,6,0,18
191007827,4,9,9,6,6,34
191007828,2,4,6,3,7,22
191007829,5,0,0,4,9,18
191007830,7,7,3,1,0,18
191007831,5,6,9,7,3,30
191007832,8,9,4,4,0,25
191007833,2,0,3,1,0,6
191007834,2,3,0,1,9,15
191007835,7,5,6,5,3,26
191007836,7,1,6,0,9,23
191007837,3,3,1,7,1,15
191007838,6,8,7,3,0,24
191007839,0,0,7,7,4,18
191007840,7,2,1,0,5,15
191007841,6,5,7,6,1,25
191007842,1,3,6,9,7,26
191007843,6,9,8,6,2,31
191007844,2,3,8,2,1,16
191007845,2,0,5,7,0,14
191007846,4,1,0,7,9,21
191007847,1,9,4,2,0,16
191007848,7,8,4,7,1,27
191007849,4,0,8,8,5,25
191007850,6,3,3,0,3,15
191007851,9,5,3,2,5,24
191007852,0,6,0,1,8,15
191007853,2,6,5,9,0,22
191007854,5,2,3,9,6,25
191007855,7,1,4,6,7,25
191007856,3,7,9,7,9,35
191007857,3,3,4,7,8,25
191007858,9,9,6,7,7,38
191007859,2,9,2,9,4,26
191007860,0,4,1,1,9,15
191007861,0,0,9,2,3,14
191007862,8,6,0,0,5,19
191007863,1,9,7,6,9,32
191007864,2,1,5,8,9,25
191007865,6,2,2,3,2,15
191007866,1,7,5,1,1,15
191007867,8,8,0,9,6,31
191007868,6,7,4,1,3,21
191007869,9,8,4,6,9,36
191007870,4,8,3,8,3,26
191007871,2,4,5,1,6,18
191007872,8,5,2,5,1,21
191007873,6,8,1,0,2,17
191007874,7,3,8,5,3,26
191007875,4,8,2,4,0,18
191007876,8,6,7,8,2,31
191007877,0,4,1,8,3,16
191007878,7,1,1,6,0,15
191007879,8,4,4,1,8,25
191007880,7,3,9,4,7,30
191007881,2,4,5,7,2,20
191007882,5,7,9,3,7,31
191007883,6,4,8,9,0,27
191007884,5,3,6,3,7,24
191007885,2,0,0,5,1,8
191007886,3,2,8,3,7,23
191007887,4,0,9,7,8,28
191007888,8,5,6,4,1,24
191007889,4,6,2,6,4,22
191007890,7,4,2,7,4,24
191007891,5,6,8,2,1,22
191007892,6,7,8,6,6,33
191007893,8,5,9,9,7,38
191007894,5,4,3,3,2,17
191007895,8,9,0,3,1,21
191007896,3,8,4,0,8,23
191007897,4,4,1,6,2,17
191007898,0,5,0,4,5,14
191007899,6,9,0,6,1,22
191007900,6,7,2,6,0,21
191007901,7,5,9,4,0,25
191007902,6,1,6,5,1,19
191007903,6,6,4,0,0,16
191007904,9,8,7,3,5,32
191007905,7,6,7,6,8,34
191007906,3,4,7,4,1,19
191007907,1,2,2,0,0,5
191007908,4,8,2,9,3,26
191007909,8,1,1,9,9,28
191007910,3,8,8,2,3,24
191007911,2,8,2,1,6,19
191007912,8,0,8,7,7,30
191007913,2,5,2,5,6,20
191007914,0,4,5,6,5,20
191007915,3,8,4,7,1,23
191007916,4,7,5,5,8,29
191007917,8,8,8,3,7,34
191007918,6,0,6,8,4,24
191007919,2,2,0,0,6,10
191007920,0,4,0,7,3,14
191007921,0,2,1,0,6,9
191007922,1,9,6,8,1,25
191007923,2,1,8,3,1,15
191007924,0,8,7,3,2,20
191007925,3,5,9,7,0,24
191007926,3,7,8,4,9,31
191007927,1,3,1,5,6,16
191007928,7,6,6,8,0,27
191007929,0,1,0,3,3,7
191007930,8,0,3,7,1,19
191007931,2,0,8,2,3,15
191007932,7,6,8,2,7,30
191007933,2,4,2,7,9,24
191007934,0,5,1,5,0,11
191007935,2,7,6,3,8,26
191007936,4,2,5,7,0,18
191007937,5,8,4,9,9,35
191007938,8,6,2,5,1,22
191007939,3,2,7,0,7,19
191007940,8,8,9,4,0,29
191007941,0,6,7,1,3,17
191007942,8,4,4,9,6,31
191007943,7,2,8,3,9,29
191007944,8,2,1,0,9,20
191007945,4,3,4,2,0,13
191007946,2,1,9,8,0,20
191007947,2,3,9,7,7,28
191007948,4,1,3,3,4,15
191007949,2,5,1,4,3,15
191007950,7,6,7,7,4,31
191007951,5,6,5,2,9,27
191007952,3,2,7,7,2,21
191007953,0,1,5,2,0,8
191007954,0,2,8,1,3,14
191007955,4,8,7,1,6,26
191007956,9,3,3,5,9,29
191007957,0,2,5,7,4,18
191007958,9,4,8,1,9,31
191007959,2,3,9,1,4,19
191007960,9,7,9,6,3,34
191007961,0,0,6,5,7,18
191007962,9,4,9,7,3,32
191007963,5,4,9,4,7,29
191007964,6,2,3,5,4,20
191007965,5,1,3,0,8,17
191007966,6,6,1,7,5,25
191007967,5,7,4,3,4,23
191007968,0,9,3,4,4,20
191007969,4,5,1,3,6,19
191007970,4,3,8,9,7,31
191007971,0,9,4,9,6,28
191007972,8,6,9,1,2,26
191007973,3,8,7,4,9,31
191007974,8,3,8,5,7,31
191007975,1,7,0,8,0,16
191007976,7,1,5,7,7,27
191007977,2,5,5,1,1,14
191007978,3,6,9,0,7,25
191007979,4,0,9,8,0,21
191007980,5,2,4,1,2,14
191007981,7,5,9,9,6,36
191007982,5,2,8,8,9,32
191007983,7,3,5,4,2,21
191007984,4,4,0,6,0,14
191007985,9,4,7,3,7,30
191007986,7,8,1,6,4,26
191007987,2,0,4,2,2,10
191007988,8,9,5,6,1,29
191007989,0,2,0,6,7,15
191007990,6,0,7,3,7,23
191007991,1,9,6,5,1,22
191007992,9,9,5,1,9,33
191007993,0,4,9,8,7,28
191007994,3,2,4,7,2,18
191007995,6,1,9,1,6,23
191007996,3,6,8,5,7,29
191007997,9,1,3,4,8,25
191007998,1,1,1,6,5,14
191007999,5,0,8,6,9,28
1910071000,7,4,4,8,3,26
1910071001,7,4,7,6,2,26
1910071002,2,3,0,6,2,13
1910071003,4,5,3,4,1,17
1910071004,6,8,6,8,8,36
1910071005,2,6,8,4,8,28
1910071006,2,5,9,0,4,20
1910071007,5,6,4,4,4,23
1910071008,2,7,2,8,8,27
1910071009,3,9,9,1,3,25
1910071010,1,6,2,2,8,19
1910071011,3,8,1,9,9,30
1910071012,7,8,1,8,5,29
1910071013,3,0,5,0,3,11
1910071014,6,8,9,0,3,26
1910071015,6,0,6,2,5,19
1910071016,7,2,7,1,2,19
1910071017,0,2,3,4,4,13
1910071018,7,8,2,8,3,28
1910071019,5,7,9,8,2,31
1910071020,3,3,7,7,0,20
1910071021,1,7,8,0,9,25
1910071022,9,1,1,8,2,21
1910071023,3,1,7,7,3,21
1910071024,2,9,1,9,4,25
1910071025,1,4,2,6,0,13
1910071026,3,8,6,5,1,23
1910071027,8,7,1,5,2,23
1910071028,9,5,8,9,7,38
1910071029,8,3,2,2,4,19
1910071030,8,9,3,5,0,25
1910071031,7,6,1,4,5,23
1910071032,5,8,5,4,3,25
1910071033,4,3,6,3,5,21
1910071034,9,1,2,4,2,18
1910071035,0,2,7,5,5,19
1910071036,4,6,4,4,4,22
1910071037,1,5,9,3,3,21
1910071038,8,8,5,7,8,36
1910071039,3,0,2,8,5,18
1910071040,8,7,6,6,1,28
1910071041,5,4,3,4,5,21
1910071042,3,7,9,0,3,22
1910071043,6,1,9,0,8,24
1910071044,4,6,5,0,5,20
1910071045,2,2,7,2,2,15
1910071046,3,1,1,9,8,22
1910071047,7,8,9,0,8,32
1910071048,5,8,3,5,3,24
1910071049,6,8,8,6,9,37
1910071050,3,9,9,4,9,34
1910071051,1,0,7,7,2,17
1910071052,4,0,6,7,1,18
1910071053,9,1,6,5,5,26
1910071054,9,2,7,4,9,31
1910071055,1,7,7,2,8,25
1910071056,0,4,3,7,9,23
1910071057,3,0,9,8,0,20
1910071058,5,1,2,3,9,20
1910071059,8,0,8,5,4,25
1910071060,0,2,8,5,4,19
1910071061,4,4,0,3,6,17
1910071062,4,8,2,4,2,20
1910071063,6,0,9,6,8,29
1910071064,2,3,8,2,6,21
1910071065,8,3,5,3,7,26
1910071066,3,8,3,6,7,27
1910071067,0,5,1,6,6,18
1910071068,9,7,1,4,5,26
1910071069,1,2,0,1,9,13
1910071070,0,5,4,4,0,13
1910071071,0,9,1,8,2,20
1910071072,3,1,2,7,4,17
1910071073,5,7,3,8,2,25
1910071074,8,1,8,3,6,26
1910071075,6,1,6,4,5,22
1910071076,7,0,5,1,7,20
1910071077,0,4,0,9,1,14
1910071078,7,9,5,8,0,29
1910071079,9,4,6,3,4,26
1910071080,6,9,4,6,8,33
1910071081,9,5,5,7,9,35
1910071082,1,2,2,6,8,19
1910071083,0,9,1,6,6,22
1910071084,6,6,9,4,1,26
1910071085,8,2,1,4,3,18
1910071086,5,3,0,1,5,14
1910071087,7,2,4,1,9,23
1910071088,7,9,5,9,6,36
1910071089,7,6,7,8,2,30
1910071090,0,0,2,2,8,12
1910071091,5,9,0,1,7,22
1910071092,8,9,7,1,0,25
1910071093,0,0,1,5,0,6
1910071094,2,0,0,9,8,19
1910071095,1,8,6,1,4,20
1910071096,2,5,3,3,2,15
1910071097,6,0,0,0,9,15
1910071098,6,7,8,9,2,32
1910071099,4,7,6,0,5,22
1910071100,3,2,9,7,3,24
1910071101,8,4,4,5,0,21
1910071102,3,7,3,9,3,25
1910071103,2,0,6,7,0,15
1910071104,6,5,7,1,1,20
1910071105,1,7,5,1,8,22
191008001,3,5,1,7,3,19
191008002,1,9,9,0,1,20
191008003,9,8,2,6,8,33
191008004,1,5,8,1,1,16
191008005,4,0,4,1,4,13
191008006,8,9,7,2,0,26
191008007,3,1,7,6,0,17
191008008,2,1,1,3,2,9
191008009,4,8,7,3,4,26
191008010,7,6,6,1,5,25
191008011,5,0,4,3,5,17
191008012,6,1,1,5,0,13
191008013,9,7,9,7,8,40
191008014,3,3,0,3,4,13
191008015,6,5,0,5,4,20
191008016,6,9,7,9,2,33
191008017,0,4,2,1,2,9
191008018,1,3,8,6,7,25
191008019,4,2,5,9,1,21
191008020,9,0,7,7,7,30
191008021,0,5,8,5,5,23
191008022,7,4,1,4,6,22
191008023,9,2,3,1,2,17
191008024,8,9,0,1,8,26
191008025,1,0,1,7,4,13
191008026,7,7,1,4,9,28
191008027,4,5,3,1,8,21
191008028,9,7,4,2,0,22
191008029,2,5,4,0,3,14
191008030,3,3,8,1,3,18
191008031,0,8,6,5,9,28
191008032,4,0,1,5,8,18
191008033,3,5,6,2,1,17
191008034,5,8,8,0,2,23
191008035,1,2,9,7,4,23
191008036,4,8,2,2,8,24
191008037,0,0,4,2,4,10
191008038,9,1,2,8,1,21
191008039,3,6,3,0,8,20
191008040,1,7,4,5,3,20
191008041,5,7,8,0,3,23
191008042,2,3,6,6,1,18
191008043,9,2,5,2,3,21
191008044,1,5,9,7,9,31
191008045,3,3,0,3,9,18
191008046,2,9,8,9,2,30
191008047,7,5,4,9,4,29
191008048,5,7,0,3,6,21
191008049,4,1,8,3,7,23
191008050,9,7,0,3,8,27
191008051,0,7,9,6,0,22
191008052,7,9,3,7,4,30
191008053,9,8,8,5,4,34
191008054,1,2,1,8,0,12
191008055,3,4,8,1,3,19
191008056,1,3,9,9,9,31
191008057,3,1,4,3,3,14
191008058,4,6,7,1,9,27
191008059,8,7,0,9,0,24
191008060,2,0,3,5,4,14
191008061,8,4,1,2,4,19
191008062,0,4,4,5,9,22
191008063,3,8,7,6,3,27
191008064,3,9,4,1,3,20
191008065,7,9,3,8,4,31
191008066,2,1,3,4,4,14
191008067,4,7,8,6,5,30
191008068,9,2,3,6,8,28
191008069,0,1,3,5,1,10
191008070,6,2,0,9,7,24
191008071,0,0,3,3,4,10
191008072,3,0,6,6,5,20
191008073,7,3,7,7,0,24
191008074,5,8,7,6,2,28
191008075,2,4,4,8,2,20
191008076,2,0,9,2,7,20
191008077,8,2,1,3,7,21
191008078,0,4,6,1,4,15
191008079,3,7,8,3,9,30
191008080,1,9,6,4,8,28
191008081,6,6,4,9,5,30
191008082,9,9,1,3,0,22
191008083,9,9,3,5,1,27
191008084,7,3,5,7,1,23
191008085,2,7,9,6,8,32
191008086,9,6,6,6,2,29
191008087,3,3,6,5,0,17
191008088,3,7,4,8,0,22
191008089,7,5,6,0,2,20
191008090,9,0,4,3,3,19
191008091,8,5,6,8,9,36
191008092,4,5,1,4,3,17
191008093,3,7,1,7,8,26
191008094,6,7,1,2,2,18
191008095,3,8,6,4,5,26
191008096,3,7,6,0,6,22
191008097,1,7,6,6,6,26
191008098,7,4,9,3,4,27
191008099,1,1,5,4,5,16
191008100,8,8,6,4,8,34
191008101,7,5,7,0,5,24
191008102,9,2,5,8,3,27
191008103,7,3,6,7,4,27
191008104,3,2,5,2,6,18
191008105,7,3,1,5,5,21
191008106,2,0,2,9,1,14
191008107,4,2,7,7,4,24
191008108,0,6,8,8,5,27
191008109,3,7,3,3,9,25
191008110,8,2,1,0,5,16
191008111,3,1,6,3,4,17
191008112,2,7,9,9,9,36
191008113,3,8,2,6,9,28
191008114,7,1,3,0,3,14
191008115,7,8,5,5,7,32
191008116,6,6,1,3,2,18
191008117,7,5,0,3,1,16
191008118,7,3,4,4,3,21
191008119,3,8,4,2,8,25
191008120,6,6,5,4,1,22
191008121,8,8,9,0,7,32
191008122,9,5,7,2,7,30
191008123,6,8,9,8,5,36
191008124,3,6,3,5,3,20
191008125,4,4,1,9,2,20
191008126,8,7,3,3,9,30
191008127,1,0,5,2,3,11
191008128,0,0,3,2,4,9
191008129,7,4,2,2,7,22
191008130,2,4,1,8,4,19
191008131,5,1,5,8,4,23
191008132,2,6,5,1,7,21
191008133,8,9,3,6,0,26
191008134,3,5,1,9,5,23
191008135,2,9,1,2,3,17
191008136,4,4,9,2,4,23
191008137,2,9,2,4,7,24
191008138,8,0,7,5,5,25
191008139,3,8,0,9,2,22
191008140,2,6,0,0,6,14
191008141,8,6,2,3,9,28
191008142,2,5,0,6,7,20
191008143,0,8,5,5,9,27
191008144,8,9,1,6,1,25
191008145,4,9,6,0,4,23
191008146,1,8,7,8,9,33
191008147,4,8,6,7,4,29
191008148,1,3,0,0,5,9
191008149,5,0,6,8,1,20
191008150,6,8,2,6,4,26
191008151,6,1,7,1,1,16
191008152,9,3,3,8,6,29
191008153,6,8,0,9,9,32
191008154,9,8,7,3,0,27
191008155,0,2,2,4,5,13
191008156,9,8,5,6,5,33
191008157,0,9,2,1,2,14
191008158,6,1,1,7,4,19
191008159,5,5,3,1,3,17
191008160,6,6,8,3,0,23
191008161,7,7,6,2,6,28
191008162,4,0,9,6,3,22
191008163,7,9,6,1,0,23
191008164,0,2,2,8,8,20
191008165,4,7,8,7,6,32
191008166,1,1,7,0,4,13
191008167,4,7,4,0,6,21
191008168,7,5,3,9,9,33
191008169,4,5,3,4,3,19
191008170,5,3,7,3,3,21
191008171,5,0,7,3,9,24
191008172,8,9,7,3,0,27
191008173,5,5,2,1,5,18
191008174,5,8,0,6,6,25
191008175,9,9,7,4,4,33
191008176,2,8,6,9,8,33
191008177,2,8,6,7,3,26
191008178,1,8,5,9,4,27
191008179,4,8,2,1,4,19
191008180,6,6,2,1,8,23
191008181,9,8,6,7,6,36
191008182,7,1,9,1,5,23
191008183,8,5,0,1,8,22
191008184,0,2,4,2,6,14
191008185,2,2,4,5,9,22
191008186,7,7,6,7,5,32
191008187,2,6,2,2,0,12
191008188,2,3,1,9,5,20
191008189,4,5,2,5,6,22
191008190,7,5,8,5,2,27
191008191,2,0,8,6,6,22
191008192,0,4,9,6,4,23
191008193,6,2,1,8,4,21
191008194,5,9,3,2,4,23
191008195,5,5,7,4,6,27
191008196,1,0,3,6,7,17
191008197,7,9,4,0,0,20
191008198,3,8,8,4,4,27
191008199,3,6,3,3,1,16
191008200,8,1,4,5,4,22
191008201,2,1,6,7,3,19
191008202,9,6,1,2,7,25
191008203,6,7,5,6,0,24
191008204,3,6,8,0,7,24
191008205,5,1,4,5,1,16
191008206,9,0,8,6,9,32
191008207,4,9,7,8,1,29
191008208,0,1,8,2,5,16
191008209,6,1,6,2,8,23
191008210,1,6,4,1,2,14
191008211,9,8,9,9,9,44
191008212,6,7,4,0,2,19
191008213,0,8,6,8,3,25
191008214,3,3,8,2,9,25
191008215,8,8,3,2,8,29
191008216,0,3,8,2,6,19
191008217,1,5,7,6,9,28
191008218,4,6,2,5,7,24
191008219,5,7,4,6,4,26
191008220,7,5,1,4,3,20
191008221,9,1,3,2,2,17
191008222,3,7,0,7,9,26
191008223,6,7,5,1,0,19
191008224,3,1,5,6,1,16
191008225,6,8,3,1,1,19
191008226,0,8,0,9,0,17
191008227,1,2,6,0,8,17
191008228,9,4,3,9,2,27
191008229,3,2,4,7,3,19
191008230,0,9,2,8,9,28
191008231,9,7,5,5,6,32
191008232,9,9,6,8,6,38
191008233,2,0,8,7,3,20
191008234,5,2,1,3,1,12
191008235,3,3,5,7,3,21
191008236,7,7,1,8,1,24
191008237,7,3,7,6,2,25
191008238,0,4,7,9,9,29
191008239,9,8,7,2,4,30
191008240,8,5,7,1,5,26
191008241,7,6,2,2,3,20
191008242,5,0,2,1,1,9
191008243,3,2,8,9,9,31
191008244,0,9,7,1,3,20
191008245,3,2,8,5,6,24
191008246,9,0,3,2,0,14
191008247,3,6,6,0,6,21
191008248,2,1,3,5,5,16
191008249,3,2,5,5,1,16
191008250,1,7,9,1,8,26
191008251,8,1,6,8,0,23
191008252,6,0,1,3,7,17
191008253,6,7,6,7,4,30
191008254,6,6,6,3,1,22
191008255,9,0,0,4,3,16
191008256,8,6,0,3,2,19
191008257,8,9,3,3,8,31
191008258,9,8,8,2,3,30
191008259,0,1,7,7,3,18
191008260,0,5,9,8,5,27
191008261,2,8,1,8,4,23
191008262,2,8,2,7,4,23
191008263,3,6,4,7,4,24
191008264,1,9,5,0,7,22
191008265,1,6,4,2,0,13
191008266,4,1,1,2,8,16
191008267,4,2,9,2,4,21
191008268,6,7,4,1,5,23
191008269,6,3,5,1,5,20
191008270,0,9,8,4,9,30
191008271,7,0,2,3,3,15
191008272,8,6,2,7,5,28
191008273,9,0,7,4,6,26
191008274,4,9,2,3,7,25
191008275,1,2,6,8,7,24
191008276,4,6,9,3,8,30
191008277,7,1,4,6,4,22
191008278,5,6,9,3,3,26
191008279,4,9,1,6,8,28
191008280,3,1,3,6,8,21
191008281,7,6,9,5,2,29
191008282,3,4,1,9,6,23
191008283,3,9,8,4,2,26
191008284,9,4,3,8,2,26
191008285,7,3,7,4,9,30
191008286,9,5,6,1,0,21
191008287,0,1,7,2,6,16
191008288,9,6,0,7,8,30
191008289,8,8,8,3,4,31
191008290,1,4,0,0,7,12
191008291,7,5,0,6,2,20
191008292,4,1,8,6,4,23
191008293,5,0,3,1,7,16
191008294,8,5,8,5,9,35
191008295,1,7,7,6,6,27
191008296,5,4,3,0,7,19
191008297,0,0,0,1,3,4
191008298,4,1,5,3,4,17
191008299,7,6,0,4,4,21
191008300,0,0,5,5,2,12
191008301,2,0,3,6,0,11
191008302,8,6,6,7,1,28
191008303,8,9,2,0,5,24
191008304,2,6,8,6,2,24
191008305,3,7,9,5,5,29
191008306,3,7,5,2,1,18
191008307,0,3,3,2,3,11
191008308,6,2,9,5,4,26
191008309,7,9,3,2,5,26
191008310,4,6,1,8,0,19
191008311,3,4,6,3,2,18
191008312,0,2,0,6,1,9
191008313,1,3,4,7,3,18
191008314,2,3,5,0,4,14
191008315,2,2,4,3,1,12
191008316,3,3,6,6,4,22
191008317,9,4,2,2,8,25
191008318,0,5,5,8,9,27
191008319,1,3,0,4,4,12
191008320,3,5,8,0,6,22
191008321,5,4,4,1,1,15
191008322,9,9,2,5,6,31
191008323,2,7,3,2,0,14
191008324,9,5,6,8,8,36
191008325,6,4,4,0,5,19
191008326,2,1,5,3,3,14
191008327,2,2,3,7,8,22
191008328,9,3,2,1,7,22
191008329,2,5,6,3,5,21
191008330,4,2,1,9,9,25
191008331,6,9,1,7,8,31
191008332,0,9,4,7,9,29
191008333,8,3,1,4,0,16
191008334,0,8,4,7,6,25
191008335,9,4,6,8,6,33
191008336,0,1,1,3,5,10
191008337,4,7,0,1,1,13
191008338,2,9,5,8,8,32
191008339,6,0,5,5,5,21
191008340,4,6,1,8,9,28
191008341,2,3,4,8,4,21
191008342,5,4,6,5,0,20
191008343,7,5,5,1,0,18
191008344,4,9,7,5,1,26
191008345,1,3,7,9,7,27
191008346,9,1,4,8,4,26
191008347,0,6,5,9,2,22
191008348,3,7,0,1,1,12
191008349,5,5,3,4,7,24
191008350,1,2,5,8,2,18
191008351,2,0,3,6,2,13
191008352,8,7,2,7,5,29
191008353,5,9,8,8,2,32
191008354,4,2,2,4,6,18
191008355,6,8,4,4,6,28
191008356,7,6,3,5,0,21
191008357,0,6,0,0,5,11
191008358,6,3,5,9,6,29
191008359,8,1,7,5,6,27
191008360,6,1,1,7,5,20
191008361,8,0,3,7,7,25
191008362,7,9,8,8,6,38
191008363,3,5,9,5,1,23
191008364,1,0,9,0,4,14
191008365,1,4,0,9,6,20
191008366,2,6,4,0,6,18
191008367,8,7,5,1,1,22
191008368,0,1,2,0,2,5
191008369,9,2,7,2,6,26
191008370,0,0,0,5,5,10
191008371,8,1,9,6,6,30
191008372,7,8,6,9,6,36
191008373,2,6,9,6,3,26
191008374,0,8,4,2,4,18
191008375,2,0,6,4,6,18
191008376,7,0,2,1,2,12
191008377,5,7,5,1,5,23
191008378,9,6,4,2,3,24
191008379,7,3,5,0,6,21
191008380,2,8,0,6,0,16
191008381,8,2,5,4,2,21
191008382,4,1,8,2,8,23
191008383,1,9,0,8,3,21
191008384,1,5,4,9,6,25
191008385,5,6,8,3,3,25
191008386,5,2,2,1,2,12
191008387,0,6,3,7,5,21
191008388,3,3,9,6,9,30
191008389,7,9,4,3,1,24
191008390,4,2,4,1,1,12
191008391,7,7,7,9,5,35
191008392,3,5,8,6,7,29
191008393,5,8,3,0,3,19
191008394,1,2,8,9,1,21
191008395,7,6,5,3,7,28
191008396,5,7,8,3,9,32
191008397,1,9,5,4,3,22
191008398,7,3,4,4,1,19
191008399,4,9,5,1,6,25
191008400,7,3,5,5,0,20
191008401,2,8,3,9,6,28
191008402,6,5,5,9,0,25
191008403,1,7,7,6,5,26
191008404,4,9,2,4,3,22
191008405,3,1,2,9,6,21
191008406,4,7,4,9,2,26
191008407,1,3,4,0,3,11
191008408,3,2,9,8,8,30
191008409,9,0,4,4,6,23
191008410,8,4,4,7,0,23
191008411,6,9,5,6,1,27
191008412,4,7,1,0,1,13
191008413,3,9,8,9,4,33
191008414,0,7,9,3,5,24
191008415,7,7,2,1,4,21
191008416,4,0,8,5,0,17
191008417,5,3,1,0,3,12
191008418,7,0,9,0,9,25
191008419,8,8,7,1,5,29
191008420,7,3,1,6,1,18
191008421,9,7,3,5,8,32
191008422,1,0,4,5,9,19
191008423,7,7,2,4,8,28
191008424,1,9,2,6,9,27
191008425,7,7,4,0,9,27
191008426,2,5,9,4,2,22
191008427,3,1,0,2,6,12
191008428,3,0,4,7,8,22
191008429,0,3,5,1,7,16
191008430,8,1,2,7,5,23
191008431,3,1,9,7,1,21
191008432,4,1,5,1,5,16
191008433,7,8,5,5,0,25
191008434,9,6,7,8,3,33
191008435,1,8,6,2,2,19
191008436,5,2,5,6,8,26
191008437,8,1,9,7,9,34
191008438,8,7,1,2,1,19
191008439,1,9,5,9,0,24
191008440,6,4,9,0,0,19
191008441,4,6,0,3,4,17
191008442,5,2,0,6,4,17
191008443,5,1,8,9,1,24
191008444,7,9,5,2,0,23
191008445,9,3,5,2,2,21
191008446,5,4,7,8,1,25
191008447,2,1,6,4,6,19
191008448,9,1,0,2,5,17
191008449,9,4,6,6,2,27
191008450,6,3,3,2,0,14
191008451,1,1,2,1,1,6
191008452,7,6,8,3,2,26
191008453,9,8,7,8,2,34
191008454,7,5,8,6,0,26
191008455,9,7,2,7,5,30
191008456,5,6,2,7,9,29
191008457,1,3,3,9,2,18
191008458,2,9,3,5,8,27
191008459,9,2,9,5,6,31
191008460,7,7,6,7,0,27
191008461,3,1,5,2,7,18
191008462,4,3,6,5,7,25
191008463,2,4,8,8,0,22
191008464,2,5,0,5,1,13
191008465,2,7,0,6,7,22
191008466,2,1,3,0,1,7
191008467,8,7,5,6,8,34
191008468,9,3,5,1,7,25
191008469,5,1,5,9,8,28
191008470,0,0,8,9,2,19
191008471,5,6,0,5,8,24
191008472,1,9,3,1,0,14
191008473,5,4,2,7,1,19
191008474,3,1,8,3,0,15
191008475,5,1,9,4,0,19
191008476,3,7,5,6,7,28
191008477,9,7,7,0,7,30
191008478,4,1,2,7,8,22
191008479,6,2,1,8,9,26
191008480,1,1,1,7,6,16
191008481,5,6,9,4,6,30
191008482,0,3,4,1,5,13
191008483,6,7,6,0,6,25
191008484,5,6,0,8,0,19
191008485,0,5,6,5,5,21
191008486,2,6,7,6,0,21
191008487,3,1,7,6,4,21
191008488,5,6,2,5,4,22
191008489,9,0,8,4,0,21
191008490,5,6,2,4,4,21
191008491,3,9,5,9,7,33
191008492,8,6,1,2,4,21
191008493,7,9,0,4,4,24
191008494,4,2,9,6,4,25
191008495,9,4,8,7,3,31
191008496,5,8,6,8,0,27
191008497,2,7,9,5,0,23
191008498,1,4,7,2,7,21
191008499,6,6,7,9,7,35
191008500,7,0,3,3,0,13
191008501,9,1,5,6,9,30
191008502,4,6,2,8,5,25
191008503,9,5,6,5,0,25
191008504,5,8,7,7,8,35
191008505,3,4,4,4,1,16
191008506,7,0,2,6,9,24
191008507,1,6,6,7,1,21
191008508,0,1,2,3,4,10
191008509,5,2,3,6,0,16
191008510,4,5,9,5,6,29
191008511,2,9,4,0,2,17
191008512,0,6,5,2,1,14
191008513,6,5,3,6,2,22
191008514,9,5,1,8,5,28
191008515,4,8,4,3,0,19
191008516,0,0,8,1,1,10
191008517,9,9,9,3,3,33
191008518,4,9,5,1,0,19
191008519,8,3,8,3,8,30
191008520,1,8,9,3,6,27
191008521,3,8,6,5,6,28
191008522,0,6,8,6,9,29
191008523,0,7,1,6,3,17
191008524,2,4,1,1,1,9
191008525,7,0,4,3,7,21
191008526,4,5,8,5,9,31
191008527,0,3,1,2,1,7
191008528,9,9,9,4,2,33
191008529,9,4,4,4,6,27
191008530,5,1,2,1,9,18
191008531,8,4,5,1,7,25
191008532,0,0,4,2,2,8
191008533,0,9,6,6,4,25
191008534,1,5,7,5,8,26
191008535,9,9,9,1,0,28
191008536,2,8,5,1,8,24
191008537,0,2,6,8,1,17
191008538,4,9,0,7,6,26
191008539,6,6,8,6,5,31
191008540,7,3,4,4,4,22
191008541,0,1,7,1,0,9
191008542,4,1,8,5,8,26
191008543,7,9,7,6,1,30
191008544,6,0,3,4,8,21
191008545,3,5,5,2,2,17
191008546,4,9,5,2,2,22
191008547,4,7,8,7,0,26
191008548,7,1,0,3,6,17
191008549,0,6,5,6,5,22
191008550,7,4,7,3,5,26
191008551,0,4,0,8,0,12
191008552,6,1,0,0,1,8
191008553,2,7,8,8,2,27
191008554,5,8,4,7,8,32
191008555,4,7,9,9,7,36
191008556,3,0,2,2,3,10
191008557,7,8,3,9,5,32
191008558,9,2,7,4,3,25
191008559,1,3,5,8,3,20
191008560,1,8,8,0,6,23
191008561,6,5,8,8,5,32
191008562,5,3,4,4,9,25
191008563,0,6,7,9,1,23
191008564,2,5,9,3,9,28
191008565,9,4,1,5,2,21
191008566,1,6,3,1,3,14
191008567,8,1,2,5,4,20
191008568,8,9,9,9,3,38
191008569,0,1,9,7,3,20
191008570,7,1,7,5,7,27
191008571,1,0,6,6,3,16
191008572,2,9,4,1,3,19
191008573,1,4,6,7,2,20
191008574,9,6,9,6,3,33
191008575,6,6,2,3,1,18
191008576,6,5,7,6,4,28
191008577,2,6,2,6,3,19
191008578,6,2,8,4,3,23
191008579,4,5,2,8,5,24
191008580,0,6,5,6,9,26
191008581,0,0,6,1,4,11
191008582,0,8,5,5,1,19
191008583,4,4,6,1,8,23
191008584,8,8,6,9,4,35
191008585,3,6,0,4,6,19
191008586,8,2,7,6,4,27
191008587,7,1,3,4,8,23
191008588,4,5,7,3,0,19
191008589,4,5,3,3,1,16
191008590,9,7,0,1,1,18
191008591,8,2,9,7,9,35
191008592,9,6,7,7,2,31
191008593,1,2,8,5,9,25
191008594,4,2,0,3,1,10
191008595,3,2,0,6,0,11
191008596,1,0,3,6,2,12
191008597,7,8,4,5,8,32
191008598,1,6,2,4,8,21
191008599,7,3,9,6,6,31
191008600,8,0,2,7,0,17
191008601,8,2,7,1,9,27
191008602,7,5,1,4,1,18
191008603,7,4,1,5,8,25
191008604,1,5,5,6,1,18
191008605,0,7,4,1,5,17
191008606,2,1,9,6,3,21
191008607,5,4,5,4,9,27
191008608,5,8,9,5,1,28
191008609,9,2,4,0,3,18
191008610,7,4,4,4,3,22
191008611,5,3,2,8,5,23
191008612,1,3,7,6,7,24
191008613,8,8,3,0,1,20
191008614,1,7,0,2,7,17
191008615,8,7,2,9,3,29
191008616,2,1,4,8,2,17
191008617,2,9,5,6,8,30
191008618,8,9,8,5,2,32
191008619,6,3,1,3,4,17
191008620,6,9,5,0,2,22
191008621,9,2,7,1,1,20
191008622,4,5,9,3,6,27
191008623,0,9,5,7,7,28
191008624,7,6,4,2,7,26
191008625,9,2,0,3,2,16
191008626,3,8,6,7,7,31
191008627,3,5,3,3,1,15
191008628,2,5,1,9,8,25
191008629,9,7,4,1,5,26
191008630,8,8,9,6,9,40
191008631,1,7,8,2,1,19
191008632,1,4,9,5,3,22
191008633,6,6,8,6,9,35
191008634,7,5,7,2,0,21
191008635,5,9,8,2,8,32
191008636,5,0,5,9,0,19
191008637,2,2,9,8,6,27
191008638,4,8,3,1,9,25
191008639,5,4,1,0,3,13
191008640,3,3,5,9,7,27
191008641,2,2,1,4,2,11
191008642,3,4,3,6,3,19
191008643,3,1,8,6,4,22
191008644,4,0,4,3,8,19
191008645,1,7,2,0,6,16
191008646,3,6,0,5,3,17
191008647,4,6,2,0,1,13
191008648,3,2,5,1,7,18
191008649,8,7,8,4,5,32
191008650,7,4,1,2,4,18
191008651,9,8,5,5,2,29
191008652,9,9,5,9,8,40
191008653,0,3,2,4,0,9
191008654,9,4,3,1,2,19
191008655,6,8,2,7,4,27
191008656,9,0,3,2,5,19
191008657,5,2,5,1,9,22
191008658,1,4,1,5,2,13
191008659,7,1,8,4,2,22
191008660,6,7,6,6,2,27
191008661,0,1,8,1,0,10
191008662,1,5,8,3,8,25
191008663,3,7,0,0,4,14
191008664,8,2,7,2,3,22
191008665,9,7,7,9,1,33
191008666,7,3,2,5,0,17
191008667,9,7,1,0,1,18
191008668,1,4,6,7,5,23
191008669,2,3,4,7,0,16
191008670,0,3,6,9,4,22
191008671,8,6,8,5,0,27
191008672,0,8,2,3,6,19
191008673,8,8,8,6,6,36
191008674,7,4,4,3,0,18
191008675,3,3,0,9,7,22
191008676,5,7,6,1,4,23
191008677,6,7,5,7,5,30
191008678,5,0,9,8,1,23
191008679,4,0,2,1,5,12
191008680,6,1,6,3,6,22
191008681,3,5,5,1,1,15
191008682,2,4,2,4,2,14
191008683,8,2,5,3,3,21
191008684,5,2,7,2,5,21
191008685,0,7,8,1,2,18
191008686,1,0,4,3,9,17
191008687,3,2,4,6,2,17
191008688,4,5,6,4,4,23
191008689,7,7,6,3,5,28
191008690,8,8,9,3,4,32
191008691,2,7,2,8,7,26
191008692,3,1,0,7,1,12
191008693,7,5,7,6,1,26
191008694,7,4,5,1,6,23
191008695,2,2,7,0,8,19
191008696,1,4,5,7,0,17
191008697,7,8,4,0,5,24
191008698,8,7,3,2,1,21
191008699,1,8,6,9,8,32
191008700,5,2,7,4,9,27
191008701,1,3,8,9,9,30
191008702,1,9,8,9,4,31
191008703,7,4,4,5,1,21
191008704,8,2,2,8,3,23
191008705,8,8,7,7,2,32
191008706,2,3,9,6,4,24
191008707,7,2,1,3,8,21
191008708,0,9,9,6,9,33
191008709,8,8,4,4,5,29
191008710,5,9,4,8,5,31
191008711,5,7,6,5,5,28
191008712,8,6,7,2,7,30
191008713,2,9,3,3,9,26
191008714,0,7,8,7,8,30
191008715,7,6,6,7,3,29
191008716,2,1,1,4,9,17
191008717,5,4,5,0,5,19
191008718,7,2,9,1,8,27
191008719,4,1,5,1,1,12
191008720,0,7,5,1,8,21
191008721,6,5,5,1,7,24
191008722,9,5,9,9,5,37
191008723,1,3,2,4,8,18
191008724,6,6,3,7,7,29
191008725,2,6,9,9,7,33
191008726,1,0,1,9,5,16
191008727,0,5,7,8,3,23
191008728,7,6,0,8,7,28
191008729,3,8,2,4,7,24
191008730,2,9,6,8,8,33
191008731,8,0,5,7,0,20
191008732,3,0,2,4,8,17
191008733,0,1,0,9,3,13
191008734,7,4,0,4,4,19
191008735,9,8,6,2,6,31
191008736,2,8,0,6,8,24
191008737,2,4,1,5,9,21
191008738,2,9,9,2,3,25
191008739,0,9,0,9,8,26
191008740,4,0,2,8,5,19
191008741,0,3,4,4,5,16
191008742,8,6,7,1,2,24
191008743,4,2,8,6,1,21
191008744,3,7,2,4,1,17
191008745,2,9,1,5,5,22
191008746,3,5,5,5,0,18
191008747,7,6,9,0,5,27
191008748,3,3,5,9,6,26
191008749,9,1,6,0,5,21
191008750,1,8,4,2,2,17
191008751,3,9,9,7,8,36
191008752,5,4,5,8,8,30
191008753,2,3,9,0,7,21
191008754,5,4,1,9,4,23
191008755,7,8,5,9,5,34
191008756,5,1,5,9,9,29
191008757,2,7,9,3,8,29
191008758,2,3,9,1,8,23
191008759,0,4,4,5,8,21
191008760,5,9,7,6,8,35
191008761,4,2,9,5,2,22
191008762,6,5,3,1,3,18
191008763,6,0,9,5,1,21
191008764,7,1,8,1,2,19
191008765,3,3,9,8,9,32
191008766,4,6,6,1,7,24
191008767,8,8,2,8,6,32
191008768,8,5,7,6,1,27
191008769,0,9,2,7,2,20
191008770,3,2,0,0,1,6
191008771,9,9,3,3,4,28
191008772,6,7,5,9,4,31
191008773,1,2,5,1,4,13
191008774,4,0,1,5,5,15
191008775,7,2,4,3,2,18
191008776,7,0,3,1,6,17
191008777,0,1,8,1,7,17
191008778,4,6,7,4,5,26
191008779,0,8,8,9,2,27
191008780,5,9,2,5,6,27
191008781,0,8,1,9,1,19
191008782,1,3,9,8,3,24
191008783,3,1,2,4,1,11
191008784,6,6,0,6,8,26
191008785,0,0,0,2,3,5
191008786,5,7,4,6,7,29
191008787,5,2,2,1,5,15
191008788,4,4,9,5,4,26
191008789,7,2,2,3,2,16
191008790,6,6,4,2,8,26
191008791,2,1,6,1,7,17
191008792,9,1,5,6,1,22
191008793,5,1,0,3,9,18
191008794,4,5,8,4,3,24
191008795,1,6,6,7,2,22
191008796,9,2,4,2,6,23
191008797,4,6,9,5,8,32
191008798,9,8,9,3,9,38
191008799,9,9,3,7,9,37
191008800,7,7,9,3,4,30
191008801,1,1,1,6,2,11
191008802,4,0,8,2,3,17
191008803,0,0,2,9,0,11
191008804,8,9,7,6,5,35
191008805,6,4,0,2,3,15
191008806,4,9,3,6,3,25
191008807,9,2,1,0,5,17
191008808,3,1,2,3,5,14
191008809,7,2,6,4,5,24
191008810,2,5,7,7,1,22
191008811,4,6,8,5,8,31
191008812,1,0,5,8,2,16
191008813,9,4,6,5,5,29
191008814,5,1,0,3,4,13
191008815,1,4,6,5,4,20
191008816,1,1,2,6,7,17
191008817,2,6,0,7,5,20
191008818,5,0,3,0,7,15
191008819,0,1,9,3,3,16
191008820,2,6,4,5,5,22
191008821,3,5,9,3,4,24
191008822,9,5,2,0,3,19
191008823,1,8,1,4,5,19
191008824,0,1,4,6,0,11
191008825,0,2,9,8,1,20
191008826,1,6,4,1,7,19
191008827,3,5,3,4,6,21
191008828,9,1,7,3,0,20
191008829,3,4,9,3,4,23
191008830,6,5,2,8,0,21
191008831,8,7,7,5,1,28
191008832,4,3,6,8,6,27
191008833,6,6,1,8,1,22
191008834,3,5,2,3,3,16
191008835,6,0,9,3,6,24
191008836,6,4,3,7,3,23
191008837,2,1,9,7,3,22
191008838,7,6,9,3,7,32
191008839,5,9,8,5,9,36
191008840,9,1,4,1,9,24
191008841,0,7,1,8,5,21
191008842,7,4,6,3,7,27
191008843,7,6,0,1,0,14
191008844,7,2,5,2,2,18
191008845,9,1,0,8,5,23
191008846,9,9,5,0,7,30
191008847,6,6,8,6,3,29
191008848,9,1,2,2,1,15
191008849,0,8,8,0,5,21
191008850,8,4,3,6,9,30
191008851,3,8,1,2,5,19
191008852,5,5,6,3,2,21
191008853,1,8,9,1,2,21
191008854,8,9,2,5,9,33
191008855,4,4,8,3,3,22
191008856,7,5,7,6,5,30
191008857,2,2,1,0,4,9
191008858,1,6,7,3,6,23
191008859,5,6,0,5,2,18
191008860,2,6,4,4,3,19
191008861,4,3,2,1,3,13
191008862,9,7,7,9,2,34
191008863,0,6,0,5,2,13
191008864,2,0,6,8,6,22
191008865,4,3,8,4,9,28
191008866,7,1,3,7,8,26
191008867,0,3,3,7,9,22
191008868,3,3,9,8,1,24
191008869,8,7,9,4,1,29
191008870,3,9,0,5,2,19
191008871,5,6,4,5,4,24
191008872,1,4,7,2,0,14
191008873,3,3,4,2,0,12
191008874,3,2,0,1,7,13
191008875,2,6,6,5,5,24
191008876,4,2,6,5,8,25
191008877,7,2,6,0,1,16
191008878,4,3,1,4,9,21
191008879,7,9,0,9,6,31
191008880,5,5,8,4,3,25
191008881,8,9,5,7,1,30
191008882,5,2,8,8,7,30
191008883,3,6,8,5,9,31
191008884,1,2,4,6,5,18
191008885,6,8,8,6,3,31
191008886,2,8,2,4,9,25
191008887,6,0,9,6,7,28
191008888,2,6,7,3,7,25
191008889,9,1,4,5,7,26
191008890,3,0,1,1,8,13
191008891,9,1,0,0,7,17
191008892,7,7,6,9,0,29
191008893,5,8,6,2,1,22
191008894,8,0,9,2,8,27
191008895,0,6,3,1,6,16
191008896,4,9,4,0,5,22
191008897,2,3,4,6,8,23
191008898,9,3,8,2,9,31
191008899,9,7,4,7,1,28
191008900,5,8,5,3,7,28
191008901,3,5,6,4,7,25
191008902,5,7,2,5,3,22
191008903,2,7,7,4,8,28
191008904,6,8,1,8,9,32
191008905,6,9,1,0,4,20
191008906,9,9,3,5,6,32
191008907,0,2,5,2,8,17
191008908,2,9,7,9,4,31
191008909,8,7,6,7,3,31
191008910,0,1,8,5,3,17
191008911,4,2,0,1,0,7
191008912,1,6,8,0,1,16
191008913,6,5,9,7,8,35
191008914,3,8,1,3,7,22
191008915,6,5,0,7,2,20
191008916,9,1,2,9,4,25
191008917,6,9,2,6,7,30
191008918,6,4,2,3,9,24
191008919,6,7,2,0,7,22
191008920,8,5,8,2,9,32
191008921,3,1,3,5,3,15
191008922,6,4,6,5,0,21
191008923,4,1,1,7,3,16
191008924,3,2,5,4,3,17
191008925,8,1,3,8,2,22
191008926,2,0,7,7,0,16
191008927,0,8,5,9,4,26
191008928,5,0,1,8,8,22
191008929,2,3,9,6,5,25
191008930,2,5,6,1,9,23
191008931,0,7,3,0,4,14
191008932,9,9,7,2,8,35
191008933,8,6,5,6,1,26
191008934,9,7,3,2,3,24
191008935,5,5,9,4,6,29
191008936,1,3,2,2,9,17
191008937,7,6,1,1,1,16
191008938,4,5,5,1,6,21
191008939,8,8,9,6,7,38
191008940,6,1,2,7,9,25
191008941,3,3,2,2,1,11
191008942,2,2,6,0,4,14
191008943,9,5,2,9,9,34
191008944,4,9,5,7,9,34
191008945,6,1,4,8,7,26
191008946,3,2,9,4,4,22
191008947,9,8,7,6,7,37
191008948,1,0,8,9,8,26
191008949,8,1,9,9,2,29
191008950,7,7,0,7,6,27
191008951,2,3,0,8,5,18
191008952,6,1,0,9,3,19
191008953,0,1,3,8,4,16
191008954,1,1,2,7,8,19
191008955,5,6,1,4,6,22
191008956,4,4,9,2,9,28
191008957,8,4,7,4,7,30
191008958,1,8,4,5,8,26
191008959,4,2,1,4,2,13
191008960,8,7,4,4,7,30
191008961,1,8,3,2,2,16
191008962,7,0,5,7,8,27
191008963,3,3,9,5,7,27
191008964,7,7,1,6,2,23
191008965,3,2,9,8,6,28
191008966,6,8,2,1,1,18
191008967,8,4,0,8,0,20
191008968,6,5,6,6,3,26
191008969,4,3,3,9,2,21
191008970,7,0,3,4,7,21
191008971,7,7,0,6,1,21
191008972,6,8,6,6,7,33
191008973,4,0,2,9,1,16
191008974,9,6,9,7,3,34
191008975,2,0,1,3,6,12
191008976,9,4,2,9,8,32
191008977,1,6,8,5,5,25
191008978,4,6,9,7,8,34
191008979,8,4,9,8,6,35
191008980,4,8,1,3,2,18
191008981,2,4,4,4,7,21
191008982,6,0,1,8,0,15
191008983,9,5,3,0,1,18
191008984,9,6,3,5,2,25
191008985,8,5,3,3,5,24
191008986,4,8,5,8,1,26
191008987,1,1,3,1,1,7
191008988,4,0,5,4,7,20
191008989,0,6,4,8,7,25
191008990,0,6,8,2,2,18
191008991,5,1,7,5,4,22
191008992,4,2,8,5,2,21
191008993,4,5,3,6,4,22
191008994,9,3,0,5,4,21
191008995,0,2,0,8,4,14
191008996,3,9,9,3,5,29
191008997,0,0,1,4,5,10
191008998,5,7,1,5,5,23
191008999,6,5,8,6,6,31
1910081000,1,4,8,4,0,17
1910081001,2,2,3,2,0,9
1910081002,8,1,0,9,9,27
1910081003,1,2,0,3,1,7
1910081004,4,7,3,8,2,24
1910081005,6,4,8,8,4,30
1910081006,3,9,3,7,5,27
1910081007,9,9,7,6,8,39
1910081008,0,4,8,0,4,16
1910081009,3,4,4,1,6,18
1910081010,2,5,2,7,8,24
1910081011,2,0,1,1,7,11
1910081012,7,4,1,6,7,25
1910081013,4,5,4,3,4,20
1910081014,1,1,8,4,8,22
1910081015,9,8,2,3,9,31
1910081016,2,4,2,9,8,25
1910081017,1,2,9,0,7,19
1910081018,0,6,4,7,5,22
1910081019,3,2,0,4,9,18
1910081020,8,7,2,8,0,25
1910081021,6,1,4,6,8,25
1910081022,4,4,2,5,3,18
1910081023,4,2,3,5,7,21
1910081024,6,9,5,2,1,23
1910081025,3,0,9,8,3,23
1910081026,6,5,9,7,5,32
1910081027,7,2,2,9,0,20
1910081028,2,4,1,9,1,17
1910081029,7,2,1,2,6,18
1910081030,9,2,7,1,0,19
1910081031,9,6,8,4,1,28
1910081032,1,5,4,9,0,19
1910081033,1,2,3,9,8,23
1910081034,6,3,2,4,2,17
1910081035,9,8,2,3,2,24
1910081036,3,2,5,6,1,17
1910081037,1,3,7,1,3,15
1910081038,3,1,4,5,9,22
1910081039,5,0,4,2,6,17
1910081040,3,4,9,2,5,23
1910081041,5,4,5,3,8,25
1910081042,1,9,4,7,4,25
1910081043,8,5,1,2,8,24
1910081044,0,9,6,5,4,24
1910081045,6,8,2,8,7,31
1910081046,1,7,2,1,2,13
1910081047,6,1,2,1,8,18
1910081048,9,7,7,6,0,29
1910081049,5,9,2,5,8,29
1910081050,0,9,9,1,2,21
1910081051,6,5,2,8,2,23
1910081052,4,2,3,0,3,12
1910081053,6,6,9,7,8,36
1910081054,6,7,8,3,5,29
1910081055,2,5,4,4,7,22
1910081056,0,4,3,9,4,20
1910081057,6,2,8,3,0,19
1910081058,2,0,1,3,2,8
1910081059,4,8,9,9,6,36
1910081060,7,8,4,1,9,29
1910081061,2,5,1,0,3,11
1910081062,0,8,6,5,7,26
1910081063,0,6,2,2,1,11
1910081064,0,1,0,8,4,13
1910081065,1,5,1,9,7,23
1910081066,0,6,7,3,2,18
1910081067,0,9,5,5,9,28
1910081068,8,2,6,8,0,24
1910081069,9,8,5,3,7,32
1910081070,1,9,7,9,4,30
1910081071,2,4,7,1,8,22
1910081072,7,9,8,3,0,27
1910081073,6,5,5,3,9,28
1910081074,5,4,5,6,1,21
1910081075,4,2,1,3,7,17
1910081076,8,9,7,0,0,24
1910081077,1,5,7,8,2,23
1910081078,6,3,1,2,8,20
1910081079,8,7,4,9,7,35
1910081080,3,7,7,4,5,26
1910081081,9,2,4,8,7,30
1910081082,6,6,6,6,7,31
1910081083,1,4,1,2,7,15
1910081084,6,9,3,1,2,21
1910081085,3,3,7,2,6,21
1910081086,4,1,0,8,3,16
1910081087,0,5,3,9,4,21
1910081088,2,0,3,9,4,18
1910081089,1,2,8,8,5,24
1910081090,8,8,8,5,1,30
1910081091,6,6,1,4,0,17
1910081092,5,6,9,2,4,26
1910081093,4,4,7,2,3,20
1910081094,1,4,0,9,9,23
1910081095,4,9,9,1,1,24
1910081096,2,8,1,8,0,19
1910081097,6,1,1,0,6,14
1910081098,5,7,4,7,3,26
1910081099,2,7,5,4,4,22
1910081100,8,8,8,0,7,31
1910081101,9,0,1,0,8,18
1910081102,2,3,1,4,6,16
1910081103,3,9,0,3,2,17
1910081104,9,6,9,6,5,35
1910081105,0,0,9,3,2,14
191009001,8,2,1,8,1,20
191009002,7,4,5,3,9,28
191009003,6,7,3,3,9,28
191009004,3,4,6,0,3,16
191009005,6,2,7,9,0,24
191009006,1,4,6,1,1,13
191009007,0,2,6,8,0,16
191009008,9,3,6,0,0,18
191009009,1,9,7,7,9,33
191009010,8,4,0,8,7,27
191009011,9,0,9,7,3,28
191009012,5,4,1,1,9,20
191009013,6,2,6,6,3,23
191009014,0,2,1,7,3,13
191009015,3,3,7,4,9,26
191009016,2,7,4,8,6,27
191009017,6,0,9,6,3,24
191009018,6,1,6,7,6,26
191009019,8,3,3,0,1,15
191009020,3,8,6,9,8,34
191009021,1,6,8,9,7,31
191009022,0,1,6,3,9,19
191009023,2,0,2,6,1,11
191009024,9,1,0,9,1,20
191009025,0,0,3,8,8,19
191009026,1,5,5,2,6,19
191009027,2,8,3,1,6,20
191009028,8,6,8,9,3,34
191009029,5,2,7,5,0,19
191009030,1,3,2,8,9,23
191009031,9,9,2,9,8,37
191009032,2,8,7,3,5,25
191009033,8,5,9,7,8,37
191009034,1,6,5,3,1,16
191009035,8,2,9,3,7,29
191009036,0,8,2,4,8,22
191009037,7,5,7,3,2,24
191009038,5,4,3,5,2,19
191009039,7,2,7,9,8,33
191009040,8,8,3,7,2,28
191009041,6,3,2,2,0,13
191009042,0,3,6,3,6,18
191009043,2,0,8,5,0,15
191009044,2,2,4,6,5,19
191009045,3,9,0,8,2,22
191009046,2,2,7,9,8,28
191009047,8,2,3,3,3,19
191009048,7,2,9,8,7,33
191009049,7,0,1,8,0,16
191009050,6,9,5,9,8,37
191009051,8,1,0,9,6,24
191009052,9,1,9,1,9,29
191009053,0,2,4,9,5,20
191009054,5,0,7,9,8,29
191009055,2,0,0,6,3,11
191009056,0,2,8,4,7,21
191009057,3,2,3,7,0,15
191009058,1,8,8,7,6,30
191009059,8,9,8,1,2,28
191009060,4,5,0,3,6,18
191009061,8,6,7,7,1,29
191009062,4,7,2,5,7,25
191009063,4,2,6,9,8,29
191009064,4,2,7,3,7,23
191009065,1,2,9,5,2,19
191009066,2,8,7,4,3,24
191009067,7,2,1,1,5,16
191009068,2,5,2,3,6,18
191009069,6,9,6,9,6,36
191009070,0,9,8,1,9,27
191009071,1,0,2,3,0,6
191009072,9,5,6,7,5,32
191009073,0,4,5,4,7,20
191009074,8,8,4,5,4,29
191009075,7,1,2,7,9,26
191009076,1,0,1,5,6,13
191009077,4,1,1,3,7,16
191009078,6,2,3,8,4,23
191009079,2,4,4,3,4,17
191009080,1,0,9,2,3,15
191009081,8,9,2,4,6,29
191009082,2,9,0,8,7,26
191009083,8,5,8,4,3,28
191009084,9,6,4,7,3,29
191009085,1,2,7,5,9,24
191009086,1,9,4,6,6,26
191009087,1,2,2,4,4,13
191009088,1,9,8,5,9,32
191009089,6,5,5,0,2,18
191009090,7,1,3,7,0,18
191009091,2,3,7,7,2,21
191009092,4,5,2,6,7,24
191009093,1,0,4,7,2,14
191009094,1,6,2,5,1,15
191009095,7,8,2,4,3,24
191009096,5,3,0,3,1,12
191009097,6,6,9,6,2,29
191009098,8,1,3,3,7,22
191009099,3,8,4,1,1,17
191009100,5,6,0,0,7,18
191009101,6,0,7,5,8,26
191009102,5,8,5,4,4,26
191009103,0,5,6,7,0,18
191009104,8,2,9,4,9,32
191009105,2,4,7,4,8,25
191009106,8,7,8,0,7,30
191009107,9,3,0,0,5,17
191009108,2,4,1,3,5,15
191009109,1,2,8,9,0,20
191009110,4,8,1,7,1,21
191009111,0,3,6,2,9,20
191009112,1,7,0,6,3,17
191009113,5,4,5,9,9,32
191009114,5,3,8,2,3,21
191009115,5,0,6,2,9,22
191009116,0,7,0,5,4,16
191009117,0,5,1,7,8,21
191009118,9,1,0,6,4,20
191009119,3,7,4,0,5,19
191009120,5,5,6,7,7,30
191009121,1,0,2,2,2,7
191009122,4,7,6,5,1,23
191009123,5,9,0,4,2,20
191009124,4,1,5,2,2,14
191009125,1,7,3,5,0,16
191009126,2,1,2,3,6,14
191009127,2,5,3,3,9,22
191009128,7,6,8,3,8,32
191009129,6,7,1,2,0,16
191009130,5,8,7,8,4,32
191009131,4,4,1,1,8,18
191009132,3,9,6,3,5,26
191009133,6,1,0,1,7,15
191009134,2,5,4,7,2,20
191009135,9,6,4,8,4,31
191009136,2,0,6,7,5,20
191009137,5,9,2,3,7,26
191009138,7,4,1,6,3,21
191009139,8,4,6,8,3,29
191009140,1,6,2,7,5,21
191009141,1,4,8,0,7,20
191009142,4,7,3,0,7,21
191009143,7,8,3,4,2,24
191009144,9,4,0,8,9,30
191009145,6,3,8,5,4,26
191009146,4,2,2,4,1,13
191009147,6,3,6,6,9,30
191009148,2,0,9,1,6,18
191009149,8,3,2,1,5,19
191009150,5,1,6,6,6,24
191009151,0,8,7,0,7,22
191009152,5,8,8,6,9,36
191009153,4,3,7,8,3,25
191009154,9,9,4,7,9,38
191009155,6,0,4,9,2,21
191009156,1,5,8,8,2,24
191009157,5,1,4,1,0,11
191009158,3,9,0,3,8,23
191009159,9,5,1,1,7,23
191009160,9,2,8,6,8,33
191009161,6,7,5,8,1,27
191009162,4,7,6,3,0,20
191009163,2,7,4,2,1,16
191009164,4,8,5,4,8,29
191009165,1,0,8,0,7,16
191009166,1,6,2,9,7,25
191009167,2,8,1,0,2,13
191009168,0,3,9,1,6,19
191009169,7,8,2,9,7,33
191009170,4,9,6,8,0,27
191009171,2,7,8,6,1,24
191009172,0,9,4,7,5,25
191009173,4,1,7,3,9,24
191009174,3,9,2,7,4,25
191009175,0,1,1,5,2,9
191009176,8,0,4,2,3,17
191009177,6,8,3,5,4,26
191009178,1,1,1,8,0,11
191009179,0,3,6,3,1,13
191009180,9,3,1,0,8,21
191009181,1,5,0,2,5,13
191009182,7,2,4,0,1,14
191009183,8,5,8,2,7,30
191009184,9,2,9,4,7,31
191009185,8,5,4,3,7,27
191009186,0,2,4,4,5,15
191009187,5,3,7,5,2,22
191009188,5,4,9,5,2,25
191009189,0,7,1,3,5,16
191009190,4,7,0,6,4,21
191009191,8,3,9,6,0,26
191009192,1,9,0,7,0,17
191009193,3,5,8,8,8,32
191009194,2,4,6,3,9,24
191009195,9,0,9,9,7,34
191009196,0,4,2,7,6,19
191009197,4,0,0,7,1,12
191009198,8,3,5,0,2,18
191009199,2,2,4,6,7,21
191009200,2,5,7,2,2,18
191009201,3,0,3,6,0,12
191009202,4,5,6,6,5,26
191009203,1,0,5,5,0,11
191009204,1,2,1,2,3,9
191009205,2,1,1,0,3,7
191009206,2,5,0,9,3,19
191009207,9,8,0,3,9,29
191009208,1,6,3,0,2,12
191009209,8,6,8,4,4,30
191009210,0,0,3,2,7,12
191009211,6,5,1,0,6,18
191009212,3,2,2,7,6,20
191009213,4,9,8,3,3,27
191009214,1,0,6,2,0,9
191009215,5,2,8,7,4,26
191009216,8,9,1,2,3,23
191009217,9,0,1,4,3,17
191009218,4,4,3,1,9,21
191009219,5,6,1,0,0,12
191009220,3,7,2,9,6,27
191009221,9,7,1,4,8,29
191009222,0,8,6,4,4,22
191009223,0,4,9,6,8,27
191009224,5,5,3,1,0,14
191009225,4,3,0,7,9,23
191009226,4,8,8,2,2,24
191009227,1,8,2,2,7,20
191009228,2,7,8,8,8,33
191009229,9,5,0,2,8,24
191009230,7,7,9,5,3,31
191009231,0,4,5,0,1,10
191009232,6,7,2,0,9,24
191009233,5,4,0,9,7,25
191009234,5,7,4,8,3,27
191009235,2,7,0,4,7,20
191009236,4,3,6,3,3,19
191009237,5,2,3,0,6,16
191009238,0,3,0,5,9,17
191009239,3,7,9,8,0,27
191009240,7,2,3,2,2,16
191009241,5,6,8,8,2,29
191009242,9,5,8,1,7,30
191009243,3,0,6,6,4,19
191009244,2,1,6,9,8,26
191009245,1,7,8,2,9,27
191009246,9,2,1,7,5,24
191009247,7,6,2,6,6,27
191009248,9,9,0,1,0,19
191009249,2,6,9,1,5,23
191009250,5,9,3,2,2,21
191009251,7,8,5,4,6,30
191009252,5,3,3,5,7,23
191009253,5,3,6,1,2,17
191009254,6,4,4,8,2,24
191009255,0,1,3,2,0,6
191009256,2,7,2,6,3,20
191009257,7,1,3,5,5,21
191009258,1,9,7,0,2,19
191009259,2,4,6,7,1,20
191009260,0,1,6,0,1,8
191009261,3,3,4,3,7,20
191009262,4,2,4,1,6,17
191009263,9,3,0,3,1,16
191009264,7,1,0,5,9,22
191009265,8,8,1,1,2,20
191009266,3,7,7,6,1,24
191009267,0,0,0,9,6,15
191009268,6,7,5,7,7,32
191009269,5,5,4,6,4,24
191009270,0,8,2,3,0,13
191009271,5,5,6,7,6,29
191009272,3,7,8,5,8,31
191009273,1,6,1,3,3,14
191009274,2,6,6,9,3,26
191009275,2,4,8,6,7,27
191009276,2,3,2,0,9,16
191009277,4,8,6,5,5,28
191009278,7,5,4,7,1,24
191009279,6,9,3,5,1,24
191009280,0,1,8,9,0,18
191009281,7,7,8,9,0,31
191009282,4,5,0,4,2,15
191009283,5,8,5,2,6,26
191009284,3,8,2,2,5,20
191009285,0,6,3,4,8,21
191009286,0,7,1,4,1,13
191009287,7,5,8,3,5,28
191009288,2,5,2,9,9,27
191009289,8,0,6,7,4,25
191009290,0,8,4,2,7,21
191009291,4,2,8,3,9,26
191009292,1,2,1,2,6,12
191009293,4,0,0,3,4,11
191009294,3,1,8,4,2,18
191009295,3,3,2,7,3,18
191009296,6,3,8,9,6,32
191009297,7,5,2,5,8,27
191009298,8,2,5,7,5,27
191009299,7,7,8,7,2,31
191009300,3,5,3,0,2,13
191009301,8,2,3,9,2,24
191009302,7,1,8,5,0,21
191009303,5,2,5,5,9,26
191009304,0,6,9,7,6,28
191009305,0,7,5,0,7,19
191009306,8,0,1,1,8,18
191009307,6,3,4,2,9,24
191009308,0,7,9,7,2,25
191009309,9,5,4,3,5,26
191009310,2,1,4,0,1,8
191009311,2,9,8,4,0,23
191009312,4,3,7,4,5,23
191009313,1,7,1,8,7,24
191009314,0,5,8,9,9,31
191009315,2,8,1,5,5,21
191009316,2,0,8,1,6,17
191009317,7,3,0,5,7,22
191009318,4,1,3,5,6,19
191009319,2,0,6,6,5,19
191009320,1,8,1,8,7,25
191009321,2,5,5,9,9,30
191009322,5,2,2,2,5,16
191009323,7,3,2,7,9,28
191009324,9,2,1,4,7,23
191009325,1,0,4,8,6,19
191009326,5,8,0,0,2,15
191009327,8,7,0,3,9,27
191009328,9,5,4,8,7,33
191009329,5,5,7,6,0,23
191009330,1,6,9,1,6,23
191009331,2,9,9,0,3,23
191009332,2,4,5,8,2,21
191009333,6,4,8,1,4,23
191009334,9,5,7,4,1,26
191009335,1,3,5,8,1,18
191009336,0,3,8,1,4,16
191009337,7,1,8,7,3,26
191009338,7,1,7,3,8,26
191009339,7,2,6,3,2,20
191009340,7,0,0,1,7,15
191009341,8,2,9,7,4,30
191009342,3,6,3,4,7,23
191009343,3,9,4,9,5,30
191009344,4,5,1,2,5,17
191009345,2,9,9,0,9,29
191009346,3,1,0,0,1,5
191009347,6,1,4,4,8,23
191009348,3,3,6,1,3,16
191009349,9,0,2,9,9,29
191009350,5,8,5,3,5,26
191009351,2,6,7,0,2,17
191009352,6,3,0,5,6,20
191009353,0,6,7,2,9,24
191009354,8,9,1,5,9,32
191009355,5,1,0,0,4,10
191009356,1,5,6,4,3,19
191009357,2,3,1,1,6,13
191009358,9,4,9,6,7,35
191009359,8,1,4,7,4,24
191009360,5,8,2,2,0,17
191009361,3,2,8,9,6,28
191009362,5,9,9,2,6,31
191009363,9,6,2,3,7,27
191009364,9,2,7,5,8,31
191009365,2,0,5,1,1,9
191009366,9,8,8,9,4,38
191009367,3,0,8,6,8,25
191009368,3,9,7,9,2,30
191009369,8,6,1,0,9,24
191009370,9,0,9,3,7,28
191009371,4,3,7,9,1,24
191009372,4,3,8,8,0,23
191009373,6,8,0,2,0,16
191009374,0,6,2,2,8,18
191009375,3,2,0,2,6,13
191009376,0,1,3,5,4,13
191009377,5,9,5,3,9,31
191009378,5,2,8,4,0,19
191009379,4,2,0,6,5,17
191009380,8,9,9,5,9,40
191009381,1,1,1,5,0,8
191009382,9,8,3,4,8,32
191009383,4,1,1,3,1,10
191009384,6,0,5,2,3,16
191009385,1,4,8,5,6,24
191009386,3,2,9,2,5,21
191009387,9,6,5,9,6,35
191009388,1,1,8,6,4,20
191009389,5,8,0,4,0,17
191009390,2,1,3,2,5,13
191009391,2,2,2,8,8,22
191009392,6,4,1,9,9,29
191009393,1,4,2,3,2,12
191009394,1,8,4,0,0,13
191009395,6,5,8,7,9,35
191009396,8,0,0,3,9,20
191009397,9,9,1,0,5,24
191009398,9,4,5,5,4,27
191009399,5,5,8,4,5,27
191009400,0,1,9,4,9,23
191009401,6,6,3,9,3,27
191009402,8,3,4,2,0,17
191009403,4,9,2,7,3,25
191009404,5,4,4,4,8,25
191009405,6,1,7,4,7,25
191009406,1,8,8,7,3,27
191009407,5,4,0,4,5,18
191009408,3,1,8,1,3,16
191009409,7,9,8,2,6,32
191009410,1,5,7,3,9,25
191009411,7,2,9,3,9,30
191009412,0,7,8,2,2,19
191009413,3,9,3,9,3,27
191009414,4,3,1,4,0,12
191009415,8,2,8,0,0,18
191009416,6,8,4,2,5,25
191009417,3,8,3,9,4,27
191009418,3,3,1,4,4,15
191009419,5,2,9,2,6,24
191009420,9,8,9,6,7,39
191009421,8,1,7,5,2,23
191009422,9,4,5,9,4,31
191009423,2,5,1,3,8,19
191009424,7,4,0,5,0,16
191009425,8,0,0,7,7,22
191009426,9,2,7,2,9,29
191009427,4,6,0,7,4,21
191009428,3,3,5,7,0,18
191009429,6,0,7,1,6,20
191009430,2,8,6,3,1,20
191009431,1,9,0,9,4,23
191009432,2,9,1,3,2,17
191009433,3,8,1,2,3,17
191009434,4,7,3,1,4,19
191009435,3,2,0,5,2,12
191009436,5,9,5,8,9,36
191009437,6,2,0,6,9,23
191009438,2,6,4,3,3,18
191009439,1,6,5,3,8,23
191009440,8,9,1,7,9,34
191009441,1,2,6,8,6,23
191009442,9,0,1,1,7,18
191009443,3,3,4,0,5,15
191009444,5,1,5,2,5,18
191009445,8,5,7,4,2,26
191009446,0,8,4,3,5,20
191009447,7,0,2,6,6,21
191009448,8,6,8,8,9,39
191009449,0,3,3,1,1,8
191009450,4,3,9,4,7,27
191009451,5,7,9,5,6,32
191009452,7,2,0,7,3,19
191009453,6,4,2,0,1,13
191009454,8,6,5,6,4,29
191009455,4,1,5,0,9,19
191009456,4,3,1,3,2,13
191009457,9,8,0,7,1,25
191009458,0,4,8,9,9,30
191009459,7,7,4,0,5,23
191009460,1,0,0,8,2,11
191009461,9,3,3,5,4,24
191009462,8,8,0,8,3,27
191009463,7,7,7,4,6,31
191009464,0,0,9,9,6,24
191009465,4,4,4,9,3,24
191009466,7,2,2,7,7,25
191009467,4,8,0,7,0,19
191009468,3,0,1,1,4,9
191009469,4,1,5,5,0,15
191009470,5,8,4,5,6,28
191009471,8,2,6,8,3,27
191009472,0,1,9,5,8,23
191009473,3,4,9,0,2,18
191009474,4,7,9,1,7,28
191009475,2,5,6,5,0,18
191009476,9,3,7,5,2,26
191009477,6,3,8,2,2,21
191009478,5,1,0,2,9,17
191009479,8,2,9,7,3,29
191009480,8,0,4,5,2,19
191009481,0,5,8,1,8,22
191009482,7,6,9,1,8,31
191009483,3,6,7,4,5,25
191009484,5,4,0,3,7,19
191009485,3,8,1,5,8,25
191009486,9,9,6,8,5,37
191009487,1,8,0,5,8,22
191009488,2,9,2,4,1,18
191009489,4,5,0,6,5,20
191009490,4,3,5,4,1,17
191009491,8,3,1,8,0,20
191009492,1,5,5,0,7,18
191009493,5,0,2,5,8,20
191009494,6,7,7,4,4,28
191009495,1,0,3,6,1,11
191009496,1,9,0,9,6,25
191009497,0,8,0,9,7,24
191009498,3,4,7,1,2,17
191009499,0,0,4,0,0,4
191009500,2,1,5,0,2,10
191009501,2,2,7,6,3,20
191009502,1,0,2,6,3,12
191009503,0,7,6,9,5,27
191009504,7,9,0,6,8,30
191009505,6,3,0,3,9,21
191009506,2,6,4,1,0,13
191009507,9,2,7,4,5,27
191009508,8,3,6,8,1,26
191009509,9,5,4,9,8,35
191009510,3,7,3,2,5,20
191009511,8,3,4,2,8,25
191009512,4,7,5,2,1,19
191009513,8,8,9,7,9,41
191009514,3,8,4,3,3,21
191009515,2,9,6,4,1,22
191009516,4,4,9,6,3,26
191009517,1,2,9,5,9,26
191009518,8,0,0,1,5,14
191009519,8,9,0,1,4,22
191009520,9,0,9,8,9,35
191009521,3,2,3,4,6,18
191009522,8,9,5,3,9,34
191009523,5,8,5,7,1,26
191009524,0,4,2,1,7,14
191009525,8,5,6,3,2,24
191009526,0,8,9,3,6,26
191009527,2,2,6,6,3,19
191009528,7,2,1,7,1,18
191009529,1,5,6,6,9,27
191009530,6,8,4,0,8,26
191009531,4,1,6,8,5,24
191009532,1,9,7,0,0,17
191009533,9,6,2,1,4,22
191009534,8,3,4,8,4,27
191009535,0,9,5,2,4,20
191009536,9,5,7,1,7,29
191009537,9,0,5,9,2,25
191009538,9,2,1,7,3,22
191009539,9,8,8,0,3,28
191009540,7,0,9,2,7,25
191009541,0,4,2,3,2,11
191009542,7,8,6,0,3,24
191009543,6,0,1,0,6,13
191009544,9,5,8,0,1,23
191009545,5,8,3,6,7,29
191009546,8,4,9,9,4,34
191009547,1,7,2,8,4,22
191009548,9,5,7,9,2,32
191009549,8,4,3,1,8,24
191009550,5,8,1,0,3,17
191009551,1,7,6,9,6,29
191009552,2,8,4,4,0,18
191009553,5,9,3,1,5,23
191009554,2,1,1,5,7,16
191009555,0,1,4,2,5,12
191009556,1,5,0,3,7,16
191009557,7,5,8,9,4,33
191009558,4,2,2,4,9,21
191009559,9,7,7,3,1,27
191009560,9,2,3,0,4,18
191009561,6,0,6,2,3,17
191009562,5,8,1,8,7,29
191009563,5,8,7,9,0,29
191009564,6,5,2,6,4,23
191009565,5,3,3,9,8,28
191009566,3,2,0,2,3,10
191009567,3,9,7,5,6,30
191009568,1,5,3,9,1,19
191009569,6,7,7,8,1,29
191009570,0,3,4,3,6,16
191009571,4,6,7,2,7,26
191009572,1,4,1,5,1,12
191009573,3,7,1,2,9,22
191009574,8,6,9,8,9,40
191009575,8,7,6,1,1,23
191009576,2,6,8,6,4,26
191009577,8,1,7,8,2,26
191009578,7,9,5,0,4,25
191009579,2,5,2,3,0,12
191009580,1,7,7,2,7,24
191009581,2,4,6,9,0,21
191009582,0,0,6,4,3,13
191009583,2,1,4,2,2,11
191009584,3,3,4,2,9,21
191009585,8,0,4,3,4,19
191009586,1,4,9,2,4,20
191009587,9,4,3,4,5,25
191009588,0,0,3,1,9,13
191009589,1,8,1,2,4,16
191009590,3,8,3,7,0,21
191009591,1,5,4,5,5,20
191009592,0,8,9,2,9,28
191009593,5,0,3,8,4,20
191009594,2,2,7,7,9,27
191009595,2,8,3,9,0,22
191009596,1,3,3,0,8,15
191009597,4,2,2,5,6,19
191009598,0,4,3,5,3,15
191009599,1,2,8,5,8,24
191009600,2,2,2,8,2,16
191009601,3,4,1,5,9,22
191009602,4,0,1,8,4,17
191009603,5,2,8,8,6,29
191009604,3,0,0,8,7,18
191009605,6,7,4,4,2,23
191009606,0,2,1,7,8,18
191009607,2,7,4,0,7,20
191009608,7,6,7,9,6,35
191009609,8,0,1,1,4,14
191009610,9,8,4,9,0,30
191009611,8,1,8,8,6,31
191009612,0,3,1,6,1,11
191009613,8,7,4,1,7,27
191009614,6,0,8,4,8,26
191009615,2,9,9,8,3,31
191009616,1,8,3,6,9,27
191009617,0,8,2,7,4,21
191009618,2,1,8,1,9,21
191009619,1,5,0,0,6,12
191009620,4,4,0,4,7,19
191009621,3,7,1,3,2,16
191009622,8,2,7,7,8,32
191009623,8,8,5,9,8,38
191009624,7,6,9,4,3,29
191009625,7,1,5,3,8,24
191009626,1,8,8,0,8,25
191009627,3,3,3,4,5,18
191009628,0,9,0,2,1,12
191009629,6,4,6,4,4,24
191009630,3,8,9,5,3,28
191009631,4,1,8,5,6,24
191009632,6,7,6,3,9,31
191009633,8,5,7,0,0,20
191009634,7,3,9,6,9,34
191009635,2,0,0,1,4,7
191009636,3,4,7,9,3,26
191009637,0,8,4,6,3,21
191009638,4,3,3,9,5,24
191009639,4,3,5,6,0,18
191009640,6,6,8,4,2,26
191009641,7,7,8,6,6,34
191009642,5,7,5,9,7,33
191009643,2,0,8,5,1,16
191009644,1,5,6,0,9,21
191009645,3,4,6,6,3,22
191009646,8,1,1,0,5,15
191009647,1,3,0,6,7,17
191009648,6,6,3,4,2,21
191009649,4,1,1,5,8,19
191009650,8,8,1,6,4,27
191009651,4,4,5,6,0,19
191009652,9,9,6,3,5,32
191009653,5,5,9,1,2,22
191009654,8,5,9,8,7,37
191009655,3,8,7,0,1,19
191009656,9,1,7,0,7,24
191009657,5,8,4,2,7,26
191009658,7,2,1,1,8,19
191009659,7,2,0,5,8,22
191009660,5,3,3,8,1,20
191009661,6,8,6,1,9,30
191009662,7,3,5,6,3,24
191009663,4,2,5,9,7,27
191009664,1,7,4,4,2,18
191009665,0,0,1,9,6,16
191009666,2,0,5,7,1,15
191009667,7,2,7,3,4,23
191009668,0,5,7,6,3,21
191009669,0,3,1,5,2,11
191009670,7,1,2,3,6,19
191009671,4,4,8,5,7,28
191009672,5,6,9,1,1,22
191009673,6,3,0,1,4,14
191009674,0,9,6,7,3,25
191009675,5,1,7,2,4,19
191009676,6,8,4,8,9,35
191009677,7,1,1,6,2,17
191009678,8,7,3,7,1,26
191009679,9,7,3,6,8,33
191009680,0,8,5,2,1,16
191009681,0,0,6,1,1,8
191009682,2,6,5,0,4,17
191009683,7,5,8,3,6,29
191009684,3,6,5,8,4,26
191009685,3,4,7,7,5,26
191009686,9,2,9,1,1,22
191009687,1,6,2,4,9,22
191009688,0,3,7,0,4,14
191009689,9,5,7,6,8,35
191009690,0,3,9,6,5,23
191009691,9,8,9,8,0,34
191009692,3,5,6,1,6,21
191009693,8,6,0,2,7,23
191009694,6,0,2,6,1,15
191009695,2,5,0,4,9,20
191009696,9,4,5,6,8,32
191009697,1,6,8,6,5,26
191009698,3,8,1,1,7,20
191009699,4,5,3,1,0,13
191009700,5,0,3,4,3,15
191009701,2,5,0,3,8,18
191009702,5,0,1,9,8,23
191009703,2,4,2,1,5,14
191009704,8,7,7,2,7,31
191009705,7,7,5,9,7,35
191009706,6,2,2,2,3,15
191009707,1,2,1,3,7,14
191009708,4,3,1,0,0,8
191009709,1,3,2,6,9,21
191009710,9,3,6,2,0,20
191009711,3,4,5,1,6,19
191009712,3,9,4,3,8,27
191009713,0,4,2,8,6,20
191009714,8,1,7,6,5,27
191009715,0,1,2,4,9,16
191009716,7,6,2,3,9,27
191009717,0,7,2,8,1,18
191009718,6,2,2,3,9,22
191009719,0,2,1,7,2,12
191009720,6,2,8,6,1,23
191009721,2,1,0,9,5,17
191009722,4,7,0,4,9,24
191009723,5,8,1,6,1,21
191009724,0,3,9,2,3,17
191009725,4,1,9,4,1,19
191009726,1,9,7,4,3,24
191009727,3,6,6,2,3,20
191009728,5,2,5,1,1,14
191009729,6,9,7,9,7,38
191009730,3,9,5,8,4,29
191009731,6,9,4,5,8,32
191009732,2,9,4,1,1,17
191009733,3,3,1,8,3,18
191009734,5,2,0,6,5,18
191009735,5,4,2,5,2,18
191009736,3,3,7,2,3,18
191009737,8,9,7,9,4,37
191009738,9,8,5,9,5,36
191009739,9,9,2,1,5,26
191009740,4,3,3,0,2,12
191009741,2,7,3,3,1,16
191009742,3,5,0,3,2,13
191009743,6,3,7,4,7,27
191009744,6,0,9,2,3,20
191009745,3,9,3,7,1,23
191009746,6,9,5,3,7,30
191009747,4,8,0,0,0,12
191009748,3,9,0,7,0,19
191009749,6,0,8,0,2,16
191009750,6,0,6,6,7,25
191009751,7,0,7,0,0,14
191009752,7,8,4,4,5,28
191009753,9,5,9,2,6,31
191009754,3,8,0,1,4,16
191009755,1,5,2,9,3,20
191009756,6,9,4,5,1,25
191009757,1,4,7,8,2,22
191009758,8,4,8,6,2,28
191009759,0,9,7,3,1,20
191009760,0,9,3,1,5,18
191009761,8,5,2,4,4,23
191009762,3,5,6,2,7,23
191009763,7,5,7,5,6,30
191009764,2,7,4,0,9,22
191009765,7,4,4,6,0,21
191009766,0,3,2,1,2,8
191009767,4,7,0,7,9,27
191009768,8,4,0,4,8,24
191009769,4,3,0,5,7,19
191009770,9,5,6,5,4,29
191009771,1,4,2,7,0,14
191009772,1,9,1,2,6,19
191009773,9,7,3,4,4,27
191009774,0,8,1,6,9,24
191009775,1,4,4,7,5,21
191009776,1,5,6,2,2,16
191009777,6,8,1,5,9,29
191009778,2,1,4,1,7,15
191009779,4,7,6,1,0,18
191009780,7,7,3,5,8,30
191009781,7,9,6,0,4,26
191009782,7,5,9,6,2,29
191009783,7,9,9,1,8,34
191009784,2,3,1,0,2,8
191009785,8,5,7,1,9,30
191009786,5,9,4,5,9,32
191009787,1,9,6,8,7,31
191009788,0,1,7,0,1,9
191009789,5,6,8,5,1,25
191009790,6,7,7,8,2,30
191009791,4,3,1,2,3,13
191009792,2,0,0,9,4,15
191009793,0,6,1,9,8,24
191009794,2,1,3,6,2,14
191009795,8,2,3,4,2,19
191009796,0,7,3,4,9,23
191009797,0,0,5,7,7,19
191009798,3,6,9,7,6,31
191009799,2,0,6,4,4,16
191009800,6,3,5,7,2,23
191009801,9,9,5,5,5,33
191009802,9,2,7,1,4,23
191009803,8,6,8,7,4,33
191009804,6,4,2,6,3,21
191009805,6,7,8,4,1,26
191009806,1,0,3,3,9,16
191009807,1,6,9,9,9,34
191009808,5,5,5,6,7,28
191009809,4,0,5,4,2,15
191009810,4,8,6,8,5,31
191009811,2,5,2,6,5,20
191009812,0,1,9,4,2,16
191009813,4,8,4,1,5,22
191009814,5,3,9,8,1,26
191009815,6,8,5,0,3,22
191009816,4,6,2,5,1,18
191009817,8,7,3,3,6,27
191009818,0,4,4,6,4,18
191009819,1,1,2,3,3,10
191009820,3,1,8,2,0,14
191009821,4,6,0,9,3,22
191009822,2,0,2,4,8,16
191009823,7,8,2,7,3,27
191009824,5,7,2,7,3,24
191009825,5,9,4,0,0,18
191009826,2,9,4,0,4,19
191009827,7,4,8,7,3,29
191009828,4,1,5,3,9,22
191009829,5,7,0,4,7,23
191009830,4,4,8,8,0,24
191009831,6,7,2,4,3,22
191009832,2,8,5,4,2,21
191009833,8,9,8,9,6,40
191009834,4,4,2,2,0,12
191009835,4,7,1,7,4,23
191009836,7,5,1,3,4,20
191009837,2,0,1,5,2,10
191009838,8,3,8,8,2,29
191009839,6,9,1,5,6,27
191009840,4,7,8,0,8,27
191009841,6,7,9,2,5,29
191009842,5,7,4,5,2,23
191009843,0,3,4,3,4,14
191009844,7,1,1,0,0,9
191009845,7,1,5,0,6,19
191009846,4,4,0,2,3,13
191009847,7,8,5,6,8,34
191009848,0,2,0,0,6,8
191009849,5,8,8,0,8,29
191009850,2,7,1,7,6,23
191009851,1,8,4,2,6,21
191009852,2,5,8,4,4,23
191009853,9,9,9,1,2,30
191009854,7,7,1,2,7,24
191009855,9,4,5,4,0,22
191009856,3,6,9,6,4,28
191009857,1,3,6,5,6,21
191009858,0,2,6,2,4,14
191009859,6,4,1,0,1,12
191009860,4,9,5,0,6,24
191009861,2,3,2,9,4,20
191009862,0,0,2,4,2,8
191009863,7,2,7,5,8,29
191009864,0,4,8,3,0,15
191009865,3,2,1,8,2,16
191009866,0,1,3,2,8,14
191009867,7,5,6,5,4,27
191009868,1,4,5,0,9,19
191009869,7,1,5,7,4,24
191009870,4,1,8,7,7,27
191009871,1,3,4,7,1,16
191009872,5,3,1,8,0,17
191009873,6,6,3,3,5,23
191009874,5,6,3,7,3,24
191009875,5,5,7,5,4,26
191009876,6,9,9,2,6,32
191009877,7,3,6,7,8,31
191009878,8,7,5,1,9,30
191009879,9,2,5,2,9,27
191009880,5,3,8,2,1,19
191009881,8,1,3,8,5,25
191009882,9,9,4,2,0,24
191009883,7,7,9,0,7,30
191009884,8,3,1,4,7,23
191009885,4,9,6,9,3,31
191009886,7,7,2,2,8,26
191009887,9,8,1,6,7,31
191009888,6,0,8,7,5,26
191009889,1,5,7,0,8,21
191009890,2,8,4,5,8,27
191009891,0,0,4,1,1,6
191009892,8,1,6,5,4,24
191009893,3,4,9,9,2,27
191009894,7,1,4,2,9,23
191009895,2,1,0,1,5,9
191009896,6,7,2,3,5,23
191009897,6,8,6,3,2,25
191009898,8,3,2,0,3,16
191009899,8,0,9,0,4,21
191009900,6,7,5,3,1,22
191009901,5,9,8,9,0,31
191009902,9,5,7,2,0,23
191009903,8,1,6,5,1,21
191009904,4,9,0,0,1,14
191009905,8,8,6,5,1,28
191009906,7,1,4,0,3,15
191009907,0,6,0,4,7,17
191009908,8,0,0,3,2,13
191009909,6,2,4,9,2,23
191009910,8,1,2,1,6,18
191009911,8,5,9,0,5,27
191009912,2,7,0,8,0,17
191009913,1,9,4,9,2,25
191009914,0,2,5,1,1,9
191009915,4,3,3,6,3,19
191009916,2,6,8,2,8,26
191009917,3,6,2,8,5,24
191009918,7,6,1,5,6,25
191009919,3,9,8,2,3,25
191009920,7,4,8,6,9,34
191009921,9,1,1,6,6,23
191009922,9,1,7,0,5,22
191009923,7,3,2,2,5,19
191009924,5,9,7,4,2,27
191009925,6,9,4,3,3,25
191009926,3,0,6,2,0,11
191009927,4,6,6,2,6,24
191009928,4,9,9,8,7,37
191009929,3,0,9,6,2,20
191009930,2,5,2,9,5,23
191009931,3,0,3,0,2,8
191009932,0,7,6,7,5,25
191009933,4,0,0,6,1,11
191009934,9,8,1,0,9,27
191009935,4,6,0,8,1,19
191009936,7,4,1,3,1,16
191009937,4,2,8,6,7,27
191009938,2,5,8,4,3,22
191009939,0,4,1,1,7,13
191009940,0,9,2,2,1,14
191009941,6,7,1,2,7,23
191009942,8,8,4,6,9,35
191009943,5,4,6,9,2,26
191009944,8,9,3,8,3,31
191009945,5,5,8,9,6,33
191009946,9,3,8,8,1,29
191009947,3,2,5,3,0,13
191009948,1,0,1,5,4,11
191009949,3,3,5,0,0,11
191009950,3,7,8,8,8,34
191009951,0,2,7,0,3,12
191009952,4,8,8,2,4,26
191009953,8,9,5,5,5,32
191009954,5,1,2,9,2,19
191009955,6,9,9,2,7,33
191009956,5,6,7,2,3,23
191009957,5,2,5,9,2,23
191009958,7,7,2,9,1,26
191009959,3,6,5,6,5,25
191009960,6,0,0,6,2,14
191009961,3,6,5,3,7,24
191009962,7,2,9,9,9,36
191009963,6,0,1,2,5,14
191009964,9,3,2,5,1,20
191009965,1,3,8,9,3,24
191009966,6,8,5,6,5,30
191009967,5,4,0,0,9,18
191009968,6,6,5,2,6,25
191009969,4,1,4,0,6,15
191009970,0,3,7,3,5,18
191009971,9,3,3,0,4,19
191009972,9,8,6,5,0,28
191009973,5,3,5,4,5,22
191009974,7,7,9,2,8,33
191009975,2,0,0,3,0,5
191009976,7,1,7,9,7,31
191009977,2,8,6,3,3,22
191009978,9,5,6,8,4,32
191009979,9,1,4,3,0,17
191009980,0,4,6,1,0,11
191009981,5,9,0,5,3,22
191009982,0,9,5,3,3,20
191009983,9,4,4,1,3,21
191009984,0,2,0,2,4,8
191009985,3,5,7,5,6,26
191009986,6,1,7,9,4,27
191009987,2,7,6,8,2,25
191009988,1,6,2,3,5,17
191009989,2,3,1,3,4,13
191009990,9,9,2,3,6,29
191009991,4,9,5,1,7,26
191009992,6,9,6,5,5,31
191009993,7,1,8,6,8,30
191009994,5,7,5,6,8,31
191009995,5,4,5,7,0,21
191009996,1,2,0,8,0,11
191009997,3,0,8,5,5,21
191009998,2,4,2,0,3,11
191009999,4,4,7,0,1,16
1910091000,2,6,4,9,2,23
1910091001,5,2,6,5,9,27
1910091002,2,4,9,6,2,23
1910091003,3,5,4,6,3,21
1910091004,0,1,8,1,3,13
1910091005,4,4,5,7,8,28
1910091006,4,5,8,9,1,27
1910091007,4,0,9,4,7,24
1910091008,0,1,5,8,8,22
1910091009,3,1,5,5,3,17
1910091010,8,5,9,5,1,28
1910091011,7,5,6,2,2,22
1910091012,7,2,2,3,3,17
1910091013,6,5,9,3,8,31
1910091014,5,9,4,6,1,25
1910091015,8,2,1,1,7,19
1910091016,0,4,2,4,1,11
1910091017,8,2,2,6,0,18
1910091018,0,1,3,3,8,15
1910091019,5,6,0,2,0,13
1910091020,7,3,7,4,7,28
1910091021,0,3,1,8,0,12
1910091022,0,8,1,7,5,21
1910091023,9,2,7,3,4,25
1910091024,2,7,3,3,2,17
1910091025,7,8,9,4,5,33
1910091026,5,8,0,3,4,20
1910091027,2,7,7,8,0,24
1910091028,0,3,8,9,1,21
1910091029,4,8,0,8,3,23
1910091030,2,4,2,8,0,16
1910091031,6,6,8,1,8,29
1910091032,0,0,4,9,2,15
1910091033,6,3,4,2,6,21
1910091034,8,8,4,4,4,28
1910091035,7,1,3,0,8,19
1910091036,5,5,7,1,0,18
1910091037,3,6,0,8,6,23
1910091038,3,9,7,0,1,20
1910091039,2,3,1,7,1,14
1910091040,4,4,3,9,2,22
1910091041,4,6,7,7,8,32
1910091042,3,4,0,1,2,10
1910091043,0,9,5,0,9,23
1910091044,8,1,3,2,8,22
1910091045,9,4,8,8,4,33
1910091046,9,2,8,4,5,28
1910091047,2,5,6,6,1,20
1910091048,0,6,7,7,9,29
1910091049,9,0,9,0,5,23
1910091050,9,1,5,9,4,28
1910091051,7,3,2,1,5,18
1910091052,8,2,0,8,5,23
1910091053,1,6,4,7,0,18
1910091054,9,2,1,6,8,26
1910091055,6,0,3,8,4,21
1910091056,9,2,5,3,7,26
1910091057,2,6,5,2,0,15
1910091058,9,7,8,9,3,36
1910091059,1,6,9,6,1,23
1910091060,1,2,1,3,6,13
1910091061,0,6,9,6,2,23
1910091062,9,1,7,6,3,26
1910091063,8,1,6,1,2,18
1910091064,4,4,4,7,5,24
1910091065,9,8,7,5,3,32
1910091066,7,3,9,3,5,27
1910091067,9,8,3,3,4,27
1910091068,9,5,0,5,8,27
1910091069,7,4,8,2,8,29
1910091070,0,9,4,6,6,25
1910091071,7,7,5,9,3,31
1910091072,5,8,5,0,5,23
1910091073,7,0,4,2,8,21
1910091074,4,6,7,6,2,25
1910091075,8,0,3,6,2,19
1910091076,7,9,3,2,7,28
1910091077,7,7,9,3,0,26
1910091078,7,0,0,2,6,15
1910091079,3,5,3,1,7,19
1910091080,8,5,1,5,2,21
1910091081,0,1,9,1,8,19
1910091082,2,6,3,2,8,21
1910091083,7,2,4,4,2,19
1910091084,2,6,4,2,0,14
1910091085,1,9,6,3,2,21
1910091086,3,4,9,0,4,20
1910091087,2,6,0,4,0,12
1910091088,9,4,7,6,1,27
1910091089,7,3,3,1,3,17
1910091090,5,7,6,9,4,31
1910091091,8,4,1,1,4,18
1910091092,1,9,4,9,0,23
1910091093,4,7,0,5,3,19
1910091094,0,8,6,2,4,20
1910091095,9,0,1,8,8,26
1910091096,9,7,3,4,6,29
1910091097,6,1,2,2,6,17
1910091098,2,2,7,9,1,21
1910091099,5,8,9,5,6,33
1910091100,1,0,3,0,9,13
1910091101,9,1,9,4,1,24
1910091102,6,0,5,6,5,22
1910091103,1,7,5,0,1,14
1910091104,0,4,1,8,8,21
1910091105,6,5,4,9,3,27
191010001,2,4,2,4,0,12
191010002,0,8,7,3,4,22
191010003,8,5,2,5,0,20
191010004,6,3,1,5,4,19
191010005,1,6,0,7,4,18
191010006,1,4,0,0,4,9
191010007,6,1,2,2,9,20
191010008,3,4,1,5,2,15
191010009,8,8,2,6,8,32
191010010,7,5,7,4,1,24
191010011,7,0,7,8,2,24
191010012,1,3,5,4,7,20
191010013,2,4,0,5,1,12
191010014,4,6,2,3,8,23
191010015,0,8,2,2,8,20
191010016,9,5,9,3,9,35
191010017,9,9,0,8,4,30
191010018,4,4,0,3,7,18
191010019,2,3,2,3,1,11
191010020,6,4,2,4,8,24
191010021,1,3,9,0,8,21
191010022,1,8,5,3,4,21
191010023,3,0,5,0,1,9
191010024,5,2,8,1,7,23
191010025,3,6,3,1,7,20
191010026,4,6,8,8,1,27
191010027,1,0,6,2,3,12
191010028,2,9,5,0,5,21
191010029,4,0,1,6,7,18
191010030,0,6,6,3,2,17
191010031,2,1,4,5,8,20
191010032,9,8,6,8,6,37
191010033,2,6,9,0,1,18
191010034,1,1,8,2,1,13
191010035,9,8,2,1,9,29
191010036,2,3,6,5,0,16
191010037,3,9,7,9,5,33
191010038,3,0,3,4,6,16
191010039,4,2,3,0,7,16
191010040,6,2,7,1,5,21
191010041,8,2,6,3,0,19
191010042,5,5,1,2,7,20
191010043,6,8,4,4,4,26
191010044,0,3,7,1,0,11
191010045,0,7,4,3,1,15
191010046,5,7,1,8,6,27
191010047,7,4,3,4,4,22
191010048,6,5,7,8,8,34
191010049,8,1,2,6,8,25
191010050,4,0,2,1,3,10
191010051,6,0,7,4,3,20
191010052,9,8,3,7,3,30
191010053,2,7,1,9,7,26
191010054,9,4,7,7,3,30
191010055,3,2,5,2,0,12
191010056,7,5,0,3,2,17
191010057,9,5,5,6,3,28
191010058,7,8,2,1,0,18
191010059,5,7,8,0,8,28
191010060,6,7,2,1,9,25
191010061,0,3,0,6,7,16
191010062,7,5,3,3,8,26
191010063,0,0,3,7,6,16
191010064,2,4,5,3,4,18
191010065,1,2,2,9,7,21
191010066,5,5,0,5,5,20
191010067,8,0,5,7,4,24
191010068,7,8,4,3,4,26
191010069,2,1,5,3,9,20
191010070,7,4,2,1,7,21
191010071,6,9,6,5,0,26
191010072,1,0,5,1,4,11
191010073,9,1,9,8,3,30
191010074,8,1,8,0,3,20
191010075,8,8,5,7,0,28
191010076,9,6,2,0,4,21
191010077,6,7,2,8,8,31
191010078,1,5,1,5,9,21
191010079,9,5,0,3,1,18
191010080,2,0,8,2,6,18
191010081,9,9,8,2,5,33
191010082,5,4,5,9,0,23
191010083,5,8,1,6,0,20
191010084,0,5,1,4,6,16
191010085,3,4,6,6,0,19
191010086,4,9,7,9,4,33
191010087,0,6,9,3,8,26
191010088,8,4,2,4,0,18
191010089,0,1,2,7,2,12
191010090,0,2,2,8,5,17
191010091,3,5,8,8,4,28
191010092,9,3,0,7,7,26
191010093,8,9,9,6,5,37
191010094,9,6,9,3,3,30
191010095,9,2,1,6,5,23
191010096,8,9,7,1,4,29
191010097,5,3,4,4,0,16
191010098,0,6,5,1,8,20
191010099,9,6,6,1,5,27
191010100,1,5,2,0,7,15
191010101,8,0,8,5,2,23
191010102,1,9,7,4,9,30
191010103,8,3,1,4,8,24
191010104,2,7,1,9,1,20
191010105,4,1,2,8,6,21
191010106,7,3,2,1,8,21
191010107,2,2,7,5,3,19
191010108,0,0,8,2,2,12
191010109,2,8,6,1,6,23
191010110,1,5,2,9,2,19
191010111,2,5,0,8,9,24
191010112,3,8,0,8,8,27
191010113,2,7,6,0,5,20
191010114,4,7,7,3,5,26
191010115,2,5,8,6,7,28
191010116,0,7,9,2,8,26
191010117,1,7,8,3,3,22
191010118,9,5,4,4,2,24
191010119,5,3,6,3,3,20
191010120,7,9,3,8,7,34
191010121,9,2,1,2,5,19
191010122,1,5,9,6,4,25
191010123,6,6,0,3,8,23
191010124,6,0,6,3,5,20
191010125,8,3,7,0,1,19
191010126,8,4,7,0,2,21
191010127,5,7,7,3,9,31
191010128,6,2,8,2,9,27
191010129,7,9,6,9,2,33
191010130,6,9,3,3,1,22
191010131,8,9,0,5,2,24
191010132,8,0,5,8,9,30
191010133,9,0,3,3,5,20
191010134,6,1,4,7,9,27
191010135,5,2,9,7,7,30
191010136,3,5,2,8,8,26
191010137,1,8,3,2,6,20
191010138,6,5,7,7,4,29
191010139,5,3,5,4,2,19
191010140,3,2,6,5,0,16
191010141,5,8,3,7,4,27
191010142,7,5,8,9,2,31
191010143,2,2,5,9,9,27
191010144,0,1,3,5,6,15
191010145,0,8,5,2,3,18
191010146,5,1,9,9,3,27
191010147,4,0,0,3,0,7
191010148,5,8,9,1,3,26
191010149,8,8,0,0,2,18
191010150,5,3,8,2,4,22
191010151,8,0,1,4,8,21
191010152,4,5,3,0,8,20
191010153,4,2,4,5,7,22
191010154,7,9,7,7,3,33
191010155,4,4,6,8,2,24
191010156,8,0,0,8,7,23
191010157,4,6,1,7,1,19
191010158,6,3,8,0,8,25
191010159,0,5,5,4,9,23
191010160,2,7,7,4,7,27
191010161,6,6,3,9,9,33
191010162,3,3,1,4,6,17
191010163,5,1,4,2,4,16
191010164,4,0,2,7,9,22
191010165,4,8,2,5,9,28
191010166,1,1,5,5,6,18
191010167,6,8,0,0,7,21
191010168,3,5,3,3,6,20
191010169,1,0,2,3,4,10
191010170,3,8,3,1,4,19
191010171,7,3,4,0,3,17
191010172,1,8,2,0,9,20
191010173,2,3,0,9,5,19
191010174,2,6,4,8,2,22
191010175,4,2,5,8,0,19
191010176,6,0,7,2,6,21
191010177,7,8,8,4,8,35
191010178,6,0,2,5,6,19
191010179,5,2,6,6,1,20
191010180,3,3,5,2,9,22
191010181,4,4,6,2,9,25
191010182,5,7,8,4,0,24
191010183,3,8,8,4,9,32
191010184,6,7,9,9,0,31
191010185,9,6,5,0,8,28
191010186,3,4,8,5,9,29
191010187,7,0,4,6,7,24
191010188,3,5,3,1,3,15
191010189,2,1,4,9,3,19
191010190,1,7,2,4,7,21
191010191,5,4,7,1,8,25
191010192,7,3,5,6,6,27
191010193,3,6,4,8,8,29
191010194,3,4,6,1,5,19
191010195,0,6,4,4,1,15
191010196,9,4,8,0,3,24
191010197,9,9,8,6,0,32
191010198,3,1,1,4,8,17
191010199,6,8,1,4,5,24
191010200,9,6,4,7,7,33
191010201,8,7,3,5,5,28
191010202,9,6,7,9,7,38
191010203,5,3,6,8,5,27
191010204,4,3,3,8,4,22
191010205,9,8,3,8,4,32
191010206,0,4,7,6,7,24
191010207,5,4,4,0,8,21
191010208,2,2,9,4,9,26
191010209,3,2,8,7,9,29
191010210,0,2,8,8,5,23
191010211,4,0,1,4,0,9
191010212,1,5,9,1,1,17
191010213,5,3,3,1,1,13
191010214,1,1,0,6,9,17
191010215,2,8,3,2,6,21
191010216,2,4,3,7,2,18
191010217,8,6,0,7,9,30
191010218,5,5,7,1,9,27
191010219,8,8,6,8,2,32
191010220,7,7,7,1,4,26
191010221,4,0,5,1,2,12
191010222,8,6,4,4,3,25
191010223,5,5,7,1,1,19
191010224,4,8,9,3,5,29
191010225,7,3,1,7,4,22
191010226,1,9,2,6,4,22
191010227,9,2,6,9,6,32
191010228,2,8,3,0,0,13
191010229,2,9,4,4,5,24
191010230,2,4,6,2,1,15
191010231,8,9,5,9,8,39
191010232,2,1,6,1,9,19
191010233,1,8,8,1,2,20
191010234,2,2,6,3,9,22
191010235,6,2,2,6,8,24
191010236,5,5,5,2,0,17
191010237,5,0,0,6,4,15
191010238,9,3,7,4,1,24
191010239,1,1,0,6,1,9
191010240,5,5,2,0,9,21
191010241,6,4,2,9,2,23
191010242,0,0,2,5,9,16
191010243,2,1,5,3,4,15
191010244,9,6,7,4,7,33
191010245,9,5,4,7,6,31
191010246,5,4,4,4,5,22
191010247,7,8,4,0,1,20
191010248,1,7,8,2,7,25
191010249,1,1,7,8,2,19
191010250,9,3,9,7,0,28
191010251,7,2,8,5,4,26
191010252,9,1,4,2,2,18
191010253,8,0,6,0,0,14
191010254,9,0,2,6,4,21
191010255,1,3,9,0,6,19
191010256,1,2,1,2,1,7
191010257,8,5,6,5,1,25
191010258,2,4,3,1,3,13
191010259,8,4,2,9,0,23
191010260,3,4,8,1,8,24
191010261,7,9,1,2,4,23
191010262,6,6,7,2,5,26
191010263,7,8,7,1,5,28
191010264,8,9,8,7,5,37
191010265,7,6,1,0,5,19
191010266,9,7,6,9,3,34
191010267,5,6,1,7,7,26
191010268,2,3,0,8,2,15
191010269,1,2,2,3,8,16
191010270,5,3,4,3,7,22
191010271,5,0,6,4,3,18
191010272,4,4,5,7,5,25
191010273,8,1,1,9,6,25
191010274,1,5,9,9,9,33
191010275,4,7,0,8,6,25
191010276,4,6,3,3,1,17
191010277,7,4,2,2,9,24
191010278,9,4,4,8,0,25
191010279,3,2,4,1,5,15
191010280,1,1,8,0,3,13
191010281,9,8,7,3,2,29
191010282,8,3,2,8,5,26
191010283,9,0,1,5,0,15
191010284,8,6,2,8,5,29
191010285,6,6,6,7,6,31
191010286,7,5,0,9,1,22
191010287,2,2,2,8,3,17
191010288,1,8,8,3,2,22
191010289,3,8,7,5,6,29
191010290,1,2,4,7,2,16
191010291,3,6,7,0,0,16
191010292,6,7,6,3,7,29
191010293,5,1,0,8,0,14
191010294,9,8,9,3,4,33
191010295,0,7,0,4,2,13
191010296,1,3,2,3,9,18
191010297,1,0,9,1,7,18
191010298,3,6,6,5,0,20
191010299,6,6,1,1,0,14
191010300,6,6,5,6,7,30
191010301,7,2,4,9,7,29
191010302,5,0,6,5,1,17
191010303,8,9,0,5,8,30
191010304,7,7,0,1,5,20
191010305,0,6,4,0,8,18
191010306,2,3,2,0,6,13
191010307,0,8,4,1,7,20
191010308,0,9,1,3,7,20
191010309,6,1,1,7,0,15
191010310,0,2,0,7,4,13
191010311,2,5,6,0,1,14
191010312,1,0,1,8,1,11
191010313,1,0,0,8,7,16
191010314,8,0,6,8,5,27
191010315,5,6,3,7,0,21
191010316,1,0,3,0,2,6
191010317,2,9,7,1,4,23
191010318,3,1,1,2,0,7
191010319,2,8,5,1,6,22
191010320,7,1,5,6,0,19
191010321,9,6,3,0,3,21
191010322,0,3,5,8,6,22
191010323,0,3,8,5,7,23
191010324,4,9,2,8,5,28
191010325,9,7,2,4,9,31
191010326,3,0,9,7,5,24
191010327,5,3,1,9,0,18
191010328,9,5,8,9,5,36
191010329,6,9,7,7,6,35
191010330,2,1,8,1,5,17
191010331,8,9,3,8,4,32
191010332,0,2,8,2,1,13
191010333,6,0,0,5,4,15
191010334,0,3,4,8,4,19
191010335,1,2,0,3,6,12
191010336,8,3,8,1,7,27
191010337,9,4,6,8,9,36
191010338,2,8,0,9,3,22
191010339,6,9,2,2,5,24
191010340,9,5,3,1,2,20
191010341,7,4,2,5,2,20
191010342,7,8,0,0,4,19
191010343,0,6,3,6,8,23
191010344,4,9,8,2,0,23
191010345,6,6,5,7,4,28
191010346,8,1,5,7,0,21
191010347,4,5,0,0,0,9
191010348,5,9,6,6,5,31
191010349,9,1,8,7,4,29
191010350,1,4,4,9,2,20
191010351,9,3,6,3,2,23
191010352,2,1,4,2,7,16
191010353,0,4,0,5,3,12
191010354,6,7,6,4,3,26
191010355,4,3,9,3,9,28
191010356,6,7,0,6,2,21
191010357,2,0,2,3,3,10
191010358,1,7,2,4,1,15
191010359,2,0,7,7,8,24
191010360,7,7,1,2,0,17
191010361,4,2,6,3,8,23
191010362,4,8,3,0,0,15
191010363,1,9,0,7,7,24
191010364,0,3,1,1,7,12
191010365,2,8,2,7,6,25
191010366,0,7,0,3,3,13
191010367,1,9,8,5,3,26
191010368,0,0,3,8,5,16
191010369,7,0,2,8,9,26
191010370,9,8,6,6,3,32
191010371,2,2,4,6,1,15
191010372,8,5,4,0,7,24
191010373,8,3,1,0,2,14
191010374,6,9,0,5,4,24
191010375,7,1,4,3,3,18
191010376,8,5,6,2,9,30
191010377,5,5,4,6,3,23
191010378,4,6,5,8,7,30
191010379,5,3,6,8,2,24
191010380,8,3,5,7,5,28
191010381,6,8,0,3,6,23
191010382,9,3,6,7,2,27
191010383,2,4,0,6,0,12
191010384,4,1,1,0,1,7
191010385,8,4,5,6,3,26
191010386,1,1,8,9,6,25
191010387,7,0,2,5,0,14
191010388,9,1,4,9,0,23
191010389,7,7,6,1,9,30
191010390,5,3,2,8,1,19
191010391,6,2,2,5,3,18
191010392,2,9,9,0,4,24
191010393,3,8,7,2,7,27
191010394,9,3,8,6,7,33
191010395,8,2,7,8,7,32
191010396,0,7,3,3,9,22
191010397,0,9,4,4,9,26
191010398,4,6,3,3,7,23
191010399,5,6,1,3,4,19
191010400,9,1,5,0,1,16
191010401,8,9,9,1,4,31
191010402,8,7,2,1,0,18
191010403,9,8,6,3,2,28
191010404,4,2,0,8,1,15
191010405,2,4,1,3,2,12
191010406,4,2,8,8,0,22
191010407,8,0,2,6,0,16
191010408,0,2,5,3,2,12
191010409,8,4,1,8,7,28
191010410,8,2,8,2,0,20
191010411,3,1,8,8,2,22
191010412,4,8,2,2,7,23
191010413,3,9,2,3,6,23
191010414,9,3,5,4,4,25
191010415,6,1,7,0,2,16
191010416,5,4,6,3,5,23
191010417,0,2,2,0,6,10
191010418,2,6,2,6,5,21
191010419,6,8,7,1,9,31
191010420,1,5,0,9,5,20
191010421,8,4,6,4,5,27
191010422,1,8,7,6,6,28
191010423,9,4,1,4,6,24
191010424,6,8,8,7,8,37
191010425,3,9,1,6,1,20
191010426,1,6,1,0,0,8
191010427,5,4,6,2,5,22
191010428,8,0,4,2,4,18
191010429,1,3,3,5,3,15
191010430,2,2,1,7,2,14
191010431,7,3,0,0,3,13
191010432,9,9,6,7,0,31
191010433,5,9,2,8,4,28
191010434,5,5,6,5,2,23
191010435,9,5,9,8,1,32
191010436,5,4,2,6,6,23
191010437,7,1,8,6,6,28
191010438,3,6,0,8,0,17
191010439,0,9,4,3,5,21
191010440,2,6,1,6,9,24
191010441,4,5,1,0,6,16
191010442,5,3,9,2,7,26
191010443,2,0,0,7,4,13
191010444,5,9,3,5,0,22
191010445,7,0,7,1,3,18
191010446,7,3,2,1,0,13
191010447,6,3,4,7,0,20
191010448,2,4,0,8,5,19
191010449,8,6,7,1,9,31
191010450,5,5,1,5,9,25
191010451,5,8,9,4,6,32
191010452,6,2,8,3,2,21
191010453,7,9,2,0,6,24
191010454,6,2,2,3,7,20
191010455,9,5,6,8,1,29
191010456,5,5,7,8,1,26
191010457,4,9,0,8,8,29
191010458,7,2,3,8,9,29
191010459,0,7,9,4,0,20
191010460,4,5,4,7,3,23
191010461,8,9,0,8,6,31
191010462,8,4,8,0,3,23
191010463,0,0,1,3,6,10
191010464,8,3,9,7,5,32
191010465,6,1,7,1,6,21
191010466,0,1,4,1,3,9
191010467,4,3,0,6,1,14
191010468,3,2,6,4,2,17
191010469,2,1,1,4,0,8
191010470,6,8,7,4,8,33
191010471,3,1,3,7,9,23
191010472,1,2,7,9,5,24
191010473,6,6,2,7,1,22
191010474,9,3,2,5,9,28
191010475,9,7,5,6,5,32
191010476,7,4,9,2,6,28
191010477,3,9,4,4,1,21
191010478,6,7,6,1,7,27
191010479,7,6,7,8,1,29
191010480,8,7,2,2,2,21
191010481,1,1,5,0,3,10
191010482,3,2,5,5,0,15
191010483,9,7,3,0,0,19
191010484,8,8,3,3,6,28
191010485,5,7,2,0,5,19
191010486,2,9,8,4,2,25
191010487,6,6,4,3,1,20
191010488,5,9,3,6,8,31
191010489,1,3,5,5,0,14
191010490,9,7,0,0,3,19
191010491,7,7,3,1,7,25
191010492,8,8,2,6,6,30
191010493,5,6,2,6,7,26
191010494,4,4,5,6,5,24
191010495,0,3,9,3,0,15
191010496,7,3,8,0,9,27
191010497,9,1,0,3,6,19
191010498,8,8,4,6,3,29
191010499,6,7,6,2,9,30
191010500,8,8,0,3,5,24
191010501,1,0,5,8,3,17
191010502,5,7,5,8,1,26
191010503,8,4,6,2,6,26
191010504,1,5,5,0,3,14
191010505,7,9,8,2,7,33
191010506,6,5,1,1,3,16
191010507,2,9,8,2,2,23
191010508,6,0,5,7,6,24
191010509,6,0,4,5,7,22
191010510,6,6,9,8,1,30
191010511,3,7,5,7,9,31
191010512,0,0,0,6,8,14
191010513,6,2,1,5,7,21
191010514,6,0,2,3,3,14
191010515,4,8,4,6,2,24
191010516,3,6,5,9,0,23
191010517,5,6,4,8,9,32
191010518,4,7,6,0,3,20
191010519,0,7,3,9,0,19
191010520,2,1,7,2,6,18
191010521,6,5,0,7,5,23
191010522,5,5,7,9,2,28
191010523,6,7,1,9,6,29
191010524,5,2,4,9,6,26
191010525,0,7,2,3,1,13
191010526,9,0,6,7,1,23
191010527,7,5,8,3,8,31
191010528,9,2,5,7,8,31
191010529,3,8,6,4,5,26
191010530,5,1,2,9,4,21
191010531,1,4,0,6,6,17
191010532,7,6,2,4,0,19
191010533,2,7,6,9,6,30
191010534,0,3,4,6,6,19
191010535,6,4,6,9,3,28
191010536,3,3,2,7,8,23
191010537,6,4,2,9,4,25
191010538,1,7,2,5,1,16
191010539,2,0,7,3,7,19
191010540,9,8,3,0,3,23
191010541,2,2,4,2,9,19
191010542,8,8,5,8,3,32
191010543,3,8,5,4,1,21
191010544,2,7,1,8,7,25
191010545,7,3,5,3,6,24
191010546,8,7,5,2,1,23
191010547,2,2,8,1,6,19
191010548,7,9,7,3,2,28
191010549,2,5,1,2,5,15
191010550,5,7,9,1,2,24
191010551,1,9,9,9,4,32
191010552,3,1,5,8,1,18
191010553,8,6,9,7,1,31
191010554,5,2,0,1,9,17
191010555,1,8,8,6,8,31
191010556,7,8,2,6,5,28
191010557,6,6,0,4,7,23
191010558,6,5,9,4,1,25
191010559,2,4,4,2,4,16
191010560,0,0,6,5,1,12
191010561,8,7,1,0,6,22
191010562,3,8,8,8,5,32
191010563,3,9,4,5,7,28
191010564,3,4,8,2,0,17
191010565,1,1,2,8,5,17
191010566,8,6,2,3,4,23
191010567,9,5,2,1,0,17
191010568,1,0,6,6,0,13
191010569,0,7,6,8,6,27
191010570,6,3,5,9,0,23
191010571,9,1,7,9,6,32
191010572,6,4,4,3,8,25
191010573,6,7,3,8,2,26
191010574,5,6,6,5,2,24
191010575,7,4,0,7,6,24
191010576,6,2,0,0,4,12
191010577,6,3,0,0,6,15
191010578,6,2,8,2,8,26
191010579,9,9,8,3,7,36
191010580,4,7,3,6,4,24
191010581,6,4,9,9,3,31
191010582,3,3,9,8,5,28
191010583,7,6,6,7,4,30
191010584,8,4,2,3,9,26
191010585,4,5,1,3,7,20
191010586,8,2,6,2,0,18
191010587,2,6,8,2,7,25
191010588,9,4,1,8,4,26
191010589,1,6,6,3,1,17
191010590,6,4,6,0,6,22
191010591,1,4,3,1,2,11
191010592,5,9,8,0,4,26
191010593,4,8,2,3,3,20
191010594,6,4,1,9,1,21
191010595,2,7,6,5,9,29
191010596,9,3,2,4,7,25
191010597,0,8,0,2,6,16
191010598,0,7,6,5,0,18
191010599,2,6,8,2,4,22
191010600,1,2,5,4,4,16
191010601,4,6,3,1,4,18
191010602,6,4,5,8,4,27
191010603,5,6,2,9,4,26
191010604,6,3,6,8,7,30
191010605,6,4,6,2,5,23
191010606,5,9,3,0,7,24
191010607,6,3,3,4,2,18
191010608,6,1,9,4,6,26
191010609,3,7,5,2,8,25
191010610,9,7,9,8,7,40
191010611,8,3,5,1,0,17
191010612,7,4,9,5,7,32
191010613,1,9,4,8,3,25
191010614,4,6,1,9,2,22
191010615,9,5,4,3,7,28
191010616,0,2,5,3,5,15
191010617,9,6,8,1,9,33
191010618,6,9,6,0,2,23
191010619,1,2,2,5,2,12
191010620,0,4,7,8,3,22
191010621,7,5,1,6,9,28
191010622,8,0,6,7,2,23
191010623,7,5,3,4,3,22
191010624,6,1,7,8,1,23
191010625,6,5,1,0,4,16
191010626,2,7,1,9,4,23
191010627,0,1,3,8,3,15
191010628,8,2,0,9,7,26
191010629,9,1,1,7,7,25
191010630,8,6,2,9,8,33
191010631,7,2,9,7,8,33
191010632,9,0,3,2,8,22
191010633,9,2,0,1,2,14
191010634,8,3,5,5,0,21
191010635,0,9,5,9,0,23
191010636,7,3,8,5,6,29
191010637,0,1,6,4,3,14
191010638,6,3,0,4,2,15
191010639,5,8,6,8,9,36
191010640,1,0,5,9,5,20
191010641,2,4,8,9,5,28
191010642,3,6,0,5,7,21
191010643,1,8,1,2,3,15
191010644,3,2,5,2,5,17
191010645,2,6,2,5,4,19
191010646,6,4,9,4,7,30
191010647,6,4,1,5,8,24
191010648,5,6,3,5,2,21
191010649,7,5,4,0,8,24
191010650,8,9,7,2,4,30
191010651,9,8,0,6,7,30
191010652,8,1,0,1,6,16
191010653,5,9,6,7,2,29
191010654,1,0,3,5,9,18
191010655,8,1,0,7,6,22
191010656,5,9,4,0,6,24
191010657,6,8,3,1,7,25
191010658,2,5,3,3,4,17
191010659,7,9,7,9,5,37
191010660,5,3,5,0,9,22
191010661,3,3,7,1,9,23
191010662,0,9,6,4,3,22
191010663,4,2,8,4,0,18
191010664,3,1,9,7,0,20
191010665,9,0,5,0,4,18
191010666,5,8,8,5,7,33
191010667,3,4,4,5,2,18
191010668,5,0,1,0,5,11
191010669,2,2,3,1,1,9
191010670,7,0,3,6,8,24
191010671,8,8,2,6,4,28
191010672,8,4,2,2,3,19
191010673,4,4,0,9,9,26
191010674,9,7,4,0,4,24
191010675,1,7,5,5,4,22
191010676,3,4,7,5,2,21
191010677,6,3,2,1,1,13
191010678,0,1,4,4,1,10
191010679,9,8,7,9,9,42
191010680,0,6,2,2,4,14
191010681,0,1,5,1,9,16
191010682,1,1,5,6,6,19
191010683,9,6,3,2,6,26
191010684,5,4,7,4,1,21
191010685,4,9,9,7,2,31
191010686,6,4,4,0,5,19
191010687,7,0,5,2,1,15
191010688,6,7,2,1,2,18
191010689,5,2,4,5,6,22
191010690,0,7,5,9,0,21
191010691,3,1,9,2,9,24
191010692,5,9,8,9,8,39
191010693,5,8,0,1,7,21
191010694,7,3,2,3,3,18
191010695,3,9,6,3,9,30
191010696,7,0,1,2,3,13
191010697,7,8,3,7,5,30
191010698,0,8,3,1,0,12
191010699,9,6,8,7,7,37
191010700,9,6,2,9,9,35
191010701,1,4,1,4,7,17
191010702,5,0,0,0,3,8
191010703,8,1,5,7,2,23
191010704,6,5,4,8,9,32
191010705,4,6,3,1,1,15
191010706,8,8,0,6,1,23
191010707,3,4,7,6,8,28
191010708,0,9,0,2,9,20
191010709,2,1,7,6,9,25
191010710,1,8,8,5,7,29
191010711,5,3,8,7,4,27
191010712,7,3,2,3,6,21
191010713,8,4,2,4,1,19
191010714,8,5,1,0,3,17
191010715,6,0,5,5,7,23
191010716,6,9,0,5,7,27
191010717,9,9,9,3,9,39
191010718,6,0,3,3,3,15
191010719,8,9,2,1,3,23
191010720,0,7,6,9,3,25
191010721,6,8,5,0,0,19
191010722,4,3,0,0,2,9
191010723,4,6,6,4,2,22
191010724,6,7,6,9,1,29
191010725,8,3,5,7,2,25
191010726,2,5,8,4,0,19
191010727,6,1,8,1,0,16
191010728,2,9,1,8,3,23
191010729,2,0,9,9,5,25
191010730,7,5,1,9,7,29
191010731,1,3,0,5,1,10
191010732,3,8,1,3,9,24
191010733,9,2,7,6,0,24
191010734,9,2,5,8,0,24
191010735,3,2,6,1,7,19
191010736,1,0,2,7,9,19
191010737,7,9,1,1,8,26
191010738,7,0,0,3,8,18
191010739,9,4,6,4,5,28
191010740,0,7,7,8,2,24
191010741,7,1,8,9,7,32
191010742,8,7,9,8,5,37
191010743,6,2,1,0,9,18
191010744,9,7,8,9,9,42
191010745,1,0,1,4,0,6
191010746,6,5,4,9,6,30
191010747,8,0,3,0,1,12
191010748,5,5,3,7,3,23
191010749,4,3,1,8,9,25
191010750,5,9,3,5,8,30
191010751,4,8,6,1,4,23
191010752,7,1,5,0,5,18
191010753,5,8,8,7,7,35
191010754,5,5,4,1,2,17
191010755,1,0,2,9,6,18
191010756,3,9,1,4,6,23
191010757,9,5,0,7,3,24
191010758,7,6,8,2,4,27
191010759,8,2,3,1,6,20
191010760,6,7,1,5,9,28
191010761,6,1,1,3,4,15
191010762,6,1,8,2,6,23
191010763,9,8,9,7,7,40
191010764,1,5,0,1,1,8
191010765,8,6,6,0,5,25
191010766,1,3,0,4,9,17
191010767,8,3,9,8,1,29
191010768,6,3,3,8,7,27
191010769,7,7,9,7,5,35
191010770,8,8,3,2,2,23
191010771,0,1,7,0,0,8
191010772,5,2,7,6,5,25
191010773,7,3,4,0,4,18
191010774,1,3,7,3,4,18
191010775,8,9,4,6,0,27
191010776,0,1,1,5,1,8
191010777,8,0,5,0,7,20
191010778,7,4,2,8,5,26
191010779,3,9,5,0,1,18
191010780,8,3,8,8,3,30
191010781,0,6,6,4,7,23
191010782,2,5,6,4,7,24
191010783,8,4,7,7,2,28
191010784,0,6,8,3,9,26
191010785,5,5,5,9,1,25
191010786,4,3,0,2,0,9
191010787,6,3,3,1,1,14
191010788,9,5,4,1,6,25
191010789,4,0,0,6,3,13
191010790,1,5,3,8,0,17
191010791,5,6,6,6,1,24
191010792,1,7,1,5,3,17
191010793,7,2,6,9,3,27
191010794,5,3,6,7,2,23
191010795,6,2,7,2,6,23
191010796,0,4,1,9,9,23
191010797,0,4,6,4,1,15
191010798,6,8,7,3,0,24
191010799,3,1,4,8,3,19
191010800,4,3,6,4,7,24
191010801,1,4,9,4,7,25
191010802,7,0,8,3,3,21
191010803,0,4,8,5,0,17
191010804,4,3,1,9,1,18
191010805,7,3,2,6,7,25
191010806,8,3,3,4,2,20
191010807,6,2,2,5,7,22
191010808,4,9,7,1,9,30
191010809,1,4,3,6,4,18
191010810,1,3,1,0,7,12
191010811,6,9,4,5,5,29
191010812,7,4,9,2,7,29
191010813,9,7,3,6,3,28
191010814,8,2,3,8,4,25
191010815,2,7,5,4,3,21
191010816,3,8,3,3,2,19
191010817,3,8,8,0,5,24
191010818,3,9,7,4,1,24
191010819,6,2,5,6,1,20
191010820,1,7,7,5,2,22
191010821,2,4,8,9,8,31
191010822,2,0,7,0,9,18
191010823,3,4,7,4,4,22
191010824,8,5,5,3,8,29
191010825,5,6,6,3,2,22
191010826,7,5,7,2,3,24
191010827,5,6,9,2,8,30
191010828,5,6,4,7,4,26
191010829,1,1,6,1,1,10
191010830,5,8,3,3,7,26
191010831,6,1,6,6,1,20
191010832,0,0,2,9,4,15
191010833,4,2,5,8,9,28
191010834,4,9,5,2,2,22
191010835,4,9,9,8,6,36
191010836,5,2,4,5,5,21
191010837,5,9,2,5,7,28
191010838,2,4,9,8,9,32
191010839,2,8,8,3,8,29
191010840,9,9,3,9,8,38
191010841,3,4,7,7,3,24
191010842,0,5,0,3,3,11
191010843,4,9,7,9,2,31
191010844,9,8,4,3,2,26
191010845,6,7,4,2,0,19
191010846,5,5,5,8,6,29
191010847,6,6,7,3,3,25
191010848,5,5,6,1,9,26
191010849,1,0,8,5,9,23
191010850,5,6,3,4,8,26
191010851,7,7,1,3,1,19
191010852,8,3,6,3,7,27
191010853,0,9,8,4,1,22
191010854,6,9,8,7,2,32
191010855,0,4,6,9,8,27
191010856,6,9,3,4,3,25
191010857,9,0,3,1,9,22
191010858,8,2,4,3,0,17
191010859,1,9,7,4,0,21
191010860,7,8,4,7,1,27
191010861,8,7,3,0,6,24
191010862,8,5,9,5,7,34
191010863,1,9,8,8,3,29
191010864,3,5,1,8,3,20
191010865,9,9,4,3,0,25
191010866,8,9,5,0,8,30
191010867,2,0,5,5,5,17
191010868,4,7,7,2,6,26
191010869,8,8,8,9,0,33
191010870,3,0,5,7,2,17
191010871,7,2,4,7,5,25
191010872,5,2,0,4,2,13
191010873,0,4,2,8,4,18
191010874,5,1,7,9,7,29
191010875,3,4,0,4,2,13
191010876,7,9,1,6,3,26
191010877,1,4,9,8,3,25
191010878,8,4,7,5,0,24
191010879,4,2,3,7,7,23
191010880,4,8,0,1,9,22
191010881,4,0,5,2,6,17
191010882,9,5,2,1,6,23
191010883,9,6,5,3,9,32
191010884,2,4,9,9,9,33
191010885,0,6,3,2,3,14
191010886,3,7,1,7,8,26
191010887,9,9,6,9,7,40
191010888,1,4,5,8,3,21
191010889,9,1,7,1,4,22
191010890,3,0,0,3,8,14
191010891,9,6,8,6,1,30
191010892,4,2,5,2,8,21
191010893,5,2,0,6,0,13
191010894,0,4,6,8,2,20
191010895,4,7,3,2,9,25
191010896,9,3,4,0,1,17
191010897,3,0,3,8,2,16
191010898,2,1,5,6,6,20
191010899,3,1,7,7,5,23
191010900,1,1,5,2,3,12
191010901,3,7,6,8,7,31
191010902,1,9,8,6,5,29
191010903,2,6,9,9,2,28
191010904,6,0,1,2,1,10
191010905,9,5,1,5,2,22
191010906,1,1,7,3,3,15
191010907,7,2,8,7,1,25
191010908,7,8,7,1,4,27
191010909,1,4,7,8,9,29
191010910,7,1,8,7,2,25
191010911,8,4,3,5,9,29
191010912,0,4,1,7,6,18
191010913,0,4,8,4,5,21
191010914,5,8,6,9,9,37
191010915,4,7,5,8,4,28
191010916,1,1,3,0,4,9
191010917,7,9,7,5,5,33
191010918,8,6,9,1,7,31
191010919,5,1,2,7,5,20
191010920,4,0,5,6,7,22
191010921,8,5,8,6,0,27
191010922,2,6,4,6,5,23
191010923,9,7,4,7,4,31
191010924,7,3,8,5,8,31
191010925,5,9,0,2,6,22
191010926,1,9,0,1,9,20
191010927,4,5,3,5,5,22
191010928,0,2,5,6,0,13
191010929,2,2,7,3,4,18
191010930,8,7,9,6,3,33
191010931,3,9,2,5,5,24
191010932,3,8,6,1,5,23
191010933,0,7,9,7,9,32
191010934,6,7,2,5,4,24
191010935,2,3,7,9,7,28
191010936,1,6,2,2,5,16
191010937,9,5,3,7,6,30
191010938,9,8,1,2,0,20
191010939,0,6,0,0,9,15
191010940,7,8,9,1,4,29
191010941,3,3,2,9,3,20
191010942,9,2,9,7,4,31
191010943,5,9,2,2,8,26
191010944,9,3,9,0,7,28
191010945,9,1,0,1,4,15
191010946,8,7,7,4,1,27
191010947,2,4,5,9,7,27
191010948,7,1,3,9,5,25
191010949,9,0,4,8,8,29
191010950,6,0,8,4,6,24
191010951,9,4,4,2,1,20
191010952,2,2,4,6,3,17
191010953,6,1,1,6,9,23
191010954,2,6,3,9,3,23
191010955,2,7,2,3,6,20
191010956,1,5,4,8,1,19
191010957,7,8,8,5,9,37
191010958,4,1,3,1,9,18
191010959,7,8,0,9,6,30
191010960,3,9,5,3,4,24
191010961,4,0,8,9,9,30
191010962,7,9,9,8,7,40
191010963,2,9,6,4,5,26
191010964,3,0,7,0,1,11
191010965,3,5,6,7,9,30
191010966,0,1,4,0,3,8
191010967,1,7,3,6,2,19
191010968,0,2,3,7,9,21
191010969,8,5,9,7,9,38
191010970,0,2,8,6,6,22
191010971,2,1,5,7,7,22
191010972,3,6,6,1,9,25
191010973,5,4,1,9,1,20
191010974,6,9,9,1,6,31
191010975,5,1,2,0,2,10
191010976,3,6,5,2,3,19
191010977,5,5,1,5,3,19
191010978,3,1,7,7,7,25
191010979,0,3,7,0,3,13
191010980,1,9,2,9,4,25
191010981,9,0,8,6,5,28
191010982,6,1,3,1,1,12
191010983,6,5,5,3,4,23
191010984,5,5,9,3,1,23
191010985,8,4,9,7,0,28
191010986,0,4,6,1,1,12
191010987,8,4,4,3,2,21
191010988,5,5,9,8,7,34
191010989,0,5,3,1,5,14
191010990,1,4,6,7,0,18
191010991,0,2,0,4,3,9
191010992,9,5,0,3,9,26
191010993,2,6,5,5,8,26
191010994,8,8,5,4,2,27
191010995,6,2,8,1,9,26
191010996,7,6,0,8,8,29
191010997,4,4,8,5,4,25
191010998,2,2,8,2,8,22
191010999,7,6,1,5,4,23
1910101000,8,0,0,4,2,14
1910101001,7,1,0,1,5,14
1910101002,1,3,3,6,0,13
1910101003,8,9,0,9,4,30
1910101004,2,8,7,5,0,22
1910101005,3,2,0,0,0,5
1910101006,5,1,5,6,1,18
1910101007,7,4,4,0,0,15
1910101008,3,1,9,3,8,24
1910101009,4,1,5,6,7,23
1910101010,3,0,8,6,0,17
1910101011,3,6,5,8,9,31
1910101012,4,7,9,4,3,27
1910101013,6,5,1,5,4,21
1910101014,9,1,6,4,5,25
1910101015,1,3,6,0,7,17
1910101016,7,6,7,9,7,36
1910101017,0,0,7,8,0,15
1910101018,9,6,2,8,8,33
1910101019,6,3,2,1,2,14
1910101020,2,2,2,7,5,18
1910101021,2,0,2,1,6,11
1910101022,1,1,4,2,4,12
1910101023,5,1,9,1,9,25
1910101024,2,8,2,8,2,22
1910101025,7,9,7,1,8,32
1910101026,1,8,4,5,4,22
1910101027,0,8,0,1,4,13
1910101028,0,1,3,3,4,11
1910101029,6,1,6,5,0,18
1910101030,1,3,2,5,0,11
1910101031,4,4,3,2,0,13
1910101032,4,7,3,8,6,28
1910101033,7,7,0,5,0,19
1910101034,8,8,0,5,0,21
1910101035,7,1,6,3,2,19
1910101036,6,7,3,1,5,22
1910101037,1,8,9,8,4,30
1910101038,9,2,6,4,1,22
1910101039,9,6,2,2,1,20
1910101040,3,6,8,7,0,24
1910101041,7,0,0,4,2,13
1910101042,8,5,6,8,1,28
1910101043,4,4,3,6,9,26
1910101044,5,2,0,1,4,12
1910101045,2,8,4,3,5,22
1910101046,9,2,3,3,0,17
1910101047,4,6,2,4,7,23
1910101048,6,0,3,7,2,18
1910101049,0,2,2,8,1,13
1910101050,6,9,3,3,7,28
1910101051,0,3,8,1,6,18
1910101052,8,0,0,0,7,15
1910101053,9,0,0,1,8,18
1910101054,6,1,2,8,5,22
1910101055,3,9,7,7,9,35
1910101056,0,6,5,8,6,25
1910101057,4,3,1,2,3,13
1910101058,8,5,9,1,5,28
1910101059,8,2,7,7,3,27
1910101060,2,7,5,3,4,21
1910101061,0,6,6,7,3,22
1910101062,9,9,5,8,7,38
1910101063,3,4,6,8,2,23
1910101064,0,0,5,3,2,10
1910101065,6,8,7,7,2,30
1910101066,6,5,2,5,0,18
1910101067,0,2,6,6,9,23
1910101068,9,9,3,3,4,28
1910101069,1,3,8,6,2,20
1910101070,9,9,4,5,2,29
1910101071,2,5,5,7,4,23
1910101072,7,6,0,7,0,20
1910101073,5,5,3,4,9,26
1910101074,4,6,3,7,3,23
1910101075,6,2,7,9,6,30
1910101076,7,9,6,8,8,38
1910101077,8,9,8,6,5,36
1910101078,1,4,5,3,8,21
1910101079,6,3,4,8,3,24
1910101080,2,3,4,6,0,15
1910101081,4,5,4,6,7,26
1910101082,9,9,5,0,6,29
1910101083,6,1,6,4,1,18
1910101084,3,9,7,8,7,34
1910101085,0,6,2,9,4,21
1910101086,4,5,5,8,2,24
1910101087,0,1,5,7,2,15
1910101088,8,6,7,4,7,32
1910101089,8,5,1,1,9,24
1910101090,7,1,5,4,3,20
1910101091,3,8,2,0,8,21
1910101092,3,8,9,4,0,24
1910101093,0,0,3,7,8,18
1910101094,5,7,8,9,7,36
1910101095,4,8,7,8,9,36
1910101096,2,9,6,1,1,19
1910101097,2,0,3,8,8,21
1910101098,6,2,4,6,7,25
1910101099,2,6,3,1,3,15
1910101100,0,2,6,8,4,20
1910101101,7,9,7,8,2,33
1910101102,6,1,5,4,5,21
1910101103,3,0,5,2,2,12
1910101104,3,9,2,5,3,22
1910101105,0,9,5,9,3,26
191011001,2,3,7,6,3,21
191011002,6,2,9,6,1,24
191011003,9,8,0,5,3,25
191011004,2,8,4,0,6,20
191011005,0,7,8,5,5,25
191011006,2,5,3,6,8,24
191011007,7,7,3,8,6,31
191011008,8,4,8,1,1,22
191011009,9,4,9,9,6,37
191011010,2,0,5,3,1,11
191011011,6,5,6,8,0,25
191011012,0,3,9,8,1,21
191011013,1,7,3,9,7,27
191011014,2,4,1,7,1,15
191011015,9,2,9,4,5,29
191011016,7,6,5,0,5,23
191011017,4,3,9,0,2,18
191011018,7,8,6,1,2,24
191011019,1,4,6,0,7,18
191011020,3,8,8,0,3,22
191011021,3,9,5,9,7,33
191011022,9,1,4,7,0,21
191011023,7,1,3,1,2,14
191011024,7,9,7,3,7,33
191011025,4,1,9,7,8,29
191011026,0,5,1,4,3,13
191011027,6,0,9,5,0,20
191011028,0,3,1,9,4,17
191011029,4,6,7,4,3,24
191011030,2,3,9,8,2,24
191011031,2,5,7,9,6,29
191011032,7,9,3,9,5,33
191011033,8,1,3,7,0,19
191011034,3,6,7,6,8,30
191011035,3,4,4,6,1,18
191011036,5,7,1,1,7,21
191011037,6,4,3,5,8,26
191011038,9,0,9,7,1,26
191011039,9,9,0,9,9,36
191011040,5,7,6,0,9,27
191011041,6,6,8,7,1,28
191011042,7,2,2,4,9,24
191011043,6,9,6,9,2,32
191011044,0,8,0,1,1,10
191011045,6,5,7,7,1,26
191011046,0,4,8,8,2,22
191011047,2,8,2,4,0,16
191011048,7,5,3,7,2,24
191011049,4,0,4,5,5,18
191011050,3,8,5,2,0,18
191011051,8,9,6,2,3,28
191011052,5,9,0,6,7,27
191011053,0,1,7,2,2,12
191011054,5,9,6,2,4,26
191011055,1,6,3,8,6,24
191011056,9,6,1,7,5,28
191011057,7,9,4,5,7,32
191011058,0,8,3,0,3,14
191011059,3,9,3,3,0,18
191011060,7,0,2,9,5,23
191011061,0,1,4,7,5,17
191011062,5,3,9,5,6,28
191011063,9,9,2,1,9,30
191011064,5,4,3,4,5,21
191011065,4,9,9,9,6,37
191011066,9,4,9,7,0,29
191011067,5,1,4,4,7,21
191011068,8,7,2,9,0,26
191011069,2,1,9,0,7,19
191011070,7,2,4,1,8,22
191011071,2,8,6,4,1,21
191011072,5,0,3,5,5,18
191011073,7,0,4,0,0,11
191011074,9,3,4,1,0,17
191011075,0,0,2,2,5,9
191011076,5,4,9,2,2,22
191011077,5,9,5,9,1,29
191011078,5,5,3,8,7,28
191011079,9,4,2,1,9,25
191011080,5,7,8,8,6,34
191011081,2,9,2,4,9,26
191011082,0,3,9,3,3,18
191011083,8,7,3,6,1,25
191011084,2,0,7,9,0,18
191011085,7,3,0,4,7,21
191011086,8,7,2,6,0,23
191011087,2,6,3,8,8,27
191011088,1,0,5,1,0,7
191011089,7,6,1,7,8,29
191011090,6,6,1,6,6,25
191011091,8,0,7,3,3,21
191011092,4,2,6,4,6,22
191011093,3,3,7,1,6,20
191011094,9,6,9,6,9,39
191011095,6,1,5,9,7,28
191011096,3,4,7,7,4,25
191011097,8,7,2,1,1,19
191011098,9,4,7,0,7,27
191011099,0,0,1,2,9,12
191011100,3,3,0,3,4,13
191011101,8,0,4,8,8,28
191011102,3,4,4,4,8,23
191011103,3,1,7,8,3,22
191011104,2,4,5,2,4,17
191011105,8,5,9,8,0,30
191011106,5,5,9,2,0,21
191011107,5,7,9,6,7,34
191011108,6,1,5,4,3,19
191011109,8,3,9,7,8,35
191011110,9,0,3,9,5,26
191011111,0,1,1,7,6,15
191011112,9,1,2,4,0,16
191011113,2,6,3,5,9,25
191011114,3,8,3,3,6,23
191011115,9,5,7,7,6,34
191011116,9,4,7,5,0,25
191011117,2,7,3,0,5,17
191011118,7,3,9,1,5,25
191011119,7,6,3,7,4,27
191011120,2,3,5,4,9,23
191011121,5,4,6,6,3,24
191011122,1,3,4,4,9,21
191011123,9,5,4,5,7,30
191011124,9,5,0,2,3,19
191011125,5,4,2,4,6,21
191011126,6,2,4,7,2,21
191011127,6,0,7,1,9,23
191011128,0,4,2,7,0,13
191011129,1,6,3,7,6,23
191011130,6,6,4,1,8,25
191011131,0,3,1,5,0,9
191011132,4,9,6,4,6,29
191011133,0,2,1,3,9,15
191011134,9,2,9,3,6,29
191011135,1,8,7,4,7,27
191011136,2,3,1,1,1,8
191011137,8,7,0,8,1,24
191011138,9,2,6,9,8,34
191011139,5,2,7,4,1,19
191011140,6,6,0,7,2,21
191011141,9,3,1,3,2,18
191011142,0,9,6,7,6,28
191011143,2,0,4,5,9,20
191011144,8,9,9,0,4,30
191011145,6,8,7,4,0,25
191011146,7,5,6,4,7,29
191011147,8,7,1,0,2,18
191011148,4,8,1,9,5,27
191011149,5,7,4,2,6,24
191011150,4,5,8,5,9,31
191011151,1,0,7,1,4,13
191011152,2,2,2,6,5,17
191011153,9,5,4,8,1,27
191011154,5,6,5,2,4,22
191011155,4,7,4,5,2,22
191011156,4,9,5,7,9,34
191011157,5,6,3,1,2,17
191011158,3,6,8,9,8,34
191011159,7,6,2,4,1,20
191011160,3,3,1,2,8,17
191011161,6,1,1,6,6,20
191011162,1,6,5,1,2,15
191011163,0,3,9,3,9,24
191011164,1,8,0,9,9,27
191011165,0,2,1,3,7,13
191011166,3,8,1,7,0,19
191011167,8,5,1,2,2,18
191011168,7,0,8,1,1,17
191011169,1,8,8,2,8,27
191011170,7,1,2,1,6,17
191011171,7,1,1,2,0,11
191011172,5,6,6,4,6,27
191011173,0,6,6,2,7,21
191011174,8,1,5,3,4,21
191011175,6,8,0,9,6,29
191011176,2,8,2,1,3,16
191011177,7,0,9,0,8,24
191011178,4,9,1,9,1,24
191011179,2,1,1,8,7,19
191011180,8,5,2,0,7,22
191011181,3,1,3,0,5,12
191011182,0,4,7,9,4,24
191011183,3,4,2,1,6,16
191011184,1,9,6,3,3,22
191011185,1,4,3,3,8,19
191011186,6,4,4,1,3,18
191011187,3,6,4,9,6,28
191011188,1,3,4,7,9,24
191011189,7,9,6,7,8,37
191011190,4,5,9,9,9,36
191011191,7,0,1,1,6,15
191011192,1,4,4,8,5,22
191011193,2,1,8,3,5,19
191011194,8,2,0,5,4,19
191011195,5,7,7,5,6,30
191011196,3,9,6,8,3,29
191011197,8,5,6,3,9,31
191011198,7,0,8,7,6,28
191011199,1,0,3,0,4,8
191011200,0,7,6,1,6,20
191011201,2,1,4,4,3,14
191011202,5,7,9,9,3,33
191011203,4,0,1,7,8,20
191011204,1,4,9,3,7,24
191011205,4,9,9,4,3,29
191011206,7,0,5,4,5,21
191011207,3,6,6,6,8,29
191011208,4,5,9,1,7,26
191011209,3,0,2,8,3,16
191011210,6,5,7,9,6,33
191011211,1,1,3,1,0,6
191011212,7,9,0,5,0,21
191011213,0,3,4,2,3,12
191011214,9,1,9,0,8,27
191011215,9,4,0,3,4,20
191011216,1,8,6,6,8,29
191011217,7,0,1,7,5,20
191011218,4,8,0,3,0,15
191011219,6,0,5,9,0,20
191011220,7,3,1,8,7,26
191011221,8,6,7,1,3,25
191011222,5,7,2,6,9,29
191011223,3,7,0,4,3,17
191011224,3,0,3,4,1,11
191011225,9,2,0,0,6,17
191011226,9,2,2,5,3,21
191011227,6,4,8,0,3,21
191011228,8,2,6,0,7,23
191011229,4,7,5,6,5,27
191011230,2,7,0,3,7,19
191011231,3,6,8,0,1,18
191011232,6,4,6,1,8,25
191011233,0,8,4,4,3,19
191011234,4,2,2,8,6,22
191011235,2,9,1,1,8,21
191011236,9,4,8,7,6,34
191011237,2,8,0,5,1,16
191011238,7,0,3,1,9,20
191011239,1,8,4,7,7,27
191011240,3,9,5,0,5,22
191011241,4,9,4,1,1,19
191011242,1,7,5,6,3,22
191011243,6,8,0,9,8,31
191011244,5,6,5,1,2,19
191011245,4,1,4,5,8,22
191011246,7,3,9,4,5,28
191011247,2,7,1,8,8,26
191011248,2,0,9,4,8,23
191011249,7,2,6,0,4,19
191011250,6,8,6,7,3,30
191011251,1,5,9,3,9,27
191011252,7,2,5,9,9,32
191011253,8,3,0,3,6,20
191011254,9,0,7,4,0,20
191011255,8,1,5,2,1,17
191011256,8,7,5,2,0,22
191011257,4,2,9,2,5,22
191011258,9,3,5,6,2,25
191011259,9,7,5,0,6,27
191011260,9,3,9,3,7,31
191011261,6,0,7,6,1,20
191011262,2,3,0,5,3,13
191011263,5,8,5,5,2,25
191011264,9,7,5,0,8,29
191011265,2,2,0,7,0,11
191011266,2,6,7,8,9,32
191011267,2,1,3,6,1,13
191011268,9,1,9,5,3,27
191011269,9,1,1,6,3,20
191011270,1,3,7,1,6,18
191011271,6,6,3,8,2,25
191011272,2,6,6,5,8,27
191011273,2,9,9,9,5,34
191011274,4,3,0,7,1,15
191011275,8,9,9,9,7,42
191011276,5,7,1,0,1,14
191011277,5,1,1,5,0,12
191011278,7,8,1,5,1,22
191011279,7,0,3,9,6,25
191011280,0,9,4,0,0,13
191011281,9,6,9,4,7,35
191011282,1,1,9,0,9,20
191011283,7,8,6,6,9,36
191011284,0,6,0,8,5,19
191011285,1,1,0,1,0,3
191011286,2,3,6,6,5,22
191011287,2,1,7,5,2,17
191011288,2,7,4,1,9,23
191011289,1,3,5,1,9,19
191011290,3,4,0,2,3,12
191011291,8,4,6,5,5,28
191011292,3,9,3,0,3,18
191011293,8,2,9,4,2,25
191011294,0,9,7,7,4,27
191011295,4,5,7,6,4,26
191011296,4,1,7,2,0,14
191011297,4,7,0,1,0,12
191011298,0,6,8,5,2,21
191011299,3,5,8,0,2,18
191011300,0,9,4,5,6,24
191011301,3,3,2,6,6,20
191011302,4,1,4,5,0,14
191011303,6,3,9,3,2,23
191011304,3,9,2,9,8,31
191011305,9,1,5,3,8,26
191011306,1,7,5,8,6,27
191011307,2,9,9,2,2,24
191011308,4,0,5,4,1,14
191011309,2,2,1,5,5,15
191011310,7,7,5,7,8,34
191011311,6,8,0,6,0,20
191011312,4,1,6,2,5,18
191011313,8,3,0,7,1,19
191011314,1,1,0,7,6,15
191011315,1,6,1,8,7,23
191011316,8,5,8,0,2,23
191011317,0,0,8,3,3,14
191011318,2,1,3,5,3,14
191011319,8,4,8,6,9,35
191011320,0,2,6,9,1,18
191011321,5,3,3,8,3,22
191011322,0,4,1,0,4,9
191011323,2,8,6,2,9,27
191011324,6,9,2,4,2,23
191011325,5,2,1,2,7,17
191011326,1,3,5,7,3,19
191011327,0,3,3,7,8,21
191011328,0,8,2,9,8,27
191011329,3,4,6,5,3,21
191011330,3,3,0,5,6,17
191011331,3,0,6,7,8,24
191011332,5,2,3,1,4,15
191011333,6,4,9,4,9,32
191011334,9,3,1,4,0,17
191011335,4,0,8,4,5,21
191011336,1,5,1,0,5,12
191011337,4,5,3,5,9,26
191011338,2,4,4,2,2,14
191011339,5,6,5,4,8,28
191011340,2,6,6,5,9,28
191011341,1,7,6,4,9,27
191011342,3,7,0,6,8,24
191011343,9,3,6,1,1,20
191011344,4,2,3,7,0,16
191011345,6,1,3,9,3,22
191011346,7,0,7,8,4,26
191011347,4,7,6,9,4,30
191011348,2,4,8,7,5,26
191011349,4,1,7,8,3,23
191011350,8,3,2,9,2,24
191011351,4,3,9,4,8,28
191011352,0,7,2,8,9,26
191011353,3,8,0,3,5,19
191011354,1,8,9,2,1,21
191011355,4,9,7,6,7,33
191011356,2,7,0,2,2,13
191011357,3,0,9,8,7,27
191011358,8,9,5,4,3,29
191011359,0,5,0,5,6,16
191011360,5,8,8,5,9,35
191011361,8,0,8,3,9,28
191011362,0,4,8,3,7,22
191011363,8,8,0,1,1,18
191011364,9,2,3,4,6,24
191011365,5,9,5,1,1,21
191011366,4,0,6,9,3,22
191011367,8,5,7,3,8,31
191011368,3,1,5,9,9,27
191011369,9,5,6,5,9,34
191011370,9,2,0,3,0,14
191011371,0,6,9,7,2,24
191011372,3,4,0,7,9,23
191011373,4,9,1,0,0,14
191011374,6,9,2,2,8,27
191011375,8,2,1,9,8,28
191011376,9,5,7,4,6,31
191011377,9,4,3,1,8,25
191011378,1,5,1,2,0,9
191011379,8,8,0,5,1,22
191011380,3,9,5,6,9,32
191011381,4,9,8,1,7,29
191011382,0,4,9,6,5,24
191011383,2,7,4,1,7,21
191011384,0,5,0,9,9,23
191011385,8,7,6,2,4,27
191011386,3,1,1,8,2,15
191011387,5,0,8,0,5,18
191011388,6,6,9,7,9,37
191011389,0,2,6,1,5,14
191011390,1,2,4,8,6,21
191011391,0,4,1,4,3,12
191011392,8,6,6,7,9,36
191011393,6,1,1,4,8,20
191011394,9,6,1,8,7,31
191011395,1,4,2,1,0,8
191011396,0,9,8,3,6,26
191011397,5,2,5,1,9,22
191011398,7,1,2,8,9,27
191011399,2,8,6,7,6,29
191011400,3,5,2,0,3,13
191011401,9,2,4,9,0,24
191011402,8,5,2,2,0,17
191011403,7,9,3,8,6,33
191011404,9,0,3,5,1,18
191011405,1,6,2,1,4,14
191011406,5,1,1,9,9,25
191011407,4,6,4,9,7,30
191011408,9,7,0,7,5,28
191011409,7,1,2,5,0,15
191011410,8,3,1,8,4,24
191011411,9,8,9,8,2,36
191011412,8,6,9,4,2,29
191011413,0,9,0,1,4,14
191011414,2,4,0,2,3,11
191011415,1,3,8,1,9,22
191011416,0,1,1,1,1,4
191011417,9,6,0,0,6,21
191011418,5,5,5,4,0,19
191011419,4,6,4,7,6,27
191011420,7,6,3,1,4,21
191011421,1,5,5,2,7,20
191011422,9,1,0,5,2,17
191011423,4,6,3,4,0,17
191011424,9,1,5,8,5,28
191011425,6,0,8,7,1,22
191011426,7,2,4,6,6,25
191011427,1,2,0,1,9,13
191011428,3,0,6,5,1,15
191011429,4,4,5,3,1,17
191011430,9,1,6,1,4,21
191011431,2,4,8,0,2,16
191011432,0,1,8,2,5,16
191011433,5,9,2,0,4,20
191011434,7,7,9,0,6,29
191011435,4,8,0,6,2,20
191011436,0,9,6,4,7,26
191011437,0,7,5,7,9,28
191011438,5,3,6,9,3,26
191011439,0,6,3,3,1,13
191011440,9,6,2,5,3,25
191011441,5,5,9,4,9,32
191011442,5,1,5,5,4,20
191011443,7,0,6,3,3,19
191011444,2,2,9,8,1,22
191011445,4,1,0,2,7,14
191011446,3,7,3,4,2,19
191011447,1,7,4,3,1,16
191011448,7,1,6,7,7,28
191011449,0,4,6,8,3,21
191011450,5,8,7,6,7,33
191011451,1,3,4,5,0,13
191011452,3,9,6,1,2,21
191011453,2,1,8,8,7,26
191011454,6,6,4,0,7,23
191011455,9,8,9,9,4,39
191011456,7,6,1,3,8,25
191011457,0,1,1,7,5,14
191011458,5,4,7,2,0,18
191011459,5,7,9,3,8,32
191011460,4,7,3,4,3,21
191011461,8,0,7,0,6,21
191011462,4,4,2,0,2,12
191011463,4,9,8,8,4,33
191011464,9,5,3,3,7,27
191011465,2,6,0,9,7,24
191011466,7,6,0,5,8,26
191011467,7,6,6,3,2,24
191011468,0,5,4,7,8,24
191011469,7,6,9,6,6,34
191011470,6,4,7,9,6,32
191011471,5,4,1,4,6,20
191011472,7,0,8,3,9,27
191011473,9,2,1,5,2,19
191011474,0,7,8,9,2,26
191011475,7,0,4,8,3,22
191011476,5,1,8,0,7,21
191011477,9,0,0,2,9,20
191011478,0,0,4,8,1,13
191011479,8,5,9,5,4,31
191011480,7,2,1,7,0,17
191011481,0,8,9,1,0,18
191011482,9,3,0,6,3,21
191011483,0,9,6,9,3,27
191011484,0,1,8,4,2,15
191011485,3,2,9,4,1,19
191011486,6,7,3,9,5,30
191011487,6,4,5,2,4,21
191011488,9,9,5,5,6,34
191011489,9,5,2,2,2,20
191011490,0,8,9,1,3,21
191011491,3,9,7,2,4,25
191011492,9,4,0,1,0,14
191011493,3,6,2,5,4,20
191011494,4,3,5,2,0,14
191011495,7,5,3,1,0,16
191011496,6,6,9,2,8,31
191011497,6,6,1,5,4,22
191011498,0,1,3,2,1,7
191011499,6,2,3,6,0,17
191011500,5,3,6,5,9,28
191011501,7,2,4,7,1,21
191011502,3,8,1,3,6,21
191011503,3,8,6,8,4,29
191011504,3,9,8,6,9,35
191011505,8,2,6,3,5,24
191011506,8,7,8,6,9,38
191011507,3,7,0,9,1,20
191011508,6,9,8,6,2,31
191011509,9,3,2,9,8,31
191011510,4,9,0,1,0,14
191011511,1,6,6,4,7,24
191011512,0,5,5,8,2,20
191011513,3,8,0,5,4,20
191011514,4,4,9,9,4,30
191011515,7,8,6,9,3,33
191011516,1,1,8,9,1,20
191011517,1,0,9,2,6,18
191011518,0,6,2,8,7,23
191011519,4,5,6,7,2,24
191011520,4,9,0,0,0,13
191011521,5,9,1,0,5,20
191011522,5,0,0,5,0,10
191011523,7,7,7,7,6,34
191011524,6,4,5,2,0,17
191011525,7,4,5,0,9,25
191011526,0,5,4,0,5,14
191011527,6,6,6,8,7,33
191011528,7,2,2,2,0,13
191011529,6,4,6,6,7,29
191011530,4,1,5,4,3,17
191011531,9,2,3,8,3,25
191011532,9,8,1,2,3,23
191011533,1,2,4,3,7,17
191011534,7,1,2,4,6,20
191011535,1,8,2,1,0,12
191011536,6,4,5,5,5,25
191011537,0,9,6,9,4,28
191011538,5,8,5,0,8,26
191011539,9,4,5,3,7,28
191011540,3,6,1,0,3,13
191011541,5,4,5,7,3,24
191011542,8,1,6,1,5,21
191011543,4,4,1,5,7,21
191011544,4,6,1,8,4,23
191011545,4,6,2,7,7,26
191011546,8,9,6,6,9,38
191011547,6,8,1,7,5,27
191011548,9,3,0,4,2,18
191011549,7,7,9,2,6,31
191011550,0,0,5,4,2,11
191011551,0,0,3,6,0,9
191011552,3,7,7,6,9,32
191011553,0,8,4,1,2,15
191011554,4,4,1,2,3,14
191011555,9,8,1,3,3,24
191011556,8,0,9,6,6,29
191011557,0,8,6,8,5,27
191011558,0,9,3,6,8,26
191011559,0,6,4,8,0,18
191011560,4,9,5,7,4,29
191011561,2,3,0,2,0,7
191011562,6,7,7,2,7,29
191011563,4,9,4,7,6,30
191011564,8,7,8,4,2,29
191011565,0,8,0,2,8,18
191011566,0,9,0,9,0,18
191011567,5,2,5,8,3,23
191011568,4,9,6,5,2,26
191011569,0,4,3,2,7,16
191011570,7,4,2,3,5,21
191011571,9,4,7,0,9,29
191011572,0,9,1,2,9,21
191011573,6,3,4,5,6,24
191011574,8,8,1,1,2,20
191011575,4,2,9,4,5,24
191011576,5,7,9,9,9,39
191011577,2,2,8,8,4,24
191011578,2,1,0,9,6,18
191011579,1,5,8,8,8,30
191011580,1,4,7,2,5,19
191011581,9,0,8,3,1,21
191011582,1,7,3,2,2,15
191011583,8,8,5,7,5,33
191011584,7,7,1,4,1,20
191011585,8,9,7,3,4,31
191011586,1,6,9,4,0,20
191011587,0,7,5,7,5,24
191011588,1,4,3,3,5,16
191011589,9,1,3,6,1,20
191011590,9,5,0,1,3,18
191011591,2,8,8,1,4,23
191011592,6,5,2,8,1,22
191011593,1,7,6,5,5,24
191011594,2,2,9,0,7,20
191011595,0,1,4,4,5,14
191011596,5,1,2,5,6,19
191011597,5,6,4,9,7,31
191011598,4,7,0,5,7,23
191011599,8,8,6,2,1,25
191011600,2,1,1,6,5,15
191011601,0,8,1,9,1,19
191011602,5,0,2,0,5,12
191011603,7,4,5,5,0,21
191011604,2,3,7,3,3,18
191011605,6,5,3,2,1,17
191011606,2,0,5,5,7,19
191011607,4,5,4,8,0,21
191011608,6,0,1,0,2,9
191011609,7,0,0,8,7,22
191011610,9,0,0,3,6,18
191011611,4,6,1,2,4,17
191011612,1,6,5,6,6,24
191011613,8,2,8,1,9,28
191011614,9,3,9,4,7,32
191011615,7,9,1,1,1,19
191011616,2,3,8,0,3,16
191011617,9,9,9,4,8,39
191011618,6,0,2,5,3,16
191011619,2,3,9,8,0,22
191011620,6,5,3,3,4,21
191011621,2,3,3,4,6,18
191011622,1,8,2,5,5,21
191011623,1,3,8,3,7,22
191011624,5,7,4,9,8,33
191011625,6,3,1,8,2,20
191011626,8,0,8,3,1,20
191011627,4,7,4,3,1,19
191011628,2,4,9,9,2,26
191011629,1,9,4,8,7,29
191011630,9,5,4,6,3,27
191011631,9,1,0,8,9,27
191011632,5,4,3,1,7,20
191011633,8,1,9,7,4,29
191011634,3,1,2,4,9,19
191011635,0,8,0,6,6,20
191011636,4,1,8,8,6,27
191011637,4,7,7,0,3,21
191011638,3,0,4,5,4,16
191011639,1,7,9,3,3,23
191011640,3,2,4,4,0,13
191011641,5,6,0,8,7,26
191011642,1,1,5,6,7,20
191011643,6,7,8,2,9,32
191011644,9,7,0,5,0,21
191011645,8,1,8,6,5,28
191011646,9,3,0,2,4,18
191011647,0,1,0,8,0,9
191011648,2,4,6,1,7,20
191011649,5,8,1,0,9,23
191011650,7,3,0,2,1,13
191011651,6,5,9,5,9,34
191011652,6,0,3,3,4,16
191011653,8,6,2,9,0,25
191011654,3,7,1,0,5,16
191011655,6,2,4,7,3,22
191011656,1,0,0,6,1,8
191011657,9,7,6,2,4,28
191011658,5,9,7,1,3,25
191011659,3,3,9,0,9,24
191011660,5,0,5,0,2,12
191011661,0,7,3,5,5,20
191011662,8,6,0,0,5,19
191011663,9,8,9,6,3,35
191011664,6,6,3,0,3,18
191011665,9,4,4,0,1,18
191011666,4,3,2,2,0,11
191011667,8,1,2,0,0,11
191011668,2,5,2,1,7,17
191011669,6,0,4,5,3,18
191011670,8,2,6,3,6,25
191011671,2,1,6,6,7,22
191011672,6,8,7,2,4,27
191011673,5,5,4,6,8,28
191011674,8,7,7,9,3,34
191011675,7,9,6,1,9,32
191011676,9,6,2,7,9,33
191011677,6,6,6,6,3,27
191011678,4,2,8,9,3,26
191011679,2,9,0,0,8,19
191011680,4,3,2,8,3,20
191011681,3,8,4,1,1,17
191011682,3,6,0,0,6,15
191011683,9,2,7,6,5,29
191011684,2,8,4,7,8,29
191011685,2,9,6,6,4,27
191011686,9,0,0,7,6,22
191011687,5,4,5,7,6,27
191011688,2,5,1,7,1,16
191011689,7,4,2,2,5,20
191011690,2,4,2,5,5,18
191011691,4,1,0,0,2,7
191011692,2,1,9,6,9,27
191011693,2,7,2,3,8,22
191011694,6,0,0,5,6,17
191011695,6,9,2,2,4,23
191011696,8,8,4,4,9,33
191011697,6,0,0,0,5,11
191011698,7,2,8,8,5,30
191011699,9,0,4,3,8,24
191011700,8,3,3,2,2,18
191011701,3,0,3,5,4,15
191011702,1,8,7,1,2,19
191011703,6,3,2,9,4,24
191011704,2,9,6,9,3,29
191011705,5,2,8,5,1,21
191011706,1,5,8,7,9,30
191011707,1,6,4,4,8,23
191011708,8,4,7,9,1,29
191011709,4,0,2,4,5,15
191011710,9,3,1,8,8,29
191011711,8,3,0,2,6,19
191011712,9,2,9,1,0,21
191011713,6,2,1,8,8,25
191011714,6,5,5,9,3,28
191011715,2,7,5,5,8,27
191011716,6,7,5,7,0,25
191011717,5,0,1,5,2,13
191011718,9,6,1,0,3,19
191011719,8,4,3,2,4,21
191011720,9,3,5,0,5,22
191011721,6,0,5,5,1,17
191011722,1,8,9,9,5,32
191011723,9,0,0,6,3,18
191011724,1,4,8,3,1,17
191011725,7,4,4,4,5,24
191011726,6,0,1,8,9,24
191011727,4,4,8,7,6,29
191011728,4,3,3,1,4,15
191011729,5,4,8,2,1,20
191011730,4,6,8,7,2,27
191011731,2,0,8,6,5,21
191011732,9,0,9,7,7,32
191011733,9,8,2,9,2,30
191011734,0,2,4,6,5,17
191011735,4,8,5,4,3,24
191011736,0,7,5,7,0,19
191011737,2,1,4,8,5,20
191011738,3,0,7,8,0,18
191011739,1,5,7,2,7,22
191011740,0,9,6,5,3,23
191011741,7,4,7,1,1,20
191011742,3,6,2,0,3,14
191011743,0,2,8,4,0,14
191011744,9,9,6,1,7,32
191011745,0,4,2,6,4,16
191011746,2,6,2,2,7,19
191011747,9,7,7,5,1,29
191011748,3,8,6,6,1,24
191011749,4,9,6,4,7,30
191011750,6,1,9,8,6,30
191011751,3,8,8,1,7,27
191011752,8,2,2,4,0,16
191011753,9,8,3,2,5,27
191011754,8,0,0,4,6,18
191011755,0,9,9,5,3,26
191011756,9,1,9,6,4,29
191011757,5,4,7,1,0,17
191011758,2,8,5,6,1,22
191011759,9,0,9,5,0,23
191011760,1,0,5,3,3,12
191011761,2,0,0,1,5,8
191011762,8,9,7,9,0,33
191011763,5,3,5,5,8,26
191011764,6,7,8,4,2,27
191011765,1,2,6,9,4,22
191011766,3,8,0,2,7,20
191011767,7,5,6,9,0,27
191011768,0,0,1,9,2,12
191011769,3,2,8,3,0,16
191011770,8,2,3,6,0,19
191011771,1,8,9,2,3,23
191011772,0,7,4,0,7,18
191011773,7,8,7,4,5,31
191011774,2,4,8,6,5,25
191011775,3,2,5,0,5,15
191011776,6,9,3,9,7,34
191011777,0,4,1,2,4,11
191011778,2,3,0,3,6,14
191011779,5,1,7,2,2,17
191011780,0,5,7,2,5,19
191011781,3,6,8,5,2,24
191011782,5,8,8,4,1,26
191011783,1,1,1,0,4,7
191011784,5,8,7,1,3,24
191011785,5,2,5,5,0,17
191011786,1,1,8,3,8,21
191011787,6,9,4,7,9,35
191011788,3,1,3,1,1,9
191011789,9,9,7,3,3,31
191011790,4,2,4,8,2,20
191011791,6,1,9,2,2,20
191011792,7,3,0,9,6,25
191011793,7,7,2,8,6,30
191011794,5,4,5,3,2,19
191011795,3,5,5,7,8,28
191011796,6,2,0,8,2,18
191011797,9,6,6,8,3,32
191011798,8,1,9,4,0,22
191011799,8,0,6,1,8,23
191011800,7,4,9,0,8,28
191011801,3,1,7,6,6,23
191011802,7,8,3,7,0,25
191011803,9,1,2,9,5,26
191011804,5,9,5,0,5,24
191011805,0,0,3,2,4,9
191011806,2,1,1,2,3,9
191011807,9,6,3,8,6,32
191011808,4,7,6,9,2,28
191011809,0,9,1,7,1,18
191011810,6,1,7,6,5,25
191011811,3,6,6,7,2,24
191011812,0,6,4,7,1,18
191011813,5,3,6,1,5,20
191011814,8,0,5,7,1,21
191011815,5,8,9,2,0,24
191011816,1,5,1,0,3,10
191011817,7,5,7,2,9,30
191011818,2,5,9,6,9,31
191011819,7,2,9,0,4,22
191011820,6,1,0,9,7,23
191011821,7,7,9,2,9,34
191011822,6,4,3,2,4,19
191011823,2,8,3,6,0,19
191011824,6,5,9,1,0,21
191011825,7,8,2,6,9,32
191011826,5,1,2,4,1,13
191011827,5,9,8,6,8,36
191011828,4,2,7,4,8,25
191011829,9,9,5,5,3,31
191011830,4,2,7,5,2,20
191011831,4,5,3,2,3,17
191011832,5,0,4,0,5,14
191011833,0,2,0,9,0,11
191011834,7,4,6,7,0,24
191011835,4,1,9,7,9,30
191011836,5,1,0,0,1,7
191011837,7,3,9,2,5,26
191011838,3,7,7,1,9,27
191011839,9,1,5,7,9,31
191011840,6,8,7,2,9,32
191011841,6,9,4,1,1,21
191011842,2,0,3,4,6,15
191011843,9,6,5,9,5,34
191011844,1,6,1,9,1,18
191011845,8,2,7,0,6,23
191011846,3,5,0,6,1,15
191011847,6,6,2,1,4,19
191011848,6,5,1,6,9,27
191011849,0,6,5,9,6,26
191011850,4,4,4,4,6,22
191011851,6,9,6,2,3,26
191011852,9,7,0,9,8,33
191011853,9,6,1,1,2,19
191011854,5,4,0,9,0,18
191011855,2,4,3,2,9,20
191011856,1,6,2,6,3,18
191011857,8,7,4,9,6,34
191011858,4,1,6,2,6,19
191011859,2,2,3,1,5,13
191011860,4,8,2,7,8,29
191011861,6,2,3,9,0,20
191011862,7,0,0,1,0,8
191011863,4,5,2,2,9,22
191011864,1,6,8,1,5,21
191011865,9,6,1,0,5,21
191011866,3,7,1,8,3,22
191011867,6,0,9,2,2,19
191011868,1,1,5,7,4,18
191011869,9,2,0,8,8,27
191011870,9,3,4,5,4,25
191011871,3,5,1,7,8,24
191011872,8,7,7,0,1,23
191011873,2,4,5,5,4,20
191011874,9,2,2,9,6,28
191011875,5,9,3,1,3,21
191011876,7,9,4,0,5,25
191011877,4,0,9,4,6,23
191011878,7,2,0,0,2,11
191011879,3,1,0,4,6,14
191011880,1,5,5,2,0,13
191011881,6,1,7,0,3,17
191011882,9,6,8,7,9,39
191011883,5,3,2,4,4,18
191011884,0,9,3,8,3,23
191011885,3,9,3,7,1,23
191011886,6,9,8,6,0,29
191011887,1,7,6,7,2,23
191011888,1,3,3,3,0,10
191011889,9,1,4,3,4,21
191011890,8,9,0,4,4,25
191011891,1,6,9,0,7,23
191011892,4,1,4,5,6,20
191011893,1,9,4,5,3,22
191011894,6,1,1,3,2,13
191011895,1,7,2,7,2,19
191011896,3,4,5,7,4,23
191011897,8,8,1,3,4,24
191011898,2,2,6,3,3,16
191011899,5,1,5,5,2,18
191011900,4,7,7,2,3,23
191011901,9,5,2,9,4,29
191011902,1,4,4,6,4,19
191011903,8,3,6,0,6,23
191011904,3,7,4,0,8,22
191011905,7,8,4,6,9,34
191011906,0,6,3,7,8,24
191011907,1,2,3,5,9,20
191011908,9,1,0,1,9,20
191011909,6,7,2,4,7,26
191011910,4,4,8,8,9,33
191011911,1,6,6,6,9,28
191011912,5,6,4,6,5,26
191011913,8,2,4,3,4,21
191011914,5,3,3,0,1,12
191011915,5,4,8,0,6,23
191011916,1,1,4,7,0,13
191011917,1,2,7,4,3,17
191011918,9,3,9,9,9,39
191011919,0,1,4,9,1,15
191011920,1,0,3,3,5,12
191011921,2,3,4,0,9,18
191011922,7,8,0,1,8,24
191011923,2,5,3,9,3,22
191011924,7,6,1,1,2,17
191011925,2,0,8,5,1,16
191011926,2,1,2,4,1,10
191011927,9,0,4,7,6,26
191011928,8,1,0,4,0,13
191011929,0,9,8,2,8,27
191011930,1,8,7,5,2,23
191011931,9,7,3,5,6,30
191011932,3,8,7,2,0,20
191011933,4,0,2,3,6,15
191011934,9,7,4,1,1,22
191011935,2,6,6,7,6,27
191011936,1,0,6,6,9,22
191011937,3,3,8,1,0,15
191011938,5,2,9,3,6,25
191011939,6,5,5,2,0,18
191011940,8,2,9,1,4,24
191011941,4,2,9,3,4,22
191011942,6,3,1,1,7,18
191011943,3,8,2,3,0,16
191011944,7,8,0,0,7,22
191011945,7,6,7,6,3,29
191011946,5,1,8,6,7,27
191011947,0,2,7,0,0,9
191011948,1,6,8,3,1,19
191011949,2,9,5,4,3,23
191011950,8,8,1,9,6,32
191011951,8,6,6,6,3,29
191011952,0,6,4,4,9,23
191011953,7,4,5,4,5,25
191011954,9,9,0,8,7,33
191011955,5,2,4,0,3,14
191011956,2,0,6,4,3,15
191011957,4,8,9,2,4,27
191011958,3,0,9,0,6,18
191011959,3,5,5,0,7,20
191011960,0,8,3,7,7,25
191011961,8,9,4,6,5,32
191011962,4,1,2,0,7,14
191011963,9,4,7,9,0,29
191011964,2,1,1,7,1,12
191011965,9,3,0,6,5,23
191011966,2,1,9,4,4,20
191011967,7,8,1,2,4,22
191011968,9,0,9,0,8,26
191011969,6,7,0,3,0,16
191011970,2,1,4,2,6,15
191011971,9,6,8,3,1,27
191011972,4,7,0,7,0,18
191011973,3,0,4,0,8,15
191011974,5,7,4,6,7,29
191011975,5,6,2,4,9,26
191011976,0,3,4,7,2,16
191011977,4,8,2,7,7,28
191011978,0,3,6,9,3,21
191011979,0,5,6,9,4,24
191011980,5,1,9,8,1,24
191011981,5,8,8,3,8,32
191011982,0,8,8,2,5,23
191011983,3,0,5,1,1,10
191011984,3,7,1,6,1,18
191011985,6,7,6,4,9,32
191011986,4,3,6,3,2,18
191011987,7,5,4,6,7,29
191011988,0,7,6,3,1,17
191011989,8,8,9,7,2,34
191011990,2,1,5,2,8,18
191011991,9,1,5,8,4,27
191011992,4,1,8,1,2,16
191011993,4,6,7,0,5,22
191011994,6,8,4,2,5,25
191011995,5,0,7,6,5,23
191011996,8,8,8,5,5,34
191011997,2,7,8,3,3,23
191011998,3,5,6,1,4,19
191011999,4,0,3,6,2,15
1910111000,7,1,6,3,0,17
1910111001,9,8,7,3,0,27
1910111002,9,4,6,5,8,32
1910111003,7,1,1,0,7,16
1910111004,9,7,4,4,0,24
1910111005,9,3,2,9,1,24
1910111006,9,5,9,7,8,38
1910111007,3,1,0,4,7,15
1910111008,2,2,7,7,1,19
1910111009,0,6,2,8,1,17
1910111010,7,2,5,5,6,25
1910111011,2,1,6,8,0,17
1910111012,1,8,5,0,4,18
1910111013,1,4,0,5,8,18
1910111014,3,8,6,4,4,25
1910111015,6,4,6,3,1,20
1910111016,1,6,5,9,5,26
1910111017,2,4,9,4,4,23
1910111018,7,8,6,8,2,31
1910111019,8,2,0,3,7,20
1910111020,9,7,3,8,9,36
1910111021,2,0,4,1,3,10
1910111022,5,4,1,6,9,25
1910111023,8,9,4,0,5,26
1910111024,9,3,6,1,3,22
1910111025,3,3,7,0,8,21
1910111026,0,1,0,6,8,15
1910111027,4,3,9,1,1,18
1910111028,6,3,1,6,1,17
1910111029,7,9,0,6,3,25
1910111030,6,8,3,1,1,19
1910111031,4,5,9,7,0,25
1910111032,1,3,2,0,1,7
1910111033,5,1,1,6,5,18
1910111034,0,4,5,2,7,18
1910111035,2,2,2,7,2,15
1910111036,5,3,3,3,7,21
1910111037,0,0,0,0,6,6
1910111038,4,6,3,5,8,26
1910111039,4,4,0,9,9,26
1910111040,6,4,4,4,8,26
1910111041,7,2,5,4,3,21
1910111042,5,7,7,0,0,19
1910111043,0,0,5,1,3,9
1910111044,8,1,8,8,6,31
1910111045,1,4,5,7,9,26
1910111046,6,2,0,9,7,24
1910111047,5,9,0,0,9,23
1910111048,1,6,9,1,1,18
1910111049,4,8,2,4,8,26
1910111050,7,2,5,9,0,23
1910111051,5,2,2,0,0,9
1910111052,9,4,8,5,3,29
1910111053,4,1,2,9,8,24
1910111054,3,0,9,8,4,24
1910111055,5,8,1,0,3,17
1910111056,5,9,2,4,4,24
1910111057,2,1,6,7,1,17
1910111058,6,7,3,9,3,28
1910111059,2,1,1,8,5,17
1910111060,4,9,5,5,9,32
1910111061,3,2,6,2,5,18
1910111062,0,7,7,4,2,20
1910111063,4,5,2,9,7,27
1910111064,4,1,6,3,2,16
1910111065,0,9,8,5,9,31
1910111066,7,9,4,0,7,27
1910111067,7,5,2,7,3,24
1910111068,5,0,1,5,1,12
1910111069,8,3,4,6,6,27
1910111070,2,2,4,0,5,13
1910111071,0,2,3,2,3,10
1910111072,3,2,5,9,6,25
1910111073,2,9,4,9,8,32
1910111074,0,0,6,9,8,23
1910111075,2,0,0,8,4,14
1910111076,6,3,9,5,3,26
1910111077,2,3,7,7,5,24
1910111078,5,9,1,8,9,32
1910111079,4,2,9,6,8,29
1910111080,6,4,3,1,7,21
1910111081,2,9,2,0,1,14
1910111082,2,6,3,6,0,17
1910111083,9,7,4,1,8,29
1910111084,7,3,3,0,1,14
1910111085,7,5,6,8,7,33
1910111086,8,1,8,8,0,25
1910111087,0,5,1,8,6,20
1910111088,0,5,0,7,7,19
1910111089,7,9,5,5,0,26
1910111090,8,3,5,1,5,22
1910111091,1,5,4,6,8,24
1910111092,2,2,1,1,5,11
1910111093,4,7,6,1,4,22
1910111094,6,4,7,5,2,24
1910111095,1,2,6,2,0,11
1910111096,4,1,5,5,6,21
1910111097,1,0,3,3,7,14
1910111098,2,4,1,0,2,9
1910111099,7,2,7,0,1,17
1910111100,6,1,3,3,7,20
1910111101,4,6,1,2,8,21
1910111102,5,0,2,4,2,13
1910111103,5,5,4,4,9,27
1910111104,3,8,8,1,0,20
1910111105,3,6,5,5,0,19
191012001,4,7,0,3,3,17
191012002,0,0,4,0,7,11
191012003,6,8,5,2,0,21
191012004,8,9,2,0,3,22
191012005,8,2,3,5,5,23
191012006,3,7,6,6,9,31
191012007,2,4,3,7,0,16
191012008,4,4,2,2,5,17
191012009,5,6,8,7,1,27
191012010,8,1,7,1,0,17
191012011,3,1,8,2,4,18
191012012,1,2,4,9,1,17
191012013,0,7,7,6,3,23
191012014,1,9,1,0,7,18
191012015,4,9,6,9,7,35
191012016,7,4,3,3,0,17
191012017,6,5,2,0,9,22
191012018,0,2,3,6,6,17
191012019,2,7,8,5,2,24
191012020,1,9,7,7,4,28
191012021,4,2,8,4,7,25
191012022,6,4,2,3,8,23
191012023,0,5,1,8,7,21
191012024,3,0,3,0,4,10
191012025,2,6,2,7,0,17
191012026,2,6,9,3,9,29
191012027,7,3,8,8,7,33
191012028,0,9,0,8,5,22
191012029,1,2,4,3,8,18
191012030,4,4,4,1,4,17
191012031,4,7,6,3,7,27
191012032,3,2,7,6,6,24
191012033,4,7,0,3,0,14
191012034,2,4,0,6,5,17
191012035,4,8,2,8,0,22
191012036,5,8,4,4,0,21
191012037,6,3,2,2,3,16
191012038,3,1,0,3,8,15
191012039,2,8,4,1,9,24
191012040,6,6,9,0,7,28
191012041,5,1,5,7,4,22
191012042,0,4,8,0,2,14
191012043,9,8,0,4,8,29
191012044,4,2,7,9,3,25
191012045,5,7,6,4,5,27
191012046,2,1,2,0,7,12
191012047,8,4,9,5,1,27
191012048,1,9,8,3,1,22
191012049,2,4,4,7,3,20
191012050,9,0,9,3,3,24
191012051,7,1,5,5,7,25
191012052,0,0,4,7,2,13
191012053,9,2,6,9,9,35
191012054,1,5,4,4,2,16
191012055,5,3,3,4,0,15
191012056,3,5,3,7,0,18
191012057,4,1,8,6,4,23
191012058,5,5,4,2,4,20
191012059,0,7,5,0,6,18
191012060,9,7,7,9,8,40
191012061,3,8,7,4,3,25
191012062,8,2,2,7,3,22
191012063,4,8,0,5,9,26
191012064,3,9,1,5,2,20
191012065,1,2,2,4,4,13
191012066,3,5,1,7,9,25
191012067,6,8,0,4,1,19
191012068,1,3,2,1,7,14
191012069,4,1,8,6,3,22
191012070,6,2,6,8,8,30
191012071,1,4,8,9,8,30
191012072,5,3,2,3,1,14
191012073,0,3,8,9,6,26
191012074,4,8,1,1,3,17
191012075,5,9,5,3,9,31
191012076,9,5,9,3,7,33
191012077,8,7,7,6,3,31
191012078,7,4,5,4,6,26
191012079,8,7,6,8,3,32
191012080,2,2,6,9,6,25
191012081,6,2,4,7,6,25
191012082,0,6,7,5,6,24
191012083,3,3,1,7,0,14
191012084,8,4,2,6,2,22
191012085,7,8,8,0,6,29
191012086,0,3,5,3,8,19
191012087,3,9,0,9,6,27
191012088,4,6,0,1,4,15
191012089,9,1,1,9,4,24
191012090,1,5,1,6,3,16
191012091,2,5,8,3,5,23
191012092,9,5,5,6,9,34
191012093,5,5,5,4,9,28
191012094,0,4,4,3,7,18
191012095,0,6,8,7,7,28
191012096,2,0,0,9,4,15
191012097,1,9,7,0,6,23
191012098,5,6,2,1,9,23
191012099,9,4,4,3,2,22
191012100,1,4,1,1,6,13
191012101,9,4,1,7,1,22
191012102,3,5,8,9,6,31
191012103,7,1,5,1,6,20
191012104,5,3,6,4,2,20
191012105,4,4,3,8,7,26
191012106,8,6,1,0,2,17
191012107,4,3,5,4,2,18
191012108,5,3,0,4,4,16
191012109,4,3,3,6,7,23
191012110,8,6,1,6,2,23
191012111,4,6,8,1,8,27
191012112,3,2,0,8,3,16
191012113,1,5,5,9,1,21
191012114,7,1,2,4,5,19
191012115,0,1,0,2,3,6
191012116,9,8,9,0,7,33
191012117,0,8,1,2,7,18
191012118,3,1,5,1,7,17
191012119,3,9,0,5,6,23
191012120,0,5,0,4,0,9
191012121,1,9,8,7,5,30
191012122,4,6,2,5,8,25
191012123,9,6,4,5,9,33
191012124,8,3,6,3,1,21
191012125,4,3,4,3,6,20
191012126,3,3,6,6,8,26
191012127,4,3,9,7,2,25
191012128,3,4,6,5,9,27
191012129,7,8,0,4,5,24
191012130,7,9,4,2,0,22
191012131,2,1,4,1,2,10
191012132,8,4,5,8,2,27
191012133,7,8,6,9,6,36
191012134,9,2,3,7,7,28
191012135,0,3,9,8,9,29
191012136,3,7,3,9,0,22
191012137,1,8,7,8,8,32
191012138,9,9,6,5,6,35
191012139,4,8,9,9,5,35
191012140,9,9,2,8,3,31
191012141,9,0,3,7,9,28
191012142,1,8,4,9,4,26
191012143,6,1,3,6,9,25
191012144,2,1,6,9,0,18
191012145,0,5,5,3,1,14
191012146,3,9,5,0,0,17
191012147,0,9,5,2,1,17
191012148,0,0,6,9,6,21
191012149,7,0,0,9,4,20
191012150,1,8,3,3,0,15
191012151,8,0,2,2,9,21
191012152,9,4,7,8,0,28
191012153,2,2,4,9,4,21
191012154,6,9,7,1,1,24
191012155,7,7,3,1,3,21
191012156,0,7,7,8,8,30
191012157,9,3,8,0,1,21
191012158,2,4,0,5,2,13
191012159,0,9,6,8,9,32
191012160,0,6,3,3,8,20
191012161,0,0,0,8,1,9
191012162,7,6,6,6,9,34
191012163,5,8,7,5,0,25
191012164,4,2,4,7,0,17
191012165,1,3,4,5,7,20
191012166,4,8,1,7,5,25
191012167,5,8,4,2,5,24
191012168,6,1,4,8,1,20
191012169,4,8,8,5,7,32
191012170,1,3,2,0,0,6
191012171,8,5,8,4,5,30
191012172,1,8,3,5,0,17
191012173,5,9,3,5,2,24
191012174,4,3,1,4,9,21
191012175,0,8,5,9,4,26
191012176,6,4,6,5,6,27
191012177,3,6,8,3,4,24
191012178,3,1,6,7,1,18
191012179,5,6,8,5,4,28
191012180,9,2,6,1,1,19
191012181,3,1,6,6,1,17
191012182,4,7,4,8,5,28
191012183,4,8,3,8,5,28
191012184,3,5,9,9,7,33
191012185,8,8,5,8,1,30
191012186,2,2,2,5,9,20
191012187,4,2,0,1,8,15
191012188,9,1,2,8,8,28
191012189,8,0,4,1,3,16
191012190,9,1,9,3,6,28
191012191,2,5,4,1,6,18
191012192,8,3,1,1,3,16
191012193,7,9,9,7,7,39
191012194,8,8,6,3,9,34
191012195,5,3,5,4,9,26
191012196,2,9,7,6,9,33
191012197,9,5,8,5,8,35
191012198,4,0,8,5,7,24
191012199,6,7,5,5,6,29
191012200,0,4,4,4,9,21
191012201,1,3,9,6,2,21
191012202,0,3,5,4,5,17
191012203,5,7,1,4,9,26
191012204,6,7,9,2,8,32
191012205,5,1,7,2,0,15
191012206,5,2,0,8,0,15
191012207,9,6,2,9,4,30
191012208,6,9,6,8,9,38
191012209,5,1,9,9,7,31
191012210,6,9,2,2,6,25
191012211,8,2,3,4,0,17
191012212,0,7,6,0,8,21
191012213,7,3,1,6,2,19
191012214,7,2,7,3,2,21
191012215,1,4,1,9,0,15
191012216,9,2,9,0,2,22
191012217,8,7,1,7,7,30
191012218,3,3,4,5,2,17
191012219,3,9,2,9,7,30
191012220,9,8,5,3,0,25
191012221,7,9,4,1,0,21
191012222,2,3,7,4,7,23
191012223,0,5,6,0,7,18
191012224,9,6,2,4,7,28
191012225,9,6,5,8,7,35
191012226,5,2,6,6,0,19
191012227,2,2,0,9,8,21
191012228,2,8,0,1,0,11
191012229,2,4,9,3,7,25
191012230,2,3,3,6,2,16
191012231,8,6,2,8,2,26
191012232,1,0,5,0,8,14
191012233,1,4,3,4,4,16
191012234,5,7,2,7,4,25
191012235,1,5,7,1,0,14
191012236,6,2,4,8,2,22
191012237,9,3,2,5,8,27
191012238,7,8,7,6,4,32
191012239,9,5,5,5,8,32
191012240,8,5,9,2,3,27
191012241,3,5,2,2,2,14
191012242,7,6,8,5,6,32
191012243,0,6,0,7,7,20
191012244,6,7,7,0,7,27
191012245,0,8,1,1,8,18
191012246,9,5,2,7,4,27
191012247,6,4,4,3,7,24
191012248,0,1,1,6,6,14
191012249,2,8,9,9,2,30
191012250,1,4,9,9,4,27
191012251,5,9,5,2,5,26
191012252,4,5,5,1,3,18
191012253,2,8,7,0,9,26
191012254,3,0,6,2,1,12
191012255,9,4,4,9,5,31
191012256,2,8,4,0,8,22
191012257,0,1,1,2,4,8
191012258,6,6,4,7,6,29
191012259,4,0,0,0,2,6
191012260,9,8,3,3,6,29
191012261,8,7,7,2,7,31
191012262,9,3,2,3,1,18
191012263,0,3,3,5,6,17
191012264,2,3,5,2,6,18
191012265,7,1,4,7,3,22
191012266,7,7,4,0,4,22
191012267,4,5,6,3,7,25
191012268,2,7,2,6,7,24
191012269,8,2,0,2,3,15
191012270,4,0,4,5,8,21
191012271,8,0,2,0,2,12
191012272,7,6,5,9,9,36
191012273,6,8,1,6,8,29
191012274,8,2,8,7,8,33
191012275,5,7,2,7,8,29
191012276,4,5,2,2,1,14
191012277,5,8,4,1,8,26
191012278,6,9,3,1,4,23
191012279,1,3,8,4,0,16
191012280,2,2,7,5,2,18
191012281,5,1,2,1,2,11
191012282,6,2,1,9,9,27
191012283,9,7,2,3,5,26
191012284,2,9,4,6,4,25
191012285,8,3,0,7,4,22
191012286,0,9,5,6,2,22
191012287,8,5,6,4,5,28
191012288,4,8,1,9,1,23
191012289,4,7,6,4,7,28
191012290,2,8,8,8,6,32
191012291,3,8,3,9,4,27
191012292,2,8,4,7,7,28
191012293,5,5,0,6,8,24
191012294,7,6,1,6,7,27
191012295,1,5,6,6,0,18
191012296,8,2,4,6,8,28
191012297,5,9,0,4,1,19
191012298,1,2,0,5,4,12
191012299,3,2,6,6,7,24
191012300,4,9,3,6,8,30
191012301,8,8,0,2,3,21
191012302,9,5,9,7,0,30
191012303,1,5,8,6,7,27
191012304,3,6,0,3,4,16
191012305,5,8,7,0,6,26
191012306,7,3,0,0,4,14
191012307,7,9,1,7,3,27
191012308,0,2,5,4,1,12
191012309,5,1,1,4,7,18
191012310,1,9,6,1,0,17
191012311,0,3,9,0,8,20
191012312,5,7,9,1,0,22
191012313,7,4,9,7,4,31
191012314,6,7,0,9,9,31
191012315,5,9,0,0,0,14
191012316,5,2,0,7,4,18
191012317,5,1,2,1,7,16
191012318,0,0,8,5,6,19
191012319,9,4,7,7,9,36
191012320,4,7,7,4,3,25
191012321,1,6,3,2,2,14
191012322,7,6,3,5,3,24
191012323,3,6,9,2,9,29
191012324,9,0,4,9,4,26
191012325,0,8,2,3,4,17
191012326,0,5,0,3,1,9
191012327,1,7,4,4,8,24
191012328,5,6,6,0,5,22
191012329,7,2,3,7,3,22
191012330,0,6,9,2,5,22
191012331,8,1,4,6,7,26
191012332,5,0,8,3,3,19
191012333,5,5,9,9,5,33
191012334,4,4,4,7,4,23
191012335,9,4,6,8,6,33
191012336,1,4,9,5,0,19
191012337,2,5,7,6,4,24
191012338,1,2,8,3,5,19
191012339,8,3,9,2,1,23
191012340,6,9,1,0,0,16
191012341,3,0,2,5,7,17
191012342,1,6,6,7,1,21
191012343,6,6,3,4,5,24
191012344,4,1,7,3,7,22
191012345,9,4,0,3,8,24
191012346,2,2,7,3,7,21
191012347,1,1,0,2,3,7
191012348,8,6,6,4,4,28
191012349,7,9,7,7,7,37
191012350,1,6,3,7,1,18
191012351,4,0,8,2,1,15
191012352,4,0,0,7,0,11
191012353,6,6,8,0,1,21
191012354,6,1,0,3,0,10
191012355,1,3,4,6,8,22
191012356,5,8,4,6,7,30
191012357,1,2,5,8,4,20
191012358,9,7,1,5,9,31
191012359,5,6,8,6,4,29
191012360,6,2,8,3,6,25
191012361,8,7,3,4,3,25
191012362,9,5,9,7,5,35
191012363,8,4,1,8,0,21
191012364,9,8,8,5,3,33
191012365,6,7,1,4,0,18
191012366,0,4,3,0,9,16
191012367,3,4,9,2,1,19
191012368,2,9,9,6,1,27
191012369,1,1,2,7,4,15
191012370,5,8,9,5,0,27
191012371,0,7,9,3,7,26
191012372,3,2,3,0,2,10
191012373,2,8,0,3,5,18
191012374,1,9,5,7,2,24
191012375,0,1,5,7,5,18
191012376,3,8,7,3,8,29
191012377,9,6,8,9,3,35
191012378,4,1,6,1,1,13
191012379,8,4,9,9,1,31
191012380,1,0,0,6,0,7
191012381,9,8,5,3,8,33
191012382,2,0,9,9,1,21
191012383,3,6,6,6,6,27
191012384,1,7,9,6,3,26
191012385,4,5,7,7,3,26
191012386,8,2,8,5,5,28
191012387,6,4,8,7,4,29
191012388,3,9,9,9,5,35
191012389,8,7,6,7,5,33
191012390,9,8,5,4,9,35
191012391,1,5,9,2,5,22
191012392,9,1,2,1,6,19
191012393,6,1,4,1,1,13
191012394,0,2,1,2,4,9
191012395,9,5,4,8,7,33
191012396,5,8,3,9,0,25
191012397,3,4,7,0,6,20
191012398,8,5,8,3,5,29
191012399,6,0,2,8,8,24
191012400,1,2,7,4,9,23
191012401,8,8,9,4,1,30
191012402,0,3,6,2,6,17
191012403,4,8,1,9,4,26
191012404,8,5,4,7,1,25
191012405,2,3,9,0,7,21
191012406,7,2,7,8,3,27
191012407,2,0,5,4,9,20
191012408,0,6,4,4,1,15
191012409,0,7,9,7,6,29
191012410,5,4,8,8,5,30
191012411,1,2,5,5,2,15
191012412,5,6,0,2,3,16
191012413,8,5,5,2,7,27
191012414,7,0,0,9,9,25
191012415,9,7,6,1,9,32
191012416,2,4,5,0,8,19
191012417,8,2,4,9,1,24
191012418,2,9,4,0,6,21
191012419,8,9,9,0,7,33
191012420,2,5,1,6,9,23
191012421,7,9,8,2,8,34
191012422,3,0,8,3,6,20
191012423,7,5,5,6,1,24
191012424,0,8,9,5,5,27
191012425,1,5,0,7,2,15
191012426,8,5,6,3,0,22
191012427,8,1,3,4,4,20
191012428,0,5,6,5,3,19
191012429,7,1,0,5,8,21
191012430,1,3,1,4,8,17
191012431,8,6,4,9,9,36
191012432,1,7,5,4,1,18
191012433,5,2,9,2,1,19
191012434,0,4,2,3,6,15
191012435,0,5,8,0,8,21
191012436,8,7,9,6,0,30
191012437,8,3,8,2,7,28
191012438,0,1,8,6,0,15
191012439,5,4,4,7,5,25
191012440,8,2,1,2,0,13
191012441,1,2,6,8,3,20
191012442,7,0,4,6,3,20
191012443,0,8,4,3,5,20
191012444,8,4,9,4,1,26
191012445,4,0,4,6,3,17
191012446,6,8,4,8,5,31
191012447,9,1,9,6,0,25
191012448,0,8,4,3,4,19
191012449,9,3,0,3,9,24
191012450,6,5,8,3,9,31
191012451,6,9,8,4,0,27
191012452,6,5,7,3,7,28
191012453,3,6,1,5,3,18
191012454,1,2,0,2,0,5
191012455,9,0,8,3,7,27
191012456,0,3,6,5,8,22
191012457,4,4,7,8,8,31
191012458,4,8,7,3,2,24
191012459,6,7,4,1,2,20
191012460,8,2,6,0,9,25
191012461,1,1,5,0,2,9
191012462,0,9,8,7,8,32
191012463,3,0,9,9,2,23
191012464,3,7,0,9,5,24
191012465,3,4,0,8,3,18
191012466,0,5,4,1,5,15
191012467,9,2,7,5,5,28
191012468,2,6,2,6,1,17
191012469,9,2,3,7,8,29
191012470,3,3,7,7,9,29
191012471,7,5,7,0,3,22
191012472,2,1,3,8,3,17
191012473,6,4,9,2,1,22
191012474,7,3,4,7,8,29
191012475,3,8,4,4,1,20
191012476,4,7,7,4,1,23
191012477,6,0,3,2,3,14
191012478,7,0,0,4,5,16
191012479,8,2,1,4,8,23
191012480,6,3,6,8,3,26
191012481,4,8,6,1,6,25
191012482,5,8,4,3,1,21
191012483,4,1,6,4,2,17
191012484,5,1,4,4,1,15
191012485,1,0,6,7,9,23
191012486,1,1,1,8,3,14
191012487,4,5,1,6,4,20
191012488,4,4,0,0,2,10
191012489,6,0,6,7,2,21
191012490,5,0,7,7,3,22
191012491,0,1,9,7,1,18
191012492,3,8,7,1,8,27
191012493,0,4,2,8,0,14
191012494,1,3,1,5,4,14
191012495,2,2,0,2,9,15
191012496,9,0,0,9,0,18
191012497,4,5,3,0,0,12
191012498,0,1,9,2,3,15
191012499,5,9,8,0,1,23
191012500,4,2,0,6,3,15
191012501,4,3,7,4,7,25
191012502,0,3,9,1,2,15
191012503,5,1,3,0,5,14
191012504,4,3,8,2,8,25
191012505,7,9,9,3,0,28
191012506,3,9,5,3,9,29
191012507,9,1,0,1,0,11
191012508,0,8,6,5,3,22
191012509,4,6,6,9,7,32
191012510,0,6,6,6,2,20
191012511,6,0,7,2,4,19
191012512,7,2,0,1,6,16
191012513,2,9,4,6,9,30
191012514,1,1,2,2,9,15
191012515,8,9,4,6,4,31
191012516,0,4,5,9,3,21
191012517,8,7,9,0,5,29
191012518,1,2,3,0,2,8
191012519,4,7,8,6,8,33
191012520,8,7,1,7,8,31
191012521,6,3,4,6,4,23
191012522,5,5,1,7,8,26
191012523,4,9,9,5,0,27
191012524,4,5,2,0,4,15
191012525,8,7,6,8,9,38
191012526,3,7,5,6,6,27
191012527,2,1,5,9,0,17
191012528,5,0,4,5,1,15
191012529,1,6,2,7,2,18
191012530,9,5,9,1,1,25
191012531,2,8,3,0,1,14
191012532,2,1,9,0,0,12
191012533,3,9,6,0,6,24
191012534,6,1,9,4,1,21
191012535,8,5,5,4,5,27
191012536,1,6,4,1,8,20
191012537,0,1,9,5,8,23
191012538,8,0,9,6,1,24
191012539,2,9,1,4,4,20
191012540,7,1,1,6,4,19
191012541,7,2,5,5,1,20
191012542,1,7,1,0,0,9
191012543,0,1,7,8,1,17
191012544,2,9,5,8,3,27
191012545,7,7,7,6,5,32
191012546,4,9,3,9,9,34
191012547,9,7,6,3,9,34
191012548,0,5,5,7,7,24
191012549,8,9,7,8,8,40
191012550,7,2,6,7,5,27
191012551,6,4,3,0,6,19
191012552,7,6,1,1,7,22
191012553,9,7,1,2,4,23
191012554,8,3,9,1,9,30
191012555,5,8,9,7,2,31
191012556,4,9,0,3,0,16
191012557,3,4,5,2,4,18
191012558,3,5,2,5,0,15
191012559,4,2,7,3,2,18
191012560,6,6,2,5,4,23
191012561,2,2,0,5,7,16
191012562,7,1,3,4,0,15
191012563,7,4,1,2,5,19
191012564,8,9,4,2,9,32
191012565,1,5,5,7,3,21
191012566,3,2,3,7,9,24
191012567,5,4,6,9,1,25
191012568,3,5,3,2,7,20
191012569,9,3,5,3,1,21
191012570,3,3,8,0,9,23
191012571,7,7,5,6,0,25
191012572,0,3,6,8,5,22
191012573,2,0,8,1,7,18
191012574,3,5,3,2,0,13
191012575,5,5,4,9,0,23
191012576,7,4,3,9,5,28
191012577,1,2,6,5,6,20
191012578,2,9,9,4,9,33
191012579,6,1,4,8,9,28
191012580,6,2,5,8,0,21
191012581,4,6,2,3,9,24
191012582,0,2,2,9,3,16
191012583,5,9,8,2,2,26
191012584,1,5,2,2,2,12
191012585,9,0,7,6,2,24
191012586,4,2,6,2,0,14
191012587,6,7,7,8,0,28
191012588,2,4,3,3,4,16
191012589,6,8,6,4,6,30
191012590,0,0,8,4,6,18
191012591,9,7,2,4,5,27
191012592,7,0,5,6,4,22
191012593,3,4,5,5,1,18
191012594,5,5,5,1,9,25
191012595,5,5,5,1,8,24
191012596,7,5,8,5,8,33
191012597,5,0,0,3,4,12
191012598,0,3,5,9,7,24
191012599,3,8,3,4,2,20
191012600,6,0,6,6,5,23
191012601,1,2,2,8,9,22
191012602,3,2,7,4,2,18
191012603,9,4,1,2,3,19
191012604,8,6,3,9,5,31
191012605,9,6,4,7,2,28
191012606,7,7,5,2,3,24
191012607,0,8,9,2,8,27
191012608,9,1,4,9,6,29
191012609,5,8,9,3,3,28
191012610,6,3,0,3,6,18
191012611,3,3,7,9,9,31
191012612,5,1,2,1,9,18
191012613,9,8,1,1,2,21
191012614,8,0,4,7,5,24
191012615,8,7,9,6,7,37
191012616,9,1,4,3,1,18
191012617,4,0,6,7,2,19
191012618,9,1,3,4,3,20
191012619,6,6,6,6,4,28
191012620,0,2,3,4,4,13
191012621,0,4,0,8,1,13
191012622,0,9,8,2,9,28
191012623,3,6,6,7,0,22
191012624,3,1,3,7,0,14
191012625,5,9,5,7,6,32
191012626,6,1,9,3,1,20
191012627,5,2,2,2,2,13
191012628,1,5,4,9,6,25
191012629,9,6,7,4,6,32
191012630,6,4,4,5,4,23
191012631,8,3,7,4,8,30
191012632,9,2,0,7,1,19
191012633,2,5,5,6,8,26
191012634,9,1,7,5,3,25
191012635,3,1,1,3,3,11
191012636,8,2,7,9,0,26
191012637,5,4,0,0,3,12
191012638,5,7,4,1,0,17
191012639,7,1,5,2,3,18
191012640,0,4,3,0,2,9
191012641,5,1,5,2,6,19
191012642,7,6,5,5,0,23
191012643,0,3,4,4,2,13
191012644,1,8,3,0,3,15
191012645,1,4,4,8,9,26
191012646,6,3,8,6,9,32
191012647,3,8,4,2,5,22
191012648,4,1,4,1,8,18
191012649,4,5,4,4,3,20
191012650,1,0,1,8,8,18
191012651,7,6,0,3,9,25
191012652,9,8,2,3,3,25
191012653,0,6,4,0,9,19
191012654,5,6,9,2,2,24
191012655,2,3,1,4,9,19
191012656,2,9,9,5,6,31
191012657,0,5,4,1,2,12
191012658,2,2,7,1,6,18
191012659,6,5,6,4,5,26
191012660,8,7,1,7,5,28
191012661,5,5,2,9,5,26
191012662,0,3,3,7,3,16
191012663,3,3,1,5,9,21
191012664,7,5,7,0,4,23
191012665,8,6,6,4,9,33
191012666,9,7,0,3,9,28
191012667,8,1,1,5,2,17
191012668,5,4,1,6,7,23
191012669,7,0,6,8,3,24
191012670,0,7,6,1,8,22
191012671,8,8,8,0,6,30
191012672,3,8,0,0,6,17
191012673,5,3,8,6,1,23
191012674,2,3,2,1,1,9
191012675,0,6,9,6,9,30
191012676,4,1,5,3,0,13
191012677,6,4,7,5,9,31
191012678,8,9,8,8,4,37
191012679,1,0,1,2,2,6
191012680,1,7,5,6,7,26
191012681,8,5,4,3,7,27
191012682,6,5,4,5,6,26
191012683,3,7,6,4,0,20
191012684,9,0,1,9,4,23
191012685,7,8,9,0,9,33
191012686,8,8,2,5,8,31
191012687,2,2,5,4,2,15
191012688,7,0,2,9,6,24
191012689,7,4,2,6,2,21
191012690,1,1,4,9,3,18
191012691,8,9,1,4,3,25
191012692,1,1,3,4,8,17
191012693,1,0,1,7,7,16
191012694,8,0,0,3,1,12
191012695,1,1,4,5,0,11
191012696,0,3,6,1,7,17
191012697,7,5,0,2,3,17
191012698,4,6,8,8,6,32
191012699,7,4,6,4,6,27
191012700,3,1,4,8,3,19
191012701,6,1,7,1,8,23
191012702,5,0,0,4,9,18
191012703,9,4,7,3,3,26
191012704,5,8,0,8,8,29
191012705,8,8,9,8,7,40
191012706,5,1,6,9,1,22
191012707,5,2,8,8,2,25
191012708,4,6,2,1,7,20
191012709,7,4,5,1,7,24
191012710,9,3,5,3,2,22
191012711,8,0,9,6,5,28
191012712,8,2,1,5,8,24
191012713,6,1,7,7,3,24
191012714,1,4,9,3,6,23
191012715,1,3,6,9,7,26
191012716,9,6,0,3,7,25
191012717,4,4,5,0,1,14
191012718,3,5,2,2,8,20
191012719,8,4,8,7,8,35
191012720,5,1,4,4,3,17
191012721,2,8,0,6,7,23
191012722,6,7,0,9,2,24
191012723,8,0,3,9,9,29
191012724,5,7,4,6,5,27
191012725,8,5,6,5,7,31
191012726,4,1,9,2,7,23
191012727,3,9,5,8,8,33
191012728,9,3,5,1,4,22
191012729,5,2,4,0,1,12
191012730,8,3,1,0,6,18
191012731,1,5,7,0,0,13
191012732,4,2,8,0,8,22
191012733,4,1,9,8,8,30
191012734,2,4,1,4,2,13
191012735,8,2,8,3,1,22
191012736,9,0,7,7,2,25
191012737,9,2,9,8,6,34
191012738,5,1,5,2,1,14
191012739,2,7,6,1,2,18
191012740,5,5,3,6,8,27
191012741,9,4,2,2,1,18
191012742,9,3,9,3,9,33
191012743,9,4,6,6,4,29
191012744,3,9,8,6,5,31
191012745,5,0,9,4,1,19
191012746,4,6,5,8,5,28
191012747,2,5,2,6,2,17
191012748,3,0,1,6,5,15
191012749,5,7,4,7,0,23
191012750,6,7,0,0,7,20
191012751,9,6,6,3,8,32
191012752,8,5,9,8,7,37
191012753,8,1,1,8,8,26
191012754,9,4,5,9,9,36
191012755,0,0,8,3,6,17
191012756,8,7,5,1,4,25
191012757,2,7,1,1,2,13
191012758,8,8,2,1,1,20
191012759,9,0,3,2,6,20
191012760,8,5,4,5,2,24
191012761,6,3,4,6,6,25
191012762,4,2,9,6,7,28
191012763,7,8,5,3,8,31
191012764,6,3,9,3,4,25
191012765,3,9,7,9,1,29
191012766,2,9,3,8,6,28
191012767,9,8,4,0,1,22
191012768,1,6,8,7,0,22
191012769,7,1,5,1,9,23
191012770,3,0,0,0,9,12
191012771,3,5,7,4,3,22
191012772,8,6,3,7,0,24
191012773,9,3,5,0,8,25
191012774,6,1,6,7,2,22
191012775,8,5,9,6,1,29
191012776,2,2,5,2,0,11
191012777,9,3,4,6,0,22
191012778,2,8,3,3,7,23
191012779,5,2,9,7,9,32
191012780,0,7,4,5,6,22
191012781,0,1,0,6,2,9
191012782,9,5,6,0,3,23
191012783,3,4,6,2,5,20
191012784,4,3,2,0,9,18
191012785,8,6,5,9,2,30
191012786,9,8,5,6,4,32
191012787,2,7,4,2,9,24
191012788,1,7,1,2,0,11
191012789,9,2,6,0,3,20
191012790,2,7,3,3,5,20
191012791,7,0,4,7,6,24
191012792,3,1,1,2,6,13
191012793,3,9,3,0,4,19
191012794,5,9,0,1,9,24
191012795,6,6,2,0,0,14
191012796,0,4,2,0,6,12
191012797,9,3,9,3,8,32
191012798,5,8,0,8,3,24
191012799,4,6,4,4,5,23
191012800,9,4,6,1,3,23
191012801,1,5,2,5,3,16
191012802,4,2,5,3,9,23
191012803,0,0,1,1,7,9
191012804,6,6,3,5,3,23
191012805,3,7,7,7,6,30
191012806,0,4,7,4,8,23
191012807,7,9,5,9,6,36
191012808,2,6,6,5,7,26
191012809,1,8,5,6,4,24
191012810,6,5,2,7,8,28
191012811,0,7,4,3,3,17
191012812,8,0,0,1,5,14
191012813,8,9,1,0,5,23
191012814,6,7,3,8,0,24
191012815,4,8,8,5,4,29
191012816,7,9,9,8,2,35
191012817,5,3,9,6,8,31
191012818,4,5,6,7,9,31
191012819,8,9,1,1,6,25
191012820,8,1,2,9,4,24
191012821,9,9,4,4,6,32
191012822,1,7,6,9,7,30
191012823,1,2,0,0,4,7
191012824,7,8,6,3,2,26
191012825,1,3,3,5,7,19
191012826,0,0,9,0,3,12
191012827,2,5,7,9,8,31
191012828,4,8,1,1,0,14
191012829,8,3,8,7,7,33
191012830,2,4,8,2,9,25
191012831,4,3,2,3,2,14
191012832,5,9,8,8,6,36
191012833,9,1,7,9,9,35
191012834,2,8,2,3,5,20
191012835,2,5,4,4,4,19
191012836,5,2,9,2,8,26
191012837,9,5,6,9,3,32
191012838,0,1,4,8,5,18
191012839,8,8,7,8,7,38
191012840,1,3,9,0,9,22
191012841,2,3,9,3,6,23
191012842,2,3,9,9,2,25
191012843,6,1,6,0,4,17
191012844,1,3,0,6,1,11
191012845,2,6,9,0,3,20
191012846,1,0,9,5,3,18
191012847,2,2,6,8,1,19
191012848,1,2,5,4,3,15
191012849,8,6,7,9,8,38
191012850,2,6,7,4,8,27
191012851,7,5,5,1,8,26
191012852,7,9,3,4,8,31
191012853,7,7,3,3,6,26
191012854,5,4,4,4,3,20
191012855,0,0,0,8,7,15
191012856,5,0,3,3,9,20
191012857,9,1,1,0,7,18
191012858,3,5,4,3,3,18
191012859,3,5,0,0,6,14
191012860,6,6,0,2,0,14
191012861,1,0,1,4,2,8
191012862,6,9,4,6,0,25
191012863,0,0,2,2,9,13
191012864,6,9,4,0,3,22
191012865,4,6,9,2,8,29
191012866,6,2,2,2,7,19
191012867,0,3,7,0,1,11
191012868,9,7,2,0,6,24
191012869,4,3,8,8,9,32
191012870,3,7,9,3,1,23
191012871,8,4,3,6,6,27
191012872,4,9,7,8,7,35
191012873,1,3,2,5,9,20
191012874,4,2,8,6,3,23
191012875,4,5,1,8,5,23
191012876,3,6,9,0,6,24
191012877,6,7,3,4,0,20
191012878,5,8,7,6,5,31
191012879,6,2,9,6,9,32
191012880,2,7,6,5,3,23
191012881,4,5,0,8,7,24
191012882,1,1,3,2,7,14
191012883,1,3,6,8,9,27
191012884,6,6,3,2,2,19
191012885,9,6,1,2,4,22
191012886,9,2,9,2,6,28
191012887,6,2,6,2,9,25
191012888,3,4,5,9,3,24
191012889,9,0,7,6,9,31
191012890,1,0,2,8,4,15
191012891,5,7,4,8,2,26
191012892,8,5,4,4,0,21
191012893,1,4,0,5,3,13
191012894,4,9,8,1,8,30
191012895,5,6,2,5,7,25
191012896,8,0,3,9,2,22
191012897,0,1,8,9,2,20
191012898,8,2,6,9,4,29
191012899,4,1,8,7,6,26
191012900,4,9,3,3,3,22
191012901,9,7,7,3,2,28
191012902,0,0,1,2,6,9
191012903,0,3,3,0,2,8
191012904,4,6,7,7,5,29
191012905,8,6,6,5,0,25
191012906,2,3,2,5,3,15
191012907,8,7,1,4,8,28
191012908,5,3,6,3,7,24
191012909,4,6,3,2,3,18
191012910,2,9,7,3,1,22
191012911,6,6,9,0,4,25
191012912,7,5,2,3,2,19
191012913,7,9,1,7,2,26
191012914,8,6,1,0,8,23
191012915,9,3,8,6,9,35
191012916,9,1,4,5,1,20
191012917,7,4,6,6,4,27
191012918,5,5,6,9,4,29
191012919,7,3,3,5,8,26
191012920,0,5,3,3,4,15
191012921,2,4,0,4,0,10
191012922,5,4,9,1,7,26
191012923,7,3,8,0,1,19
191012924,6,8,0,1,9,24
191012925,4,3,8,2,5,22
191012926,0,7,5,6,5,23
191012927,3,3,0,6,7,19
191012928,3,6,0,3,5,17
191012929,4,1,8,1,8,22
191012930,1,7,7,4,9,28
191012931,0,1,8,0,0,9
191012932,8,8,6,0,3,25
191012933,9,4,0,6,3,22
191012934,6,7,7,0,6,26
191012935,6,3,7,2,0,18
191012936,0,2,2,6,5,15
191012937,2,3,4,2,4,15
191012938,6,9,3,5,1,24
191012939,2,8,8,0,9,27
191012940,3,8,8,4,7,30
191012941,3,8,6,2,4,23
191012942,9,1,7,5,1,23
191012943,8,0,8,3,5,24
191012944,6,6,9,5,9,35
191012945,1,7,1,6,9,24
191012946,2,6,3,9,7,27
191012947,1,7,4,9,3,24
191012948,2,0,3,3,0,8
191012949,7,1,6,2,2,18
191012950,2,5,3,2,1,13
191012951,2,9,9,7,5,32
191012952,0,2,7,4,7,20
191012953,6,9,2,8,3,28
191012954,1,8,3,8,7,27
191012955,5,6,3,7,1,22
191012956,9,4,0,0,8,21
191012957,7,7,6,4,0,24
191012958,8,3,6,9,2,28
191012959,5,1,2,2,2,12
191012960,8,6,3,0,4,21
191012961,3,3,1,3,8,18
191012962,7,7,2,3,4,23
191012963,2,0,2,8,8,20
191012964,7,1,1,3,8,20
191012965,3,7,4,5,1,20
191012966,4,0,0,1,0,5
191012967,6,1,5,6,2,20
191012968,0,4,2,3,0,9
191012969,6,9,2,0,4,21
191012970,2,1,3,7,2,15
191012971,5,6,6,2,5,24
191012972,1,4,3,9,7,24
191012973,9,4,9,3,1,26
191012974,4,9,1,0,2,16
191012975,9,0,9,3,0,21
191012976,9,4,2,5,5,25
191012977,5,3,6,9,8,31
191012978,0,4,5,6,9,24
191012979,1,8,7,7,9,32
191012980,6,7,0,4,1,18
191012981,4,0,3,4,5,16
191012982,5,8,2,3,9,27
191012983,4,2,1,8,5,20
191012984,2,8,5,4,8,27
191012985,5,1,7,9,7,29
191012986,4,2,0,4,2,12
191012987,9,1,3,9,6,28
191012988,9,0,2,7,0,18
191012989,0,6,7,7,0,20
191012990,7,4,6,2,7,26
191012991,7,7,9,7,7,37
191012992,0,2,9,4,7,22
191012993,8,1,6,7,5,27
191012994,4,3,1,1,6,15
191012995,0,1,1,3,4,9
191012996,8,5,9,5,3,30
191012997,1,8,0,1,0,10
191012998,8,3,9,4,2,26
191012999,3,2,4,1,1,11
1910121000,0,9,2,1,8,20
1910121001,1,6,9,6,8,30
1910121002,2,2,4,7,4,19
1910121003,6,8,9,6,1,30
1910121004,0,8,4,1,0,13
1910121005,8,3,8,1,5,25
1910121006,5,5,8,2,6,26
1910121007,9,5,1,6,7,28
1910121008,1,3,2,1,4,11
1910121009,9,2,1,2,9,23
1910121010,7,2,6,1,1,17
1910121011,0,4,9,6,6,25
1910121012,5,6,6,6,8,31
1910121013,5,4,5,3,7,24
1910121014,4,9,7,3,4,27
1910121015,5,2,1,9,8,25
1910121016,6,6,5,2,4,23
1910121017,6,3,7,8,1,25
1910121018,8,4,8,4,5,29
1910121019,8,5,5,6,4,28
1910121020,1,8,7,7,7,30
1910121021,5,3,0,3,1,12
1910121022,8,1,0,6,5,20
1910121023,5,1,8,1,0,15
1910121024,3,2,7,2,2,16
1910121025,6,4,9,8,9,36
1910121026,1,5,2,9,1,18
1910121027,3,8,5,6,3,25
1910121028,7,8,9,6,4,34
1910121029,4,1,6,8,0,19
1910121030,7,7,8,4,8,34
1910121031,4,8,2,0,8,22
1910121032,7,7,0,1,2,17
1910121033,3,3,1,7,3,17
1910121034,8,4,7,2,4,25
1910121035,1,1,0,1,7,10
1910121036,8,6,2,4,8,28
1910121037,5,5,9,7,6,32
1910121038,0,5,5,2,4,16
1910121039,3,8,3,9,8,31
1910121040,2,9,5,6,5,27
1910121041,2,1,4,3,6,16
1910121042,6,4,2,4,5,21
1910121043,0,2,8,4,1,15
1910121044,4,9,9,2,3,27
1910121045,4,3,2,9,8,26
1910121046,9,7,7,8,1,32
1910121047,0,1,9,9,0,19
1910121048,3,9,9,9,3,33
1910121049,0,4,6,3,9,22
1910121050,8,2,8,2,4,24
1910121051,0,4,8,9,2,23
1910121052,6,1,3,3,5,18
1910121053,2,1,3,1,1,8
1910121054,5,6,9,8,3,31
1910121055,0,7,1,4,5,17
1910121056,6,7,4,5,0,22
1910121057,0,8,5,5,1,19
1910121058,2,9,1,7,9,28
1910121059,1,8,0,8,6,23
1910121060,4,2,0,6,4,16
1910121061,7,8,1,1,3,20
1910121062,7,9,4,0,9,29
1910121063,3,0,0,1,7,11
1910121064,4,7,2,3,8,24
1910121065,9,9,4,6,8,36
1910121066,8,2,8,0,3,21
1910121067,0,2,9,0,3,14
1910121068,2,8,9,1,3,23
1910121069,9,1,4,8,9,31
1910121070,3,9,7,6,4,29
1910121071,0,0,2,0,3,5
1910121072,4,7,9,8,6,34
1910121073,2,7,7,6,1,23
1910121074,3,9,4,7,9,32
1910121075,9,3,7,3,2,24
1910121076,1,5,4,1,7,18
1910121077,8,5,5,5,2,25
1910121078,1,3,4,5,3,16
1910121079,4,8,9,9,0,30
1910121080,4,6,7,2,9,28
1910121081,8,5,9,9,3,34
1910121082,4,3,5,4,6,22
1910121083,9,3,3,0,8,23
1910121084,0,1,7,0,6,14
1910121085,1,6,0,6,3,16
1910121086,0,2,3,3,9,17
1910121087,0,7,8,4,8,27
1910121088,3,2,7,5,1,18
1910121089,7,1,7,3,6,24
1910121090,8,6,3,0,8,25
1910121091,3,1,1,9,4,18
1910121092,9,6,0,8,7,30
1910121093,5,2,4,7,4,22
1910121094,8,6,0,2,6,22
1910121095,3,5,3,8,4,23
1910121096,5,0,9,2,1,17
1910121097,2,0,7,1,2,12
1910121098,8,4,7,9,8,36
1910121099,9,4,2,7,5,27
1910121100,5,4,1,5,8,23
1910121101,9,9,8,7,1,34
1910121102,3,3,9,8,9,32
1910121103,2,7,1,3,8,21
1910121104,9,6,3,4,1,23
1910121105,1,4,7,9,9,30
191013001,6,0,7,0,4,17
191013002,3,0,3,2,4,12
191013003,6,8,7,9,7,37
191013004,0,7,3,0,0,10
191013005,7,5,9,2,8,31
191013006,1,6,5,2,8,22
191013007,5,5,4,6,0,20
191013008,7,9,9,8,7,40
191013009,2,0,0,6,4,12
191013010,4,7,0,6,5,22
191013011,0,9,4,5,0,18
191013012,6,3,9,1,3,22
191013013,9,0,7,2,2,20
191013014,4,1,4,6,7,22
191013015,8,3,0,9,7,27
191013016,5,6,8,8,4,31
191013017,0,0,7,7,8,22
191013018,9,1,3,8,5,26
191013019,9,9,7,9,0,34
191013020,1,2,4,6,9,22
191013021,4,1,9,0,2,16
191013022,9,2,5,8,0,24
191013023,6,0,7,7,2,22
191013024,9,1,9,6,6,31
191013025,7,4,8,5,9,33
191013026,1,8,3,2,8,22
191013027,0,1,6,0,8,15
191013028,6,0,0,5,3,14
191013029,8,7,9,9,4,37
191013030,3,0,1,8,2,14
191013031,9,0,7,3,2,21
191013032,6,6,9,6,5,32
191013033,8,8,5,3,7,31
191013034,8,4,1,7,3,23
191013035,6,1,2,9,9,27
191013036,7,7,2,5,5,26
191013037,1,2,3,3,7,16
191013038,5,5,2,9,7,28
191013039,9,1,0,9,7,26
191013040,0,9,8,3,1,21
191013041,7,5,4,6,3,25
191013042,8,8,1,0,0,17
191013043,3,2,7,2,9,23
191013044,5,9,0,5,5,24
191013045,3,7,5,2,2,19
191013046,3,1,5,1,3,13
191013047,9,8,2,4,7,30
191013048,5,1,3,9,6,24
191013049,3,6,9,1,2,21
191013050,0,0,0,9,1,10
191013051,8,8,7,2,0,25
191013052,3,7,2,5,2,19
191013053,7,3,8,0,8,26
191013054,1,9,1,5,8,24
191013055,9,9,5,9,8,40
191013056,7,1,2,5,3,18
191013057,2,2,9,8,4,25
191013058,8,9,3,4,1,25
191013059,4,8,9,8,1,30
191013060,5,5,6,3,7,26
191013061,1,2,1,7,9,20
191013062,2,8,7,2,9,28
191013063,6,9,5,5,5,30
191013064,7,2,6,2,8,25
191013065,1,1,9,9,1,21
191013066,0,0,7,3,4,14
191013067,6,5,8,7,1,27
191013068,1,2,0,8,7,18
191013069,9,8,9,8,5,39
191013070,4,1,6,8,2,21
191013071,2,3,4,4,5,18
191013072,2,7,7,7,7,30
191013073,1,6,9,0,6,22
191013074,7,6,7,9,8,37
191013075,1,5,9,2,4,21
191013076,6,9,5,9,9,38
191013077,7,3,4,1,1,16
191013078,5,2,0,5,5,17
191013079,0,0,6,3,4,13
191013080,5,1,0,8,9,23
191013081,3,8,1,5,7,24
191013082,4,8,9,5,5,31
191013083,2,6,1,4,2,15
191013084,2,0,3,3,6,14
191013085,5,3,2,1,0,11
191013086,0,0,6,2,5,13
191013087,5,0,2,2,9,18
191013088,6,7,2,7,5,27
191013089,3,3,6,9,6,27
191013090,9,8,9,8,6,40
191013091,4,5,3,2,5,19
191013092,4,6,7,1,2,20
191013093,2,6,4,9,5,26
191013094,5,5,0,2,5,17
191013095,0,8,3,9,2,22
191013096,9,5,8,0,8,30
191013097,0,5,0,5,9,19
191013098,3,6,9,6,9,33
191013099,0,8,8,7,5,28
191013100,8,9,0,6,2,25
191013101,6,8,6,6,7,33
191013102,6,5,0,4,6,21
191013103,1,2,6,8,0,17
191013104,5,3,7,1,7,23
191013105,3,4,5,5,3,20
191013106,2,0,9,8,9,28
191013107,3,9,1,5,5,23
191013108,9,8,9,7,4,37
191013109,9,2,6,7,3,27
191013110,9,5,4,9,7,34
191013111,9,9,6,2,2,28
191013112,0,2,2,3,3,10
191013113,7,0,1,1,1,10
191013114,5,0,6,5,7,23
191013115,4,2,8,6,1,21
191013116,1,1,1,9,7,19
191013117,9,2,0,9,2,22
191013118,1,2,8,8,5,24
191013119,1,8,4,6,7,26
191013120,3,1,4,5,5,18
191013121,2,9,8,0,7,26
191013122,6,8,1,6,2,23
191013123,4,6,1,1,4,16
191013124,7,4,0,0,0,11
191013125,5,8,6,8,4,31
191013126,6,1,2,2,2,13
191013127,4,5,8,8,4,29
191013128,0,6,8,0,7,21
191013129,4,1,8,6,9,28
191013130,5,5,3,4,9,26
191013131,0,8,7,0,2,17
191013132,6,0,8,7,3,24
191013133,5,1,1,8,0,15
191013134,7,5,6,9,7,34
191013135,5,2,3,7,3,20
191013136,2,0,8,6,7,23
191013137,3,7,6,2,9,27
191013138,7,6,0,5,2,20
191013139,0,0,6,1,3,10
191013140,4,7,1,5,7,24
191013141,1,6,8,6,5,26
191013142,7,5,0,6,2,20
191013143,6,1,7,3,7,24
191013144,5,0,5,9,3,22
191013145,4,1,6,6,4,21
191013146,8,4,8,3,9,32
191013147,8,0,1,9,0,18
191013148,1,6,8,0,6,21
191013149,7,7,5,4,3,26
191013150,2,8,9,9,4,32
191013151,9,1,7,6,8,31
191013152,0,3,5,6,3,17
191013153,2,4,8,8,8,30
191013154,2,6,7,1,6,22
191013155,7,0,8,0,1,16
191013156,9,3,2,4,6,24
191013157,0,9,4,0,7,20
191013158,6,3,3,1,7,20
191013159,7,1,7,5,0,20
191013160,2,6,2,0,1,11
191013161,7,2,9,1,2,21
191013162,6,6,9,7,8,36
191013163,7,1,5,6,7,26
191013164,5,8,2,6,2,23
191013165,8,8,3,9,2,30
191013166,5,6,2,4,3,20
191013167,2,2,2,9,8,23
191013168,6,1,2,1,0,10
191013169,7,8,6,5,4,30
191013170,7,5,0,7,0,19
191013171,5,0,6,5,4,20
191013172,8,6,4,0,6,24
191013173,1,8,6,1,1,17
191013174,2,5,6,4,2,19
191013175,7,1,6,2,0,16
191013176,7,5,1,1,5,19
191013177,1,2,1,4,3,11
191013178,6,2,0,4,1,13
191013179,6,8,5,2,7,28
191013180,4,5,0,3,3,15
191013181,9,6,4,7,1,27
191013182,3,0,2,7,7,19
191013183,2,6,7,2,5,22
191013184,3,7,3,5,8,26
191013185,9,1,9,5,5,29
191013186,9,5,9,0,5,28
191013187,4,6,6,9,1,26
191013188,1,7,1,4,3,16
191013189,2,3,1,3,0,9
191013190,3,0,0,7,0,10
191013191,9,9,9,6,7,40
191013192,8,0,4,1,2,15
191013193,3,1,5,0,3,12
191013194,6,6,8,9,1,30
191013195,0,1,0,2,2,5
191013196,2,7,5,0,9,23
191013197,1,8,5,1,4,19
191013198,5,6,2,3,6,22
191013199,6,2,3,6,1,18
191013200,5,6,1,7,4,23
191013201,0,3,9,7,7,26
191013202,6,1,3,0,1,11
191013203,2,3,9,6,4,24
191013204,7,2,1,8,3,21
191013205,3,9,1,0,5,18
191013206,8,9,0,1,6,24
191013207,4,4,3,4,3,18
191013208,3,0,7,8,3,21
191013209,3,8,6,8,3,28
191013210,5,9,3,0,5,22
191013211,2,1,9,5,3,20
191013212,6,4,7,6,5,28
191013213,3,6,5,9,2,25
191013214,8,2,4,5,6,25
191013215,3,6,4,7,4,24
191013216,9,4,9,7,0,29
191013217,8,7,6,8,6,35
191013218,0,0,4,7,6,17
191013219,2,7,1,0,3,13
191013220,7,0,2,4,5,18
191013221,5,3,9,2,6,25
191013222,2,0,8,0,2,12
191013223,0,0,4,7,8,19
191013224,4,9,7,6,9,35
191013225,8,1,1,6,2,18
191013226,1,4,7,8,2,22
191013227,7,3,3,6,0,19
191013228,6,4,9,2,4,25
191013229,0,8,4,0,7,19
191013230,1,2,5,3,4,15
191013231,3,0,5,3,9,20
191013232,2,2,9,1,5,19
191013233,6,3,3,8,7,27
191013234,3,9,6,6,1,25
191013235,2,2,2,8,7,21
191013236,7,1,2,8,5,23
191013237,5,1,9,0,9,24
191013238,8,5,1,2,5,21
191013239,4,4,9,4,3,24
191013240,3,0,7,6,2,18
191013241,7,8,2,9,9,35
191013242,0,7,1,3,9,20
191013243,2,3,7,7,1,20
191013244,7,6,7,4,4,28
191013245,5,9,7,9,7,37
191013246,7,1,1,5,0,14
191013247,9,0,8,4,9,30
191013248,0,2,6,3,3,14
191013249,8,2,7,1,6,24
191013250,1,1,3,9,6,20
191013251,6,1,9,8,0,24
191013252,3,4,7,2,3,19
191013253,7,7,4,0,7,25
191013254,8,3,8,3,1,23
191013255,8,0,8,6,7,29
191013256,1,8,9,7,5,30
191013257,4,1,9,5,2,21
191013258,7,5,5,6,5,28
191013259,3,3,7,7,4,24
191013260,2,2,4,4,3,15
191013261,7,1,8,1,1,18
191013262,6,7,2,9,5,29
191013263,2,9,8,2,9,30
191013264,5,6,7,1,0,19
191013265,2,0,0,0,3,5
191013266,8,9,1,9,1,28
191013267,6,8,8,7,2,31
191013268,5,4,2,7,0,18
191013269,4,6,4,9,8,31
191013270,8,1,5,1,0,15
191013271,8,0,6,8,5,27
191013272,6,4,3,1,9,23
191013273,0,7,6,0,6,19
191013274,7,9,3,1,1,21
191013275,9,0,5,7,5,26
191013276,8,5,4,1,2,20
191013277,1,7,9,5,6,28
191013278,7,4,0,7,8,26
191013279,4,1,6,4,6,21
191013280,5,5,9,3,8,30
191013281,9,4,8,9,3,33
191013282,1,5,1,3,1,11
191013283,5,8,5,7,8,33
191013284,9,1,4,2,5,21
191013285,3,1,4,3,8,19
191013286,6,4,1,4,1,16
191013287,6,3,2,6,6,23
191013288,4,0,2,9,5,20
191013289,8,1,0,8,4,21
191013290,1,6,5,2,3,17
191013291,7,0,2,7,3,19
191013292,0,6,6,2,8,22
191013293,6,0,5,0,2,13
191013294,0,8,1,9,6,24
191013295,2,6,6,5,6,25
191013296,2,6,6,1,5,20
191013297,0,2,0,3,8,13
191013298,1,1,1,2,1,6
191013299,1,6,1,3,1,12
191013300,2,2,1,3,0,8
191013301,7,1,1,9,6,24
191013302,9,8,8,3,6,34
191013303,9,7,0,1,1,18
191013304,5,2,1,2,4,14
191013305,4,8,4,8,8,32
191013306,0,6,0,7,0,13
191013307,6,4,4,6,8,28
191013308,4,0,9,5,3,21
191013309,5,9,4,7,3,28
191013310,6,1,0,9,3,19
191013311,5,7,7,9,3,31
191013312,0,0,4,7,7,18
191013313,1,1,2,8,1,13
191013314,9,4,9,5,1,28
191013315,5,3,3,6,2,19
191013316,6,8,9,3,2,28
191013317,0,9,0,0,2,11
191013318,3,5,3,4,2,17
191013319,2,8,1,0,4,15
191013320,7,0,9,7,3,26
191013321,0,6,7,0,9,22
191013322,3,7,9,2,0,21
191013323,1,3,2,6,8,20
191013324,3,4,1,1,8,17
191013325,2,7,5,4,3,21
191013326,7,2,1,8,8,26
191013327,1,3,4,0,1,9
191013328,0,5,4,7,1,17
191013329,1,3,4,6,1,15
191013330,1,0,9,0,0,10
191013331,4,6,1,0,4,15
191013332,8,1,0,2,6,17
191013333,5,1,5,6,4,21
191013334,4,7,2,5,0,18
191013335,8,6,9,2,4,29
191013336,4,2,3,0,5,14
191013337,4,5,1,7,2,19
191013338,5,9,8,1,8,31
191013339,9,0,3,4,3,19
191013340,5,8,5,5,2,25
191013341,0,5,2,5,6,18
191013342,7,1,7,8,6,29
191013343,0,1,5,4,6,16
191013344,4,3,7,1,9,24
191013345,1,0,7,1,0,9
191013346,7,8,4,2,6,27
191013347,7,2,3,8,0,20
191013348,1,1,0,2,9,13
191013349,5,9,4,9,4,31
191013350,0,1,5,3,5,14
191013351,6,4,5,2,9,26
191013352,2,7,9,1,7,26
191013353,7,6,1,1,6,21
191013354,2,4,3,2,6,17
191013355,5,1,7,0,7,20
191013356,6,6,2,4,6,24
191013357,4,8,1,9,7,29
191013358,7,7,3,1,0,18
191013359,5,6,3,7,4,25
191013360,1,1,7,9,4,22
191013361,8,3,4,0,9,24
191013362,8,7,5,9,5,34
191013363,8,7,9,0,1,25
191013364,6,9,7,0,7,29
191013365,0,3,6,1,3,13
191013366,5,5,4,0,5,19
191013367,4,3,9,8,7,31
191013368,3,3,2,7,8,23
191013369,4,0,0,9,1,14
191013370,5,5,4,9,9,32
191013371,0,6,7,0,7,20
191013372,6,0,5,1,2,14
191013373,7,1,7,0,0,15
191013374,0,2,7,9,7,25
191013375,1,2,3,7,5,18
191013376,3,8,6,1,3,21
191013377,5,1,7,1,7,21
191013378,7,8,4,8,2,29
191013379,1,4,8,2,3,18
191013380,3,7,2,4,0,16
191013381,3,8,6,3,2,22
191013382,5,5,7,5,0,22
191013383,6,6,7,4,3,26
191013384,1,9,3,0,2,15
191013385,3,2,4,9,8,26
191013386,7,1,0,9,8,25
191013387,3,3,5,0,1,12
191013388,7,1,2,7,9,26
191013389,1,5,6,8,3,23
191013390,9,1,5,7,6,28
191013391,9,0,7,6,3,25
191013392,0,5,1,8,2,16
191013393,5,1,4,0,3,13
191013394,6,7,6,8,7,34
191013395,1,0,9,5,6,21
191013396,1,1,6,6,5,19
191013397,0,1,3,6,2,12
191013398,4,3,5,2,5,19
191013399,7,2,6,2,5,22
191013400,8,0,4,6,9,27
191013401,8,5,3,9,4,29
191013402,8,5,9,1,0,23
191013403,5,8,3,4,8,28
191013404,0,0,4,6,4,14
191013405,6,9,3,5,7,30
191013406,1,6,6,8,9,30
191013407,2,2,7,5,7,23
191013408,3,2,8,1,4,18
191013409,3,8,0,1,9,21
191013410,7,9,6,4,7,33
191013411,0,5,5,2,3,15
191013412,7,0,6,8,9,30
191013413,1,4,8,6,2,21
191013414,2,7,5,9,5,28
191013415,9,7,0,8,0,24
191013416,2,4,4,1,3,14
191013417,2,2,3,2,4,13
191013418,8,3,3,2,6,22
191013419,6,1,3,1,8,19
191013420,1,1,4,7,4,17
191013421,0,0,0,0,8,8
191013422,6,0,5,4,9,24
191013423,3,1,9,3,2,18
191013424,4,3,3,1,0,11
191013425,2,9,3,2,3,19
191013426,9,2,3,7,1,22
191013427,3,8,5,0,7,23
191013428,7,0,7,2,3,19
191013429,1,6,8,9,2,26
191013430,9,6,0,8,3,26
191013431,7,1,5,7,2,22
191013432,7,4,7,3,0,21
191013433,0,3,0,2,6,11
191013434,0,9,5,3,8,25
191013435,3,2,9,9,2,25
191013436,5,9,9,4,2,29
191013437,9,8,8,0,2,27
191013438,3,1,9,2,2,17
191013439,7,7,1,0,8,23
191013440,4,8,1,8,1,22
191013441,3,8,9,2,1,23
191013442,7,6,8,9,6,36
191013443,3,0,8,6,5,22
191013444,3,6,2,0,4,15
191013445,0,8,9,2,9,28
191013446,5,3,6,8,6,28
191013447,8,3,1,4,8,24
191013448,8,3,5,1,4,21
191013449,1,4,2,9,1,17
191013450,7,5,5,0,9,26
191013451,2,7,9,3,0,21
191013452,2,7,5,8,1,23
191013453,9,4,3,1,2,19
191013454,8,3,0,5,7,23
191013455,8,1,8,9,8,34
191013456,9,6,7,7,9,38
191013457,3,1,8,3,7,22
191013458,4,3,7,7,4,25
191013459,8,7,6,6,5,32
191013460,0,0,8,4,4,16
191013461,9,0,6,8,6,29
191013462,9,6,4,1,9,29
191013463,8,7,4,6,5,30
191013464,0,7,2,7,4,20
191013465,9,5,8,6,3,31
191013466,1,6,4,2,2,15
191013467,6,8,3,5,2,24
191013468,1,7,2,9,2,21
191013469,1,0,9,7,4,21
191013470,9,1,5,0,2,17
191013471,8,8,8,5,6,35
191013472,9,5,2,5,5,26
191013473,6,6,4,8,5,29
191013474,3,6,1,6,8,24
191013475,8,2,7,7,4,28
191013476,9,5,6,5,8,33
191013477,2,1,2,3,3,11
191013478,6,9,0,6,0,21
191013479,3,3,8,3,9,26
191013480,9,8,8,9,6,40
191013481,7,4,6,2,0,19
191013482,6,9,9,2,8,34
191013483,0,9,7,8,3,27
191013484,4,5,7,4,3,23
191013485,2,1,5,1,3,12
191013486,1,5,8,0,3,17
191013487,5,2,5,2,1,15
191013488,7,3,4,7,0,21
191013489,3,1,1,4,8,17
191013490,9,5,5,3,3,25
191013491,6,3,9,1,4,23
191013492,2,0,8,1,3,14
191013493,7,9,4,5,7,32
191013494,0,6,5,0,4,15
191013495,3,5,4,9,4,25
191013496,6,4,7,0,5,22
191013497,7,5,3,8,8,31
191013498,4,4,8,3,1,20
191013499,3,4,9,3,4,23
191013500,7,4,6,6,2,25
191013501,2,4,3,7,4,20
191013502,8,7,6,9,0,30
191013503,1,2,6,0,3,12
191013504,3,6,9,6,6,30
191013505,0,2,2,7,9,20
191013506,7,7,1,8,3,26
191013507,7,1,8,5,8,29
191013508,6,0,8,5,9,28
191013509,2,6,9,2,5,24
191013510,8,1,8,7,9,33
191013511,0,2,2,8,0,12
191013512,3,6,5,4,4,22
191013513,1,8,9,9,4,31
191013514,6,4,2,7,1,20
191013515,3,1,8,0,6,18
191013516,4,2,0,5,5,16
191013517,4,6,4,7,4,25
191013518,4,1,7,4,3,19
191013519,8,3,8,4,7,30
191013520,0,8,3,3,5,19
191013521,6,8,4,3,0,21
191013522,5,7,6,1,2,21
191013523,2,5,6,2,7,22
191013524,0,5,1,4,2,12
191013525,9,2,1,7,4,23
191013526,8,1,0,4,4,17
191013527,9,3,7,7,3,29
191013528,1,6,8,8,9,32
191013529,4,3,8,5,9,29
191013530,3,3,5,0,0,11
191013531,8,0,3,6,3,20
191013532,8,6,7,3,6,30
191013533,5,9,9,6,4,33
191013534,4,9,2,5,8,28
191013535,9,7,2,6,6,30
191013536,0,3,5,3,1,12
191013537,8,1,8,7,7,31
191013538,4,9,4,4,7,28
191013539,3,7,0,4,9,23
191013540,9,1,7,1,2,20
191013541,8,5,5,6,1,25
191013542,2,2,3,7,6,20
191013543,1,7,6,3,9,26
191013544,3,2,5,0,9,19
191013545,8,2,4,4,5,23
191013546,4,6,0,6,4,20
191013547,0,2,4,7,6,19
191013548,6,4,9,7,8,34
191013549,5,8,4,2,9,28
191013550,0,1,0,2,5,8
191013551,7,8,5,7,4,31
191013552,2,4,6,5,9,26
191013553,2,4,5,4,7,22
191013554,6,1,4,8,0,19
191013555,8,0,9,7,6,30
191013556,0,1,0,1,6,8
191013557,8,9,7,6,5,35
191013558,3,6,9,5,0,23
191013559,0,9,8,9,2,28
191013560,8,3,0,7,2,20
191013561,6,1,1,8,8,24
191013562,8,7,2,3,1,21
191013563,3,5,2,7,1,18
191013564,4,4,9,7,0,24
191013565,5,5,5,4,0,19
191013566,2,0,4,9,7,22
191013567,4,9,8,7,1,29
191013568,3,5,1,6,5,20
191013569,5,4,3,6,0,18
191013570,7,5,3,6,6,27
191013571,5,0,7,1,2,15
191013572,7,4,3,9,0,23
191013573,3,6,3,8,9,29
191013574,0,3,4,3,2,12
191013575,6,8,1,8,4,27
191013576,9,4,2,8,9,32
191013577,6,1,1,9,1,18
191013578,3,1,9,8,3,24
191013579,5,2,1,2,2,12
191013580,2,5,1,5,7,20
191013581,9,0,2,6,0,17
191013582,4,8,7,6,2,27
191013583,2,4,6,4,9,25
191013584,4,1,3,9,7,24
191013585,8,9,6,3,7,33
191013586,7,5,6,6,5,29
191013587,7,4,5,3,3,22
191013588,3,6,2,3,3,17
191013589,5,4,4,5,0,18
191013590,9,9,2,1,4,25
191013591,5,0,6,3,5,19
191013592,7,9,5,6,5,32
191013593,7,1,1,1,9,19
191013594,2,0,0,5,8,15
191013595,8,7,7,9,0,31
191013596,4,0,2,2,8,16
191013597,7,1,3,0,3,14
191013598,2,2,0,2,8,14
191013599,1,3,2,7,8,21
191013600,4,6,5,5,2,22
191013601,8,3,8,6,9,34
191013602,3,0,4,0,4,11
191013603,2,5,7,2,2,18
191013604,6,7,9,2,6,30
191013605,9,4,3,9,6,31
191013606,9,9,4,7,3,32
191013607,4,7,3,7,1,22
191013608,6,6,8,7,5,32
191013609,1,6,8,6,1,22
191013610,5,5,1,7,4,22
191013611,5,8,4,3,0,20
191013612,9,4,2,7,0,22
191013613,2,8,8,2,4,24
191013614,8,0,4,6,0,18
191013615,1,0,3,2,4,10
191013616,3,5,7,3,1,19
191013617,4,8,7,1,5,25
191013618,9,4,3,9,7,32
191013619,4,6,5,2,7,24
191013620,0,5,4,5,3,17
191013621,2,0,3,5,5,15
191013622,5,1,6,4,5,21
191013623,7,2,5,1,0,15
191013624,3,6,8,8,4,29
191013625,4,3,5,5,2,19
191013626,7,3,9,9,6,34
191013627,9,0,8,9,8,34
191013628,0,0,5,5,5,15
191013629,7,4,5,2,5,23
191013630,0,2,6,4,7,19
191013631,4,7,2,5,3,21
191013632,7,2,2,8,9,28
191013633,5,5,0,8,2,20
191013634,0,9,7,0,0,16
191013635,5,7,2,7,9,30
191013636,9,0,8,5,8,30
191013637,3,6,4,0,3,16
191013638,3,4,5,2,3,17
191013639,3,7,5,8,5,28
191013640,3,0,9,8,5,25
191013641,9,3,9,9,4,34
191013642,3,2,1,8,0,14
191013643,1,7,2,4,2,16
191013644,4,3,1,0,9,17
191013645,7,6,8,4,8,33
191013646,8,3,4,7,3,25
191013647,2,5,8,3,2,20
191013648,8,9,4,2,4,27
191013649,6,0,6,4,1,17
191013650,4,5,8,5,5,27
191013651,6,5,6,9,5,31
191013652,6,4,0,7,1,18
191013653,0,8,9,0,9,26
191013654,8,8,7,9,4,36
191013655,2,2,1,2,7,14
191013656,9,2,5,1,3,20
191013657,3,2,0,6,2,13
191013658,2,9,1,0,9,21
191013659,8,9,8,5,2,32
191013660,7,9,6,7,4,33
191013661,4,1,1,8,4,18
191013662,5,5,5,8,1,24
191013663,1,2,9,7,5,24
191013664,8,4,8,4,6,30
191013665,6,1,6,9,9,31
191013666,1,5,6,6,7,25
191013667,6,6,7,4,6,29
191013668,2,7,9,4,1,23
191013669,9,4,8,4,0,25
191013670,1,2,2,6,2,13
191013671,9,3,4,8,0,24
191013672,4,4,6,8,2,24
191013673,9,7,8,6,4,34
191013674,8,9,1,4,2,24
191013675,8,4,0,6,5,23
191013676,9,6,4,9,7,35
191013677,8,1,5,7,5,26
191013678,5,8,5,7,0,25
191013679,9,4,1,3,8,25
191013680,8,5,7,9,6,35
191013681,3,8,7,0,7,25
191013682,1,7,1,5,9,23
191013683,7,9,9,2,3,30
191013684,6,8,9,2,4,29
191013685,6,0,7,5,3,21
191013686,2,2,8,4,6,22
191013687,9,2,1,1,5,18
191013688,1,9,5,7,1,23
191013689,2,1,4,3,3,13
191013690,1,5,2,6,1,15
191013691,7,0,6,6,5,24
191013692,1,7,1,7,5,21
191013693,4,1,8,0,7,20
191013694,7,5,4,1,7,24
191013695,3,0,2,5,2,12
191013696,6,9,5,5,3,28
191013697,3,1,4,9,4,21
191013698,5,5,2,5,8,25
191013699,6,4,3,5,8,26
191013700,3,4,6,1,5,19
191013701,6,6,3,6,4,25
191013702,7,4,4,6,8,29
191013703,2,2,9,7,9,29
191013704,6,1,3,4,7,21
191013705,6,8,1,9,7,31
191013706,9,6,9,4,2,30
191013707,8,1,9,9,7,34
191013708,0,5,1,6,2,14
191013709,2,4,6,1,2,15
191013710,8,7,4,2,6,27
191013711,1,6,5,0,6,18
191013712,7,1,8,3,9,28
191013713,6,1,2,4,5,18
191013714,3,5,7,7,0,22
191013715,3,5,6,6,3,23
191013716,1,7,9,6,4,27
191013717,6,5,4,7,8,30
191013718,2,6,0,5,9,22
191013719,2,0,0,1,2,5
191013720,9,8,7,1,0,25
191013721,5,9,2,5,5,26
191013722,9,4,8,6,3,30
191013723,8,2,6,8,4,28
191013724,9,4,9,1,0,23
191013725,7,5,3,5,3,23
191013726,7,9,1,8,8,33
191013727,7,3,3,3,2,18
191013728,3,8,3,2,4,20
191013729,8,5,2,3,4,22
191013730,8,2,3,1,3,17
191013731,1,6,3,0,1,11
191013732,1,7,3,7,3,21
191013733,6,5,2,2,3,18
191013734,5,3,3,1,8,20
191013735,3,7,1,2,8,21
191013736,0,6,8,7,3,24
191013737,1,2,8,2,8,21
191013738,9,8,2,2,2,23
191013739,7,0,4,7,0,18
191013740,1,9,0,8,4,22
191013741,0,7,7,0,0,14
191013742,2,7,4,1,5,19
191013743,0,1,7,7,6,21
191013744,1,5,4,8,0,18
191013745,4,6,8,4,4,26
191013746,0,2,6,1,1,10
191013747,9,0,6,3,3,21
191013748,1,1,3,9,4,18
191013749,1,3,4,5,0,13
191013750,4,1,4,4,0,13
191013751,0,1,3,4,5,13
191013752,8,7,0,6,3,24
191013753,5,2,3,4,9,23
191013754,2,1,1,6,2,12
191013755,1,1,2,2,0,6
191013756,5,0,0,0,1,6
191013757,4,7,6,3,0,20
191013758,4,3,1,5,0,13
191013759,6,4,0,8,8,26
191013760,7,2,6,8,2,25
191013761,2,8,7,8,6,31
191013762,7,2,0,1,9,19
191013763,5,8,3,9,6,31
191013764,2,7,3,1,9,22
191013765,1,4,3,2,8,18
191013766,4,5,3,8,4,24
191013767,7,2,5,7,0,21
191013768,3,0,4,0,3,10
191013769,3,8,6,6,4,27
191013770,9,5,7,5,9,35
191013771,1,0,8,8,2,19
191013772,1,8,2,9,9,29
191013773,0,3,3,5,4,15
191013774,6,3,8,2,2,21
191013775,2,5,4,9,3,23
191013776,9,3,7,4,8,31
191013777,8,3,0,0,8,19
191013778,8,5,3,8,6,30
191013779,4,1,4,4,3,16
191013780,2,3,2,7,8,22
191013781,8,0,6,4,1,19
191013782,7,5,5,8,8,33
191013783,0,1,8,2,2,13
191013784,6,0,4,6,7,23
191013785,2,8,7,9,0,26
191013786,4,8,3,5,1,21
191013787,0,0,1,9,3,13
191013788,1,4,7,9,5,26
191013789,9,7,7,1,4,28
191013790,6,0,7,3,8,24
191013791,0,3,6,2,1,12
191013792,8,2,3,3,2,18
191013793,7,4,2,9,0,22
191013794,5,6,4,0,0,15
191013795,3,0,4,0,5,12
191013796,8,3,6,8,5,30
191013797,0,9,8,3,9,29
191013798,5,2,1,3,7,18
191013799,0,0,2,9,0,11
191013800,4,9,4,1,6,24
191013801,9,0,9,4,9,31
191013802,6,2,9,9,5,31
191013803,5,8,8,6,1,28
191013804,6,9,5,9,6,35
191013805,3,9,2,4,8,26
191013806,6,3,0,8,0,17
191013807,0,6,9,9,9,33
191013808,9,7,5,1,4,26
191013809,9,6,3,8,9,35
191013810,3,8,0,5,0,16
191013811,5,8,4,5,1,23
191013812,7,8,3,8,3,29
191013813,2,0,7,0,7,16
191013814,6,5,1,6,7,25
191013815,0,9,0,9,5,23
191013816,9,1,9,3,7,29
191013817,0,5,5,8,7,25
191013818,9,0,0,3,1,13
191013819,0,1,6,9,5,21
191013820,2,3,4,9,3,21
191013821,3,7,9,0,1,20
191013822,0,0,2,1,2,5
191013823,3,6,3,8,5,25
191013824,2,2,2,1,1,8
191013825,8,3,7,7,2,27
191013826,9,6,7,2,3,27
191013827,4,3,5,6,1,19
191013828,2,9,0,1,4,16
191013829,9,9,4,7,6,35
191013830,4,2,4,9,3,22
191013831,1,3,3,9,2,18
191013832,8,0,2,2,7,19
191013833,8,6,0,2,0,16
191013834,6,0,1,2,7,16
191013835,1,2,3,2,5,13
191013836,1,9,8,1,4,23
191013837,7,4,5,9,8,33
191013838,0,1,4,3,9,17
191013839,9,2,4,3,7,25
191013840,1,8,3,4,5,21
191013841,0,6,5,4,1,16
191013842,9,4,5,3,7,28
191013843,7,4,5,7,3,26
191013844,0,4,4,1,8,17
191013845,2,5,7,7,2,23
191013846,8,4,3,7,1,23
191013847,4,3,8,6,4,25
191013848,8,8,3,3,4,26
191013849,1,0,4,7,4,16
191013850,5,8,5,1,3,22
191013851,8,8,5,4,7,32
191013852,0,9,1,6,3,19
191013853,9,6,5,0,3,23
191013854,6,5,4,1,6,22
191013855,6,5,5,7,9,32
191013856,5,6,3,5,7,26
191013857,6,8,7,6,3,30
191013858,4,6,9,6,8,33
191013859,3,8,6,7,6,30
191013860,0,9,9,0,9,27
191013861,0,9,9,9,3,30
191013862,7,5,0,5,0,17
191013863,7,7,1,7,3,25
191013864,5,7,1,8,4,25
191013865,8,0,7,1,0,16
191013866,2,8,9,8,1,28
191013867,5,7,1,8,1,22
191013868,5,0,3,3,7,18
191013869,5,7,2,5,6,25
191013870,5,3,8,3,6,25
191013871,2,7,6,6,8,29
191013872,7,9,9,4,2,31
191013873,1,9,1,0,8,19
191013874,9,5,3,0,1,18
191013875,3,0,2,8,1,14
191013876,7,7,7,2,7,30
191013877,3,7,7,3,0,20
191013878,1,9,7,1,7,25
191013879,9,8,8,4,4,33
191013880,9,9,9,1,2,30
191013881,9,3,0,5,5,22
191013882,4,5,1,7,0,17
191013883,9,1,0,7,1,18
191013884,5,4,0,8,2,19
191013885,2,8,4,1,8,23
191013886,9,7,0,3,6,25
191013887,4,5,1,3,3,16
191013888,1,5,5,5,3,19
191013889,4,8,3,9,1,25
191013890,1,9,1,2,3,16
191013891,9,0,2,6,2,19
191013892,7,4,0,0,1,12
191013893,7,5,9,1,8,30
191013894,7,3,0,2,3,15
191013895,7,4,9,0,3,23
191013896,3,5,1,7,2,18
191013897,0,2,0,5,7,14
191013898,6,2,4,7,9,28
191013899,5,3,8,0,6,22
191013900,6,3,1,8,9,27
191013901,7,4,1,6,9,27
191013902,8,1,8,1,9,27
191013903,0,1,8,5,5,19
191013904,6,8,1,0,3,18
191013905,4,6,2,5,2,19
191013906,4,8,8,5,1,26
191013907,7,4,3,9,1,24
191013908,5,8,1,6,5,25
191013909,6,3,9,6,9,33
191013910,6,5,0,6,0,17
191013911,1,7,4,3,9,24
191013912,2,7,0,8,4,21
191013913,6,0,8,0,7,21
191013914,3,5,3,4,3,18
191013915,7,2,8,7,6,30
191013916,6,6,4,5,0,21
191013917,9,6,6,3,0,24
191013918,5,2,0,7,0,14
191013919,2,8,9,8,4,31
191013920,6,5,4,3,5,23
191013921,1,3,1,2,1,8
191013922,5,1,9,5,5,25
191013923,0,6,6,6,0,18
191013924,8,4,4,3,6,25
191013925,7,6,0,7,1,21
191013926,8,2,0,0,8,18
191013927,7,6,6,7,7,33
191013928,7,0,4,7,3,21
191013929,6,3,0,4,8,21
191013930,0,9,0,2,1,12
191013931,4,9,6,6,8,33
191013932,1,9,3,2,9,24
191013933,3,5,4,8,3,23
191013934,4,6,3,4,1,18
191013935,3,0,1,1,3,8
191013936,1,2,9,1,2,15
191013937,3,4,7,3,4,21
191013938,0,4,9,2,0,15
191013939,5,8,4,6,1,24
191013940,0,1,0,8,4,13
191013941,3,0,0,6,1,10
191013942,0,4,3,3,9,19
191013943,4,6,6,4,9,29
191013944,6,1,9,6,6,28
191013945,3,6,8,6,8,31
191013946,4,2,3,0,0,9
191013947,9,1,5,8,0,23
191013948,7,8,9,3,1,28
191013949,5,1,4,9,1,20
191013950,6,2,4,7,8,27
191013951,4,6,4,2,2,18
191013952,9,2,8,1,9,29
191013953,7,0,9,7,5,28
191013954,6,5,5,2,7,25
191013955,9,4,0,7,8,28
191013956,9,7,3,2,1,22
191013957,3,7,2,2,4,18
191013958,3,1,0,3,5,12
191013959,4,8,1,1,8,22
191013960,1,4,9,5,1,20
191013961,4,8,8,2,5,27
191013962,5,9,4,2,2,22
191013963,6,6,2,9,9,32
191013964,4,7,1,4,1,17
191013965,9,4,3,7,3,26
191013966,3,7,6,4,1,21
191013967,5,3,1,0,9,18
191013968,4,8,0,8,9,29
191013969,7,5,3,3,2,20
191013970,5,2,6,1,5,19
191013971,6,8,6,4,7,31
191013972,7,9,0,9,8,33
191013973,0,6,8,8,1,23
191013974,5,0,9,3,5,22
191013975,8,6,5,0,6,25
191013976,5,6,4,8,3,26
191013977,5,8,7,1,4,25
191013978,0,4,6,6,3,19
191013979,0,3,6,5,2,16
191013980,7,7,8,6,1,29
191013981,1,5,3,7,4,20
191013982,1,7,2,0,6,16
191013983,0,3,4,6,7,20
191013984,9,9,7,7,5,37
191013985,0,6,8,8,7,29
191013986,5,5,0,8,1,19
191013987,5,0,1,9,5,20
191013988,9,3,8,4,6,30
191013989,6,5,1,1,7,20
191013990,0,6,9,8,1,24
191013991,1,8,5,0,5,19
191013992,0,7,2,9,2,20
191013993,5,5,9,9,1,29
191013994,3,2,0,9,8,22
191013995,0,1,9,9,2,21
191013996,5,4,4,5,7,25
191013997,3,8,7,9,1,28
191013998,3,4,6,0,5,18
191013999,1,3,6,4,1,15
1910131000,4,0,5,0,6,15
1910131001,9,2,5,0,4,20
1910131002,9,7,0,4,4,24
1910131003,2,7,1,8,4,22
1910131004,6,4,7,5,5,27
1910131005,0,6,4,3,4,17
1910131006,3,2,5,9,1,20
1910131007,2,0,6,8,1,17
1910131008,7,8,1,5,2,23
1910131009,4,7,5,0,6,22
1910131010,8,6,4,6,7,31
1910131011,0,9,9,0,0,18
1910131012,6,4,0,3,3,16
1910131013,7,2,5,0,7,21
1910131014,5,2,2,5,0,14
1910131015,3,0,6,7,9,25
1910131016,0,0,3,6,6,15
1910131017,3,4,5,9,6,27
1910131018,3,8,7,2,2,22
1910131019,7,0,4,5,4,20
1910131020,7,8,5,6,4,30
1910131021,9,4,4,6,5,28
1910131022,6,7,7,3,8,31
1910131023,6,4,5,6,3,24
1910131024,9,1,1,2,5,18
1910131025,6,6,9,9,0,30
1910131026,1,4,6,6,0,17
1910131027,1,2,6,0,9,18
1910131028,5,1,5,2,7,20
1910131029,9,4,7,0,4,24
1910131030,2,3,0,0,0,5
1910131031,1,3,4,1,7,16
1910131032,0,2,3,9,3,17
1910131033,1,7,7,4,5,24
1910131034,7,3,8,0,2,20
1910131035,0,6,7,4,9,26
1910131036,0,1,2,7,8,18
1910131037,3,4,7,1,1,16
1910131038,4,6,2,4,8,24
1910131039,5,1,6,3,5,20
1910131040,5,9,1,0,3,18
1910131041,5,1,5,4,6,21
1910131042,6,4,4,8,1,23
1910131043,1,2,4,3,5,15
1910131044,9,1,6,5,2,23
1910131045,0,5,5,8,0,18
1910131046,1,6,2,3,7,19
1910131047,5,8,5,7,7,32
1910131048,4,4,5,5,4,22
1910131049,8,1,8,1,8,26
1910131050,0,0,7,8,7,22
1910131051,7,8,0,9,5,29
1910131052,3,2,1,3,6,15
1910131053,5,4,1,4,8,22
1910131054,9,3,1,2,7,22
1910131055,3,4,6,9,7,29
1910131056,7,4,5,1,5,22
1910131057,9,6,9,4,4,32
1910131058,9,6,9,7,8,39
1910131059,7,8,7,7,2,31
1910131060,3,4,8,3,7,25
1910131061,9,2,0,1,6,18
1910131062,9,6,0,7,9,31
1910131063,4,8,7,9,2,30
1910131064,8,9,8,5,3,33
1910131065,4,5,4,0,0,13
1910131066,2,8,0,9,0,19
1910131067,1,6,2,4,2,15
1910131068,3,5,4,1,1,14
1910131069,3,5,9,0,9,26
1910131070,6,2,6,1,9,24
1910131071,5,0,3,9,2,19
1910131072,4,4,3,4,7,22
1910131073,1,7,7,3,8,26
1910131074,6,4,1,4,4,19
1910131075,4,5,6,1,1,17
1910131076,8,1,8,7,2,26
1910131077,6,0,0,4,7,17
1910131078,9,7,5,7,0,28
1910131079,7,9,6,7,9,38
1910131080,5,4,1,3,9,22
1910131081,3,3,0,0,1,7
1910131082,0,5,2,9,9,25
1910131083,0,4,4,2,4,14
1910131084,0,8,1,7,3,19
1910131085,9,9,7,5,4,34
1910131086,3,3,9,8,6,29
1910131087,6,1,6,9,5,27
1910131088,0,8,7,1,2,18
1910131089,6,3,3,1,0,13
1910131090,7,6,6,3,2,24
1910131091,2,5,7,0,0,14
1910131092,9,6,7,4,8,34
1910131093,6,6,0,5,4,21
1910131094,2,2,4,3,7,18
1910131095,3,1,8,1,1,14
1910131096,0,9,2,7,2,20
1910131097,0,5,9,4,6,24
1910131098,0,4,0,4,1,9
1910131099,9,0,2,1,3,15
1910131100,9,3,5,0,5,22
1910131101,2,2,4,6,7,21
1910131102,5,8,4,1,3,21
1910131103,0,2,6,4,6,18
1910131104,7,0,3,8,7,25
1910131105,4,4,3,1,5,17
191014001,5,4,8,6,5,28
191014002,6,3,2,4,1,16
191014003,6,6,2,9,5,28
191014004,9,0,1,8,4,22
191014005,0,5,8,1,7,21
191014006,1,6,5,9,5,26
191014007,7,3,6,2,8,26
191014008,8,9,9,0,3,29
191014009,2,4,5,9,8,28
191014010,9,4,1,2,6,22
191014011,2,8,0,4,4,18
191014012,4,9,4,3,1,21
191014013,0,0,4,8,0,12
191014014,9,7,4,7,2,29
191014015,1,3,5,6,3,18
191014016,4,4,2,2,3,15
191014017,4,9,3,0,8,24
191014018,9,5,8,1,8,31
191014019,7,4,1,7,2,21
191014020,1,1,6,8,1,17
191014021,4,4,5,3,9,25
191014022,6,5,1,8,4,24
191014023,5,6,2,1,4,18
191014024,9,9,1,8,6,33
191014025,0,8,5,9,7,29
191014026,5,8,9,2,5,29
191014027,6,0,3,6,8,23
191014028,1,4,3,6,7,21
191014029,0,1,1,3,1,6
191014030,4,5,8,2,4,23
191014031,0,9,2,2,2,15
191014032,3,9,6,6,0,24
191014033,4,6,1,7,5,23
191014034,3,0,1,3,7,14
191014035,9,5,1,9,2,26
191014036,1,4,1,8,3,17
191014037,9,8,7,2,7,33
191014038,4,9,8,1,3,25
191014039,8,1,5,2,1,17
191014040,5,0,1,5,0,11
191014041,4,0,2,4,4,14
191014042,6,6,4,3,6,25
191014043,7,5,3,2,9,26
191014044,0,6,6,5,4,21
191014045,6,3,5,8,6,28
191014046,4,5,7,7,6,29
191014047,3,4,9,4,5,25
191014048,1,6,6,9,5,27
191014049,6,2,4,2,6,20
191014050,5,3,0,8,8,24
191014051,2,9,4,8,4,27
191014052,1,5,5,9,4,24
191014053,8,4,1,4,4,21
191014054,1,8,0,1,8,18
191014055,9,6,8,5,4,32
191014056,0,1,7,9,4,21
191014057,7,4,8,4,7,30
191014058,9,8,1,4,8,30
191014059,4,9,9,3,8,33
191014060,0,6,7,1,5,19
191014061,7,7,0,2,8,24
191014062,0,5,3,4,6,18
191014063,3,0,5,8,2,18
191014064,8,1,7,5,7,28
191014065,1,1,5,9,7,23
191014066,8,3,1,9,7,28
191014067,2,5,7,3,0,17
191014068,9,6,0,5,9,29
191014069,1,2,2,0,1,6
191014070,2,8,2,5,6,23
191014071,9,1,9,2,0,21
191014072,1,8,6,5,9,29
191014073,4,2,7,7,2,22
191014074,8,2,1,1,2,14
191014075,5,1,2,6,5,19
191014076,7,0,3,5,5,20
191014077,7,5,9,2,5,28
191014078,6,9,2,3,5,25
191014079,4,1,5,9,1,20
191014080,2,1,0,5,3,11
191014081,7,3,1,4,7,22
191014082,0,6,1,9,5,21
191014083,3,5,1,3,4,16
191014084,5,1,8,1,8,23
191014085,7,6,0,8,2,23
191014086,3,6,9,1,0,19
191014087,6,2,8,5,7,28
191014088,4,2,5,6,1,18
191014089,9,1,9,4,1,24
191014090,6,8,3,7,3,27
191014091,7,2,1,3,6,19
191014092,0,5,0,6,7,18
191014093,8,1,6,4,4,23
191014094,5,8,7,0,3,23
191014095,1,2,0,5,3,11
191014096,6,3,8,0,8,25
191014097,5,0,0,0,0,5
191014098,1,8,6,3,6,24
191014099,3,6,3,2,7,21
191014100,2,1,8,4,2,17
191014101,3,6,1,8,0,18
191014102,0,7,5,2,0,14
191014103,5,9,0,8,9,31
191014104,6,9,0,0,3,18
191014105,2,8,8,6,0,24
191014106,5,3,1,3,3,15
191014107,5,8,4,8,3,28
191014108,5,9,5,9,5,33
191014109,7,4,9,5,1,26
191014110,3,1,2,2,8,16
191014111,3,0,8,2,6,19
191014112,4,5,3,8,3,23
191014113,8,1,2,8,6,25
191014114,7,2,2,8,1,20
191014115,1,7,5,8,7,28
191014116,9,3,9,0,4,25
191014117,4,9,2,8,2,25
191014118,6,1,9,2,2,20
191014119,4,4,3,0,5,16
191014120,5,8,8,9,0,30
191014121,6,8,7,4,4,29
191014122,3,1,9,3,8,24
191014123,3,9,3,8,6,29
191014124,2,1,3,0,3,9
191014125,5,1,8,8,9,31
191014126,4,7,6,1,0,18
191014127,8,7,8,3,2,28
191014128,6,0,5,6,0,17
191014129,5,5,1,8,7,26
191014130,5,0,0,4,5,14
191014131,5,8,2,0,1,16
191014132,8,7,1,6,6,28
191014133,2,2,5,1,0,10
191014134,9,2,7,0,2,20
191014135,2,1,1,4,4,12
191014136,3,7,4,0,9,23
191014137,6,4,5,5,9,29
191014138,4,6,9,0,2,21
191014139,9,8,5,9,7,38
191014140,2,9,4,7,4,26
191014141,3,6,5,6,3,23
191014142,2,2,7,3,5,19
191014143,8,1,6,1,4,20
191014144,3,8,3,5,2,21
191014145,2,7,1,5,7,22
191014146,9,7,4,1,6,27
191014147,3,8,4,2,3,20
191014148,3,7,8,7,9,34
191014149,1,8,6,8,3,26
191014150,6,5,4,9,9,33
191014151,4,1,1,0,5,11
191014152,1,9,7,5,8,30
191014153,8,2,6,0,8,24
191014154,2,5,7,3,1,18
191014155,4,5,9,8,4,30
191014156,7,1,9,9,8,34
191014157,8,9,8,2,2,29
191014158,3,0,2,7,0,12
191014159,6,5,8,4,4,27
191014160,7,3,7,6,3,26
191014161,7,3,6,5,1,22
191014162,7,1,6,4,3,21
191014163,6,1,9,1,4,21
191014164,9,0,3,9,0,21
191014165,8,4,6,0,4,22
191014166,3,7,2,7,0,19
191014167,7,9,4,2,0,22
191014168,7,9,7,9,6,38
191014169,7,9,4,1,9,30
191014170,3,9,0,9,2,23
191014171,6,2,0,6,4,18
191014172,0,1,6,4,4,15
191014173,6,2,1,0,6,15
191014174,5,8,6,8,0,27
191014175,0,7,9,9,2,27
191014176,7,0,0,2,0,9
191014177,8,3,5,3,9,28
191014178,9,5,2,8,2,26
191014179,7,5,1,6,8,27
191014180,5,5,5,7,9,31
191014181,1,8,3,5,4,21
191014182,9,4,1,1,4,19
191014183,8,3,9,2,0,22
191014184,4,9,9,8,1,31
191014185,9,8,1,8,8,34
191014186,2,9,4,6,6,27
191014187,1,2,3,1,5,12
191014188,7,9,7,9,7,39
191014189,5,8,9,8,2,32
191014190,8,3,1,7,0,19
191014191,1,8,8,2,1,20
191014192,9,2,3,3,5,22
191014193,9,6,0,4,7,26
191014194,9,1,3,7,7,27
191014195,0,4,8,8,8,28
191014196,9,7,5,0,3,24
191014197,0,2,5,9,5,21
191014198,5,3,6,3,3,20
191014199,8,3,3,9,2,25
191014200,1,1,8,0,9,19
191014201,7,8,3,0,0,18
191014202,4,0,3,4,9,20
191014203,7,3,5,5,0,20
191014204,6,1,0,0,1,8
191014205,0,7,0,4,7,18
191014206,1,4,6,7,2,20
191014207,5,2,0,4,7,18
191014208,7,6,8,7,2,30
191014209,2,9,5,6,3,25
191014210,2,9,7,7,9,34
191014211,3,3,9,1,4,20
191014212,9,4,8,9,6,36
191014213,3,4,7,8,1,23
191014214,6,5,5,7,8,31
191014215,3,1,0,7,2,13
191014216,7,5,0,1,1,14
191014217,5,2,9,3,9,28
191014218,1,4,5,4,4,18
191014219,5,8,0,2,3,18
191014220,7,8,3,4,1,23
191014221,2,8,1,8,7,26
191014222,5,3,0,2,4,14
191014223,6,3,9,2,6,26
191014224,1,5,3,3,9,21
191014225,3,4,9,9,4,29
191014226,8,3,7,7,5,30
191014227,4,1,8,3,9,25
191014228,8,6,8,8,5,35
191014229,3,3,2,5,9,22
191014230,1,1,8,9,3,22
191014231,5,4,7,9,5,30
191014232,4,2,9,2,0,17
191014233,0,5,6,3,4,18
191014234,0,6,9,7,3,25
191014235,5,7,4,9,1,26
191014236,8,6,5,9,1,29
191014237,1,7,4,1,7,20
191014238,8,8,9,7,6,38
191014239,6,4,3,3,2,18
191014240,1,9,6,9,2,27
191014241,5,5,9,6,4,29
191014242,8,0,7,1,2,18
191014243,2,2,5,1,4,14
191014244,4,5,7,3,3,22
191014245,7,2,8,8,2,27
191014246,2,4,8,4,9,27
191014247,1,6,5,4,2,18
191014248,5,8,8,9,6,36
191014249,4,5,1,4,7,21
191014250,8,7,1,9,2,27
191014251,3,9,3,5,1,21
191014252,4,4,3,0,6,17
191014253,4,4,7,5,9,29
191014254,3,3,7,2,2,17
191014255,2,4,4,0,7,17
191014256,6,6,5,6,2,25
191014257,4,5,5,2,6,22
191014258,9,7,4,6,5,31
191014259,2,7,4,0,9,22
191014260,9,9,4,7,2,31
191014261,4,5,4,6,0,19
191014262,8,0,3,2,7,20
191014263,3,2,9,7,6,27
191014264,7,7,2,5,7,28
191014265,6,7,9,1,9,32
191014266,4,2,6,1,0,13
191014267,0,7,0,6,0,13
191014268,8,6,8,0,1,23
191014269,6,9,0,5,0,20
191014270,8,5,8,2,9,32
191014271,6,0,8,3,6,23
191014272,1,5,7,9,2,24
191014273,2,7,9,9,9,36
191014274,1,3,2,2,8,16
191014275,3,7,1,6,9,26
191014276,3,6,2,4,2,17
191014277,5,4,1,9,0,19
191014278,9,6,2,0,7,24
191014279,8,1,3,6,2,20
191014280,6,7,2,3,4,22
191014281,4,3,2,9,5,23
191014282,4,2,9,0,6,21
191014283,2,7,2,5,0,16
191014284,7,9,5,8,9,38
191014285,3,6,2,3,2,16
191014286,8,9,7,0,7,31
191014287,1,8,2,3,2,16
191014288,8,9,7,6,4,34
191014289,1,1,8,5,4,19
191014290,1,9,8,0,6,24
191014291,0,9,1,7,1,18
191014292,8,8,4,5,7,32
191014293,2,4,0,0,5,11
191014294,2,1,5,2,6,16
191014295,6,8,3,3,1,21
191014296,9,2,0,6,1,18
191014297,6,3,4,7,3,23
191014298,5,1,8,7,7,28
191014299,0,7,0,4,4,15
191014300,9,3,1,3,9,25
191014301,4,5,4,8,2,23
191014302,9,6,0,1,1,17
191014303,0,0,4,2,8,14
191014304,8,9,5,4,9,35
191014305,4,3,3,7,8,25
191014306,1,9,0,0,7,17
191014307,7,7,9,4,7,34
191014308,6,9,7,7,3,32
191014309,2,5,0,6,0,13
191014310,0,8,1,9,8,26
191014311,7,6,7,8,1,29
191014312,1,4,9,1,1,16
191014313,8,4,1,5,3,21
191014314,3,2,7,0,2,14
191014315,2,8,7,7,6,30
191014316,7,9,0,9,9,34
191014317,1,7,5,8,4,25
191014318,0,0,2,2,2,6
191014319,7,9,9,9,4,38
191014320,8,2,0,7,6,23
191014321,2,2,5,0,3,12
191014322,3,6,0,4,6,19
191014323,4,6,2,5,5,22
191014324,3,3,4,0,8,18
191014325,5,7,6,0,7,25
191014326,2,9,0,0,6,17
191014327,3,6,3,7,4,23
191014328,1,4,3,8,3,19
191014329,7,4,6,1,0,18
191014330,3,3,0,7,8,21
191014331,2,9,4,2,4,21
191014332,7,3,3,6,9,28
191014333,0,2,2,3,4,11
191014334,0,3,6,7,9,25
191014335,6,9,1,4,3,23
191014336,0,8,6,0,7,21
191014337,1,7,1,2,5,16
191014338,0,9,5,7,5,26
191014339,0,0,0,3,4,7
191014340,0,3,4,8,9,24
191014341,2,5,4,8,2,21
191014342,4,4,0,5,8,21
191014343,1,3,8,9,0,21
191014344,7,0,5,6,1,19
191014345,7,8,5,0,0,20
191014346,2,4,8,0,2,16
191014347,8,3,5,1,0,17
191014348,5,3,7,6,4,25
191014349,5,0,5,0,2,12
191014350,3,4,1,6,2,16
191014351,3,4,6,1,4,18
191014352,8,9,4,1,4,26
191014353,2,0,7,7,8,24
191014354,0,1,7,1,2,11
191014355,1,7,9,4,9,30
191014356,8,1,1,1,2,13
191014357,9,2,9,9,4,33
191014358,4,6,8,2,5,25
191014359,8,2,5,6,1,22
191014360,3,3,3,1,4,14
191014361,5,9,7,7,0,28
191014362,0,8,8,7,7,30
191014363,9,0,2,8,7,26
191014364,7,5,3,0,5,20
191014365,2,3,8,6,7,26
191014366,0,6,8,0,3,17
191014367,2,0,6,8,3,19
191014368,2,8,8,9,7,34
191014369,2,8,1,6,1,18
191014370,2,7,8,9,6,32
191014371,9,7,0,7,8,31
191014372,6,9,0,1,7,23
191014373,1,2,5,4,4,16
191014374,6,7,7,4,5,29
191014375,1,3,1,9,4,18
191014376,4,9,4,1,4,22
191014377,6,0,8,4,6,24
191014378,3,1,5,4,1,14
191014379,1,8,6,0,2,17
191014380,4,2,5,5,7,23
191014381,7,2,1,1,6,17
191014382,4,7,5,9,4,29
191014383,8,2,1,0,1,12
191014384,3,3,0,5,1,12
191014385,3,0,6,4,6,19
191014386,3,2,7,1,8,21
191014387,8,3,0,5,0,16
191014388,4,2,5,9,3,23
191014389,1,2,8,1,2,14
191014390,1,4,0,3,1,9
191014391,2,1,1,2,1,7
191014392,2,1,8,6,2,19
191014393,9,4,3,9,0,25
191014394,7,8,8,5,7,35
191014395,7,5,1,4,8,25
191014396,4,7,6,8,5,30
191014397,2,4,8,0,8,22
191014398,7,8,6,0,1,22
191014399,4,3,6,7,9,29
191014400,5,4,4,6,2,21
191014401,5,8,2,5,5,25
191014402,3,2,4,6,9,24
191014403,0,7,3,7,0,17
191014404,8,6,7,7,0,28
191014405,6,0,6,2,3,17
191014406,8,8,5,9,3,33
191014407,1,1,5,2,9,18
191014408,8,7,2,5,6,28
191014409,1,8,6,3,0,18
191014410,7,2,0,2,4,15
191014411,3,4,7,1,9,24
191014412,9,2,2,3,7,23
191014413,0,9,1,2,9,21
191014414,7,7,3,9,2,28
191014415,2,3,8,1,2,16
191014416,0,9,0,1,0,10
191014417,7,0,9,7,4,27
191014418,1,4,7,3,1,16
191014419,3,2,6,0,2,13
191014420,2,0,4,8,6,20
191014421,2,2,6,6,6,22
191014422,1,3,4,0,6,14
191014423,2,1,7,3,9,22
191014424,2,3,7,7,7,26
191014425,1,2,2,0,3,8
191014426,8,0,3,8,7,26
191014427,7,6,1,7,8,29
191014428,9,8,8,0,8,33
191014429,4,8,7,3,0,22
191014430,0,3,1,7,3,14
191014431,7,8,3,2,2,22
191014432,5,3,3,8,7,26
191014433,4,3,3,8,7,25
191014434,7,3,8,6,3,27
191014435,1,3,9,7,7,27
191014436,0,0,9,9,4,22
191014437,1,6,1,5,7,20
191014438,5,7,9,8,2,31
191014439,8,4,7,4,2,25
191014440,4,1,5,7,1,18
191014441,7,7,8,8,1,31
191014442,4,4,6,7,2,23
191014443,4,8,1,7,5,25
191014444,8,1,0,7,9,25
191014445,6,0,9,0,4,19
191014446,4,4,3,9,7,27
191014447,5,3,6,0,0,14
191014448,6,2,2,4,9,23
191014449,5,1,2,3,1,12
191014450,8,9,9,9,7,42
191014451,1,5,5,3,8,22
191014452,8,7,5,0,7,27
191014453,7,6,6,1,9,29
191014454,5,8,8,1,6,28
191014455,1,5,1,3,3,13
191014456,9,5,4,5,6,29
191014457,5,2,8,5,3,23
191014458,9,0,0,3,0,12
191014459,8,8,8,4,0,28
191014460,8,9,1,2,0,20
191014461,8,1,8,4,6,27
191014462,8,4,0,1,0,13
191014463,3,9,6,4,3,25
191014464,1,8,1,3,8,21
191014465,2,1,5,0,0,8
191014466,2,2,0,5,1,10
191014467,4,6,1,0,2,13
191014468,2,9,8,1,8,28
191014469,8,3,3,9,7,30
191014470,2,0,0,9,1,12
191014471,5,3,5,0,1,14
191014472,0,2,8,3,8,21
191014473,4,7,1,0,4,16
191014474,4,9,7,8,9,37
191014475,3,6,6,2,4,21
191014476,4,5,5,1,9,24
191014477,0,1,3,0,7,11
191014478,6,6,3,3,1,19
191014479,6,5,1,2,0,14
191014480,4,3,8,2,4,21
191014481,2,4,3,7,5,21
191014482,5,9,1,1,0,16
191014483,5,8,1,2,6,22
191014484,9,9,1,2,7,28
191014485,5,4,5,3,6,23
191014486,4,8,5,1,5,23
191014487,1,3,5,7,6,22
191014488,5,9,9,6,8,37
191014489,7,0,1,3,1,12
191014490,2,5,3,3,1,14
191014491,8,8,5,7,2,30
191014492,9,4,5,3,6,27
191014493,7,8,0,4,2,21
191014494,2,7,5,1,3,18
191014495,2,5,1,1,4,13
191014496,5,3,0,5,3,16
191014497,3,5,9,0,8,25
191014498,1,4,4,9,6,24
191014499,9,5,7,5,2,28
191014500,5,3,4,8,2,22
191014501,1,7,8,1,2,19
191014502,4,1,0,4,2,11
191014503,1,1,4,8,2,16
191014504,2,0,2,7,6,17
191014505,3,0,8,2,8,21
191014506,1,4,8,9,2,24
191014507,7,8,4,7,0,26
191014508,5,3,4,9,8,29
191014509,1,1,7,2,2,13
191014510,2,2,5,2,9,20
191014511,2,6,6,2,8,24
191014512,3,6,6,6,6,27
191014513,8,8,8,8,0,32
191014514,4,6,8,4,0,22
191014515,3,0,2,7,1,13
191014516,7,6,5,0,8,26
191014517,7,9,7,9,9,41
191014518,0,1,3,3,6,13
191014519,8,5,0,1,6,20
191014520,7,1,8,6,7,29
191014521,7,6,1,4,4,22
191014522,1,0,7,8,2,18
191014523,9,8,7,5,1,30
191014524,9,1,6,4,3,23
191014525,7,4,0,4,1,16
191014526,3,5,1,8,0,17
191014527,6,1,4,8,1,20
191014528,4,0,4,6,7,21
191014529,1,8,3,7,7,26
191014530,1,9,4,8,7,29
191014531,0,3,5,3,7,18
191014532,6,1,2,0,1,10
191014533,3,7,4,7,4,25
191014534,1,8,4,5,6,24
191014535,0,4,2,4,7,17
191014536,4,3,9,9,0,25
191014537,2,1,9,1,9,22
191014538,4,1,4,0,4,13
191014539,5,1,2,0,9,17
191014540,2,0,5,5,3,15
191014541,8,2,3,3,5,21
191014542,4,6,6,1,0,17
191014543,4,8,5,1,4,22
191014544,8,3,3,1,1,16
191014545,2,7,3,1,2,15
191014546,1,2,5,9,4,21
191014547,6,7,8,1,3,25
191014548,5,6,0,4,2,17
191014549,0,0,9,1,7,17
191014550,5,9,8,6,6,34
191014551,4,0,3,9,0,16
191014552,5,7,9,6,4,31
191014553,5,5,2,9,9,30
191014554,4,4,2,5,2,17
191014555,8,9,0,9,3,29
191014556,1,0,9,1,3,14
191014557,4,7,5,4,3,23
191014558,4,0,1,8,0,13
191014559,7,3,2,8,1,21
191014560,6,1,2,9,7,25
191014561,9,2,8,5,9,33
191014562,2,0,3,2,6,13
191014563,6,9,4,7,5,31
191014564,1,3,7,6,6,23
191014565,5,3,4,1,1,14
191014566,9,6,5,3,5,28
191014567,6,5,4,1,8,24
191014568,7,7,3,1,2,20
191014569,2,1,8,1,5,17
191014570,8,5,5,5,3,26
191014571,3,6,8,3,2,22
191014572,9,6,8,3,4,30
191014573,4,5,4,7,7,27
191014574,7,4,1,2,7,21
191014575,5,8,4,6,4,27
191014576,0,7,2,9,5,23
191014577,3,6,6,7,7,29
191014578,8,6,0,9,9,32
191014579,1,0,1,9,8,19
191014580,7,9,1,5,5,27
191014581,6,3,7,4,9,29
191014582,1,7,5,1,4,18
191014583,3,7,1,6,3,20
191014584,8,7,6,1,2,24
191014585,5,5,1,8,0,19
191014586,7,3,9,4,8,31
191014587,6,6,5,9,8,34
191014588,8,9,6,3,8,34
191014589,6,6,4,3,7,26
191014590,1,7,2,4,6,20
191014591,4,0,4,3,9,20
191014592,6,4,4,8,7,29
191014593,5,7,1,2,7,22
191014594,4,3,9,9,6,31
191014595,4,1,1,4,4,14
191014596,7,8,6,7,5,33
191014597,2,2,8,0,3,15
191014598,3,0,1,7,0,11
191014599,9,3,6,4,6,28
191014600,4,4,5,5,3,21
191014601,0,3,8,3,4,18
191014602,0,5,8,7,7,27
191014603,6,3,1,1,2,13
191014604,4,2,6,0,9,21
191014605,0,9,1,6,0,16
191014606,2,1,9,7,1,20
191014607,3,5,6,7,9,30
191014608,2,3,8,4,9,26
191014609,4,0,7,7,3,21
191014610,5,8,1,0,4,18
191014611,5,0,7,5,0,17
191014612,2,8,5,7,3,25
191014613,3,0,1,6,1,11
191014614,0,9,3,6,1,19
191014615,5,8,9,2,0,24
191014616,7,0,2,6,1,16
191014617,1,0,3,5,5,14
191014618,5,9,8,5,8,35
191014619,6,9,1,3,2,21
191014620,6,5,5,1,5,22
191014621,2,3,9,8,7,29
191014622,6,0,0,2,3,11
191014623,1,2,9,9,0,21
191014624,8,6,0,6,8,28
191014625,3,4,6,4,4,21
191014626,7,6,2,8,7,30
191014627,5,2,0,1,2,10
191014628,0,3,7,7,6,23
191014629,0,2,9,5,5,21
191014630,3,5,5,7,5,25
191014631,3,4,2,0,4,13
191014632,8,2,3,1,6,20
191014633,2,6,5,5,0,18
191014634,7,8,5,1,0,21
191014635,1,6,7,9,5,28
191014636,5,1,6,8,9,29
191014637,8,7,2,1,5,23
191014638,3,0,4,0,7,14
191014639,6,2,8,8,1,25
191014640,2,1,5,5,1,14
191014641,2,3,0,6,9,20
191014642,4,0,1,0,9,14
191014643,7,0,0,8,2,17
191014644,6,6,7,4,2,25
191014645,2,8,9,5,8,32
191014646,5,6,7,5,1,24
191014647,7,4,1,5,1,18
191014648,9,4,4,2,4,23
191014649,5,4,0,0,5,14
191014650,8,9,0,2,7,26
191014651,9,8,8,2,4,31
191014652,1,4,6,5,5,21
191014653,9,3,1,7,9,29
191014654,7,8,5,9,8,37
191014655,0,2,8,6,7,23
191014656,3,3,1,8,8,23
191014657,3,8,6,0,3,20
191014658,2,8,2,3,3,18
191014659,1,1,6,9,9,26
191014660,5,1,1,5,9,21
191014661,0,5,4,3,7,19
191014662,6,4,6,8,3,27
191014663,6,8,3,2,5,24
191014664,3,7,0,6,8,24
191014665,7,3,2,4,6,22
191014666,5,8,3,9,1,26
191014667,5,3,1,8,2,19
191014668,9,9,2,7,4,31
191014669,1,6,4,9,2,22
191014670,6,2,1,0,7,16
191014671,5,4,8,3,6,26
191014672,1,9,5,0,8,23
191014673,2,6,3,7,0,18
191014674,1,6,2,1,3,13
191014675,9,3,6,6,4,28
191014676,0,0,6,2,3,11
191014677,8,7,7,7,4,33
191014678,4,4,7,4,0,19
191014679,5,8,6,5,1,25
191014680,7,2,1,6,1,17
191014681,7,8,5,6,0,26
191014682,3,0,3,7,4,17
191014683,8,1,5,8,2,24
191014684,2,4,6,1,7,20
191014685,3,9,0,6,1,19
191014686,0,7,1,8,1,17
191014687,1,3,1,7,5,17
191014688,5,4,5,3,9,26
191014689,9,8,5,6,1,29
191014690,2,8,4,4,5,23
191014691,9,5,8,1,5,28
191014692,0,9,0,1,9,19
191014693,4,6,6,4,7,27
191014694,5,4,0,1,8,18
191014695,7,0,8,1,9,25
191014696,8,1,3,1,1,14
191014697,5,3,8,9,7,32
191014698,2,7,8,7,5,29
191014699,3,1,4,3,5,16
191014700,3,4,9,7,8,31
191014701,5,2,9,0,3,19
191014702,4,4,5,0,4,17
191014703,7,4,7,6,8,32
191014704,9,9,9,4,1,32
191014705,2,2,5,4,1,14
191014706,2,4,3,9,0,18
191014707,0,0,3,3,4,10
191014708,3,2,1,9,4,19
191014709,1,9,4,7,6,27
191014710,5,2,7,3,7,24
191014711,7,0,4,4,6,21
191014712,1,8,1,0,9,19
191014713,1,0,2,6,2,11
191014714,2,3,8,2,5,20
191014715,0,2,0,8,3,13
191014716,8,5,5,9,0,27
191014717,0,3,0,9,0,12
191014718,4,7,1,6,1,19
191014719,6,1,4,2,7,20
191014720,7,8,1,6,6,28
191014721,5,9,3,3,3,23
191014722,2,3,6,0,2,13
191014723,8,5,2,9,8,32
191014724,2,7,5,6,0,20
191014725,6,0,2,8,1,17
191014726,2,1,4,7,5,19
191014727,0,0,9,0,7,16
191014728,2,6,3,7,2,20
191014729,6,6,5,8,8,33
191014730,6,9,9,4,9,37
191014731,1,2,0,1,6,10
191014732,6,4,5,8,9,32
191014733,8,3,7,8,1,27
191014734,3,7,2,0,5,17
191014735,2,3,7,1,1,14
191014736,0,7,8,6,0,21
191014737,7,6,1,1,8,23
191014738,6,5,1,7,5,24
191014739,8,2,9,4,1,24
191014740,9,3,2,1,7,22
191014741,2,1,6,1,5,15
191014742,6,0,0,1,9,16
191014743,7,4,0,5,3,19
191014744,0,8,2,8,9,27
191014745,4,6,9,4,4,27
191014746,2,0,7,0,1,10
191014747,7,5,5,1,7,25
191014748,3,8,8,9,1,29
191014749,8,8,3,3,1,23
191014750,4,1,0,8,1,14
191014751,5,2,6,5,2,20
191014752,8,1,5,0,5,19
191014753,3,9,0,2,2,16
191014754,8,8,4,9,2,31
191014755,5,4,1,4,9,23
191014756,0,0,9,2,5,16
191014757,6,5,1,5,2,19
191014758,3,4,6,6,1,20
191014759,5,1,7,4,1,18
191014760,0,8,9,3,9,29
191014761,7,3,8,5,8,31
191014762,0,7,6,7,6,26
191014763,2,9,5,4,1,21
191014764,4,7,9,8,2,30
191014765,1,6,8,8,5,28
191014766,4,0,1,0,0,5
191014767,5,2,6,0,2,15
191014768,7,5,4,0,3,19
191014769,5,5,7,3,2,22
191014770,8,0,2,8,1,19
191014771,1,6,1,1,3,12
191014772,0,9,1,5,7,22
191014773,3,1,0,4,2,10
191014774,7,4,8,5,4,28
191014775,3,0,9,2,1,15
191014776,5,0,4,5,1,15
191014777,6,2,6,3,9,26
191014778,2,3,4,1,6,16
191014779,4,7,1,8,5,25
191014780,8,7,2,7,6,30
191014781,2,1,3,3,1,10
191014782,9,8,0,3,3,23
191014783,4,0,1,7,6,18
191014784,6,7,5,2,2,22
191014785,8,8,5,4,0,25
191014786,2,2,9,3,7,23
191014787,7,0,0,6,1,14
191014788,4,9,4,1,1,19
191014789,1,4,1,7,5,18
191014790,4,3,4,5,6,22
191014791,5,1,8,2,7,23
191014792,0,7,3,2,4,16
191014793,5,1,2,9,4,21
191014794,4,2,0,8,4,18
191014795,7,2,9,1,3,22
191014796,5,2,0,5,0,12
191014797,2,5,3,6,7,23
191014798,6,7,6,6,4,29
191014799,3,2,4,8,3,20
191014800,3,4,2,4,2,15
191014801,2,2,2,5,6,17
191014802,7,9,7,7,1,31
191014803,7,1,7,1,6,22
191014804,0,4,7,8,2,21
191014805,8,7,9,0,5,29
191014806,3,2,4,3,4,16
191014807,0,8,4,9,0,21
191014808,7,0,8,1,3,19
191014809,9,6,4,2,9,30
191014810,6,1,9,5,8,29
191014811,5,5,8,9,0,27
191014812,3,8,3,2,1,17
191014813,6,5,2,6,9,28
191014814,8,7,5,0,0,20
191014815,2,8,7,7,1,25
191014816,6,8,9,8,6,37
191014817,0,7,6,8,9,30
191014818,2,8,6,1,5,22
191014819,2,2,5,6,8,23
191014820,8,8,8,5,9,38
191014821,4,4,1,1,0,10
191014822,5,3,2,3,1,14
191014823,7,3,6,4,4,24
191014824,7,4,5,9,3,28
191014825,8,8,5,0,1,22
191014826,0,3,9,7,4,23
191014827,1,2,2,5,3,13
191014828,3,1,3,3,5,15
191014829,3,8,4,9,2,26
191014830,3,1,0,7,9,20
191014831,7,8,3,3,1,22
191014832,8,3,1,9,8,29
191014833,9,3,0,8,2,22
191014834,1,6,0,6,6,19
191014835,1,3,9,9,1,23
191014836,1,6,3,5,9,24
191014837,6,7,8,5,9,35
191014838,5,5,7,0,2,19
191014839,9,8,0,2,1,20
191014840,5,1,3,1,7,17
191014841,6,7,0,9,9,31
191014842,6,3,3,7,4,23
191014843,8,5,3,8,5,29
191014844,6,7,0,8,4,25
191014845,0,5,5,3,2,15
191014846,8,4,9,4,8,33
191014847,7,7,2,4,4,24
191014848,4,6,8,4,9,31
191014849,4,7,6,6,9,32
191014850,2,9,4,0,3,18
191014851,1,7,1,9,6,24
191014852,7,3,4,1,5,20
191014853,1,4,8,0,9,22
191014854,1,5,5,2,4,17
191014855,7,8,6,9,2,32
191014856,7,2,1,1,0,11
191014857,8,7,8,0,4,27
191014858,6,3,7,0,1,17
191014859,6,8,2,4,0,20
191014860,8,4,0,2,4,18
191014861,4,7,3,4,6,24
191014862,6,9,1,0,8,24
191014863,3,3,0,2,4,12
191014864,6,0,9,5,5,25
191014865,4,0,9,7,4,24
191014866,5,4,8,7,7,31
191014867,9,9,3,3,6,30
191014868,8,8,7,8,1,32
191014869,5,3,6,2,3,19
191014870,1,8,6,8,0,23
191014871,5,6,3,1,7,22
191014872,8,8,5,7,4,32
191014873,2,4,0,8,6,20
191014874,1,5,7,4,6,23
191014875,5,0,8,1,5,19
191014876,2,5,8,7,2,24
191014877,1,6,9,3,2,21
191014878,4,1,4,9,4,22
191014879,9,1,8,6,6,30
191014880,9,6,8,1,7,31
191014881,1,0,4,3,9,17
191014882,0,3,7,6,9,25
191014883,0,9,4,5,5,23
191014884,4,7,7,0,3,21
191014885,1,0,3,1,7,12
191014886,1,5,6,3,4,19
191014887,6,3,7,1,2,19
191014888,8,1,2,8,8,27
191014889,3,6,1,7,5,22
191014890,9,9,8,3,2,31
191014891,3,5,5,4,4,21
191014892,9,5,2,9,9,34
191014893,5,2,0,2,0,9
191014894,0,2,3,8,3,16
191014895,1,9,6,3,7,26
191014896,8,8,0,9,8,33
191014897,0,6,1,1,5,13
191014898,0,2,3,6,2,13
191014899,7,5,1,8,1,22
191014900,6,8,0,8,1,23
191014901,2,0,8,8,7,25
191014902,7,9,9,9,8,42
191014903,5,5,3,1,7,21
191014904,9,1,2,5,8,25
191014905,9,8,5,0,7,29
191014906,1,4,4,7,3,19
191014907,8,5,0,3,7,23
191014908,4,4,2,0,0,10
191014909,0,9,1,7,4,21
191014910,7,0,3,3,2,15
191014911,2,5,0,3,7,17
191014912,9,0,1,3,2,15
191014913,4,7,9,0,5,25
191014914,0,3,1,7,4,15
191014915,9,8,8,0,9,34
191014916,6,9,9,0,1,25
191014917,5,7,6,0,2,20
191014918,2,4,8,3,5,22
191014919,3,5,0,7,8,23
191014920,9,3,8,8,5,33
191014921,5,3,8,6,3,25
191014922,6,3,0,9,6,24
191014923,2,8,5,1,9,25
191014924,0,5,3,8,9,25
191014925,2,0,6,6,4,18
191014926,4,4,5,8,0,21
191014927,2,2,4,7,0,15
191014928,2,6,9,1,9,27
191014929,0,7,4,4,3,18
191014930,1,4,8,1,5,19
191014931,1,5,7,6,4,23
191014932,7,9,6,4,4,30
191014933,6,3,8,0,2,19
191014934,6,0,5,9,7,27
191014935,1,6,1,6,6,20
191014936,7,4,0,4,4,19
191014937,2,0,1,1,1,5
191014938,7,3,4,4,3,21
191014939,7,3,9,8,7,34
191014940,7,8,9,6,6,36
191014941,9,1,9,2,9,30
191014942,5,3,0,0,2,10
191014943,8,6,7,2,1,24
191014944,2,2,1,7,8,20
191014945,4,0,1,7,3,15
191014946,8,5,7,5,1,26
191014947,3,6,8,6,0,23
191014948,2,8,3,8,4,25
191014949,0,5,5,3,4,17
191014950,1,4,3,5,3,16
191014951,7,3,2,1,1,14
191014952,3,3,2,2,6,16
191014953,6,2,0,2,2,12
191014954,6,0,8,9,0,23
191014955,7,5,6,1,8,27
191014956,5,3,7,3,8,26
191014957,9,7,0,8,9,33
191014958,5,1,4,8,6,24
191014959,7,3,6,5,7,28
191014960,6,2,0,5,5,18
191014961,6,1,8,3,5,23
191014962,5,4,3,7,9,28
191014963,0,7,9,7,6,29
191014964,1,5,5,0,3,14
191014965,5,4,5,5,6,25
191014966,6,6,8,6,6,32
191014967,6,8,3,0,6,23
191014968,4,1,7,8,1,21
191014969,3,2,0,0,5,10
191014970,6,8,2,5,6,27
191014971,0,8,8,7,1,24
191014972,8,7,5,2,6,28
191014973,7,1,6,5,6,25
191014974,0,4,7,1,5,17
191014975,2,2,0,9,2,15
191014976,5,4,8,9,9,35
191014977,1,8,8,4,5,26
191014978,5,5,7,9,0,26
191014979,0,4,4,4,4,16
191014980,6,3,8,6,8,31
191014981,5,8,4,2,4,23
191014982,1,7,3,4,7,22
191014983,4,0,9,7,6,26
191014984,2,8,8,7,8,33
191014985,2,3,7,6,3,21
191014986,6,5,2,2,2,17
191014987,7,9,4,6,5,31
191014988,8,3,2,2,6,21
191014989,7,5,8,9,0,29
191014990,6,6,7,4,9,32
191014991,4,2,5,3,3,17
191014992,5,4,3,4,1,17
191014993,1,1,0,8,0,10
191014994,3,3,0,5,2,13
191014995,8,8,3,4,0,23
191014996,3,3,4,0,1,11
191014997,3,6,8,6,2,25
191014998,4,7,5,4,6,26
191014999,6,4,1,4,2,17
1910141000,9,6,4,3,6,28
1910141001,8,4,2,7,8,29
1910141002,8,1,9,8,8,34
1910141003,8,9,5,2,3,27
1910141004,8,0,3,0,0,11
1910141005,0,8,1,7,7,23
1910141006,6,8,1,2,7,24
1910141007,1,7,3,1,3,15
1910141008,2,7,1,5,9,24
1910141009,8,5,2,3,5,23
1910141010,0,2,4,8,8,22
1910141011,8,1,3,8,9,29
1910141012,2,5,5,1,5,18
1910141013,7,7,1,2,7,24
1910141014,7,1,2,1,1,12
1910141015,3,0,1,7,2,13
1910141016,3,9,7,2,5,26
1910141017,5,4,7,3,1,20
1910141018,7,5,8,2,5,27
1910141019,5,0,6,3,8,22
1910141020,6,6,0,4,8,24
1910141021,5,2,1,8,4,20
1910141022,6,4,2,2,1,15
1910141023,7,1,3,4,4,19
1910141024,7,4,2,0,6,19
1910141025,4,5,1,6,7,23
1910141026,1,1,6,9,4,21
1910141027,6,1,2,4,0,13
1910141028,3,4,5,2,9,23
1910141029,5,6,4,1,1,17
1910141030,5,2,4,1,2,14
1910141031,4,6,0,7,6,23
1910141032,8,9,0,4,9,30
1910141033,4,3,2,1,5,15
1910141034,1,6,3,5,8,23
1910141035,4,4,8,1,5,22
1910141036,1,9,5,1,7,23
1910141037,2,0,4,0,6,12
1910141038,7,7,8,6,9,37
1910141039,4,2,1,6,4,17
1910141040,3,6,0,6,4,19
1910141041,3,3,1,0,7,14
1910141042,4,2,9,1,9,25
1910141043,5,9,4,0,2,20
1910141044,4,0,9,6,1,20
1910141045,4,4,0,9,4,21
1910141046,6,4,7,4,1,22
1910141047,4,9,5,2,8,28
1910141048,9,5,9,5,7,35
1910141049,6,0,8,9,5,28
1910141050,0,4,4,5,7,20
1910141051,9,9,2,5,6,31
1910141052,1,7,8,4,4,24
1910141053,4,8,9,5,1,27
1910141054,0,9,5,6,6,26
1910141055,5,6,0,8,1,20
1910141056,3,9,3,9,7,31
1910141057,7,7,5,1,5,25
1910141058,0,2,7,4,5,18
1910141059,4,8,6,0,3,21
1910141060,6,0,7,8,1,22
1910141061,0,6,1,5,7,19
1910141062,1,8,9,0,6,24
1910141063,3,6,1,9,1,20
1910141064,7,1,6,7,5,26
1910141065,5,3,8,5,5,26
1910141066,6,4,1,3,5,19
1910141067,7,4,8,9,2,30
1910141068,9,9,1,7,6,32
1910141069,5,3,1,8,3,20
1910141070,2,2,9,5,9,27
1910141071,4,8,2,0,7,21
1910141072,5,7,4,5,4,25
1910141073,9,7,4,8,3,31
1910141074,2,8,1,5,3,19
1910141075,4,2,1,6,7,20
1910141076,5,1,5,4,2,17
1910141077,3,9,2,5,6,25
1910141078,0,2,6,9,5,22
1910141079,6,7,7,9,8,37
1910141080,9,0,2,0,5,16
1910141081,6,5,9,6,7,33
1910141082,2,2,9,2,1,16
1910141083,9,1,4,4,6,24
1910141084,5,2,4,4,2,17
1910141085,4,8,4,6,9,31
1910141086,9,4,8,7,2,30
1910141087,7,1,7,4,7,26
1910141088,6,4,3,6,4,23
1910141089,0,5,7,2,6,20
1910141090,3,1,2,9,0,15
1910141091,1,4,6,6,9,26
1910141092,2,4,3,5,2,16
1910141093,3,0,2,4,8,17
1910141094,6,3,0,7,2,18
1910141095,8,9,7,1,0,25
1910141096,2,8,4,9,4,27
1910141097,2,5,5,1,7,20
1910141098,4,8,0,7,8,27
1910141099,4,8,6,1,3,22
1910141100,8,4,1,4,8,25
1910141101,4,1,5,4,8,22
1910141102,7,7,8,7,4,33
1910141103,1,0,2,0,2,5
1910141104,4,4,8,2,7,25
1910141105,7,1,7,6,8,29
191015001,9,4,0,1,4,18
191015002,8,7,6,9,7,37
191015003,5,0,9,5,7,26
191015004,1,3,6,8,6,24
191015005,4,1,2,0,8,15
191015006,2,8,5,7,2,24
191015007,2,7,7,9,2,27
191015008,0,8,3,0,4,15
191015009,0,2,6,2,1,11
191015010,6,7,4,0,2,19
191015011,5,6,4,2,2,19
191015012,9,3,6,8,4,30
191015013,2,1,8,4,3,18
191015014,1,6,3,7,1,18
191015015,6,0,8,4,0,18
191015016,2,5,0,3,1,11
191015017,1,4,1,0,9,15
191015018,2,4,6,3,5,20
191015019,1,6,0,2,4,13
191015020,4,5,2,4,5,20
191015021,5,3,4,6,3,21
191015022,1,7,7,0,8,23
191015023,1,0,9,4,4,18
191015024,4,6,5,3,1,19
191015025,7,3,0,1,4,15
191015026,9,3,3,9,3,27
191015027,4,1,7,1,8,21
191015028,6,8,5,0,0,19
191015029,5,4,7,1,3,20
191015030,7,5,5,1,8,26
191015031,1,5,7,4,7,24
191015032,2,1,7,8,1,19
191015033,8,4,5,6,8,31
191015034,7,9,7,5,3,31
191015035,8,1,8,6,5,28
191015036,0,7,5,3,7,22
191015037,2,5,2,5,8,22
191015038,3,8,9,5,2,27
191015039,5,4,3,4,9,25
191015040,1,1,6,6,3,17
191015041,3,6,1,7,7,24
191015042,4,7,1,1,0,13
191015043,7,4,9,5,8,33
191015044,7,3,5,7,0,22
191015045,7,8,7,9,9,40
191015046,9,6,1,7,3,26
191015047,2,5,9,3,5,24
191015048,6,4,1,5,9,25
191015049,8,2,4,5,1,20
191015050,5,9,8,4,0,26
191015051,7,7,9,6,0,29
191015052,7,6,3,2,6,24
191015053,1,5,7,2,6,21
191015054,3,9,0,6,5,23
191015055,7,9,7,3,5,31
191015056,5,7,8,7,8,35
191015057,1,5,4,6,1,17
191015058,4,7,6,4,2,23
191015059,6,6,9,8,3,32
191015060,5,6,0,2,7,20
191015061,4,8,0,1,4,17
191015062,0,6,3,1,4,14
191015063,4,5,1,6,0,16
191015064,9,0,1,8,1,19
191015065,8,8,9,9,0,34
191015066,0,7,8,8,6,29
191015067,2,7,7,4,3,23
191015068,5,8,8,3,8,32
191015069,5,7,8,5,6,31
191015070,6,6,1,0,7,20
191015071,9,5,1,2,7,24
191015072,6,0,5,3,6,20
191015073,3,8,4,4,8,27
191015074,9,3,1,9,4,26
191015075,3,8,5,2,5,23
191015076,2,0,3,2,7,14
191015077,9,1,9,5,6,30
191015078,6,5,8,1,3,23
191015079,1,5,7,1,5,19
191015080,8,6,7,3,0,24
191015081,0,9,6,5,3,23
191015082,5,2,4,2,9,22
191015083,8,5,5,7,5,30
191015084,9,2,3,1,1,16
191015085,3,1,5,5,5,19
191015086,4,3,3,2,1,13
191015087,1,6,7,0,5,19
191015088,6,5,6,0,4,21
191015089,5,3,1,2,2,13
191015090,0,2,5,8,6,21
191015091,4,3,7,5,8,27
191015092,2,6,4,4,5,21
191015093,3,6,6,3,0,18
191015094,5,3,7,5,9,29
191015095,2,7,0,0,0,9
191015096,8,6,9,8,3,34
191015097,8,2,2,2,6,20
191015098,9,1,5,0,9,24
191015099,2,4,1,9,8,24
191015100,2,1,9,0,6,18
191015101,5,9,6,4,0,24
191015102,1,1,1,2,7,12
191015103,4,3,0,7,8,22
191015104,4,9,8,9,5,35
191015105,6,2,5,2,0,15
191015106,8,0,7,7,2,24
191015107,8,7,2,7,4,28
191015108,2,6,1,7,2,18
191015109,7,4,0,5,1,17
191015110,3,7,0,6,9,25
191015111,1,0,9,9,6,25
191015112,3,5,4,6,2,20
191015113,8,1,5,4,0,18
191015114,7,6,1,4,7,25
191015115,3,5,6,6,2,22
191015116,4,5,5,0,2,16
191015117,1,3,4,8,5,21
191015118,2,2,9,9,7,29
191015119,4,3,6,5,6,24
191015120,2,3,4,2,8,19
191015121,2,8,9,4,6,29
191015122,1,6,4,4,1,16
191015123,1,8,9,8,2,28
191015124,6,6,8,2,6,28
191015125,0,2,1,3,3,9
191015126,8,0,0,7,8,23
191015127,9,4,7,9,3,32
191015128,1,0,7,5,5,18
191015129,5,3,3,3,3,17
191015130,4,2,5,2,8,21
191015131,5,5,0,1,8,19
191015132,6,5,8,5,4,28
191015133,8,1,2,1,8,20
191015134,5,6,0,1,6,18
191015135,0,9,2,7,9,27
191015136,9,0,9,8,5,31
191015137,6,4,8,0,5,23
191015138,4,9,2,1,3,19
191015139,2,0,7,3,0,12
191015140,9,5,3,7,8,32
191015141,0,6,7,7,7,27
191015142,4,8,3,5,8,28
191015143,1,4,3,0,5,13
191015144,1,2,1,4,9,17
191015145,3,4,3,3,6,19
191015146,7,0,1,7,4,19
191015147,2,4,9,9,4,28
191015148,5,9,8,1,5,28
191015149,7,1,8,3,4,23
191015150,9,8,8,7,2,34
191015151,2,7,7,9,1,26
191015152,7,7,9,1,5,29
191015153,6,4,9,2,7,28
191015154,9,8,4,1,2,24
191015155,2,3,9,4,0,18
191015156,1,5,7,3,3,19
191015157,5,6,8,3,1,23
191015158,7,2,4,7,5,25
191015159,1,5,1,3,5,15
191015160,4,3,9,0,2,18
191015161,4,9,0,6,8,27
191015162,9,4,9,7,9,38
191015163,4,0,5,7,5,21
191015164,8,6,5,8,9,36
191015165,2,6,5,2,6,21
191015166,4,5,2,7,3,21
191015167,4,9,2,4,2,21
191015168,2,8,6,6,2,24
191015169,4,9,0,7,7,27
191015170,1,8,4,7,2,22
191015171,8,8,5,5,8,34
191015172,7,2,0,0,6,15
191015173,6,2,0,4,5,17
191015174,5,6,7,7,6,31
191015175,3,4,6,2,2,17
191015176,6,3,4,9,7,29
191015177,4,1,9,1,6,21
191015178,5,5,3,9,0,22
191015179,7,0,3,1,0,11
191015180,0,0,6,2,2,10
191015181,5,6,3,6,4,24
191015182,4,5,2,6,2,19
191015183,8,9,2,0,4,23
191015184,0,5,3,6,3,17
191015185,1,3,5,5,3,17
191015186,8,6,0,1,2,17
191015187,9,8,5,2,9,33
191015188,5,8,1,6,7,27
191015189,9,3,1,6,1,20
191015190,9,4,4,7,0,24
191015191,1,9,2,6,3,21
191015192,9,3,7,1,6,26
191015193,2,8,7,5,1,23
191015194,3,6,4,9,2,24
191015195,4,5,9,3,7,28
191015196,1,3,7,0,5,16
191015197,4,5,3,6,2,20
191015198,9,6,2,7,2,26
191015199,7,5,6,2,0,20
191015200,4,5,5,5,5,24
191015201,0,2,0,2,8,12
191015202,2,8,6,8,3,27
191015203,7,6,0,9,7,29
191015204,2,6,5,4,5,22
191015205,4,1,4,8,0,17
191015206,9,6,1,8,6,30
191015207,8,2,9,6,4,29
191015208,6,0,1,5,1,13
191015209,9,8,8,2,9,36
191015210,3,4,0,5,7,19
191015211,3,9,6,7,0,25
191015212,6,5,2,5,5,23
191015213,9,1,4,2,4,20
191015214,5,9,5,4,2,25
191015215,1,1,4,6,0,12
191015216,3,9,0,6,4,22
191015217,9,6,1,9,1,26
191015218,3,1,5,9,3,21
191015219,4,5,7,2,1,19
191015220,7,6,4,0,5,22
191015221,8,3,9,2,2,24
191015222,2,9,9,0,5,25
191015223,4,7,1,3,5,20
191015224,1,5,0,7,1,14
191015225,0,9,2,1,2,14
191015226,7,6,0,3,6,22
191015227,5,1,6,4,9,25
191015228,7,7,3,7,3,27
191015229,4,1,6,6,8,25
191015230,1,8,2,6,1,18
191015231,4,2,9,0,8,23
191015232,4,3,8,2,8,25
191015233,7,2,4,6,4,23
191015234,2,6,5,8,0,21
191015235,2,0,8,2,1,13
191015236,8,5,9,9,0,31
191015237,0,7,7,3,5,22
191015238,0,7,3,8,6,24
191015239,6,5,8,7,6,32
191015240,3,6,1,4,6,20
191015241,9,4,5,4,8,30
191015242,9,2,7,6,8,32
191015243,8,4,9,5,2,28
191015244,7,8,6,4,4,29
191015245,1,1,6,9,2,19
191015246,6,0,3,0,0,9
191015247,5,0,2,6,6,19
191015248,8,4,4,8,0,24
191015249,1,5,1,1,5,13
191015250,4,6,9,2,3,24
191015251,6,5,8,6,1,26
191015252,5,1,3,0,5,14
191015253,0,3,0,7,7,17
191015254,6,4,5,2,3,20
191015255,6,1,6,6,7,26
191015256,7,2,9,4,7,29
191015257,5,1,8,0,2,16
191015258,8,3,4,1,8,24
191015259,7,4,4,8,8,31
191015260,0,1,9,6,9,25
191015261,8,1,2,8,7,26
191015262,0,9,9,0,4,22
191015263,4,8,3,7,7,29
191015264,7,9,9,3,4,32
191015265,9,4,5,6,4,28
191015266,0,0,2,9,9,20
191015267,1,8,1,3,1,14
191015268,1,9,9,2,3,24
191015269,7,2,2,8,5,24
191015270,0,8,3,9,5,25
191015271,9,7,7,5,9,37
191015272,8,4,2,0,4,18
191015273,7,6,0,3,5,21
191015274,6,5,5,5,6,27
191015275,9,4,6,9,2,30
191015276,3,8,4,3,9,27
191015277,3,2,4,0,3,12
191015278,3,8,6,9,6,32
191015279,6,1,1,3,0,11
191015280,4,0,2,0,4,10
191015281,4,2,8,4,5,23
191015282,7,2,7,9,3,28
191015283,8,3,0,3,5,19
191015284,4,2,6,7,7,26
191015285,8,5,8,5,3,29
191015286,6,3,4,1,1,15
191015287,7,5,0,1,0,13
191015288,0,1,5,7,4,17
191015289,9,2,3,4,8,26
191015290,9,6,7,4,7,33
191015291,8,3,5,1,1,18
191015292,9,5,9,3,6,32
191015293,4,5,9,4,1,23
191015294,5,2,9,6,0,22
191015295,2,0,8,8,6,24
191015296,6,5,8,2,0,21
191015297,5,2,6,3,5,21
191015298,4,2,9,9,8,32
191015299,4,4,2,9,1,20
191015300,2,1,9,0,4,16
191015301,6,2,0,9,3,20
191015302,3,7,4,4,1,19
191015303,4,2,7,9,1,23
191015304,3,3,9,9,2,26
191015305,5,0,9,9,4,27
191015306,9,1,1,8,7,26
191015307,2,0,7,2,9,20
191015308,2,0,7,9,2,20
191015309,3,7,8,3,2,23
191015310,7,3,8,0,3,21
191015311,3,9,9,4,1,26
191015312,7,4,1,6,5,23
191015313,0,6,3,9,8,26
191015314,3,6,6,1,5,21
191015315,9,0,4,9,6,28
191015316,7,2,6,2,2,19
191015317,1,5,9,3,0,18
191015318,0,8,4,8,1,21
191015319,6,2,8,4,3,23
191015320,8,9,9,9,9,44
191015321,5,1,3,7,7,23
191015322,6,4,6,6,4,26
191015323,3,9,3,3,5,23
191015324,7,9,1,9,1,27
191015325,1,8,7,4,0,20
191015326,0,5,9,7,2,23
191015327,4,4,7,6,3,24
191015328,7,3,6,1,7,24
191015329,5,4,3,2,7,21
191015330,3,9,3,2,8,25
191015331,0,6,6,2,1,15
191015332,5,2,1,7,4,19
191015333,2,0,1,9,4,16
191015334,6,4,1,0,6,17
191015335,6,6,5,1,9,27
191015336,2,1,2,7,4,16
191015337,7,0,3,3,7,20
191015338,5,2,2,9,0,18
191015339,7,4,6,1,2,20
191015340,6,8,3,3,6,26
191015341,0,1,3,1,1,6
191015342,1,8,4,7,4,24
191015343,6,7,3,3,8,27
191015344,6,0,2,3,4,15
191015345,4,4,1,7,3,19
191015346,1,2,9,6,5,23
191015347,6,7,3,5,1,22
191015348,4,9,7,6,0,26
191015349,6,6,0,1,3,16
191015350,7,2,7,1,8,25
191015351,9,3,9,2,6,29
191015352,1,2,9,5,4,21
191015353,3,3,5,2,4,17
191015354,4,6,2,7,3,22
191015355,8,6,0,3,1,18
191015356,4,1,0,2,6,13
191015357,3,0,0,0,4,7
191015358,5,7,4,0,4,20
191015359,1,7,4,2,2,16
191015360,4,8,6,9,6,33
191015361,2,8,3,0,2,15
191015362,0,6,1,2,8,17
191015363,2,1,2,5,6,16
191015364,8,4,2,4,3,21
191015365,5,8,4,8,9,34
191015366,7,9,3,7,7,33
191015367,9,8,3,2,3,25
191015368,5,8,6,9,2,30
191015369,2,6,4,7,0,19
191015370,1,7,2,0,5,15
191015371,8,7,9,4,6,34
191015372,8,0,9,0,0,17
191015373,0,5,1,6,7,19
191015374,3,8,0,7,2,20
191015375,4,8,2,2,1,17
191015376,5,7,9,3,0,24
191015377,4,5,2,4,8,23
191015378,8,1,1,8,1,19
191015379,5,5,3,3,0,16
191015380,2,2,0,7,8,19
191015381,7,2,8,6,3,26
191015382,2,5,2,1,3,13
191015383,4,6,8,5,0,23
191015384,9,2,5,5,2,23
191015385,0,2,7,9,9,27
191015386,1,9,3,4,0,17
191015387,0,3,8,2,5,18
191015388,4,6,2,2,4,18
191015389,1,1,7,3,8,20
191015390,5,2,6,8,5,26
191015391,0,1,8,4,5,18
191015392,7,0,5,2,9,23
191015393,8,4,9,3,7,31
191015394,1,7,2,2,1,13
191015395,4,9,0,6,2,21
191015396,5,9,5,3,7,29
191015397,1,9,5,1,3,19
191015398,1,0,2,8,6,17
191015399,1,5,1,9,8,24
191015400,5,1,5,7,0,18
191015401,9,4,1,6,6,26
191015402,0,4,9,3,5,21
191015403,2,7,5,7,2,23
191015404,1,7,5,4,6,23
191015405,7,6,8,2,1,24
191015406,2,6,1,8,5,22
191015407,3,2,3,7,6,21
191015408,5,5,2,1,9,22
191015409,5,9,2,1,4,21
191015410,8,3,9,8,3,31
191015411,1,2,6,5,9,23
191015412,1,1,8,9,8,27
191015413,8,8,0,0,3,19
191015414,9,8,7,6,3,33
191015415,9,6,2,3,4,24
191015416,6,4,7,5,0,22
191015417,0,9,5,8,5,27
191015418,4,4,9,2,4,23
191015419,2,2,5,7,9,25
191015420,3,7,8,3,8,29
191015421,3,1,0,4,5,13
191015422,9,7,4,4,0,24
191015423,3,3,7,5,7,25
191015424,6,5,8,3,4,26
191015425,4,7,7,2,7,27
191015426,4,9,4,6,0,23
191015427,1,6,8,1,8,24
191015428,9,6,9,9,4,37
191015429,2,6,2,4,8,22
191015430,1,9,0,3,5,18
191015431,5,1,7,3,3,19
191015432,1,7,3,7,8,26
191015433,5,3,6,6,9,29
191015434,9,0,6,3,1,19
191015435,0,8,5,7,6,26
191015436,0,4,2,1,2,9
191015437,8,9,4,7,8,36
191015438,0,8,4,5,0,17
191015439,6,9,2,2,2,21
191015440,6,8,7,0,8,29
191015441,5,1,0,1,5,12
191015442,3,9,0,6,2,20
191015443,0,6,8,5,5,24
191015444,8,4,9,8,0,29
191015445,6,6,7,0,3,22
191015446,3,6,1,1,0,11
191015447,3,7,1,0,1,12
191015448,2,0,5,6,1,14
191015449,5,0,6,7,1,19
191015450,0,2,9,6,4,21
191015451,5,8,0,0,2,15
191015452,8,4,0,5,5,22
191015453,6,5,7,3,5,26
191015454,9,2,2,8,1,22
191015455,4,4,1,4,5,18
191015456,2,1,1,4,2,10
191015457,2,0,2,2,1,7
191015458,6,1,1,2,1,11
191015459,4,0,5,6,1,16
191015460,7,6,5,6,8,32
191015461,0,1,5,1,2,9
191015462,3,8,9,7,4,31
191015463,1,5,2,4,2,14
191015464,8,0,4,1,4,17
191015465,7,0,8,6,1,22
191015466,8,2,4,1,5,20
191015467,1,1,1,3,6,12
191015468,0,5,0,5,5,15
191015469,8,6,1,4,1,20
191015470,3,3,5,6,9,26
191015471,8,1,8,0,2,19
191015472,3,2,9,7,4,25
191015473,7,3,3,4,2,19
191015474,9,0,0,2,4,15
191015475,7,6,7,9,4,33
191015476,8,2,0,3,5,18
191015477,9,6,9,3,6,33
191015478,2,8,3,2,6,21
191015479,9,6,6,8,3,32
191015480,1,9,7,1,9,27
191015481,4,5,8,8,2,27
191015482,7,1,2,4,6,20
191015483,6,5,2,8,0,21
191015484,2,4,1,8,5,20
191015485,7,6,1,8,4,26
191015486,4,0,8,9,8,29
191015487,6,1,7,7,4,25
191015488,7,7,6,9,2,31
191015489,6,5,5,6,4,26
191015490,7,9,8,4,1,29
191015491,0,0,5,2,6,13
191015492,0,4,3,5,3,15
191015493,1,8,9,4,2,24
191015494,9,1,0,6,1,17
191015495,4,0,7,1,6,18
191015496,2,4,6,8,8,28
191015497,8,2,4,0,8,22
191015498,8,9,3,4,6,30
191015499,4,0,9,4,1,18
191015500,0,5,4,4,7,20
191015501,1,6,2,0,0,9
191015502,9,8,8,9,0,34
191015503,2,1,0,8,2,13
191015504,2,4,4,4,0,14
191015505,4,3,8,7,8,30
191015506,2,6,1,1,6,16
191015507,9,2,7,5,3,26
191015508,0,8,5,9,1,23
191015509,6,8,5,3,6,28
191015510,3,0,5,3,1,12
191015511,7,1,3,4,0,15
191015512,2,4,4,8,4,22
191015513,3,8,5,4,7,27
191015514,7,8,5,3,2,25
191015515,0,6,6,1,8,21
191015516,8,9,2,3,1,23
191015517,9,9,1,9,7,35
191015518,7,0,1,3,9,20
191015519,4,3,3,7,3,20
191015520,4,0,5,4,9,22
191015521,5,2,8,5,0,20
191015522,5,9,9,3,1,27
191015523,5,7,4,3,8,27
191015524,9,2,5,6,8,30
191015525,7,0,6,6,1,20
191015526,8,5,4,7,6,30
191015527,5,9,3,3,6,26
191015528,1,6,8,0,2,17
191015529,2,2,3,2,0,9
191015530,3,3,5,2,8,21
191015531,7,4,2,3,3,19
191015532,2,8,5,8,0,23
191015533,0,1,1,8,1,11
191015534,0,5,4,3,0,12
191015535,3,2,2,5,6,18
191015536,8,3,4,2,8,25
191015537,0,6,5,8,3,22
191015538,1,9,3,0,4,17
191015539,0,3,0,5,8,16
191015540,2,6,9,1,4,22
191015541,3,6,9,9,5,32
191015542,4,3,4,3,5,19
191015543,1,6,6,5,7,25
191015544,8,9,7,6,1,31
191015545,5,1,1,0,0,7
191015546,5,5,8,5,0,23
191015547,7,7,9,5,0,28
191015548,7,7,9,5,7,35
191015549,3,6,0,8,5,22
191015550,0,0,5,1,1,7
191015551,1,6,2,6,5,20
191015552,9,2,3,2,8,24
191015553,8,7,8,4,2,29
191015554,7,1,4,8,8,28
191015555,4,8,8,0,2,22
191015556,0,6,2,4,4,16
191015557,2,5,0,8,4,19
191015558,1,4,8,1,8,22
191015559,7,9,2,8,0,26
191015560,9,2,2,7,1,21
191015561,8,6,6,2,5,27
191015562,5,0,2,2,0,9
191015563,1,2,9,2,8,22
191015564,3,5,2,5,1,16
191015565,3,6,4,8,6,27
191015566,3,5,3,2,0,13
191015567,7,2,8,1,3,21
191015568,9,7,9,7,9,41
191015569,0,5,6,3,5,19
191015570,4,5,9,1,4,23
191015571,1,8,8,0,0,17
191015572,4,4,8,2,3,21
191015573,0,6,0,5,3,14
191015574,2,7,8,6,6,29
191015575,6,4,8,6,1,25
191015576,3,0,7,4,5,19
191015577,5,0,5,0,5,15
191015578,8,5,1,4,0,18
191015579,6,3,0,9,7,25
191015580,5,9,4,8,8,34
191015581,4,0,6,2,5,17
191015582,0,1,4,7,1,13
191015583,0,4,7,0,5,16
191015584,5,1,5,2,6,19
191015585,9,2,0,6,6,23
191015586,5,2,7,8,7,29
191015587,0,5,8,2,1,16
191015588,2,3,9,3,9,26
191015589,0,8,7,8,8,31
191015590,4,0,0,8,2,14
191015591,9,0,4,0,2,15
191015592,5,6,1,0,8,20
191015593,9,1,1,4,7,22
191015594,4,6,5,9,3,27
191015595,7,7,3,0,4,21
191015596,0,0,0,8,1,9
191015597,1,1,2,1,5,10
191015598,5,3,3,1,6,18
191015599,3,5,8,6,4,26
191015600,7,6,0,8,1,22
191015601,2,6,8,0,2,18
191015602,2,4,8,7,7,28
191015603,0,5,1,6,3,15
191015604,7,6,4,3,2,22
191015605,9,5,5,2,7,28
191015606,6,3,7,2,8,26
191015607,0,7,3,4,3,17
191015608,9,7,3,0,8,27
191015609,6,4,8,4,4,26
191015610,4,2,0,7,7,20
191015611,0,5,5,2,7,19
191015612,0,5,3,8,0,16
191015613,3,9,1,8,7,28
191015614,4,7,4,7,3,25
191015615,2,6,9,5,2,24
191015616,8,9,0,0,8,25
191015617,9,5,7,4,2,27
191015618,6,4,6,6,8,30
191015619,4,3,9,0,4,20
191015620,7,6,2,2,9,26
191015621,3,7,0,5,0,15
191015622,4,1,9,9,8,31
191015623,4,3,9,3,7,26
191015624,0,6,7,1,3,17
191015625,8,4,2,7,6,27
191015626,1,3,0,9,0,13
191015627,1,0,5,9,2,17
191015628,3,7,5,8,7,30
191015629,4,7,2,5,7,25
191015630,6,4,2,7,6,25
191015631,9,7,6,2,3,27
191015632,7,6,0,0,0,13
191015633,6,6,3,4,2,21
191015634,5,6,1,6,0,18
191015635,4,1,2,8,0,15
191015636,4,4,4,4,4,20
191015637,7,9,9,1,9,35
191015638,1,7,3,7,5,23
191015639,8,4,5,0,5,22
191015640,7,1,3,4,8,23
191015641,2,7,1,1,9,20
191015642,3,5,8,2,0,18
191015643,5,3,3,3,4,18
191015644,3,6,9,8,4,30
191015645,0,3,2,8,2,15
191015646,7,6,1,8,6,28
191015647,0,5,6,4,0,15
191015648,5,2,4,6,8,25
191015649,0,9,0,8,2,19
191015650,1,6,5,9,1,22
191015651,2,4,1,5,2,14
191015652,0,8,2,2,9,21
191015653,1,5,3,9,1,19
191015654,8,1,3,2,2,16
191015655,3,6,9,4,2,24
191015656,3,4,5,3,6,21
191015657,8,8,6,3,7,32
191015658,0,2,7,8,1,18
191015659,6,5,3,4,1,19
191015660,7,3,7,7,2,26
191015661,1,9,5,9,2,26
191015662,2,1,6,8,5,22
191015663,8,0,3,2,8,21
191015664,7,5,1,5,5,23
191015665,3,7,4,4,2,20
191015666,7,6,2,3,2,20
191015667,0,9,0,5,9,23
191015668,2,4,8,8,8,30
191015669,0,1,6,0,2,9
191015670,7,0,0,2,3,12
191015671,5,6,3,6,6,26
191015672,3,3,2,4,4,16
191015673,5,7,5,6,2,25
191015674,3,0,7,0,8,18
191015675,7,6,3,5,4,25
191015676,2,3,0,1,8,14
191015677,1,1,5,2,3,12
191015678,5,6,5,8,2,26
191015679,9,1,3,3,3,19
191015680,3,0,3,1,1,8
191015681,5,4,2,0,8,19
191015682,0,7,0,5,7,19
191015683,9,7,5,0,7,28
191015684,1,6,7,8,6,28
191015685,7,5,6,9,0,27
191015686,4,6,6,2,2,20
191015687,4,0,9,0,8,21
191015688,7,7,1,3,8,26
191015689,6,3,9,4,7,29
191015690,3,5,7,7,2,24
191015691,8,6,0,0,9,23
191015692,1,7,3,2,3,16
191015693,3,6,8,3,1,21
191015694,5,6,9,9,1,30
191015695,6,5,3,5,8,27
191015696,1,5,9,8,0,23
191015697,7,8,0,2,0,17
191015698,0,7,8,5,2,22
191015699,9,4,6,6,6,31
191015700,4,4,3,6,1,18
191015701,7,0,9,7,3,26
191015702,0,6,4,7,3,20
191015703,0,4,1,8,4,17
191015704,4,0,6,2,1,13
191015705,4,8,3,0,3,18
191015706,9,8,2,3,0,22
191015707,7,5,6,8,9,35
191015708,7,2,0,8,0,17
191015709,1,2,2,5,7,17
191015710,8,3,2,9,4,26
191015711,2,8,8,9,5,32
191015712,3,9,9,5,8,34
191015713,4,8,9,2,7,30
191015714,3,6,7,9,4,29
191015715,0,0,9,3,8,20
191015716,8,2,4,0,5,19
191015717,9,0,7,7,3,26
191015718,4,5,3,5,4,21
191015719,1,5,3,6,8,23
191015720,5,5,6,4,1,21
191015721,3,4,0,8,0,15
191015722,0,8,5,2,7,22
191015723,4,1,7,2,7,21
191015724,2,0,3,5,0,10
191015725,9,6,2,8,8,33
191015726,5,3,7,0,6,21
191015727,6,9,9,4,8,36
191015728,5,9,9,3,7,33
191015729,4,7,7,0,6,24
191015730,5,5,0,7,0,17
191015731,1,9,6,5,7,28
191015732,1,6,9,1,9,26
191015733,2,5,7,5,5,24
191015734,9,8,4,6,4,31
191015735,5,5,4,8,5,27
191015736,2,9,5,8,9,33
191015737,1,4,1,8,4,18
191015738,5,5,0,2,1,13
191015739,9,4,3,0,8,24
191015740,7,4,7,0,4,22
191015741,8,2,6,1,3,20
191015742,7,6,4,8,9,34
191015743,1,0,1,0,9,11
191015744,2,5,6,1,4,18
191015745,5,5,3,5,5,23
191015746,9,9,3,3,5,29
191015747,7,5,1,4,5,22
191015748,9,7,9,9,5,39
191015749,9,1,5,4,3,22
191015750,3,2,3,4,5,17
191015751,6,4,0,4,6,20
191015752,9,6,3,8,4,30
191015753,4,5,0,6,5,20
191015754,7,8,5,4,5,29
191015755,7,6,6,2,5,26
191015756,1,0,3,4,7,15
191015757,1,4,8,3,3,19
191015758,2,8,0,4,8,22
191015759,6,9,9,3,6,33
191015760,7,4,1,1,6,19
191015761,3,5,1,2,0,11
191015762,2,8,3,3,1,17
191015763,0,3,1,3,1,8
191015764,1,2,6,3,2,14
191015765,2,5,5,3,6,21
191015766,2,1,1,5,2,11
191015767,6,2,4,0,4,16
191015768,0,4,8,5,9,26
191015769,8,3,0,8,1,20
191015770,3,9,2,7,5,26
191015771,7,5,7,2,0,21
191015772,3,3,5,1,1,13
191015773,3,9,8,8,9,37
191015774,1,4,7,3,6,21
191015775,6,7,0,7,0,20
191015776,6,4,6,9,0,25
191015777,1,2,8,0,4,15
191015778,0,3,7,1,3,14
191015779,3,4,1,9,3,20
191015780,2,7,2,5,2,18
191015781,7,0,4,0,3,14
191015782,3,3,6,1,8,21
191015783,2,3,8,5,2,20
191015784,3,1,1,7,5,17
191015785,8,5,8,0,9,30
191015786,8,8,8,1,4,29
191015787,8,7,8,2,4,29
191015788,4,9,6,3,2,24
191015789,3,7,3,0,2,15
191015790,5,7,9,4,8,33
191015791,6,5,8,8,1,28
191015792,4,0,5,5,3,17
191015793,7,2,9,4,2,24
191015794,1,4,0,3,9,17
191015795,9,9,7,1,8,34
191015796,8,8,2,8,3,29
191015797,6,8,3,8,4,29
191015798,2,4,7,1,1,15
191015799,6,9,2,2,0,19
191015800,5,9,1,2,5,22
191015801,6,6,1,6,9,28
191015802,6,3,4,9,9,31
191015803,4,6,4,6,7,27
191015804,8,2,7,0,4,21
191015805,0,5,2,1,0,8
191015806,7,3,8,8,1,27
191015807,4,8,7,6,9,34
191015808,7,5,0,0,6,18
191015809,7,1,8,4,6,26
191015810,2,7,0,8,2,19
191015811,0,9,1,0,6,16
191015812,7,0,5,7,0,19
191015813,4,5,6,7,2,24
191015814,7,0,8,3,9,27
191015815,1,5,5,7,5,23
191015816,9,7,4,6,0,26
191015817,6,2,6,3,7,24
191015818,3,3,5,3,6,20
191015819,9,9,3,7,0,28
191015820,5,5,1,3,3,17
191015821,6,3,5,6,1,21
191015822,4,9,0,3,9,25
191015823,6,7,6,7,4,30
191015824,6,6,5,0,1,18
191015825,9,5,5,3,6,28
191015826,7,9,5,6,9,36
191015827,0,1,5,5,7,18
191015828,2,9,7,1,2,21
191015829,5,2,1,0,0,8
191015830,8,4,6,1,7,26
191015831,8,4,7,5,3,27
191015832,3,3,9,6,7,28
191015833,4,4,3,6,6,23
191015834,9,9,1,3,2,24
191015835,0,2,4,7,9,22
191015836,5,5,6,8,5,29
191015837,2,6,1,9,1,19
191015838,4,7,6,3,6,26
191015839,6,3,4,7,7,27
191015840,9,3,7,2,1,22
191015841,5,8,4,4,6,27
191015842,2,7,1,9,6,25
191015843,2,5,1,9,4,21
191015844,6,2,2,2,3,15
191015845,0,0,4,8,1,13
191015846,8,4,9,7,2,30
191015847,9,7,4,5,1,26
191015848,4,6,2,4,5,21
191015849,4,1,7,0,9,21
191015850,0,2,8,4,6,20
191015851,2,6,5,5,2,20
191015852,0,5,8,6,0,19
191015853,8,5,2,2,3,20
191015854,2,9,2,5,0,18
191015855,0,4,9,6,9,28
191015856,9,5,1,6,8,29
191015857,1,2,2,5,6,16
191015858,5,5,7,5,2,24
191015859,3,8,2,0,9,22
191015860,1,3,2,6,8,20
191015861,3,3,2,6,5,19
191015862,1,0,2,4,6,13
191015863,8,4,7,8,5,32
191015864,7,3,0,0,3,13
191015865,5,2,8,3,7,25
191015866,3,1,7,2,1,14
191015867,8,3,1,5,4,21
191015868,8,1,0,6,0,15
191015869,7,6,4,8,4,29
191015870,8,7,0,5,3,23
191015871,7,4,4,0,1,16
191015872,9,6,5,3,1,24
191015873,2,1,2,3,8,16
191015874,9,5,1,6,2,23
191015875,4,9,7,3,3,26
191015876,8,3,5,4,5,25
191015877,0,3,4,3,7,17
191015878,2,8,2,7,6,25
191015879,4,4,8,6,2,24
191015880,1,0,1,4,3,9
191015881,5,7,0,6,4,22
191015882,6,2,5,6,7,26
191015883,8,0,1,1,0,10
191015884,9,6,1,9,2,27
191015885,4,6,6,8,6,30
191015886,5,1,9,9,9,33
191015887,3,3,8,1,9,24
191015888,7,4,0,5,4,20
191015889,9,1,8,2,1,21
191015890,0,0,9,1,9,19
191015891,1,6,0,5,0,12
191015892,2,5,4,7,4,22
191015893,0,9,1,9,1,20
191015894,0,2,8,9,2,21
191015895,6,1,4,9,2,22
191015896,0,0,0,6,7,13
191015897,8,4,0,1,2,15
191015898,7,3,7,8,1,26
191015899,2,9,0,3,5,19
191015900,2,3,0,2,1,8
191015901,6,8,5,4,0,23
191015902,1,4,5,7,9,26
191015903,8,2,0,9,9,28
191015904,9,8,5,4,3,29
191015905,6,1,5,0,4,16
191015906,6,8,9,8,9,40
191015907,1,7,7,7,7,29
191015908,9,1,5,5,1,21
191015909,1,9,6,8,4,28
191015910,9,9,5,7,0,30
191015911,4,3,6,9,8,30
191015912,9,7,2,8,7,33
191015913,4,9,4,5,7,29
191015914,7,6,4,8,1,26
191015915,4,2,8,4,2,20
191015916,4,4,0,8,1,17
191015917,3,8,1,1,8,21
191015918,9,3,2,6,5,25
191015919,3,3,9,5,2,22
191015920,2,4,8,5,0,19
191015921,0,8,5,9,2,24
191015922,3,6,6,6,2,23
191015923,3,3,6,7,8,27
191015924,7,7,2,2,1,19
191015925,8,6,0,2,8,24
191015926,1,2,6,4,8,21
191015927,4,1,2,8,9,24
191015928,9,0,9,9,1,28
191015929,2,9,1,7,3,22
191015930,6,2,9,7,4,28
191015931,8,4,8,2,2,24
191015932,1,4,4,7,7,23
191015933,8,0,4,2,1,15
191015934,1,2,3,9,0,15
191015935,4,7,3,3,7,24
191015936,5,3,6,2,7,23
191015937,4,8,5,9,7,33
191015938,2,5,8,8,8,31
191015939,8,2,9,4,6,29
191015940,1,9,2,7,0,19
191015941,4,4,2,5,8,23
191015942,1,5,7,4,8,25
191015943,7,1,0,1,9,18
191015944,2,2,8,9,4,25
191015945,1,8,6,5,6,26
191015946,2,4,8,7,3,24
191015947,8,5,1,0,4,18
191015948,3,7,6,4,9,29
191015949,8,0,6,7,6,27
191015950,7,4,8,0,6,25
191015951,0,8,0,1,2,11
191015952,3,8,8,8,7,34
191015953,5,4,9,7,9,34
191015954,2,0,0,9,3,14
191015955,4,3,0,8,9,24
191015956,6,5,7,6,5,29
191015957,3,3,4,4,8,22
191015958,5,5,1,6,4,21
191015959,5,7,6,3,9,30
191015960,5,8,2,9,1,25
191015961,4,2,8,6,1,21
191015962,3,3,4,5,6,21
191015963,2,1,4,5,3,15
191015964,1,6,2,6,2,17
191015965,9,5,3,0,7,24
191015966,7,4,9,6,3,29
191015967,4,8,4,4,5,25
191015968,6,4,3,7,9,29
191015969,5,5,8,1,1,20
191015970,9,5,0,5,3,22
191015971,0,2,2,2,7,13
191015972,4,8,4,9,5,30
191015973,2,2,5,5,1,15
191015974,7,0,5,3,7,22
191015975,7,3,4,8,6,28
191015976,6,6,3,0,1,16
191015977,4,1,5,9,9,28
191015978,9,3,5,0,7,24
191015979,4,3,8,0,2,17
191015980,1,5,8,3,9,26
191015981,0,0,1,8,6,15
191015982,8,1,3,6,3,21
191015983,5,1,4,1,6,17
191015984,2,6,7,3,2,20
191015985,2,8,0,8,1,19
191015986,7,2,0,0,4,13
191015987,3,3,2,1,8,17
191015988,8,9,7,9,0,33
191015989,6,8,8,4,0,26
191015990,8,2,8,2,2,22
191015991,0,7,2,3,2,14
191015992,4,7,6,5,8,30
191015993,2,8,9,1,8,28
191015994,4,1,2,8,4,19
191015995,1,1,9,1,8,20
191015996,7,0,6,1,4,18
191015997,3,2,9,5,6,25
191015998,6,9,5,5,2,27
191015999,4,8,9,4,9,34
1910151000,1,4,0,0,4,9
1910151001,4,0,6,4,6,20
1910151002,1,1,2,9,9,22
1910151003,2,0,3,8,5,18
1910151004,4,7,3,9,1,24
1910151005,8,5,6,3,9,31
1910151006,1,2,4,8,4,19
1910151007,2,5,9,5,1,22
1910151008,4,2,6,3,6,21
1910151009,7,5,9,3,9,33
1910151010,0,7,1,5,4,17
1910151011,8,2,3,8,3,24
1910151012,5,9,4,7,8,33
1910151013,6,3,1,7,9,26
1910151014,1,3,6,3,6,19
1910151015,0,0,5,4,8,17
1910151016,4,9,9,2,3,27
1910151017,9,2,2,2,9,24
1910151018,2,2,2,4,2,12
1910151019,5,2,6,6,3,22
1910151020,9,3,4,7,0,23
1910151021,1,0,0,0,0,1
1910151022,5,9,1,3,8,26
1910151023,4,2,8,7,2,23
1910151024,0,3,4,4,0,11
1910151025,5,9,2,9,9,34
1910151026,7,4,1,0,0,12
1910151027,3,4,3,8,1,19
1910151028,7,9,0,2,9,27
1910151029,6,5,6,1,9,27
1910151030,0,0,8,2,8,18
1910151031,4,2,1,7,7,21
1910151032,3,6,3,2,6,20
1910151033,9,3,6,0,1,19
1910151034,7,0,1,4,1,13
1910151035,6,3,9,6,5,29
1910151036,8,2,7,6,8,31
1910151037,8,3,5,6,0,22
1910151038,6,0,2,0,4,12
1910151039,5,0,3,5,9,22
1910151040,4,3,7,3,3,20
1910151041,3,5,4,2,3,17
1910151042,3,9,1,2,5,20
1910151043,4,2,7,2,1,16
1910151044,5,1,1,7,5,19
1910151045,8,7,3,2,9,29
1910151046,3,5,7,1,5,21
1910151047,8,3,3,5,7,26
1910151048,7,5,6,5,6,29
1910151049,1,6,1,7,5,20
1910151050,8,4,5,7,6,30
1910151051,6,8,5,2,7,28
1910151052,2,6,2,2,9,21
1910151053,7,1,4,0,8,20
1910151054,7,8,6,2,2,25
1910151055,3,1,7,7,6,24
1910151056,8,5,9,9,3,34
1910151057,9,4,5,4,9,31
1910151058,1,4,2,8,5,20
1910151059,9,6,3,4,1,23
1910151060,5,7,7,9,9,37
1910151061,1,8,9,1,2,21
1910151062,2,1,1,8,4,16
1910151063,3,1,0,3,2,9
1910151064,5,3,4,1,2,15
1910151065,9,3,8,9,8,37
1910151066,9,8,8,6,9,40
1910151067,9,5,8,5,5,32
1910151068,1,5,4,0,2,12
1910151069,7,2,0,8,8,25
1910151070,9,6,8,3,0,26
1910151071,7,8,7,4,0,26
1910151072,4,6,0,1,9,20
1910151073,9,4,0,8,9,30
1910151074,1,9,8,6,7,31
1910151075,7,2,9,0,6,24
1910151076,5,9,5,7,2,28
1910151077,9,9,0,9,3,30
1910151078,6,5,6,9,7,33
1910151079,5,9,7,6,0,27
1910151080,0,2,3,1,1,7
1910151081,3,5,9,7,1,25
1910151082,2,3,0,3,5,13
1910151083,4,3,4,0,8,19
1910151084,7,2,1,2,5,17
1910151085,3,8,4,5,2,22
1910151086,9,4,8,4,8,33
1910151087,6,7,1,0,0,14
1910151088,6,2,2,6,0,16
1910151089,0,3,6,4,6,19
1910151090,9,4,1,7,4,25
1910151091,7,6,3,9,2,27
1910151092,4,1,8,5,9,27
1910151093,4,3,8,5,7,27
1910151094,5,6,9,1,5,26
1910151095,2,0,9,1,1,13
1910151096,2,6,9,7,0,24
1910151097,7,7,0,2,6,22
1910151098,4,3,8,1,2,18
1910151099,1,8,9,1,9,28
1910151100,8,8,1,3,5,25
1910151101,6,0,6,1,1,14
1910151102,5,2,9,5,2,23
1910151103,6,1,7,8,0,22
1910151104,0,0,4,2,9,15
1910151105,9,9,4,6,3,31
191016001,6,1,2,8,7,24
191016002,9,7,5,6,7,34
191016003,4,4,6,7,0,21
191016004,3,0,3,2,4,12
191016005,7,4,2,9,1,23
191016006,3,2,5,5,5,20
191016007,2,9,7,9,7,34
191016008,4,6,0,7,2,19
191016009,9,4,6,7,7,33
191016010,1,9,3,8,9,30
191016011,5,7,7,0,8,27
191016012,8,9,2,3,9,31
191016013,0,3,4,4,1,12
191016014,7,8,6,7,2,30
191016015,0,8,2,5,6,21
191016016,6,5,8,0,1,20
191016017,7,7,4,5,1,24
191016018,0,0,4,3,2,9
191016019,0,6,4,2,5,17
191016020,5,9,8,8,1,31
191016021,4,5,7,6,0,22
191016022,8,1,0,7,8,24
191016023,7,4,9,2,9,31
191016024,4,3,3,6,9,25
191016025,3,9,3,1,5,21
191016026,6,7,2,3,5,23
191016027,2,0,7,9,1,19
191016028,2,8,8,4,7,29
191016029,8,2,5,1,6,22
191016030,2,7,5,2,7,23
191016031,2,9,0,5,0,16
191016032,8,3,3,5,6,25
191016033,1,3,1,2,6,13
191016034,1,9,8,2,5,25
191016035,4,2,5,3,6,20
191016036,6,4,8,8,5,31
191016037,5,1,2,5,2,15
191016038,4,8,2,4,7,25
191016039,5,2,8,0,1,16
191016040,2,4,7,8,8,29
191016041,3,8,6,7,3,27
191016042,6,9,2,5,7,29
191016043,8,9,0,0,1,18
191016044,1,1,6,0,8,16
191016045,4,9,6,2,0,21
191016046,8,7,0,1,8,24
191016047,0,5,5,6,7,23
191016048,6,0,4,8,6,24
191016049,9,7,2,2,8,28
191016050,2,1,2,9,0,14
191016051,4,3,4,7,2,20
191016052,9,5,5,6,5,30
191016053,6,8,7,3,4,28
191016054,9,2,6,2,8,27
191016055,4,4,4,7,4,23
191016056,3,7,4,2,2,18
191016057,1,6,8,2,9,26
191016058,6,2,4,0,7,19
191016059,2,8,6,6,6,28
191016060,7,7,1,1,4,20
191016061,8,9,2,0,5,24
191016062,4,6,7,3,9,29
191016063,3,7,4,6,0,20
191016064,0,1,2,4,8,15
191016065,9,9,5,1,5,29
191016066,9,3,7,8,0,27
191016067,3,6,4,1,0,14
191016068,5,6,1,9,8,29
191016069,1,4,0,7,1,13
191016070,1,1,8,0,3,13
191016071,4,4,8,4,9,29
191016072,4,1,7,7,8,27
191016073,1,1,7,7,3,19
191016074,6,3,2,8,2,21
191016075,5,4,8,7,0,24
191016076,3,5,4,7,5,24
191016077,1,3,8,7,6,25
191016078,1,9,9,3,7,29
191016079,5,9,1,1,3,19
191016080,2,6,2,7,4,21
191016081,8,5,1,1,9,24
191016082,1,2,7,2,1,13
191016083,9,3,9,4,6,31
191016084,6,2,4,1,7,20
191016085,4,7,0,3,5,19
191016086,4,2,0,1,4,11
191016087,0,4,0,4,6,14
191016088,1,2,9,0,8,20
191016089,2,9,4,1,3,19
191016090,5,6,5,6,8,30
191016091,3,2,8,1,5,19
191016092,1,6,3,1,2,13
191016093,3,7,3,3,3,19
191016094,4,4,4,3,1,16
191016095,7,3,5,8,2,25
191016096,8,6,1,0,5,20
191016097,1,9,5,6,5,26
191016098,8,3,9,9,7,36
191016099,2,7,2,8,0,19
191016100,4,2,1,6,0,13
191016101,4,8,9,6,0,27
191016102,5,7,2,4,9,27
191016103,8,8,5,1,4,26
191016104,3,4,1,0,9,17
191016105,6,1,5,6,7,25
191016106,5,1,2,3,5,16
191016107,7,4,3,0,4,18
191016108,1,8,8,8,5,30
191016109,4,4,5,0,8,21
191016110,3,2,5,5,6,21
191016111,7,3,6,6,3,25
191016112,6,9,6,0,4,25
191016113,2,5,7,2,5,21
191016114,3,1,7,1,4,16
191016115,4,5,9,5,4,27
191016116,7,7,6,1,0,21
191016117,5,4,2,5,2,18
191016118,9,8,3,4,9,33
191016119,9,8,5,1,3,26
191016120,8,4,2,9,2,25
191016121,1,3,4,5,8,21
191016122,9,0,9,9,7,34
191016123,2,6,8,7,6,29
191016124,3,3,2,3,4,15
191016125,0,0,2,9,0,11
191016126,0,5,5,1,8,19
191016127,4,4,1,3,1,13
191016128,1,0,1,5,8,15
191016129,4,9,9,8,4,34
191016130,2,1,8,3,6,20
191016131,5,5,5,4,4,23
191016132,2,6,4,8,5,25
191016133,8,6,0,0,6,20
191016134,8,9,0,5,2,24
191016135,5,0,1,3,9,18
191016136,2,3,4,9,3,21
191016137,8,5,3,1,0,17
191016138,1,1,0,6,0,8
191016139,0,9,3,5,4,21
191016140,6,2,6,0,8,22
191016141,9,3,5,3,2,22
191016142,9,5,8,5,6,33
191016143,4,6,8,1,9,28
191016144,2,0,1,1,7,11
191016145,3,3,8,2,2,18
191016146,9,4,1,4,7,25
191016147,2,1,2,0,2,7
191016148,6,4,1,0,8,19
191016149,6,4,3,7,5,25
191016150,8,5,6,0,0,19
191016151,8,0,3,6,0,17
191016152,7,7,3,8,6,31
191016153,4,4,2,7,0,17
191016154,3,5,2,0,7,17
191016155,8,9,2,5,3,27
191016156,8,9,5,4,5,31
191016157,8,0,4,5,4,21
191016158,0,5,0,3,2,10
191016159,8,9,7,7,8,39
191016160,8,3,9,4,0,24
191016161,2,7,4,4,2,19
191016162,6,7,9,9,5,36
191016163,5,1,9,8,7,30
191016164,1,8,2,9,4,24
191016165,9,7,8,3,2,29
191016166,0,5,9,3,9,26
191016167,2,3,8,5,8,26
191016168,2,1,9,6,7,25
191016169,6,8,2,8,5,29
191016170,8,1,9,4,1,23
191016171,0,1,2,8,3,14
191016172,2,5,2,9,3,21
191016173,1,6,7,7,1,22
191016174,5,7,5,8,1,26
191016175,4,6,5,4,6,25
191016176,5,8,0,5,3,21
191016177,9,9,5,0,3,26
191016178,2,7,6,2,4,21
191016179,5,6,3,0,2,16
191016180,6,6,9,1,1,23
191016181,5,1,7,0,5,18
191016182,7,9,0,3,2,21
191016183,2,6,9,9,9,35
191016184,5,8,7,7,9,36
191016185,2,6,4,2,8,22
191016186,2,2,6,3,9,22
191016187,3,3,8,0,8,22
191016188,6,7,9,7,4,33
191016189,3,6,7,3,6,25
191016190,8,8,9,6,5,36
191016191,4,9,1,8,5,27
191016192,5,8,1,8,8,30
191016193,3,5,0,8,9,25
191016194,4,8,7,3,5,27
191016195,1,1,5,8,6,21
191016196,4,1,8,7,3,23
191016197,2,0,1,6,2,11
191016198,8,5,1,9,3,26
191016199,2,0,5,1,0,8
191016200,1,3,3,8,2,17
191016201,5,1,2,5,7,20
191016202,0,0,3,5,3,11
191016203,1,7,1,4,9,22
191016204,2,4,1,8,4,19
191016205,2,5,0,7,6,20
191016206,6,0,2,3,8,19
191016207,0,1,3,7,5,16
191016208,2,2,4,9,3,20
191016209,6,5,4,2,2,19
191016210,9,5,6,7,7,34
191016211,1,0,5,3,9,18
191016212,2,1,1,5,3,12
191016213,4,6,5,1,6,22
191016214,1,7,0,4,2,14
191016215,1,1,8,6,8,24
191016216,5,8,5,3,2,23
191016217,3,2,8,3,2,18
191016218,8,9,7,8,7,39
191016219,2,5,2,5,4,18
191016220,8,7,2,4,5,26
191016221,2,3,8,1,9,23
191016222,7,6,0,0,4,17
191016223,3,7,4,5,1,20
191016224,3,5,9,4,2,23
191016225,8,1,7,4,1,21
191016226,2,2,2,6,8,20
191016227,5,2,5,3,6,21
191016228,1,0,3,0,0,4
191016229,8,8,0,5,9,30
191016230,1,6,2,7,7,23
191016231,4,4,5,4,1,18
191016232,4,8,6,6,8,32
191016233,6,1,1,5,9,22
191016234,8,3,2,5,3,21
191016235,8,8,0,4,1,21
191016236,1,0,3,6,1,11
191016237,5,0,0,0,3,8
191016238,3,5,3,7,3,21
191016239,0,4,2,2,1,9
191016240,6,6,5,9,3,29
191016241,2,6,2,4,0,14
191016242,8,9,4,3,7,31
191016243,9,8,5,7,7,36
191016244,3,9,2,7,0,21
191016245,3,0,9,9,2,23
191016246,7,7,7,2,6,29
191016247,8,2,7,6,7,30
191016248,1,7,3,9,3,23
191016249,9,2,3,7,9,30
191016250,6,9,0,9,2,26
191016251,5,4,6,5,2,22
191016252,7,6,0,6,8,27
191016253,2,8,4,8,8,30
191016254,0,3,6,7,7,23
191016255,7,4,3,9,8,31
191016256,6,3,0,0,3,12
191016257,4,3,0,9,6,22
191016258,8,1,5,0,4,18
191016259,3,6,8,1,4,22
191016260,7,8,2,7,8,32
191016261,9,2,0,1,4,16
191016262,7,0,8,5,5,25
191016263,7,1,4,1,1,14
191016264,1,0,4,6,2,13
191016265,6,5,9,6,4,30
191016266,8,7,8,4,8,35
191016267,6,5,3,6,5,25
191016268,3,7,8,5,6,29
191016269,0,9,2,0,2,13
191016270,1,6,6,4,0,17
191016271,5,0,8,5,5,23
191016272,1,5,3,1,6,16
191016273,0,8,7,9,9,33
191016274,6,5,8,2,3,24
191016275,6,4,7,3,4,24
191016276,3,9,3,8,9,32
191016277,0,0,8,2,2,12
191016278,3,8,2,9,8,30
191016279,4,8,5,1,6,24
191016280,3,5,5,4,1,18
191016281,7,2,7,1,5,22
191016282,8,4,5,0,3,20
191016283,3,3,8,2,0,16
191016284,5,9,1,1,9,25
191016285,7,8,3,1,5,24
191016286,4,6,8,2,3,23
191016287,5,6,5,0,0,16
191016288,9,1,1,4,9,24
191016289,4,8,1,2,5,20
191016290,5,2,8,8,8,31
191016291,4,5,0,0,8,17
191016292,2,5,6,5,2,20
191016293,7,1,7,5,1,21
191016294,5,1,2,0,7,15
191016295,4,2,7,6,1,20
191016296,5,6,9,7,7,34
191016297,8,7,4,6,4,29
191016298,8,6,8,4,4,30
191016299,5,8,9,9,9,40
191016300,7,3,9,1,8,28
191016301,0,6,9,0,6,21
191016302,5,6,2,0,5,18
191016303,9,1,1,2,9,22
191016304,7,1,4,9,6,27
191016305,0,5,5,0,7,17
191016306,4,9,8,7,0,28
191016307,7,1,3,4,7,22
191016308,3,3,1,2,1,10
191016309,1,0,7,6,6,20
191016310,7,3,6,0,9,25
191016311,1,9,3,1,4,18
191016312,8,8,3,3,6,28
191016313,0,6,5,6,3,20
191016314,8,2,9,2,2,23
191016315,5,5,5,0,8,23
191016316,7,3,3,3,9,25
191016317,6,6,9,8,1,30
191016318,9,2,9,2,6,28
191016319,2,7,1,0,0,10
191016320,7,4,3,3,0,17
191016321,6,5,8,6,8,33
191016322,1,4,9,1,5,20
191016323,1,2,4,9,1,17
191016324,5,2,4,6,9,26
191016325,8,2,7,6,2,25
191016326,9,6,6,3,0,24
191016327,5,0,8,9,0,22
191016328,8,6,3,8,2,27
191016329,6,6,6,4,8,30
191016330,6,5,8,1,1,21
191016331,7,5,0,6,7,25
191016332,6,5,1,8,0,20
191016333,6,4,3,3,7,23
191016334,9,6,6,1,1,23
191016335,6,6,5,4,5,26
191016336,7,3,4,0,7,21
191016337,9,2,0,8,3,22
191016338,7,6,8,1,5,27
191016339,8,3,9,9,0,29
191016340,6,9,8,5,3,31
191016341,8,8,1,8,9,34
191016342,1,0,4,5,8,18
191016343,8,3,8,1,5,25
191016344,7,9,8,0,8,32
191016345,9,2,9,9,9,38
191016346,4,2,2,9,5,22
191016347,1,2,4,7,3,17
191016348,0,9,2,1,5,17
191016349,8,2,9,0,7,26
191016350,1,8,5,8,8,30
191016351,8,8,0,2,5,23
191016352,1,3,1,4,7,16
191016353,9,4,6,5,8,32
191016354,2,3,1,7,0,13
191016355,8,9,2,2,5,26
191016356,5,3,5,5,6,24
191016357,4,1,6,6,0,17
191016358,3,4,6,4,7,24
191016359,5,0,8,0,0,13
191016360,5,2,7,4,3,21
191016361,3,8,4,8,8,31
191016362,4,2,8,7,1,22
191016363,2,5,6,3,8,24
191016364,5,6,1,9,5,26
191016365,7,1,5,5,0,18
191016366,9,7,7,9,9,41
191016367,4,8,0,0,4,16
191016368,8,5,3,7,6,29
191016369,5,6,1,5,1,18
191016370,0,3,7,8,4,22
191016371,8,0,2,9,7,26
191016372,9,5,4,0,1,19
191016373,5,6,4,6,7,28
191016374,0,8,1,4,0,13
191016375,1,1,9,9,0,20
191016376,0,6,8,2,8,24
191016377,5,1,5,1,2,14
191016378,8,3,1,1,7,20
191016379,6,3,2,9,1,21
191016380,2,6,1,9,5,23
191016381,4,7,3,0,6,20
191016382,9,6,1,9,9,34
191016383,0,8,9,5,9,31
191016384,3,2,6,8,8,27
191016385,9,5,1,0,8,23
191016386,7,2,7,2,7,25
191016387,8,5,8,1,6,28
191016388,7,7,9,6,3,32
191016389,2,7,8,1,2,20
191016390,8,4,0,1,1,14
191016391,2,6,6,0,8,22
191016392,5,4,1,2,3,15
191016393,6,2,8,6,4,26
191016394,0,8,8,4,3,23
191016395,1,1,7,9,9,27
191016396,3,6,2,1,2,14
191016397,7,4,2,1,2,16
191016398,6,3,5,1,3,18
191016399,8,2,1,8,6,25
191016400,0,3,7,8,5,23
191016401,4,7,7,4,9,31
191016402,2,2,3,5,0,12
191016403,0,9,4,8,2,23
191016404,2,6,5,3,5,21
191016405,1,1,3,2,9,16
191016406,9,5,9,3,1,27
191016407,2,9,1,3,3,18
191016408,5,8,0,9,5,27
191016409,0,0,2,9,8,19
191016410,7,2,0,2,4,15
191016411,8,4,0,4,8,24
191016412,7,6,8,2,7,30
191016413,2,5,9,8,5,29
191016414,9,3,6,5,6,29
191016415,1,9,1,9,4,24
191016416,3,2,0,4,4,13
191016417,3,1,3,2,9,18
191016418,0,9,0,5,7,21
191016419,8,5,0,8,9,30
191016420,7,7,1,6,9,30
191016421,8,2,9,6,3,28
191016422,5,7,3,5,6,26
191016423,9,2,3,7,7,28
191016424,6,3,3,4,2,18
191016425,8,1,3,7,6,25
191016426,5,3,0,4,0,12
191016427,3,7,9,5,6,30
191016428,9,3,6,4,4,26
191016429,8,0,3,6,1,18
191016430,5,0,7,8,2,22
191016431,6,0,5,9,1,21
191016432,9,1,4,4,3,21
191016433,8,1,4,7,2,22
191016434,6,0,7,3,0,16
191016435,7,3,6,8,2,26
191016436,5,9,4,2,8,28
191016437,3,2,9,8,4,26
191016438,7,6,3,5,3,24
191016439,0,1,2,4,1,8
191016440,3,9,1,7,6,26
191016441,8,2,2,3,4,19
191016442,5,0,9,1,2,17
191016443,5,2,9,5,4,25
191016444,8,9,9,8,1,35
191016445,2,2,3,9,9,25
191016446,7,0,9,5,6,27
191016447,0,3,5,7,8,23
191016448,1,6,4,8,7,26
191016449,8,0,5,6,2,21
191016450,6,9,8,1,6,30
191016451,3,2,7,9,8,29
191016452,2,2,1,0,3,8
191016453,0,2,1,9,2,14
191016454,4,2,5,7,7,25
191016455,0,3,8,4,9,24
191016456,1,9,1,0,8,19
191016457,7,3,4,4,5,23
191016458,7,5,9,0,1,22
191016459,0,1,9,0,8,18
191016460,7,9,9,9,5,39
191016461,0,4,8,0,1,13
191016462,0,6,3,3,3,15
191016463,9,1,9,4,8,31
191016464,8,9,0,9,9,35
191016465,5,3,2,8,9,27
191016466,7,0,5,3,6,21
191016467,9,4,3,4,9,29
191016468,4,3,3,1,4,15
191016469,1,2,1,3,8,15
191016470,5,7,5,0,2,19
191016471,1,6,6,6,1,20
191016472,6,4,9,1,1,21
191016473,1,9,3,7,6,26
191016474,0,9,9,8,2,28
191016475,6,0,2,0,3,11
191016476,1,8,0,2,8,19
191016477,9,3,5,6,9,32
191016478,5,6,1,2,5,19
191016479,2,6,6,6,9,29
191016480,8,8,7,6,7,36
191016481,7,2,7,6,2,24
191016482,4,6,8,0,8,26
191016483,8,0,7,5,7,27
191016484,8,2,5,6,8,29
191016485,2,5,4,3,0,14
191016486,6,6,1,7,9,29
191016487,0,8,9,2,3,22
191016488,5,5,6,7,7,30
191016489,5,1,9,4,9,28
191016490,7,8,7,5,0,27
191016491,7,8,4,5,5,29
191016492,0,6,9,0,5,20
191016493,8,6,5,9,4,32
191016494,5,5,7,2,0,19
191016495,3,1,0,2,3,9
191016496,3,1,1,6,7,18
191016497,2,9,3,3,3,20
191016498,7,3,7,6,5,28
191016499,4,0,5,7,8,24
191016500,7,0,9,6,5,27
191016501,2,6,1,9,8,26
191016502,7,6,4,5,7,29
191016503,7,5,8,0,6,26
191016504,9,7,6,9,8,39
191016505,4,3,4,1,6,18
191016506,0,5,8,6,6,25
191016507,5,1,3,0,0,9
191016508,7,5,6,4,0,22
191016509,8,9,4,3,1,25
191016510,1,7,4,1,6,19
191016511,2,8,4,7,2,23
191016512,7,2,4,2,6,21
191016513,5,8,4,6,6,29
191016514,6,1,4,0,7,18
191016515,7,7,0,7,2,23
191016516,6,1,2,1,7,17
191016517,6,7,6,3,8,30
191016518,4,7,8,1,2,22
191016519,5,5,3,4,7,24
191016520,8,5,1,4,1,19
191016521,1,5,3,1,4,14
191016522,4,9,5,4,6,28
191016523,2,9,9,5,1,26
191016524,6,8,8,8,4,34
191016525,1,2,3,9,6,21
191016526,9,5,2,0,2,18
191016527,9,1,3,7,3,23
191016528,1,5,0,1,6,13
191016529,2,6,7,1,5,21
191016530,2,8,8,2,5,25
191016531,0,4,2,3,3,12
191016532,7,5,9,2,7,30
191016533,5,3,2,5,7,22
191016534,0,2,1,0,8,11
191016535,4,4,9,8,0,25
191016536,8,9,9,3,9,38
191016537,0,5,1,5,3,14
191016538,5,8,3,9,5,30
191016539,3,3,6,2,0,14
191016540,5,2,2,4,9,22
191016541,3,4,8,2,2,19
191016542,5,5,2,4,6,22
191016543,2,8,9,3,7,29
191016544,4,2,7,9,3,25
191016545,0,6,9,1,7,23
191016546,2,1,9,3,2,17
191016547,5,2,2,0,5,14
191016548,5,7,4,7,8,31
191016549,5,1,8,5,8,27
191016550,6,6,0,5,9,26
191016551,7,8,9,5,4,33
191016552,6,1,7,5,4,23
191016553,4,5,2,1,5,17
191016554,1,3,1,9,4,18
191016555,4,2,1,9,8,24
191016556,9,3,1,5,1,19
191016557,5,5,3,3,7,23
191016558,3,8,2,4,5,22
191016559,9,0,8,3,8,28
191016560,6,8,2,7,3,26
191016561,3,1,9,8,5,26
191016562,5,7,9,9,9,39
191016563,1,1,4,3,9,18
191016564,6,6,7,8,2,29
191016565,1,4,9,5,9,28
191016566,9,2,8,8,6,33
191016567,6,9,6,8,0,29
191016568,2,4,4,9,2,21
191016569,2,1,3,8,6,20
191016570,3,4,3,0,9,19
191016571,0,7,1,3,2,13
191016572,1,5,2,2,0,10
191016573,9,4,9,5,9,36
191016574,0,2,0,9,4,15
191016575,2,6,0,9,8,25
191016576,7,4,8,7,8,34
191016577,6,9,0,2,2,19
191016578,4,5,6,5,2,22
191016579,0,9,8,1,7,25
191016580,1,0,4,9,9,23
191016581,9,1,9,0,0,19
191016582,6,1,5,7,5,24
191016583,9,9,1,8,0,27
191016584,5,6,7,2,4,24
191016585,5,2,9,2,2,20
191016586,4,9,7,4,7,31
191016587,1,8,9,6,2,26
191016588,7,0,8,7,5,27
191016589,5,3,9,4,9,30
191016590,4,9,0,7,6,26
191016591,8,3,4,8,2,25
191016592,2,9,7,8,4,30
191016593,3,2,2,2,8,17
191016594,9,5,9,2,7,32
191016595,8,1,5,1,9,24
191016596,6,9,0,4,2,21
191016597,9,7,3,9,3,31
191016598,5,0,8,4,1,18
191016599,3,3,6,5,7,24
191016600,3,6,1,1,9,20
191016601,1,7,9,6,5,28
191016602,5,2,6,9,6,28
191016603,0,6,7,4,6,23
191016604,4,0,8,4,5,21
191016605,9,4,8,3,0,24
191016606,5,9,2,1,3,20
191016607,0,7,9,3,0,19
191016608,2,0,6,7,4,19
191016609,7,1,0,6,1,15
191016610,8,6,2,0,1,17
191016611,0,7,2,4,0,13
191016612,3,0,8,6,9,26
191016613,2,0,5,0,5,12
191016614,2,7,8,4,8,29
191016615,8,1,6,5,4,24
191016616,6,4,3,1,5,19
191016617,3,0,5,1,0,9
191016618,1,9,0,1,1,12
191016619,3,7,9,4,0,23
191016620,0,8,4,7,2,21
191016621,1,2,2,5,2,12
191016622,7,3,7,4,7,28
191016623,4,6,7,9,6,32
191016624,0,9,6,2,5,22
191016625,0,0,1,3,6,10
191016626,4,8,6,3,1,22
191016627,8,5,6,2,0,21
191016628,7,9,0,7,6,29
191016629,6,0,6,3,7,22
191016630,4,1,0,6,5,16
191016631,7,6,3,4,1,21
191016632,5,7,9,4,0,25
191016633,8,4,9,5,0,26
191016634,5,8,6,1,7,27
191016635,7,8,5,7,3,30
191016636,9,8,6,3,7,33
191016637,0,5,2,2,9,18
191016638,7,9,4,2,6,28
191016639,7,6,3,9,7,32
191016640,8,1,4,3,0,16
191016641,4,4,6,9,7,30
191016642,3,1,8,6,2,20
191016643,2,8,0,5,4,19
191016644,9,7,4,4,4,28
191016645,6,1,4,6,9,26
191016646,7,0,1,9,5,22
191016647,8,8,4,5,7,32
191016648,8,6,5,5,4,28
191016649,1,0,4,4,6,15
191016650,2,0,6,7,5,20
191016651,6,0,0,6,8,20
191016652,4,2,2,4,6,18
191016653,6,2,9,6,1,24
191016654,9,7,2,3,5,26
191016655,4,5,5,4,3,21
191016656,0,8,1,9,2,20
191016657,6,9,1,2,1,19
191016658,3,3,7,4,5,22
191016659,2,0,9,0,5,16
191016660,8,2,0,5,2,17
191016661,9,8,4,5,0,26
191016662,0,2,5,7,4,18
191016663,7,3,2,9,1,22
191016664,3,0,2,7,0,12
191016665,4,2,6,0,4,16
191016666,7,4,3,2,2,18
191016667,2,7,5,5,9,28
191016668,4,0,1,2,8,15
191016669,9,9,4,0,8,30
191016670,0,5,2,7,0,14
191016671,8,9,1,2,1,21
191016672,6,6,6,8,6,32
191016673,5,7,7,5,0,24
191016674,1,0,0,3,5,9
191016675,9,1,3,3,9,25
191016676,3,8,7,4,5,27
191016677,0,9,8,6,3,26
191016678,3,0,0,7,7,17
191016679,4,8,4,2,1,19
191016680,5,5,7,6,7,30
191016681,9,9,3,9,5,35
191016682,4,6,2,9,4,25
191016683,7,7,7,7,0,28
191016684,0,6,5,4,9,24
191016685,6,4,0,0,9,19
191016686,7,9,9,3,6,34
191016687,5,6,2,8,5,26
191016688,6,8,9,4,1,28
191016689,7,7,4,1,2,21
191016690,8,7,4,8,0,27
191016691,7,2,4,1,4,18
191016692,0,4,4,6,0,14
191016693,3,0,4,4,3,14
191016694,3,7,3,3,9,25
191016695,1,4,1,5,0,11
191016696,9,4,3,9,7,32
191016697,5,8,5,1,1,20
191016698,9,8,1,0,3,21
191016699,9,8,5,6,3,31
191016700,6,4,5,8,6,29
191016701,2,0,4,8,2,16
191016702,8,9,0,1,9,27
191016703,9,4,9,0,1,23
191016704,0,0,9,0,6,15
191016705,0,2,2,2,1,7
191016706,1,2,1,5,2,11
191016707,1,1,9,7,5,23
191016708,1,3,5,3,4,16
191016709,6,8,7,6,3,30
191016710,1,2,2,4,2,11
191016711,7,7,1,3,4,22
191016712,6,0,2,0,5,13
191016713,9,7,4,6,2,28
191016714,1,7,5,3,4,20
191016715,8,3,9,3,7,30
191016716,5,0,6,0,7,18
191016717,7,3,3,7,4,24
191016718,9,6,1,6,5,27
191016719,4,2,4,5,5,20
191016720,2,4,0,4,9,19
191016721,6,4,6,5,9,30
191016722,5,5,1,0,0,11
191016723,0,9,9,8,3,29
191016724,4,7,8,8,6,33
191016725,2,0,4,6,6,18
191016726,8,7,9,5,2,31
191016727,7,4,3,1,1,16
191016728,2,3,0,1,5,11
191016729,0,1,9,9,0,19
191016730,9,6,7,6,9,37
191016731,7,5,7,4,0,23
191016732,1,0,8,4,8,21
191016733,4,0,2,3,1,10
191016734,4,5,2,8,2,21
191016735,5,3,1,1,9,19
191016736,0,3,1,5,1,10
191016737,6,0,1,6,4,17
191016738,1,8,8,7,6,30
191016739,1,2,6,0,6,15
191016740,9,4,5,5,1,24
191016741,0,7,9,7,3,26
191016742,6,8,1,3,2,20
191016743,7,8,1,3,1,20
191016744,5,1,5,7,6,24
191016745,8,6,5,8,6,33
191016746,8,3,4,8,6,29
191016747,0,4,2,9,3,18
191016748,4,9,6,8,1,28
191016749,6,6,5,5,6,28
191016750,6,7,4,3,1,21
191016751,4,1,1,3,0,9
191016752,8,7,8,3,6,32
191016753,5,0,0,7,5,17
191016754,9,5,3,1,7,25
191016755,3,1,5,9,1,19
191016756,3,0,7,1,0,11
191016757,2,9,4,3,9,27
191016758,8,5,2,5,8,28
191016759,7,0,1,3,1,12
191016760,4,8,2,5,1,20
191016761,9,5,0,0,0,14
191016762,7,9,9,1,1,27
191016763,6,9,6,0,1,22
191016764,6,3,6,6,8,29
191016765,2,3,5,2,2,14
191016766,8,4,3,1,7,23
191016767,8,2,1,6,9,26
191016768,3,9,6,2,8,28
191016769,5,4,7,5,4,25
191016770,8,8,9,1,3,29
191016771,8,6,0,9,6,29
191016772,9,3,2,8,0,22
191016773,1,3,9,2,2,17
191016774,9,9,7,4,2,31
191016775,2,4,2,2,4,14
191016776,2,0,9,6,5,22
191016777,8,3,7,3,4,25
191016778,8,2,3,9,4,26
191016779,6,0,1,3,2,12
191016780,8,4,6,8,0,26
191016781,8,8,2,8,9,35
191016782,7,7,2,5,1,22
191016783,5,6,6,5,5,27
191016784,1,2,1,0,3,7
191016785,9,8,5,4,2,28
191016786,4,8,1,2,8,23
191016787,1,4,1,1,4,11
191016788,6,5,0,5,1,17
191016789,7,9,8,3,1,28
191016790,2,7,9,7,0,25
191016791,8,8,0,5,4,25
191016792,8,5,9,3,8,33
191016793,6,0,9,3,2,20
191016794,3,7,9,0,1,20
191016795,4,6,4,1,8,23
191016796,5,4,7,4,7,27
191016797,5,6,2,5,4,22
191016798,5,0,9,4,1,19
191016799,8,9,8,8,3,36
191016800,2,3,5,7,3,20
191016801,8,8,1,9,7,33
191016802,9,0,4,9,5,27
191016803,3,4,0,0,3,10
191016804,4,6,0,4,7,21
191016805,8,5,0,1,8,22
191016806,6,1,2,0,1,10
191016807,2,1,5,9,0,17
191016808,4,6,1,1,0,12
191016809,1,9,4,9,2,25
191016810,1,8,9,8,0,26
191016811,4,2,5,9,6,26
191016812,0,7,2,7,4,20
191016813,6,9,6,0,8,29
191016814,1,8,8,5,0,22
191016815,8,1,1,5,2,17
191016816,7,8,8,9,0,32
191016817,2,5,2,6,6,21
191016818,4,4,6,8,5,27
191016819,6,9,1,9,3,28
191016820,5,0,1,3,7,16
191016821,2,9,5,6,4,26
191016822,7,4,3,7,5,26
191016823,8,5,2,1,2,18
191016824,0,4,0,0,0,4
191016825,9,7,5,1,4,26
191016826,8,2,0,4,3,17
191016827,0,0,9,8,0,17
191016828,4,7,0,8,8,27
191016829,9,6,6,7,1,29
191016830,6,2,5,4,7,24
191016831,1,0,4,4,4,13
191016832,5,5,7,0,7,24
191016833,4,9,2,4,9,28
191016834,4,3,1,3,0,11
191016835,3,0,6,4,5,18
191016836,6,9,9,1,4,29
191016837,5,8,3,2,2,20
191016838,3,2,9,2,5,21
191016839,9,5,6,9,6,35
191016840,3,0,2,2,8,15
191016841,9,9,6,9,1,34
191016842,7,9,5,8,8,37
191016843,2,2,2,8,1,15
191016844,6,5,6,1,8,26
191016845,3,7,7,1,0,18
191016846,5,8,9,7,8,37
191016847,1,8,1,3,3,16
191016848,3,3,8,7,9,30
191016849,6,3,5,1,2,17
191016850,7,4,2,5,0,18
191016851,6,4,4,0,0,14
191016852,4,4,7,9,3,27
191016853,9,9,4,2,9,33
191016854,9,6,1,9,5,30
191016855,4,1,6,3,5,19
191016856,3,4,0,9,3,19
191016857,5,5,8,2,5,25
191016858,0,3,1,3,5,12
191016859,8,8,3,2,0,21
191016860,6,0,6,4,1,17
191016861,2,1,3,2,0,8
191016862,1,8,5,6,3,23
191016863,2,5,6,7,5,25
191016864,6,9,7,5,9,36
191016865,9,1,6,2,6,24
191016866,8,5,6,9,5,33
191016867,6,9,0,6,7,28
191016868,4,5,3,5,3,20
191016869,8,3,6,9,2,28
191016870,5,9,7,7,2,30
191016871,4,9,3,2,9,27
191016872,2,0,3,3,8,16
191016873,4,8,2,1,4,19
191016874,2,7,6,9,8,32
191016875,9,9,2,8,0,28
191016876,6,0,7,9,6,28
191016877,6,2,5,7,4,24
191016878,5,2,2,8,6,23
191016879,9,1,3,8,4,25
191016880,5,8,6,0,7,26
191016881,7,6,8,1,1,23
191016882,7,0,1,7,3,18
191016883,5,4,0,1,1,11
191016884,7,4,6,7,1,25
191016885,8,4,0,5,9,26
191016886,3,0,9,6,1,19
191016887,7,9,4,6,3,29
191016888,2,9,2,6,6,25
191016889,0,4,7,4,8,23
191016890,3,5,2,7,3,20
191016891,0,6,5,9,6,26
191016892,0,3,2,2,1,8
191016893,5,9,1,3,0,18
191016894,6,4,1,0,2,13
191016895,3,2,1,8,9,23
191016896,9,0,5,8,6,28
191016897,6,0,5,8,5,24
191016898,2,1,1,8,0,12
191016899,9,1,8,0,9,27
191016900,0,7,1,0,5,13
191016901,2,0,7,7,7,23
191016902,4,5,4,3,2,18
191016903,4,0,7,8,6,25
191016904,2,7,3,1,5,18
191016905,0,5,9,7,0,21
191016906,2,3,4,9,5,23
191016907,9,3,5,1,0,18
191016908,5,6,0,8,3,22
191016909,5,7,6,7,7,32
191016910,6,9,1,8,3,27
191016911,8,2,5,5,1,21
191016912,1,9,4,4,7,25
191016913,0,8,8,6,9,31
191016914,6,4,0,5,2,17
191016915,5,1,0,8,0,14
191016916,6,6,7,1,1,21
191016917,7,7,9,4,1,28
191016918,0,7,7,5,5,24
191016919,3,9,5,9,1,27
191016920,0,2,6,2,3,13
191016921,6,8,9,1,0,24
191016922,1,2,9,3,3,18
191016923,3,1,2,8,6,20
191016924,7,5,6,1,7,26
191016925,0,4,8,7,1,20
191016926,3,4,2,7,6,22
191016927,5,9,3,2,4,23
191016928,7,9,2,3,0,21
191016929,1,8,0,9,1,19
191016930,7,3,2,8,7,27
191016931,0,4,7,3,5,19
191016932,1,6,9,9,2,27
191016933,0,5,3,7,9,24
191016934,9,6,7,7,8,37
191016935,9,4,3,3,2,21
191016936,3,3,5,7,5,23
191016937,0,4,7,0,0,11
191016938,8,7,8,0,5,28
191016939,8,3,8,7,6,32
191016940,2,5,0,8,3,18
191016941,2,1,6,7,6,22
191016942,2,4,1,9,0,16
191016943,3,5,1,6,8,23
191016944,7,2,3,3,8,23
191016945,1,9,3,5,2,20
191016946,4,2,5,8,6,25
191016947,5,0,2,0,2,9
191016948,6,0,3,5,6,20
191016949,4,2,0,8,8,22
191016950,4,7,1,8,1,21
191016951,5,6,6,7,3,27
191016952,8,6,1,0,2,17
191016953,4,1,8,0,6,19
191016954,2,8,7,9,5,31
191016955,2,2,9,3,7,23
191016956,6,2,9,9,6,32
191016957,5,6,9,1,9,30
191016958,7,8,9,8,5,37
191016959,0,6,4,4,8,22
191016960,8,7,2,4,7,28
191016961,6,9,0,1,2,18
191016962,9,5,9,9,0,32
191016963,1,4,7,7,8,27
191016964,1,3,7,5,6,22
191016965,0,0,3,4,2,9
191016966,4,6,6,6,0,22
191016967,7,9,1,0,4,21
191016968,7,1,4,6,2,20
191016969,5,3,6,7,4,25
191016970,9,4,7,1,0,21
191016971,0,6,5,0,7,18
191016972,8,5,9,0,2,24
191016973,7,1,9,2,8,27
191016974,6,9,7,8,3,33
191016975,0,4,2,2,3,11
191016976,4,4,8,4,0,20
191016977,5,5,5,8,7,30
191016978,1,7,0,6,8,22
191016979,8,9,3,4,4,28
191016980,1,6,1,2,0,10
191016981,3,7,8,0,1,19
191016982,5,7,9,3,1,25
191016983,5,1,5,6,3,20
191016984,1,9,1,3,3,17
191016985,6,8,3,8,7,32
191016986,8,8,2,0,4,22
191016987,1,6,3,9,0,19
191016988,5,9,6,6,2,28
191016989,2,1,4,0,9,16
191016990,6,9,1,2,4,22
191016991,1,2,0,4,4,11
191016992,6,0,8,7,6,27
191016993,8,6,4,7,8,33
191016994,8,0,0,6,0,14
191016995,0,0,0,4,5,9
191016996,7,8,5,8,8,36
191016997,3,9,2,1,1,16
191016998,8,9,1,7,3,28
191016999,4,5,0,0,5,14
1910161000,4,1,6,6,1,18
1910161001,6,0,9,9,3,27
1910161002,6,4,0,4,9,23
1910161003,3,9,9,3,8,32
1910161004,9,2,4,6,4,25
1910161005,0,6,3,1,9,19
1910161006,3,1,8,0,1,13
1910161007,2,9,0,4,2,17
1910161008,6,0,6,6,4,22
1910161009,4,6,7,4,4,25
1910161010,0,4,6,0,1,11
1910161011,1,8,3,6,9,27
1910161012,3,4,0,7,9,23
1910161013,9,5,9,7,1,31
1910161014,3,6,0,3,9,21
1910161015,1,5,5,0,4,15
1910161016,7,5,2,1,0,15
1910161017,2,0,4,3,5,14
1910161018,3,5,4,2,5,19
1910161019,5,5,9,1,5,25
1910161020,5,7,7,9,8,36
1910161021,2,6,7,3,0,18
1910161022,1,9,3,2,8,23
1910161023,2,7,3,3,3,18
1910161024,3,0,1,3,0,7
1910161025,0,4,3,6,9,22
1910161026,3,6,1,2,2,14
1910161027,5,3,6,7,5,26
1910161028,6,9,5,2,4,26
1910161029,5,6,3,0,7,21
1910161030,4,6,4,5,6,25
1910161031,9,3,0,8,1,21
1910161032,0,2,9,9,8,28
1910161033,8,3,1,7,5,24
1910161034,6,5,1,1,0,13
1910161035,5,3,6,5,0,19
1910161036,4,4,8,9,0,25
1910161037,8,5,3,6,2,24
1910161038,1,7,7,4,5,24
1910161039,9,5,4,0,2,20
1910161040,6,1,6,1,1,15
1910161041,0,5,9,0,2,16
1910161042,0,8,0,4,7,19
1910161043,2,2,9,9,4,26
1910161044,2,6,0,3,1,12
1910161045,9,5,7,7,6,34
1910161046,5,6,9,8,1,29
1910161047,0,9,9,7,7,32
1910161048,5,5,9,7,6,32
1910161049,4,8,1,2,1,16
1910161050,3,2,6,3,7,21
1910161051,1,2,3,0,5,11
1910161052,6,6,3,5,6,26
1910161053,1,7,6,7,2,23
1910161054,8,1,6,4,4,23
1910161055,7,6,7,5,4,29
1910161056,4,0,2,3,3,12
1910161057,4,8,0,0,8,20
1910161058,4,0,9,5,1,19
1910161059,5,6,6,9,6,32
1910161060,8,9,0,9,8,34
1910161061,0,0,6,4,8,18
1910161062,4,8,0,3,5,20
1910161063,5,8,2,6,4,25
1910161064,1,1,8,8,9,27
1910161065,3,1,3,3,1,11
1910161066,3,9,6,9,9,36
1910161067,4,0,3,9,3,19
1910161068,0,5,8,7,9,29
1910161069,0,1,2,0,8,11
1910161070,9,6,7,7,6,35
1910161071,0,0,0,0,5,5
1910161072,2,9,1,9,0,21
1910161073,4,0,9,6,7,26
1910161074,5,0,4,6,1,16
1910161075,7,2,6,2,5,22
1910161076,0,7,8,5,7,27
1910161077,1,5,7,9,5,27
1910161078,0,1,3,2,0,6
1910161079,9,9,0,2,4,24
1910161080,4,1,0,5,3,13
1910161081,2,0,4,7,3,16
1910161082,6,5,0,2,5,18
1910161083,8,8,2,8,4,30
1910161084,9,1,2,7,7,26
1910161085,9,6,4,5,4,28
1910161086,1,0,9,2,5,17
1910161087,3,7,3,1,0,14
1910161088,5,9,2,4,9,29
1910161089,3,6,7,2,8,26
1910161090,3,8,9,2,9,31
1910161091,1,5,3,3,9,21
1910161092,7,5,3,2,0,17
1910161093,5,5,7,9,2,28
1910161094,5,3,9,2,7,26
1910161095,5,9,3,7,3,27
1910161096,9,1,5,0,6,21
1910161097,6,2,5,1,0,14
1910161098,2,2,4,6,7,21
1910161099,3,0,6,4,7,20
1910161100,7,2,4,3,1,17
1910161101,8,5,3,0,8,24
1910161102,9,4,3,7,1,24
1910161103,6,4,9,9,9,37
1910161104,9,5,1,0,5,20
1910161105,4,5,6,4,5,24
191017001,3,3,1,6,4,17
191017002,3,4,4,4,4,19
191017003,3,4,1,3,1,12
191017004,2,7,7,8,7,31
191017005,8,0,9,5,7,29
191017006,8,2,3,8,4,25
191017007,0,0,8,9,7,24
191017008,6,6,0,6,7,25
191017009,9,3,9,0,9,30
191017010,8,7,3,1,7,26
191017011,3,9,7,4,7,30
191017012,3,3,3,8,9,26
191017013,3,0,3,5,7,18
191017014,7,8,5,4,1,25
191017015,2,2,3,2,7,16
191017016,9,1,7,3,0,20
191017017,5,7,2,5,0,19
191017018,2,1,5,1,5,14
191017019,9,9,0,3,2,23
191017020,7,2,8,5,4,26
191017021,8,3,0,7,2,20
191017022,5,6,5,1,5,22
191017023,1,3,3,9,0,16
191017024,3,0,5,5,4,17
191017025,6,6,8,1,2,23
191017026,2,0,5,6,2,15
191017027,6,2,7,6,0,21
191017028,3,4,5,3,7,22
191017029,7,7,9,3,3,29
191017030,5,3,8,2,9,27
191017031,9,0,7,8,6,30
191017032,7,7,7,0,6,27
191017033,6,4,6,8,1,25
191017034,6,3,0,5,7,21
191017035,9,0,7,1,2,19
191017036,2,9,6,1,1,19
191017037,6,3,5,9,8,31
191017038,1,3,9,8,0,21
191017039,9,9,0,8,7,33
191017040,7,2,2,2,9,22
191017041,0,9,3,3,2,17
191017042,6,2,1,8,5,22
191017043,6,5,6,4,0,21
191017044,3,2,6,2,9,22
191017045,5,2,1,2,8,18
191017046,3,5,5,7,8,28
191017047,4,3,7,0,9,23
191017048,7,3,4,3,2,19
191017049,0,4,3,8,9,24
191017050,5,5,5,9,4,28
191017051,3,7,7,9,8,34
191017052,9,1,3,3,4,20
191017053,8,5,5,5,4,27
191017054,8,1,1,8,3,21
191017055,5,2,7,8,9,31
191017056,5,3,5,7,7,27
191017057,3,2,0,7,3,15
191017058,9,6,2,0,4,21
191017059,0,9,9,7,0,25
191017060,9,4,6,0,6,25
191017061,6,1,0,9,9,25
191017062,3,9,5,0,6,23
191017063,7,5,5,2,5,24
191017064,3,1,1,5,7,17
191017065,7,8,9,4,2,30
191017066,4,3,7,6,5,25
191017067,1,8,3,9,9,30
191017068,3,4,4,6,5,22
191017069,1,4,9,8,3,25
191017070,1,4,2,5,9,21
191017071,5,5,0,4,0,14
191017072,0,6,1,2,0,9
191017073,1,4,4,7,5,21
191017074,6,1,2,4,4,17
191017075,7,5,5,2,1,20
191017076,5,1,9,0,5,20
191017077,9,1,7,8,3,28
191017078,2,2,3,6,4,17
191017079,4,8,2,7,3,24
191017080,7,8,1,2,0,18
191017081,4,3,8,6,4,25
191017082,0,4,1,6,8,19
191017083,1,6,4,1,9,21
191017084,4,2,6,3,8,23
191017085,5,1,2,6,0,14
191017086,6,5,7,6,4,28
191017087,3,6,7,1,6,23
191017088,2,3,5,5,5,20
191017089,4,8,0,9,7,28
191017090,1,9,0,0,1,11
191017091,1,4,7,6,5,23
191017092,0,0,7,9,3,19
191017093,8,7,5,1,0,21
191017094,5,2,3,2,6,18
191017095,7,4,7,9,1,28
191017096,9,5,4,6,5,29
191017097,3,7,2,9,1,22
191017098,9,4,6,6,3,28
191017099,2,1,1,0,3,7
191017100,5,9,6,8,4,32
191017101,2,3,8,5,6,24
191017102,3,1,1,1,7,13
191017103,9,4,4,5,4,26
191017104,1,9,6,6,4,26
191017105,2,9,0,0,2,13
191017106,0,5,8,1,9,23
191017107,8,5,4,2,6,25
191017108,0,0,0,1,4,5
191017109,1,8,0,7,5,21
191017110,7,5,0,7,9,28
191017111,4,6,3,7,3,23
191017112,3,0,3,4,1,11
191017113,6,9,2,9,9,35
191017114,7,8,8,5,4,32
191017115,7,9,9,2,9,36
191017116,3,0,3,9,6,21
191017117,1,4,0,3,0,8
191017118,9,9,4,8,2,32
191017119,2,8,0,3,6,19
191017120,3,1,9,4,5,22
191017121,2,7,0,8,9,26
191017122,8,2,7,5,0,22
191017123,3,0,2,5,4,14
191017124,4,7,7,3,5,26
191017125,3,5,0,9,3,20
191017126,3,3,7,2,3,18
191017127,3,8,6,3,4,24
191017128,3,1,9,7,3,23
191017129,1,6,4,3,0,14
191017130,1,2,4,2,4,13
191017131,3,0,6,3,9,21
191017132,2,7,1,1,3,14
191017133,3,1,4,5,1,14
191017134,9,5,1,7,1,23
191017135,4,8,1,8,4,25
191017136,9,2,1,8,2,22
191017137,1,9,4,8,9,31
191017138,0,7,3,9,6,25
191017139,4,3,3,0,2,12
191017140,0,2,2,9,4,17
191017141,4,4,4,0,9,21
191017142,5,4,5,1,4,19
191017143,0,3,2,1,6,12
191017144,8,5,1,9,0,23
191017145,5,0,0,9,8,22
191017146,3,6,7,7,9,32
191017147,2,8,8,4,5,27
191017148,1,4,5,7,6,23
191017149,9,6,5,0,1,21
191017150,6,5,4,7,6,28
191017151,2,7,8,3,3,23
191017152,8,3,2,5,9,27
191017153,7,9,8,5,6,35
191017154,6,4,4,1,2,17
191017155,9,4,7,6,2,28
191017156,0,1,3,0,9,13
191017157,1,0,1,2,1,5
191017158,2,6,5,6,9,28
191017159,7,2,1,4,3,17
191017160,5,6,1,3,4,19
191017161,9,8,8,7,6,38
191017162,6,4,3,0,3,16
191017163,6,6,7,2,4,25
191017164,1,1,9,8,4,23
191017165,0,5,8,4,8,25
191017166,4,4,9,4,5,26
191017167,6,7,4,6,3,26
191017168,5,4,3,0,0,12
191017169,7,8,1,4,6,26
191017170,3,8,0,1,9,21
191017171,2,2,0,7,7,18
191017172,3,5,7,4,7,26
191017173,5,7,9,8,6,35
191017174,4,6,2,7,8,27
191017175,0,8,2,1,1,12
191017176,8,3,7,7,5,30
191017177,1,4,6,7,5,23
191017178,1,6,9,3,6,25
191017179,9,4,3,0,1,17
191017180,5,6,9,4,3,27
191017181,0,7,5,5,6,23
191017182,2,5,9,6,9,31
191017183,1,1,4,2,9,17
191017184,0,0,4,7,0,11
191017185,7,6,7,4,0,24
191017186,5,6,8,8,4,31
191017187,1,9,7,5,8,30
191017188,0,0,9,6,1,16
191017189,2,3,6,0,9,20
191017190,3,4,8,7,4,26
191017191,6,3,5,1,7,22
191017192,6,3,1,7,5,22
191017193,9,5,7,9,6,36
191017194,1,2,9,1,4,17
191017195,4,3,4,6,9,26
191017196,0,6,7,9,5,27
191017197,7,9,7,7,7,37
191017198,4,6,6,4,0,20
191017199,7,7,0,5,6,25
191017200,9,1,0,3,2,15
191017201,5,9,1,8,6,29
191017202,8,2,7,3,7,27
191017203,2,9,6,5,6,28
191017204,5,3,9,6,7,30
191017205,9,0,1,1,5,16
191017206,9,5,5,4,7,30
191017207,5,1,2,8,3,19
191017208,9,3,1,9,9,31
191017209,8,2,4,2,6,22
191017210,4,7,3,8,3,25
191017211,1,2,8,4,4,19
191017212,9,0,0,1,8,18
191017213,5,1,3,7,6,22
191017214,1,6,2,2,7,18
191017215,1,5,5,4,4,19
191017216,5,5,9,0,8,27
191017217,8,6,0,5,5,24
191017218,5,5,5,8,4,27
191017219,9,8,0,6,9,32
191017220,2,8,9,0,4,23
191017221,1,2,7,6,7,23
191017222,1,7,6,9,7,30
191017223,4,1,4,6,8,23
191017224,7,1,1,7,0,16
191017225,9,3,0,5,1,18
191017226,2,1,8,5,7,23
191017227,4,7,0,9,1,21
191017228,7,3,5,7,8,30
191017229,6,6,9,7,6,34
191017230,7,0,7,3,1,18
191017231,6,0,7,1,3,17
191017232,7,3,1,9,6,26
191017233,5,3,6,5,6,25
191017234,7,7,4,9,8,35
191017235,1,4,1,9,1,16
191017236,1,9,9,4,9,32
191017237,3,7,0,2,3,15
191017238,0,6,6,2,0,14
191017239,7,7,9,5,5,33
191017240,0,8,8,2,8,26
191017241,7,9,4,4,4,28
191017242,0,9,9,0,8,26
191017243,0,7,0,8,2,17
191017244,4,3,4,4,9,24
191017245,7,8,8,3,3,29
191017246,7,3,6,7,9,32
191017247,4,7,2,2,5,20
191017248,1,1,5,1,8,16
191017249,9,3,5,8,1,26
191017250,5,9,9,9,1,33
191017251,3,4,1,5,7,20
191017252,0,2,0,7,6,15
191017253,6,5,8,2,9,30
191017254,6,9,2,7,1,25
191017255,5,4,2,8,4,23
191017256,9,4,6,3,3,25
191017257,2,5,6,6,5,24
191017258,4,0,6,1,9,20
191017259,7,9,0,1,3,20
191017260,6,3,5,5,6,25
191017261,2,6,4,9,6,27
191017262,7,2,9,3,1,22
191017263,5,2,1,2,3,13
191017264,9,4,5,6,7,31
191017265,7,6,2,0,7,22
191017266,7,3,5,6,9,30
191017267,8,2,6,1,0,17
191017268,3,2,8,2,9,24
191017269,9,1,4,0,6,20
191017270,3,7,3,2,7,22
191017271,7,4,7,8,6,32
191017272,5,8,7,1,5,26
191017273,5,3,1,3,2,14
191017274,1,1,6,8,9,25
191017275,6,9,2,8,5,30
191017276,3,3,4,3,1,14
191017277,9,8,5,3,1,26
191017278,7,7,4,3,7,28
191017279,8,2,4,0,9,23
191017280,1,8,8,1,8,26
191017281,7,0,3,5,7,22
191017282,1,8,0,7,3,19
191017283,7,3,2,8,3,23
191017284,0,5,4,7,9,25
191017285,7,9,6,5,9,36
191017286,6,3,7,7,7,30
191017287,7,9,6,1,2,25
191017288,0,3,2,1,3,9
191017289,6,3,9,8,3,29
191017290,3,4,1,3,4,15
191017291,8,1,5,2,4,20
191017292,9,6,1,8,6,30
191017293,0,4,8,6,7,25
191017294,5,1,3,9,4,22
191017295,3,7,2,3,9,24
191017296,2,8,1,7,7,25
191017297,4,2,4,9,4,23
191017298,7,6,3,6,8,30
191017299,9,0,1,7,8,25
191017300,0,3,3,4,9,19
191017301,3,1,7,2,0,13
191017302,1,4,9,6,3,23
191017303,8,2,0,2,1,13
191017304,6,8,9,4,4,31
191017305,4,2,9,6,3,24
191017306,0,5,0,5,1,11
191017307,4,8,7,5,5,29
191017308,5,0,5,4,4,18
191017309,4,7,8,3,6,28
191017310,2,7,5,4,3,21
191017311,0,7,7,4,3,21
191017312,4,2,1,6,3,16
191017313,4,3,7,6,8,28
191017314,1,6,4,5,1,17
191017315,9,8,9,6,3,35
191017316,2,5,0,9,8,24
191017317,7,0,8,1,3,19
191017318,9,7,4,9,9,38
191017319,9,5,1,0,9,24
191017320,4,2,3,8,9,26
191017321,5,0,8,9,5,27
191017322,4,7,3,9,6,29
191017323,8,7,4,2,9,30
191017324,9,5,6,3,6,29
191017325,4,8,5,2,2,21
191017326,9,4,3,3,5,24
191017327,6,1,9,7,2,25
191017328,6,5,8,9,9,37
191017329,9,1,0,1,7,18
191017330,5,6,5,6,3,25
191017331,3,7,4,3,0,17
191017332,5,8,0,7,3,23
191017333,9,9,2,4,0,24
191017334,8,3,6,1,4,22
191017335,2,9,6,5,4,26
191017336,9,5,9,2,0,25
191017337,2,2,4,8,2,18
191017338,3,8,2,4,6,23
191017339,2,2,9,4,8,25
191017340,7,7,7,3,5,29
191017341,6,6,4,6,2,24
191017342,7,8,3,7,8,33
191017343,0,9,5,3,0,17
191017344,8,6,1,8,9,32
191017345,1,4,3,1,6,15
191017346,1,0,5,7,9,22
191017347,0,4,0,5,9,18
191017348,3,9,9,4,6,31
191017349,5,6,9,2,4,26
191017350,1,0,2,8,5,16
191017351,3,1,7,7,4,22
191017352,0,3,9,9,7,28
191017353,8,4,6,0,5,23
191017354,4,1,5,1,7,18
191017355,0,0,7,9,9,25
191017356,4,8,4,9,6,31
191017357,1,9,1,1,8,20
191017358,1,9,7,3,0,20
191017359,0,0,8,3,5,16
191017360,5,3,7,4,9,28
191017361,8,5,9,5,8,35
191017362,1,7,7,3,5,23
191017363,7,9,4,0,4,24
191017364,4,9,1,0,9,23
191017365,9,1,0,5,7,22
191017366,2,9,2,6,3,22
191017367,9,0,2,5,0,16
191017368,1,4,0,5,5,15
191017369,1,1,9,1,1,13
191017370,4,3,7,1,3,18
191017371,1,9,6,0,6,22
191017372,5,9,3,3,4,24
191017373,0,8,8,8,8,32
191017374,9,0,7,8,5,29
191017375,0,4,4,9,2,19
191017376,9,7,7,0,7,30
191017377,2,6,6,7,0,21
191017378,2,9,3,3,6,23
191017379,0,4,9,2,8,23
191017380,6,2,7,2,3,20
191017381,0,2,5,1,1,9
191017382,4,0,3,6,3,16
191017383,6,4,5,7,9,31
191017384,1,5,4,7,1,18
191017385,1,9,6,2,3,21
191017386,2,4,7,7,6,26
191017387,0,6,0,6,6,18
191017388,9,7,2,8,3,29
191017389,1,4,9,7,1,22
191017390,4,4,3,1,0,12
191017391,1,0,9,2,0,12
191017392,7,8,4,7,2,28
191017393,2,1,7,2,6,18
191017394,6,8,7,0,6,27
191017395,8,6,1,5,9,29
191017396,4,1,5,7,6,23
191017397,0,7,5,8,8,28
191017398,2,1,1,4,9,17
191017399,3,7,8,1,3,22
191017400,5,1,7,8,1,22
191017401,1,5,3,4,6,19
191017402,3,1,2,1,3,10
191017403,3,6,5,0,5,19
191017404,8,4,5,2,0,19
191017405,2,2,2,4,4,14
191017406,5,2,4,9,3,23
191017407,6,7,9,1,5,28
191017408,6,7,7,9,0,29
191017409,2,2,7,1,9,21
191017410,5,4,7,9,1,26
191017411,0,7,1,0,2,10
191017412,1,1,2,4,9,17
191017413,3,3,9,3,7,25
191017414,7,4,3,9,2,25
191017415,0,7,4,2,4,17
191017416,8,0,9,4,6,27
191017417,6,6,4,8,5,29
191017418,8,2,9,0,5,24
191017419,5,0,3,1,5,14
191017420,3,1,3,6,5,18
191017421,2,3,3,2,7,17
191017422,5,7,5,3,1,21
191017423,5,1,5,7,2,20
191017424,5,1,4,2,1,13
191017425,3,0,6,5,3,17
191017426,5,2,8,0,8,23
191017427,9,7,5,2,2,25
191017428,7,5,6,8,6,32
191017429,6,7,5,3,3,24
191017430,3,1,9,4,8,25
191017431,7,7,8,9,9,40
191017432,2,9,4,7,8,30
191017433,0,1,5,1,7,14
191017434,9,6,8,8,2,33
191017435,1,5,4,6,5,21
191017436,4,8,8,0,0,20
191017437,1,5,0,7,5,18
191017438,9,6,4,6,8,33
191017439,3,5,4,2,6,20
191017440,1,4,3,4,3,15
191017441,6,3,6,3,1,19
191017442,1,5,3,6,5,20
191017443,3,0,9,3,7,22
191017444,3,2,8,1,2,16
191017445,3,4,9,3,1,20
191017446,7,6,0,1,6,20
191017447,8,5,0,7,1,21
191017448,8,7,4,5,7,31
191017449,4,7,3,9,9,32
191017450,7,8,5,2,7,29
191017451,9,9,5,4,0,27
191017452,9,1,1,3,0,14
191017453,8,5,1,4,4,22
191017454,5,7,0,6,6,24
191017455,5,4,2,1,1,13
191017456,8,8,6,6,4,32
191017457,3,6,1,1,4,15
191017458,0,9,1,2,2,14
191017459,1,0,0,6,3,10
191017460,8,6,0,5,4,23
191017461,2,6,9,2,7,26
191017462,3,8,3,0,5,19
191017463,1,7,6,4,5,23
191017464,5,5,5,6,1,22
191017465,6,8,4,9,0,27
191017466,2,7,2,3,1,15
191017467,7,9,1,5,2,24
191017468,3,7,3,8,0,21
191017469,6,3,9,7,3,28
191017470,0,4,4,3,6,17
191017471,9,9,0,1,9,28
191017472,5,4,5,9,1,24
191017473,1,4,6,8,0,19
191017474,6,4,0,7,1,18
191017475,4,8,3,3,3,21
191017476,2,7,7,8,9,33
191017477,2,4,9,8,5,28
191017478,9,9,0,9,0,27
191017479,0,1,6,9,5,21
191017480,6,3,7,1,3,20
191017481,7,9,0,5,1,22
191017482,5,6,9,9,3,32
191017483,7,9,3,2,8,29
191017484,4,7,3,5,1,20
191017485,0,1,4,1,5,11
191017486,7,2,0,5,5,19
191017487,6,5,9,9,1,30
191017488,4,5,2,3,7,21
191017489,2,7,2,4,2,17
191017490,4,3,7,6,4,24
191017491,2,3,4,6,8,23
191017492,7,2,2,2,5,18
191017493,2,5,7,4,3,21
191017494,1,9,6,0,2,18
191017495,3,4,8,1,0,16
191017496,7,6,7,5,8,33
191017497,0,7,7,7,4,25
191017498,5,1,5,5,5,21
191017499,2,4,1,3,4,14
191017500,9,7,0,4,1,21
191017501,8,9,6,9,5,37
191017502,2,4,6,0,9,21
191017503,3,4,3,3,8,21
191017504,6,7,3,8,7,31
191017505,7,3,7,2,3,22
191017506,1,8,6,0,8,23
191017507,4,0,5,2,5,16
191017508,9,4,2,2,9,26
191017509,1,8,4,8,9,30
191017510,1,0,3,7,8,19
191017511,1,1,2,7,1,12
191017512,1,6,2,9,9,27
191017513,2,6,2,1,7,18
191017514,2,2,4,3,3,14
191017515,7,8,8,1,1,25
191017516,4,4,5,6,1,20
191017517,0,8,1,1,0,10
191017518,0,7,7,9,3,26
191017519,6,7,8,6,1,28
191017520,1,3,9,0,0,13
191017521,4,5,5,0,4,18
191017522,4,1,3,6,3,17
191017523,9,4,2,5,9,29
191017524,9,2,5,8,4,28
191017525,0,1,0,9,2,12
191017526,4,4,4,3,9,24
191017527,5,7,3,9,5,29
191017528,1,3,6,9,3,22
191017529,7,2,7,8,6,30
191017530,7,6,3,9,0,25
191017531,7,9,6,0,8,30
191017532,1,3,5,5,3,17
191017533,8,3,3,1,6,21
191017534,4,1,2,2,3,12
191017535,2,5,1,0,2,10
191017536,2,7,0,8,6,23
191017537,4,5,4,3,5,21
191017538,0,8,8,1,4,21
191017539,8,0,8,6,1,23
191017540,4,5,0,0,4,13
191017541,1,6,2,2,8,19
191017542,1,3,9,2,7,22
191017543,1,5,0,1,7,14
191017544,8,8,8,5,1,30
191017545,7,1,4,4,7,23
191017546,3,9,6,1,0,19
191017547,0,2,7,7,0,16
191017548,5,7,5,2,9,28
191017549,6,7,1,8,3,25
191017550,9,8,4,5,2,28
191017551,1,0,0,5,8,14
191017552,5,6,7,6,5,29
191017553,7,2,0,4,0,13
191017554,7,5,5,8,3,28
191017555,7,5,9,4,4,29
191017556,4,8,0,4,5,21
191017557,6,1,0,1,1,9
191017558,4,4,7,0,0,15
191017559,2,7,3,7,7,26
191017560,3,6,2,2,5,18
191017561,1,6,8,4,7,26
191017562,1,6,4,4,2,17
191017563,8,5,5,1,9,28
191017564,5,3,3,1,5,17
191017565,0,5,2,3,1,11
191017566,7,4,6,4,2,23
191017567,9,3,6,5,5,28
191017568,3,4,2,6,2,17
191017569,4,7,2,8,9,30
191017570,9,6,0,5,6,26
191017571,9,1,5,8,5,28
191017572,0,1,6,2,9,18
191017573,1,9,9,5,4,28
191017574,2,8,1,2,6,19
191017575,2,9,4,8,7,30
191017576,0,2,8,8,5,23
191017577,0,8,4,8,3,23
191017578,6,6,3,2,4,21
191017579,1,7,1,5,8,22
191017580,8,7,1,5,7,28
191017581,3,6,5,5,0,19
191017582,7,0,5,4,9,25
191017583,2,3,8,0,2,15
191017584,8,7,0,2,9,26
191017585,2,4,4,0,9,19
191017586,9,1,1,2,7,20
191017587,9,1,1,5,8,24
191017588,1,2,3,0,9,15
191017589,4,1,0,3,3,11
191017590,4,1,1,7,8,21
191017591,1,0,4,6,7,18
191017592,2,0,9,9,2,22
191017593,7,6,9,1,0,23
191017594,8,2,6,4,0,20
191017595,7,9,9,7,4,36
191017596,5,0,9,7,7,28
191017597,1,6,0,7,9,23
191017598,2,4,8,4,9,27
191017599,5,6,3,3,7,24
191017600,5,0,8,9,1,23
191017601,9,6,5,5,1,26
191017602,6,4,7,9,0,26
191017603,5,5,2,7,9,28
191017604,6,3,4,1,4,18
191017605,4,7,0,8,2,21
191017606,3,4,2,7,9,25
191017607,4,9,1,4,6,24
191017608,1,6,2,0,6,15
191017609,4,5,0,1,3,13
191017610,7,7,5,6,8,33
191017611,8,2,2,9,8,29
191017612,7,8,4,3,6,28
191017613,3,1,7,3,5,19
191017614,0,3,4,9,7,23
191017615,0,2,6,6,4,18
191017616,9,6,4,1,5,25
191017617,2,9,9,4,5,29
191017618,0,2,9,1,3,15
191017619,2,7,5,3,9,26
191017620,3,4,2,5,6,20
191017621,1,9,4,3,3,20
191017622,1,1,5,4,5,16
191017623,4,5,6,2,0,17
191017624,5,2,2,1,0,10
191017625,4,8,4,4,4,24
191017626,1,9,8,0,8,26
191017627,9,4,0,0,1,14
191017628,9,0,6,7,1,23
191017629,5,6,9,7,1,28
191017630,6,9,4,0,2,21
191017631,0,4,8,5,0,17
191017632,3,6,6,8,0,23
191017633,7,8,4,9,7,35
191017634,2,1,2,1,8,14
191017635,7,0,8,0,5,20
191017636,3,4,9,5,1,22
191017637,0,4,8,9,8,29
191017638,0,9,1,5,0,15
191017639,2,9,2,6,4,23
191017640,3,7,3,4,5,22
191017641,1,9,1,0,4,15
191017642,0,5,0,4,9,18
191017643,9,4,2,1,3,19
191017644,9,8,8,0,4,29
191017645,2,6,4,1,6,19
191017646,1,1,2,5,4,13
191017647,3,2,8,2,4,19
191017648,9,6,2,6,6,29
191017649,2,1,9,5,3,20
191017650,5,3,7,2,0,17
191017651,5,3,5,0,5,18
191017652,6,8,6,6,9,35
191017653,0,1,1,2,5,9
191017654,4,9,4,0,9,26
191017655,8,3,9,0,0,20
191017656,1,7,8,9,3,28
191017657,7,7,2,0,1,17
191017658,7,3,3,0,6,19
191017659,8,2,2,4,4,20
191017660,4,1,6,7,8,26
191017661,4,9,8,7,7,35
191017662,1,1,2,7,6,17
191017663,6,4,5,2,1,18
191017664,9,3,1,6,7,26
191017665,0,1,9,8,7,25
191017666,8,8,7,4,5,32
191017667,9,4,4,6,5,28
191017668,8,2,2,8,1,21
191017669,4,0,2,1,9,16
191017670,4,0,2,2,5,13
191017671,4,5,5,2,0,16
191017672,7,8,1,7,1,24
191017673,6,3,1,9,8,27
191017674,5,1,8,0,7,21
191017675,7,6,8,7,4,32
191017676,5,5,1,8,0,19
191017677,2,4,5,3,7,21
191017678,5,2,9,2,5,23
191017679,8,3,4,2,1,18
191017680,6,1,2,4,7,20
191017681,5,0,6,2,3,16
191017682,3,6,2,1,0,12
191017683,5,3,4,6,7,25
191017684,7,0,9,2,7,25
191017685,2,8,8,1,8,27
191017686,5,7,0,2,3,17
191017687,9,8,2,7,2,28
191017688,5,7,9,9,3,33
191017689,4,6,2,0,3,15
191017690,4,8,1,6,0,19
191017691,8,8,7,5,8,36
191017692,0,6,5,1,6,18
191017693,3,0,4,6,5,18
191017694,5,4,1,2,2,14
191017695,1,5,3,8,5,22
191017696,0,9,2,2,6,19
191017697,0,2,3,3,3,11
191017698,6,2,0,0,7,15
191017699,8,9,9,6,2,34
191017700,9,3,3,0,7,22
191017701,8,8,4,1,8,29
191017702,4,2,9,4,6,25
191017703,6,7,4,0,1,18
191017704,2,7,9,1,6,25
191017705,9,2,8,4,1,24
191017706,2,3,5,9,1,20
191017707,8,7,7,1,6,29
191017708,8,0,9,6,1,24
191017709,4,7,8,3,8,30
191017710,8,7,3,5,7,30
191017711,5,9,3,1,1,19
191017712,2,0,7,9,6,24
191017713,2,3,6,1,0,12
191017714,4,8,1,1,5,19
191017715,8,8,7,9,5,37
191017716,3,8,9,5,8,33
191017717,6,3,2,2,5,18
191017718,7,8,5,6,2,28
191017719,5,6,0,4,2,17
191017720,4,0,0,1,0,5
191017721,2,1,7,3,8,21
191017722,8,7,2,0,4,21
191017723,0,1,4,6,6,17
191017724,6,9,4,5,7,31
191017725,0,0,1,8,1,10
191017726,0,2,0,8,8,18
191017727,2,6,3,6,2,19
191017728,3,5,7,0,3,18
191017729,5,8,5,2,1,21
191017730,0,2,1,3,0,6
191017731,6,5,4,9,7,31
191017732,8,0,3,2,7,20
191017733,3,4,7,4,0,18
191017734,0,2,4,6,6,18
191017735,7,2,6,4,4,23
191017736,2,8,0,7,4,21
191017737,7,0,6,2,4,19
191017738,2,4,4,0,7,17
191017739,4,5,5,5,1,20
191017740,0,8,1,9,7,25
191017741,0,5,1,0,7,13
191017742,8,3,2,0,2,15
191017743,4,6,8,7,9,34
191017744,0,6,5,1,7,19
191017745,4,4,3,5,5,21
191017746,6,4,4,6,8,28
191017747,9,3,6,6,0,24
191017748,0,5,2,9,8,24
191017749,0,1,8,7,9,25
191017750,6,4,7,0,5,22
191017751,2,9,1,6,5,23
191017752,5,1,4,4,8,22
191017753,9,3,6,7,7,32
191017754,9,5,3,1,4,22
191017755,8,7,4,4,7,30
191017756,5,7,8,4,8,32
191017757,1,3,4,5,9,22
191017758,1,1,9,3,2,16
191017759,8,0,3,0,1,12
191017760,9,3,2,0,6,20
191017761,4,5,9,0,0,18
191017762,4,4,2,0,2,12
191017763,3,2,7,7,8,27
191017764,1,5,4,5,9,24
191017765,7,0,6,9,4,26
191017766,9,2,0,7,4,22
191017767,7,1,6,0,9,23
191017768,3,7,3,5,3,21
191017769,2,9,6,8,6,31
191017770,9,8,0,7,3,27
191017771,6,8,1,2,8,25
191017772,0,9,4,9,0,22
191017773,1,4,3,5,3,16
191017774,3,7,7,3,5,25
191017775,6,3,2,1,3,15
191017776,3,7,7,2,5,24
191017777,6,4,6,8,0,24
191017778,7,3,9,0,7,26
191017779,8,7,1,6,7,29
191017780,9,9,0,1,0,19
191017781,0,4,3,1,6,14
191017782,4,5,0,4,8,21
191017783,4,3,7,4,7,25
191017784,4,9,8,6,4,31
191017785,5,1,8,0,8,22
191017786,1,2,0,7,7,17
191017787,5,0,8,3,1,17
191017788,1,9,8,2,7,27
191017789,5,8,7,0,6,26
191017790,6,8,2,2,6,24
191017791,9,5,0,0,5,19
191017792,5,6,6,5,9,31
191017793,2,2,0,7,9,20
191017794,3,3,1,4,0,11
191017795,2,7,8,3,4,24
191017796,5,2,5,9,1,22
191017797,4,3,0,0,5,12
191017798,2,7,9,6,6,30
191017799,3,7,0,8,8,26
191017800,4,0,6,2,1,13
191017801,4,6,8,6,1,25
191017802,1,9,8,7,0,25
191017803,1,9,2,1,5,18
191017804,8,0,2,5,3,18
191017805,2,3,8,2,8,23
191017806,7,5,4,9,9,34
191017807,8,2,6,1,4,21
191017808,1,1,8,1,4,15
191017809,1,6,1,4,0,12
191017810,0,3,7,5,9,24
191017811,1,7,7,8,9,32
191017812,9,6,6,7,2,30
191017813,7,9,1,0,1,18
191017814,7,2,8,4,5,26
191017815,4,6,6,9,1,26
191017816,8,6,8,3,2,27
191017817,7,3,1,0,1,12
191017818,1,2,2,7,5,17
191017819,4,4,0,7,0,15
191017820,5,8,8,6,1,28
191017821,9,2,3,0,0,14
191017822,4,3,9,3,4,23
191017823,8,1,1,5,3,18
191017824,7,6,2,8,0,23
191017825,6,4,3,2,2,17
191017826,9,9,4,8,9,39
191017827,7,8,7,0,9,31
191017828,5,4,6,8,9,32
191017829,5,1,5,4,7,22
191017830,0,6,4,8,5,23
191017831,2,0,9,8,7,26
191017832,3,0,4,1,3,11
191017833,8,0,2,6,2,18
191017834,1,4,1,0,5,11
191017835,8,9,3,6,9,35
191017836,4,1,8,0,7,20
191017837,3,0,3,3,4,13
191017838,2,3,7,5,0,17
191017839,9,3,2,8,6,28
191017840,4,3,3,5,1,16
191017841,1,0,9,4,9,23
191017842,3,7,9,1,5,25
191017843,3,8,2,8,4,25
191017844,8,0,5,9,8,30
191017845,1,9,6,2,2,20
191017846,2,3,0,3,9,17
191017847,7,7,7,3,1,25
191017848,6,3,7,5,1,22
191017849,4,3,5,7,9,28
191017850,6,4,3,9,4,26
191017851,1,3,9,9,1,23
191017852,0,5,4,0,2,11
191017853,2,4,5,5,2,18
191017854,2,5,1,3,4,15
191017855,2,3,1,5,6,17
191017856,1,2,4,4,3,14
191017857,7,5,7,9,4,32
191017858,9,4,4,6,1,24
191017859,8,6,8,4,8,34
191017860,7,0,6,3,6,22
191017861,7,0,1,1,6,15
191017862,2,2,2,5,8,19
191017863,6,1,4,6,7,24
191017864,1,0,9,9,5,24
191017865,2,5,4,0,6,17
191017866,6,2,3,0,8,19
191017867,2,0,9,3,5,19
191017868,7,0,5,0,5,17
191017869,6,9,3,0,5,23
191017870,2,6,8,6,2,24
191017871,6,8,4,8,9,35
191017872,3,5,2,7,9,26
191017873,3,0,6,9,1,19
191017874,7,0,8,0,9,24
191017875,9,6,9,5,9,38
191017876,3,5,9,5,4,26
191017877,8,6,2,4,9,29
191017878,9,7,8,7,9,40
191017879,7,4,6,0,0,17
191017880,6,3,2,4,4,19
191017881,4,6,5,7,7,29
191017882,9,8,5,8,6,36
191017883,3,4,2,2,6,17
191017884,9,1,4,3,1,18
191017885,8,3,6,5,7,29
191017886,1,2,2,0,3,8
191017887,8,1,0,1,1,11
191017888,9,4,3,0,0,16
191017889,4,2,8,8,4,26
191017890,8,3,4,9,6,30
191017891,7,7,7,1,1,23
191017892,5,9,8,0,3,25
191017893,2,1,1,8,7,19
191017894,1,0,2,5,2,10
191017895,3,4,7,3,1,18
191017896,3,2,2,8,6,21
191017897,8,8,7,5,9,37
191017898,1,3,5,6,0,15
191017899,7,4,5,0,8,24
191017900,8,4,3,3,3,21
191017901,9,9,6,6,8,38
191017902,5,8,2,7,1,23
191017903,4,6,4,9,4,27
191017904,8,8,0,0,0,16
191017905,3,7,4,4,5,23
191017906,7,5,3,0,0,15
191017907,9,8,7,9,7,40
191017908,7,4,2,2,2,17
191017909,5,6,3,4,2,20
191017910,4,2,6,1,6,19
191017911,1,7,1,5,7,21
191017912,6,7,5,7,0,25
191017913,8,6,6,5,4,29
191017914,5,6,3,2,7,23
191017915,3,8,6,2,3,22
191017916,1,5,5,0,8,19
191017917,2,8,5,6,0,21
191017918,7,6,1,4,0,18
191017919,9,4,9,7,1,30
191017920,3,0,4,3,7,17
191017921,9,0,1,1,3,14
191017922,9,8,9,0,4,30
191017923,1,2,0,2,9,14
191017924,9,8,4,5,4,30
191017925,6,6,6,6,5,29
191017926,8,0,8,8,7,31
191017927,4,3,8,9,1,25
191017928,6,6,0,5,4,21
191017929,6,3,7,8,1,25
191017930,1,4,4,0,2,11
191017931,9,3,0,7,2,21
191017932,1,6,4,8,2,21
191017933,0,0,2,5,9,16
191017934,6,9,8,9,7,39
191017935,8,9,6,8,7,38
191017936,3,5,5,9,5,27
191017937,5,2,4,3,3,17
191017938,1,1,5,9,6,22
191017939,0,9,2,8,2,21
191017940,2,5,0,9,7,23
191017941,5,7,7,3,7,29
191017942,8,6,8,5,6,33
191017943,7,2,4,1,7,21
191017944,2,6,3,9,2,22
191017945,4,5,6,0,5,20
191017946,1,6,6,9,6,28
191017947,6,9,3,9,1,28
191017948,7,6,3,1,1,18
191017949,8,0,4,0,0,12
191017950,1,2,4,2,2,11
191017951,5,0,1,2,2,10
191017952,9,6,5,6,3,29
191017953,4,7,9,7,6,33
191017954,9,4,3,6,0,22
191017955,1,1,5,2,8,17
191017956,4,4,2,4,8,22
191017957,6,0,4,5,2,17
191017958,2,8,7,1,1,19
191017959,2,7,3,3,6,21
191017960,2,9,0,3,4,18
191017961,2,9,1,5,5,22
191017962,6,0,2,9,2,19
191017963,2,3,6,9,2,22
191017964,5,0,6,2,6,19
191017965,0,2,8,3,4,17
191017966,9,8,2,8,1,28
191017967,0,9,6,5,7,27
191017968,9,4,3,7,0,23
191017969,0,9,3,1,3,16
191017970,8,7,3,3,6,27
191017971,3,1,2,7,3,16
191017972,8,6,7,0,9,30
191017973,6,2,9,0,3,20
191017974,2,3,2,3,7,17
191017975,9,4,5,2,2,22
191017976,7,8,0,0,1,16
191017977,9,4,0,5,3,21
191017978,8,1,3,8,8,28
191017979,6,5,7,5,7,30
191017980,9,1,3,5,3,21
191017981,3,2,8,5,9,27
191017982,7,2,2,0,1,12
191017983,7,5,2,2,9,25
191017984,0,5,8,5,1,19
191017985,4,2,4,7,0,17
191017986,0,5,3,2,5,15
191017987,4,0,3,3,1,11
191017988,7,4,8,1,5,25
191017989,9,8,8,1,0,26
191017990,7,1,0,3,2,13
191017991,5,2,2,5,2,16
191017992,0,8,6,3,3,20
191017993,8,4,8,8,2,30
191017994,6,8,9,9,1,33
191017995,3,2,8,6,0,19
191017996,0,9,8,5,7,29
191017997,9,3,1,6,1,20
191017998,0,8,7,7,7,29
191017999,8,9,6,6,8,37
1910171000,9,3,8,9,0,29
1910171001,8,3,8,9,4,32
1910171002,6,1,8,1,9,25
1910171003,8,1,8,2,5,24
1910171004,5,7,4,1,3,20
1910171005,2,2,3,4,5,16
1910171006,3,1,3,6,0,13
1910171007,0,7,3,3,0,13
1910171008,9,1,5,7,1,23
1910171009,4,6,3,1,4,18
1910171010,3,0,8,3,4,18
1910171011,3,7,3,7,4,24
1910171012,5,2,7,9,7,30
1910171013,1,3,9,5,2,20
1910171014,3,5,5,8,3,24
1910171015,6,7,6,0,5,24
1910171016,1,5,7,8,9,30
1910171017,0,3,4,2,8,17
1910171018,8,3,3,2,5,21
1910171019,0,6,0,5,8,19
1910171020,9,7,0,6,8,30
1910171021,8,7,1,0,1,17
1910171022,3,8,8,0,8,27
1910171023,8,5,2,1,3,19
1910171024,6,7,2,8,9,32
1910171025,7,2,1,0,9,19
1910171026,5,9,3,0,0,17
1910171027,9,5,7,4,9,34
1910171028,6,6,5,3,8,28
1910171029,0,7,0,9,9,25
1910171030,7,9,7,7,5,35
1910171031,8,8,8,5,2,31
1910171032,8,7,3,7,1,26
1910171033,7,6,3,0,5,21
1910171034,9,3,1,2,4,19
1910171035,9,5,8,8,5,35
1910171036,2,4,9,7,2,24
1910171037,5,0,3,5,3,16
1910171038,9,0,4,0,1,14
1910171039,9,1,6,3,0,19
1910171040,2,1,0,3,6,12
1910171041,4,5,5,3,8,25
1910171042,3,9,8,9,2,31
1910171043,1,1,8,5,3,18
1910171044,6,2,0,1,0,9
1910171045,1,9,2,4,6,22
1910171046,5,3,2,2,1,13
1910171047,7,7,2,7,4,27
1910171048,9,6,6,8,7,36
1910171049,1,3,3,8,9,24
1910171050,4,1,3,8,3,19
1910171051,4,4,5,5,1,19
1910171052,3,4,5,9,1,22
1910171053,6,4,5,1,9,25
1910171054,9,7,9,0,1,26
1910171055,3,8,0,7,4,22
1910171056,7,8,9,7,4,35
1910171057,4,1,9,9,9,32
1910171058,0,0,2,4,2,8
1910171059,9,0,2,1,8,20
1910171060,4,4,4,8,4,24
1910171061,4,3,5,0,7,19
1910171062,1,7,2,9,5,24
1910171063,9,3,3,0,6,21
1910171064,9,0,4,4,6,23
1910171065,7,6,9,9,7,38
1910171066,8,9,5,8,1,31
1910171067,1,7,1,0,8,17
1910171068,5,3,8,9,0,25
1910171069,2,0,6,7,1,16
1910171070,6,0,6,0,1,13
1910171071,5,4,4,4,1,18
1910171072,9,4,9,1,0,23
1910171073,4,2,3,2,8,19
1910171074,5,2,4,0,2,13
1910171075,7,5,2,1,9,24
1910171076,1,2,8,6,9,26
1910171077,3,4,4,6,3,20
1910171078,1,1,0,1,5,8
1910171079,7,1,3,3,7,21
1910171080,8,0,4,0,5,17
1910171081,4,9,1,6,4,24
1910171082,6,4,7,0,0,17
1910171083,1,7,4,5,2,19
1910171084,4,7,3,2,4,20
1910171085,6,0,0,5,2,13
1910171086,4,8,5,5,8,30
1910171087,1,1,8,9,4,23
1910171088,7,9,4,8,5,33
1910171089,6,0,1,6,9,22
1910171090,5,9,6,2,5,27
1910171091,1,4,0,9,7,21
1910171092,7,8,5,5,2,27
1910171093,1,0,2,0,0,3
1910171094,9,4,9,7,7,36
1910171095,6,7,3,4,9,29
1910171096,9,3,0,2,5,19
1910171097,3,1,8,1,7,20
1910171098,0,4,5,2,9,20
1910171099,1,7,0,5,5,18
1910171100,1,5,9,8,4,27
1910171101,8,3,9,4,7,31
1910171102,5,1,7,0,9,22
1910171103,8,4,8,7,1,28
1910171104,0,0,7,4,5,16
1910171105,6,3,6,9,4,28
191018001,5,1,0,1,0,7
191018002,0,2,9,0,3,14
191018003,1,8,0,3,3,15
191018004,1,8,5,1,6,21
191018005,3,9,9,8,2,31
191018006,3,6,2,5,6,22
191018007,2,2,7,3,4,18
191018008,6,6,6,4,4,26
191018009,1,7,6,2,5,21
191018010,0,6,0,7,4,17
191018011,1,6,3,5,2,17
191018012,2,4,1,0,4,11
191018013,2,5,7,4,8,26
191018014,5,1,1,7,2,16
191018015,8,3,6,8,2,27
191018016,8,2,1,0,4,15
191018017,9,1,7,0,1,18
191018018,1,9,3,2,1,16
191018019,4,4,8,1,9,26
191018020,9,7,9,5,4,34
191018021,9,0,2,0,4,15
191018022,9,9,3,7,6,34
191018023,4,1,2,1,6,14
191018024,3,1,5,1,2,12
191018025,1,5,4,0,6,16
191018026,9,0,3,0,3,15
191018027,9,8,5,5,0,27
191018028,1,7,3,9,0,20
191018029,5,4,3,6,8,26
191018030,8,1,1,3,4,17
191018031,3,8,9,6,3,29
191018032,8,8,3,6,5,30
191018033,3,1,7,5,5,21
191018034,6,2,6,7,3,24
191018035,2,4,2,3,1,12
191018036,9,6,0,4,0,19
191018037,2,5,8,7,2,24
191018038,5,8,6,4,9,32
191018039,9,0,9,6,6,30
191018040,8,8,0,1,6,23
191018041,8,6,3,6,8,31
191018042,8,3,3,7,8,29
191018043,5,9,4,3,7,28
191018044,3,2,7,7,6,25
191018045,6,2,0,8,5,21
191018046,0,8,9,7,1,25
191018047,9,8,3,0,3,23
191018048,7,5,4,3,8,27
191018049,8,1,9,3,3,24
191018050,4,5,1,2,7,19
191018051,1,5,0,4,1,11
191018052,8,2,2,0,7,19
191018053,6,8,2,0,9,25
191018054,1,1,9,2,0,13
191018055,6,3,6,7,9,31
191018056,0,8,0,0,1,9
191018057,9,0,1,7,3,20
191018058,2,7,4,1,7,21
191018059,6,1,2,1,9,19
191018060,3,0,3,8,9,23
191018061,5,0,2,0,4,11
191018062,5,7,1,7,1,21
191018063,1,4,9,8,9,31
191018064,7,4,9,5,1,26
191018065,0,1,1,4,3,9
191018066,6,5,6,3,1,21
191018067,2,9,1,7,9,28
191018068,6,1,9,9,7,32
191018069,0,8,1,0,5,14
191018070,8,1,4,2,3,18
191018071,5,1,8,4,8,26
191018072,3,7,5,2,5,22
191018073,7,3,5,8,5,28
191018074,5,8,4,3,8,28
191018075,6,7,5,2,5,25
191018076,8,6,2,5,9,30
191018077,0,8,2,8,4,22
191018078,0,9,2,4,3,18
191018079,7,7,2,1,6,23
191018080,8,7,3,4,5,27
191018081,1,2,8,0,2,13
191018082,4,5,2,4,7,22
191018083,3,3,0,2,0,8
191018084,5,5,4,4,6,24
191018085,9,4,1,0,7,21
191018086,0,1,1,5,3,10
191018087,1,6,5,7,4,23
191018088,2,9,5,6,3,25
191018089,5,2,3,4,9,23
191018090,8,5,3,2,9,27
191018091,6,5,5,7,5,28
191018092,5,9,3,2,7,26
191018093,4,0,5,3,4,16
191018094,8,3,5,5,2,23
191018095,2,4,8,0,5,19
191018096,4,2,5,1,7,19
191018097,9,8,2,4,0,23
191018098,6,4,2,4,7,23
191018099,9,5,6,3,9,32
191018100,1,9,3,7,8,28
191018101,3,2,1,5,2,13
191018102,7,3,3,9,4,26
191018103,3,7,7,8,0,25
191018104,1,1,8,0,8,18
191018105,2,2,6,8,2,20
191018106,3,3,8,6,9,29
191018107,2,0,7,9,4,22
191018108,6,3,4,1,3,17
191018109,6,6,4,1,1,18
191018110,3,0,3,3,1,10
191018111,5,2,9,8,6,30
191018112,5,9,1,4,6,25
191018113,7,9,2,0,4,22
191018114,9,6,0,1,6,22
191018115,3,1,3,6,2,15
191018116,0,8,7,6,2,23
191018117,1,7,3,3,1,15
191018118,6,8,3,2,2,21
191018119,0,5,0,7,0,12
191018120,5,0,5,6,7,23
191018121,4,6,5,5,7,27
191018122,1,9,2,9,4,25
191018123,9,3,4,9,0,25
191018124,9,3,9,6,2,29
191018125,4,5,4,7,9,29
191018126,7,0,7,7,3,24
191018127,0,0,6,2,2,10
191018128,1,1,4,6,4,16
191018129,5,2,2,2,9,20
191018130,4,8,2,6,6,26
191018131,9,3,0,2,6,20
191018132,7,7,9,2,2,27
191018133,5,4,4,7,3,23
191018134,6,8,7,5,6,32
191018135,9,0,2,6,9,26
191018136,0,2,8,1,1,12
191018137,9,2,9,4,1,25
191018138,4,4,1,2,2,13
191018139,8,3,7,1,5,24
191018140,8,1,4,5,4,22
191018141,7,3,1,2,0,13
191018142,0,8,6,1,9,24
191018143,1,6,7,8,8,30
191018144,3,8,1,4,2,18
191018145,8,2,2,7,1,20
191018146,2,4,2,3,5,16
191018147,5,5,8,5,0,23
191018148,0,3,2,4,8,17
191018149,7,7,9,9,7,39
191018150,9,6,5,4,5,29
191018151,3,1,2,0,0,6
191018152,6,9,9,3,3,30
191018153,2,4,8,6,5,25
191018154,5,2,9,7,5,28
191018155,7,9,6,5,8,35
191018156,1,0,9,8,2,20
191018157,3,5,3,8,1,20
191018158,3,7,4,6,5,25
191018159,4,7,7,0,8,26
191018160,5,1,0,4,8,18
191018161,2,3,9,1,8,23
191018162,8,5,6,2,9,30
191018163,7,4,7,8,0,26
191018164,9,4,5,9,4,31
191018165,4,8,0,4,8,24
191018166,2,2,1,7,1,13
191018167,6,7,7,8,2,30
191018168,5,9,7,4,1,26
191018169,2,3,2,0,8,15
191018170,2,5,7,5,6,25
191018171,7,7,8,7,1,30
191018172,4,9,9,5,1,28
191018173,4,5,8,9,3,29
191018174,7,5,7,4,5,28
191018175,0,4,9,2,5,20
191018176,3,3,2,4,8,20
191018177,6,8,4,0,3,21
191018178,0,4,3,1,9,17
191018179,1,9,5,4,7,26
191018180,9,1,0,4,0,14
191018181,0,6,9,0,4,19
191018182,8,7,4,5,1,25
191018183,5,2,5,4,3,19
191018184,3,4,2,6,1,16
191018185,8,1,9,3,0,21
191018186,5,6,3,1,6,21
191018187,6,6,1,2,0,15
191018188,0,0,0,9,2,11
191018189,9,8,4,7,5,33
191018190,2,5,6,8,8,29
191018191,1,0,9,8,4,22
191018192,1,7,7,5,6,26
191018193,7,7,7,7,4,32
191018194,0,2,1,8,5,16
191018195,8,7,0,1,4,20
191018196,7,3,2,5,0,17
191018197,0,1,3,6,7,17
191018198,8,9,6,6,6,35
191018199,5,3,6,7,1,22
191018200,2,0,4,4,3,13
191018201,4,6,5,3,8,26
191018202,8,9,0,9,3,29
191018203,2,6,9,3,0,20
191018204,0,5,0,8,6,19
191018205,1,3,0,3,8,15
191018206,4,6,3,8,4,25
191018207,3,4,0,1,9,17
191018208,3,5,0,4,4,16
191018209,7,2,2,5,9,25
191018210,7,3,2,0,9,21
191018211,2,5,8,8,1,24
191018212,2,5,5,4,4,20
191018213,3,6,6,0,7,22
191018214,6,8,4,8,6,32
191018215,9,0,7,5,2,23
191018216,3,1,3,0,4,11
191018217,5,3,6,8,4,26
191018218,7,0,5,7,6,25
191018219,9,4,1,1,0,15
191018220,4,9,0,5,6,24
191018221,3,3,4,6,9,25
191018222,1,1,5,6,6,19
191018223,8,4,1,1,5,19
191018224,9,5,4,6,7,31
191018225,7,7,1,9,2,26
191018226,6,3,4,1,1,15
191018227,3,1,3,1,5,13
191018228,6,6,5,8,6,31
191018229,9,3,9,1,6,28
191018230,7,0,8,9,7,31
191018231,9,5,1,4,7,26
191018232,9,4,4,8,4,29
191018233,7,2,4,1,3,17
191018234,1,1,1,0,4,7
191018235,4,3,2,9,7,25
191018236,8,6,4,6,3,27
191018237,3,1,3,0,9,16
191018238,2,0,8,0,3,13
191018239,0,6,0,5,3,14
191018240,7,0,6,7,7,27
191018241,9,5,1,7,5,27
191018242,4,9,0,7,2,22
191018243,5,7,4,7,6,29
191018244,8,4,1,7,7,27
191018245,9,1,5,1,1,17
191018246,9,0,1,9,8,27
191018247,3,5,6,2,0,16
191018248,5,5,2,8,4,24
191018249,9,8,3,2,3,25
191018250,1,3,8,0,2,14
191018251,6,3,2,9,4,24
191018252,7,3,9,3,1,23
191018253,3,4,7,1,5,20
191018254,1,0,0,7,8,16
191018255,1,9,8,0,1,19
191018256,4,1,6,9,0,20
191018257,1,7,0,2,3,13
191018258,5,7,1,6,8,27
191018259,3,4,9,4,6,26
191018260,5,0,5,7,7,24
191018261,8,5,4,7,4,28
191018262,4,4,3,0,1,12
191018263,5,5,4,8,9,31
191018264,3,6,9,9,8,35
191018265,2,6,3,2,9,22
191018266,5,0,4,7,9,25
191018267,1,5,4,4,7,21
191018268,8,8,7,2,0,25
191018269,1,4,0,0,1,6
191018270,4,7,1,9,0,21
191018271,2,5,1,1,5,14
191018272,4,0,6,6,0,16
191018273,2,6,7,2,6,23
191018274,7,0,9,4,4,24
191018275,2,4,6,0,5,17
191018276,2,5,5,9,3,24
191018277,7,2,7,5,1,22
191018278,2,0,8,9,0,19
191018279,2,6,6,4,9,27
191018280,0,7,7,5,6,25
191018281,1,0,5,2,2,10
191018282,9,3,5,8,9,34
191018283,0,3,4,3,5,15
191018284,3,4,3,9,4,23
191018285,5,4,5,8,4,26
191018286,9,2,0,5,5,21
191018287,7,3,3,8,4,25
191018288,6,7,0,8,8,29
191018289,4,1,4,0,6,15
191018290,5,8,2,7,7,29
191018291,9,1,0,2,2,14
191018292,4,1,8,4,3,20
191018293,8,1,2,5,3,19
191018294,6,6,8,2,1,23
191018295,9,2,3,4,7,25
191018296,2,7,5,1,2,17
191018297,9,6,4,6,4,29
191018298,8,9,8,1,8,34
191018299,1,6,6,4,6,23
191018300,6,8,6,0,3,23
191018301,9,1,0,1,3,14
191018302,9,7,9,1,7,33
191018303,9,5,4,5,5,28
191018304,5,0,1,7,9,22
191018305,0,4,9,9,3,25
191018306,8,6,2,8,8,32
191018307,4,2,8,3,7,24
191018308,8,9,5,0,9,31
191018309,1,8,8,5,3,25
191018310,7,5,0,1,8,21
191018311,4,1,6,5,4,20
191018312,7,0,6,0,3,16
191018313,4,5,8,9,5,31
191018314,4,1,0,1,1,7
191018315,3,2,6,4,9,24
191018316,9,7,6,6,3,31
191018317,7,2,8,5,7,29
191018318,2,8,9,9,1,29
191018319,2,5,9,1,7,24
191018320,2,2,7,3,3,17
191018321,8,5,3,6,8,30
191018322,8,1,3,9,1,22
191018323,6,6,6,4,9,31
191018324,8,8,3,8,9,36
191018325,5,1,9,0,4,19
191018326,2,4,5,3,1,15
191018327,8,3,4,3,2,20
191018328,4,6,3,3,8,24
191018329,9,1,4,1,7,22
191018330,0,0,7,8,6,21
191018331,9,3,4,2,8,26
191018332,1,5,9,7,1,23
191018333,8,5,2,8,1,24
191018334,5,7,6,7,9,34
191018335,3,2,0,7,1,13
191018336,6,5,4,7,8,30
191018337,3,6,3,6,9,27
191018338,9,6,2,5,4,26
191018339,6,8,2,5,1,22
191018340,2,1,1,2,9,15
191018341,3,9,1,7,0,20
191018342,4,2,3,2,9,20
191018343,7,0,1,0,5,13
191018344,0,9,8,7,3,27
191018345,7,0,9,0,0,16
191018346,0,2,0,9,1,12
191018347,4,3,8,3,6,24
191018348,8,3,7,8,6,32
191018349,9,9,3,8,5,34
191018350,9,2,9,9,5,34
191018351,2,4,8,2,5,21
191018352,1,3,7,6,8,25
191018353,5,8,0,7,8,28
191018354,2,2,7,7,4,22
191018355,6,2,7,4,7,26
191018356,9,4,0,8,0,21
191018357,8,2,1,6,1,18
191018358,2,3,2,3,4,14
191018359,9,2,1,1,5,18
191018360,8,1,4,6,2,21
191018361,1,9,2,5,6,23
191018362,1,6,2,9,5,23
191018363,2,1,3,6,3,15
191018364,1,6,2,1,0,10
191018365,9,7,8,6,0,30
191018366,7,1,1,7,7,23
191018367,4,6,4,2,7,23
191018368,9,6,0,1,0,16
191018369,1,9,2,2,4,18
191018370,4,0,0,6,8,18
191018371,4,0,6,2,4,16
191018372,1,8,7,5,6,27
191018373,6,3,0,2,0,11
191018374,7,7,5,5,0,24
191018375,7,8,1,6,9,31
191018376,8,7,0,3,2,20
191018377,3,2,7,2,2,16
191018378,6,3,6,2,3,20
191018379,0,2,5,9,1,17
191018380,2,8,3,1,6,20
191018381,2,9,6,2,0,19
191018382,6,7,0,8,2,23
191018383,7,9,4,6,8,34
191018384,8,9,2,9,2,30
191018385,7,3,8,3,8,29
191018386,6,3,0,4,4,17
191018387,6,4,7,3,8,28
191018388,2,6,5,8,2,23
191018389,4,1,7,4,1,17
191018390,6,3,2,5,3,19
191018391,6,6,6,3,1,22
191018392,2,4,8,7,7,28
191018393,2,4,6,4,5,21
191018394,9,3,3,9,8,32
191018395,8,5,3,9,4,29
191018396,7,9,0,0,7,23
191018397,1,8,8,6,4,27
191018398,4,3,3,2,0,12
191018399,3,8,9,0,8,28
191018400,7,6,2,2,4,21
191018401,9,0,2,3,6,20
191018402,9,0,8,2,9,28
191018403,4,5,8,4,2,23
191018404,3,1,1,9,3,17
191018405,5,5,6,1,6,23
191018406,5,3,5,2,1,16
191018407,9,3,1,4,4,21
191018408,2,3,2,0,9,16
191018409,7,4,8,9,0,28
191018410,4,1,0,4,2,11
191018411,9,8,1,5,3,26
191018412,6,4,2,1,7,20
191018413,3,4,6,3,6,22
191018414,0,1,8,2,8,19
191018415,0,7,7,4,7,25
191018416,2,8,1,0,0,11
191018417,8,6,5,0,2,21
191018418,1,7,2,7,9,26
191018419,1,6,8,3,3,21
191018420,8,9,9,0,4,30
191018421,3,1,8,7,1,20
191018422,1,7,3,1,7,19
191018423,6,7,3,3,4,23
191018424,9,8,9,2,4,32
191018425,8,0,8,7,7,30
191018426,4,0,9,0,2,15
191018427,8,8,4,5,4,29
191018428,8,0,1,2,7,18
191018429,5,2,5,4,2,18
191018430,1,5,8,7,2,23
191018431,9,9,0,5,7,30
191018432,2,2,2,7,3,16
191018433,1,5,5,6,9,26
191018434,1,8,6,1,2,18
191018435,4,9,0,3,4,20
191018436,2,7,9,6,1,25
191018437,2,8,5,0,6,21
191018438,8,4,9,0,4,25
191018439,4,2,5,0,1,12
191018440,2,0,0,3,4,9
191018441,8,6,2,1,9,26
191018442,3,6,0,5,7,21
191018443,7,4,1,4,2,18
191018444,6,1,1,5,2,15
191018445,4,7,0,6,4,21
191018446,6,4,5,1,4,20
191018447,6,2,5,5,6,24
191018448,3,0,6,9,6,24
191018449,1,2,0,4,1,8
191018450,4,0,8,7,8,27
191018451,0,3,2,7,1,13
191018452,8,8,2,4,2,24
191018453,7,9,1,7,4,28
191018454,7,3,4,1,6,21
191018455,0,3,0,8,0,11
191018456,9,9,1,7,7,33
191018457,3,6,4,9,4,26
191018458,2,0,0,4,0,6
191018459,0,2,8,2,2,14
191018460,7,9,3,4,4,27
191018461,5,7,2,7,7,28
191018462,1,3,5,6,4,19
191018463,7,9,4,6,5,31
191018464,5,7,7,1,8,28
191018465,3,6,6,6,2,23
191018466,0,1,5,5,0,11
191018467,5,3,7,4,1,20
191018468,8,7,4,0,4,23
191018469,7,8,3,3,2,23
191018470,2,0,3,8,5,18
191018471,4,9,2,0,9,24
191018472,0,0,1,1,0,2
191018473,3,3,5,8,0,19
191018474,6,4,8,9,6,33
191018475,8,2,8,3,7,28
191018476,6,5,8,2,0,21
191018477,9,5,5,2,6,27
191018478,7,0,3,2,0,12
191018479,9,0,6,9,2,26
191018480,1,1,5,0,9,16
191018481,6,1,2,9,8,26
191018482,7,8,6,6,0,27
191018483,0,4,4,5,7,20
191018484,6,6,4,4,0,20
191018485,4,1,8,3,0,16
191018486,5,3,1,3,4,16
191018487,0,1,6,8,8,23
191018488,3,6,8,3,3,23
191018489,5,3,4,4,8,24
191018490,3,5,5,9,4,26
191018491,7,0,2,0,3,12
191018492,1,4,6,8,3,22
191018493,5,3,9,9,4,30
191018494,1,8,7,2,7,25
191018495,2,6,9,7,2,26
191018496,8,6,0,7,9,30
191018497,8,2,4,9,3,26
191018498,6,6,1,5,5,23
191018499,1,3,7,5,4,20
191018500,4,7,3,9,4,27
191018501,4,6,9,6,3,28
191018502,1,2,4,1,0,8
191018503,9,9,3,5,5,31
191018504,8,4,8,9,3,32
191018505,1,0,3,9,8,21
191018506,3,1,9,6,6,25
191018507,4,7,4,3,8,26
191018508,3,3,6,5,6,23
191018509,7,1,6,4,2,20
191018510,9,0,0,5,9,23
191018511,6,1,6,9,6,28
191018512,6,4,6,5,8,29
191018513,8,0,7,3,3,21
191018514,8,0,0,7,5,20
191018515,0,0,6,4,4,14
191018516,8,3,3,6,3,23
191018517,2,6,2,2,3,15
191018518,3,2,5,0,3,13
191018519,7,4,3,6,2,22
191018520,9,5,8,6,2,30
191018521,4,0,1,6,7,18
191018522,7,0,1,3,2,13
191018523,5,7,1,3,9,25
191018524,0,1,4,7,8,20
191018525,0,9,9,4,4,26
191018526,6,7,0,6,8,27
191018527,5,3,6,9,0,23
191018528,6,2,1,1,9,19
191018529,1,9,3,3,2,18
191018530,7,3,5,4,1,20
191018531,3,4,1,6,4,18
191018532,4,4,6,5,3,22
191018533,1,5,6,9,6,27
191018534,2,2,8,1,4,17
191018535,3,4,9,9,2,27
191018536,2,2,0,2,5,11
191018537,7,6,0,2,0,15
191018538,2,9,7,1,3,22
191018539,6,1,6,6,2,21
191018540,4,8,0,7,8,27
191018541,5,8,8,2,8,31
191018542,2,3,2,6,2,15
191018543,6,2,4,3,6,21
191018544,8,7,2,1,8,26
191018545,9,1,3,0,6,19
191018546,4,2,5,6,7,24
191018547,9,3,3,8,7,30
191018548,2,4,9,2,7,24
191018549,3,7,6,7,0,23
191018550,5,0,9,2,4,20
191018551,8,8,9,0,4,29
191018552,2,1,4,2,2,11
191018553,3,1,7,1,2,14
191018554,0,2,3,3,6,14
191018555,6,0,4,8,1,19
191018556,7,3,2,9,5,26
191018557,6,8,9,0,9,32
191018558,0,4,6,6,0,16
191018559,3,1,6,5,2,17
191018560,5,5,7,5,6,28
191018561,3,2,9,8,1,23
191018562,6,5,3,3,5,22
191018563,9,9,1,5,0,24
191018564,8,1,4,2,9,24
191018565,8,1,0,8,2,19
191018566,9,3,1,1,6,20
191018567,3,7,4,3,7,24
191018568,2,2,4,2,8,18
191018569,5,1,6,9,7,28
191018570,6,2,2,1,2,13
191018571,0,2,2,0,3,7
191018572,4,4,8,1,4,21
191018573,1,5,8,2,2,18
191018574,7,5,7,3,8,30
191018575,0,0,8,9,1,18
191018576,6,5,8,6,4,29
191018577,3,9,6,4,4,26
191018578,8,1,7,0,2,18
191018579,0,2,3,3,0,8
191018580,5,1,6,1,4,17
191018581,0,6,0,9,2,17
191018582,3,5,4,9,8,29
191018583,6,5,1,5,0,17
191018584,3,0,1,9,2,15
191018585,3,9,8,1,3,24
191018586,7,9,3,2,9,30
191018587,3,6,5,7,0,21
191018588,3,6,6,8,8,31
191018589,9,6,8,7,0,30
191018590,9,2,4,0,2,17
191018591,7,6,7,8,5,33
191018592,1,2,9,3,6,21
191018593,2,3,9,9,4,27
191018594,2,8,4,3,4,21
191018595,5,2,4,4,1,16
191018596,7,5,4,4,9,29
191018597,3,6,0,0,7,16
191018598,6,8,9,4,6,33
191018599,6,2,6,6,6,26
191018600,3,0,7,9,0,19
191018601,1,5,6,7,9,28
191018602,0,8,5,2,2,17
191018603,0,1,4,5,4,14
191018604,8,1,4,8,8,29
191018605,2,4,6,9,3,24
191018606,1,9,0,0,7,17
191018607,5,3,3,1,2,14
191018608,8,9,0,4,5,26
191018609,2,1,0,4,3,10
191018610,1,1,2,3,3,10
191018611,1,5,4,8,7,25
191018612,4,7,8,5,9,33
191018613,8,2,0,5,8,23
191018614,6,5,6,5,8,30
191018615,8,5,1,4,2,20
191018616,9,0,1,3,9,22
191018617,5,3,8,3,2,21
191018618,7,7,4,0,4,22
191018619,2,7,2,3,0,14
191018620,9,8,7,5,7,36
191018621,2,6,1,4,0,13
191018622,3,0,3,5,8,19
191018623,7,9,2,5,1,24
191018624,0,5,4,1,5,15
191018625,6,9,3,0,9,27
191018626,2,2,4,0,4,12
191018627,1,2,0,9,6,18
191018628,7,0,0,9,4,20
191018629,7,0,4,9,8,28
191018630,9,1,2,8,0,20
191018631,1,3,1,3,2,10
191018632,1,0,2,1,3,7
191018633,3,8,5,5,3,24
191018634,5,6,0,7,6,24
191018635,9,7,6,1,8,31
191018636,9,6,0,7,7,29
191018637,2,9,6,4,6,27
191018638,8,4,8,9,6,35
191018639,5,9,5,2,1,22
191018640,8,0,3,0,8,19
191018641,9,5,5,1,9,29
191018642,3,9,4,0,4,20
191018643,0,1,2,6,6,15
191018644,3,3,9,9,3,27
191018645,8,9,5,9,1,32
191018646,1,1,7,9,1,19
191018647,5,3,8,7,4,27
191018648,9,1,0,5,3,18
191018649,9,8,2,8,2,29
191018650,8,7,3,5,5,28
191018651,6,3,8,8,9,34
191018652,6,2,8,9,5,30
191018653,6,8,2,6,6,28
191018654,7,5,9,9,4,34
191018655,2,5,0,8,2,17
191018656,0,2,3,7,9,21
191018657,1,0,1,5,4,11
191018658,3,2,4,2,4,15
191018659,7,8,5,4,8,32
191018660,9,6,3,7,3,28
191018661,9,8,6,5,4,32
191018662,6,8,1,1,0,16
191018663,3,7,3,0,0,13
191018664,3,7,1,1,3,15
191018665,3,3,2,7,2,17
191018666,3,5,4,9,0,21
191018667,8,5,0,3,5,21
191018668,0,2,9,4,1,16
191018669,4,7,9,2,5,27
191018670,3,0,8,8,3,22
191018671,8,3,4,7,9,31
191018672,5,1,6,4,7,23
191018673,5,3,7,7,0,22
191018674,0,9,9,9,1,28
191018675,0,3,7,7,5,22
191018676,0,3,2,2,5,12
191018677,4,2,0,4,5,15
191018678,7,2,5,2,6,22
191018679,2,4,3,0,9,18
191018680,3,4,8,1,8,24
191018681,1,6,0,7,3,17
191018682,6,6,6,2,3,23
191018683,1,4,3,8,0,16
191018684,9,8,1,6,1,25
191018685,7,1,7,2,3,20
191018686,2,8,7,1,8,26
191018687,8,5,3,3,3,22
191018688,4,1,1,2,9,17
191018689,8,2,5,9,4,28
191018690,7,9,7,2,5,30
191018691,6,5,7,6,1,25
191018692,7,7,8,4,9,35
191018693,8,9,6,8,3,34
191018694,2,1,4,8,8,23
191018695,1,6,6,4,4,21
191018696,4,8,7,9,6,34
191018697,0,6,1,9,7,23
191018698,8,6,7,1,8,30
191018699,6,9,2,4,4,25
191018700,6,7,5,9,2,29
191018701,9,6,8,0,8,31
191018702,4,4,7,8,8,31
191018703,0,4,6,4,1,15
191018704,7,4,2,9,8,30
191018705,2,5,0,3,6,16
191018706,1,0,1,3,4,9
191018707,1,9,0,8,4,22
191018708,4,2,2,1,3,12
191018709,0,8,4,6,4,22
191018710,0,9,5,2,7,23
191018711,8,2,0,6,8,24
191018712,7,6,6,6,1,26
191018713,8,7,9,2,4,30
191018714,3,6,2,6,9,26
191018715,7,0,5,1,3,16
191018716,5,5,4,3,2,19
191018717,1,9,1,2,6,19
191018718,6,0,8,2,8,24
191018719,5,8,4,9,3,29
191018720,1,8,4,7,5,25
191018721,7,9,2,4,9,31
191018722,5,6,1,4,4,20
191018723,9,6,9,1,7,32
191018724,2,6,0,4,6,18
191018725,5,4,2,1,8,20
191018726,7,1,7,2,4,21
191018727,0,3,7,4,0,14
191018728,6,6,6,3,8,29
191018729,1,0,5,8,1,15
191018730,8,1,5,5,0,19
191018731,2,1,2,0,3,8
191018732,2,1,7,9,0,19
191018733,5,0,5,7,0,17
191018734,9,2,4,7,1,23
191018735,8,2,4,4,9,27
191018736,9,3,1,4,8,25
191018737,0,2,8,0,8,18
191018738,6,3,4,9,8,30
191018739,6,9,8,3,4,30
191018740,0,6,2,5,1,14
191018741,0,6,3,8,8,25
191018742,3,3,8,0,5,19
191018743,9,9,4,3,3,28
191018744,6,0,4,0,0,10
191018745,7,4,4,3,7,25
191018746,8,4,9,4,6,31
191018747,3,8,5,5,4,25
191018748,4,3,3,7,2,19
191018749,2,1,7,2,9,21
191018750,0,5,3,4,8,20
191018751,4,1,9,3,8,25
191018752,2,2,8,4,9,25
191018753,8,7,9,3,1,28
191018754,8,3,7,7,6,31
191018755,6,1,3,7,4,21
191018756,4,3,1,1,4,13
191018757,7,7,7,4,5,30
191018758,5,5,4,4,4,22
191018759,4,7,4,2,5,22
191018760,0,5,4,5,1,15
191018761,5,0,2,3,8,18
191018762,8,5,4,0,9,26
191018763,7,6,2,9,6,30
191018764,3,3,1,5,2,14
191018765,1,0,3,5,5,14
191018766,4,5,5,7,4,25
191018767,3,3,6,7,0,19
191018768,6,4,5,0,8,23
191018769,0,8,6,8,7,29
191018770,1,0,6,5,3,15
191018771,4,6,5,0,9,24
191018772,4,1,6,9,1,21
191018773,5,1,9,2,7,24
191018774,3,1,1,6,4,15
191018775,2,5,1,9,4,21
191018776,9,8,2,1,2,22
191018777,2,7,6,1,5,21
191018778,8,1,7,6,5,27
191018779,7,9,9,0,9,34
191018780,6,6,7,2,9,30
191018781,0,8,6,5,4,23
191018782,0,5,0,1,0,6
191018783,6,8,9,7,6,36
191018784,8,3,3,7,1,22
191018785,4,7,8,0,3,22
191018786,0,6,0,6,8,20
191018787,9,2,4,2,0,17
191018788,2,9,9,9,5,34
191018789,1,2,9,7,6,25
191018790,3,8,8,6,6,31
191018791,2,1,9,9,9,30
191018792,5,1,5,5,1,17
191018793,0,5,5,0,4,14
191018794,3,8,8,1,6,26
191018795,6,6,7,0,5,24
191018796,2,6,0,9,9,26
191018797,8,4,9,9,4,34
191018798,8,0,1,4,8,21
191018799,9,6,1,4,9,29
191018800,2,1,4,2,8,17
191018801,3,0,0,4,3,10
191018802,3,8,8,3,1,23
191018803,8,2,8,5,9,32
191018804,5,5,3,7,3,23
191018805,8,4,8,6,8,34
191018806,6,0,0,6,4,16
191018807,6,5,7,8,7,33
191018808,3,2,1,6,3,15
191018809,4,9,6,1,3,23
191018810,6,7,5,9,7,34
191018811,6,8,4,7,1,26
191018812,1,4,0,4,3,12
191018813,6,4,4,3,9,26
191018814,9,7,8,5,8,37
191018815,7,7,4,6,1,25
191018816,9,9,7,6,5,36
191018817,9,9,4,3,2,27
191018818,8,2,1,6,5,22
191018819,9,1,1,7,2,20
191018820,6,2,9,5,3,25
191018821,8,9,8,6,4,35
191018822,1,8,4,9,8,30
191018823,7,0,0,8,9,24
191018824,4,2,1,2,6,15
191018825,9,4,8,4,4,29
191018826,4,0,7,5,5,21
191018827,6,3,9,9,9,36
191018828,6,0,9,0,7,22
191018829,6,6,5,4,7,28
191018830,2,7,2,2,2,15
191018831,5,0,9,4,6,24
191018832,5,8,4,8,3,28
191018833,7,6,0,4,3,20
191018834,5,3,2,4,3,17
191018835,4,1,1,6,0,12
191018836,9,1,9,3,6,28
191018837,9,2,5,6,3,25
191018838,3,7,3,2,6,21
191018839,7,8,1,1,5,22
191018840,3,6,2,8,6,25
191018841,6,9,7,7,1,30
191018842,8,5,1,3,7,24
191018843,5,7,1,1,2,16
191018844,2,0,9,4,0,15
191018845,3,6,1,6,9,25
191018846,0,9,4,9,7,29
191018847,6,2,4,8,3,23
191018848,1,1,0,4,9,15
191018849,6,3,7,3,3,22
191018850,6,5,4,0,8,23
191018851,8,0,7,8,5,28
191018852,0,9,9,4,2,24
191018853,6,4,3,8,5,26
191018854,2,7,4,8,9,30
191018855,5,9,8,1,4,27
191018856,9,1,6,5,9,30
191018857,4,1,1,3,9,18
191018858,3,0,6,1,4,14
191018859,6,0,5,7,8,26
191018860,8,4,9,6,8,35
191018861,0,8,5,4,0,17
191018862,9,7,1,6,7,30
191018863,2,5,0,6,4,17
191018864,1,3,0,2,4,10
191018865,5,0,1,8,2,16
191018866,1,4,1,1,0,7
191018867,8,6,4,1,8,27
191018868,7,9,4,9,9,38
191018869,3,0,7,1,2,13
191018870,5,2,2,9,3,21
191018871,5,9,4,1,4,23
191018872,6,4,2,3,9,24
191018873,2,4,8,6,0,20
191018874,9,5,8,7,0,29
191018875,7,9,6,7,9,38
191018876,8,7,6,0,2,23
191018877,2,8,5,2,0,17
191018878,6,5,6,0,3,20
191018879,6,7,8,1,0,22
191018880,2,5,2,1,1,11
191018881,4,7,5,2,2,20
191018882,4,7,0,2,7,20
191018883,9,6,7,9,1,32
191018884,3,9,3,0,6,21
191018885,1,6,9,8,2,26
191018886,1,2,1,1,6,11
191018887,6,1,9,3,2,21
191018888,6,7,1,7,2,23
191018889,9,2,5,9,4,29
191018890,1,2,1,3,7,14
191018891,9,7,5,9,7,37
191018892,6,8,7,4,3,28
191018893,6,2,4,3,3,18
191018894,2,4,6,6,2,20
191018895,3,7,0,9,8,27
191018896,6,8,5,0,7,26
191018897,4,7,9,8,2,30
191018898,3,3,7,0,0,13
191018899,0,3,4,7,5,19
191018900,5,2,7,9,1,24
191018901,7,6,4,4,6,27
191018902,5,4,2,6,2,19
191018903,4,1,1,9,9,24
191018904,0,5,9,6,8,28
191018905,1,8,3,5,4,21
191018906,5,7,3,5,7,27
191018907,8,0,8,1,5,22
191018908,0,0,8,9,2,19
191018909,8,3,0,6,7,24
191018910,8,8,0,1,5,22
191018911,4,9,5,9,6,33
191018912,4,9,5,2,8,28
191018913,5,4,7,2,7,25
191018914,1,3,2,3,8,17
191018915,3,5,1,8,0,17
191018916,9,8,5,0,6,28
191018917,9,8,9,8,4,38
191018918,1,0,4,5,4,14
191018919,8,0,5,0,6,19
191018920,8,3,2,4,3,20
191018921,7,4,4,5,4,24
191018922,5,9,6,7,3,30
191018923,2,3,0,9,7,21
191018924,2,0,0,1,4,7
191018925,3,5,6,0,8,22
191018926,7,7,2,3,1,20
191018927,0,1,6,5,1,13
191018928,0,1,2,2,9,14
191018929,5,9,3,2,0,19
191018930,4,5,0,4,3,16
191018931,1,8,8,4,3,24
191018932,9,7,2,6,1,25
191018933,5,5,7,0,3,20
191018934,7,3,1,2,5,18
191018935,1,6,5,1,4,17
191018936,8,7,6,7,8,36
191018937,3,1,3,3,5,15
191018938,4,2,4,0,3,13
191018939,1,5,7,4,9,26
191018940,7,9,2,3,8,29
191018941,0,9,9,5,2,25
191018942,0,5,0,3,9,17
191018943,6,8,6,1,5,26
191018944,9,4,4,4,3,24
191018945,0,4,5,8,9,26
191018946,1,8,8,5,2,24
191018947,5,1,1,2,0,9
191018948,5,8,2,8,9,32
191018949,5,6,9,8,3,31
191018950,1,6,0,6,8,21
191018951,0,3,9,4,8,24
191018952,8,0,3,1,3,15
191018953,8,5,2,4,1,20
191018954,3,0,2,4,9,18
191018955,3,4,2,9,9,27
191018956,6,3,2,7,2,20
191018957,6,3,5,1,4,19
191018958,9,8,5,6,2,30
191018959,6,3,4,7,5,25
191018960,2,7,5,6,8,28
191018961,8,5,7,1,6,27
191018962,6,7,1,7,0,21
191018963,0,1,3,1,2,7
191018964,3,4,3,9,3,22
191018965,9,9,0,1,4,23
191018966,2,1,7,4,6,20
191018967,3,9,5,4,2,23
191018968,0,7,1,6,8,22
191018969,1,0,7,8,8,24
191018970,5,0,2,9,7,23
191018971,8,0,7,5,7,27
191018972,6,8,0,9,8,31
191018973,6,4,7,2,1,20
191018974,5,8,5,6,3,27
191018975,5,4,7,8,3,27
191018976,2,1,1,0,8,12
191018977,7,8,6,6,1,28
191018978,5,2,3,2,9,21
191018979,2,4,9,3,5,23
191018980,1,6,2,4,8,21
191018981,1,9,9,0,4,23
191018982,1,2,7,0,3,13
191018983,2,2,0,3,1,8
191018984,6,8,9,2,0,25
191018985,2,4,8,8,8,30
191018986,0,8,7,0,1,16
191018987,4,0,3,9,0,16
191018988,6,7,0,1,6,20
191018989,6,3,9,7,8,33
191018990,7,9,1,1,9,27
191018991,2,1,2,0,8,13
191018992,8,7,5,2,9,31
191018993,8,9,3,8,2,30
191018994,4,1,0,8,9,22
191018995,4,0,3,0,7,14
191018996,9,4,5,3,1,22
191018997,8,0,2,6,4,20
191018998,6,0,2,9,3,20
191018999,6,6,8,2,9,31
1910181000,9,0,3,9,5,26
1910181001,1,1,9,5,9,25
1910181002,5,4,4,1,1,15
1910181003,6,0,7,0,4,17
1910181004,6,5,1,7,9,28
1910181005,7,5,4,3,1,20
1910181006,0,5,3,3,4,15
1910181007,3,2,5,6,1,17
1910181008,7,1,0,7,0,15
1910181009,9,5,3,2,9,28
1910181010,7,7,3,0,8,25
1910181011,1,1,8,7,4,21
1910181012,4,2,4,6,7,23
1910181013,2,3,6,9,8,28
1910181014,2,4,8,0,7,21
1910181015,4,5,6,5,6,26
1910181016,4,8,6,9,5,32
1910181017,2,8,8,0,2,20
1910181018,2,5,8,8,9,32
1910181019,3,3,4,3,4,17
1910181020,8,7,2,0,5,22
1910181021,9,2,4,2,8,25
1910181022,0,2,4,8,9,23
1910181023,4,6,7,5,2,24
1910181024,2,2,6,2,2,14
1910181025,4,7,1,1,6,19
1910181026,1,7,8,4,5,25
1910181027,0,7,2,4,9,22
1910181028,2,3,8,2,1,16
1910181029,4,5,6,9,1,25
1910181030,6,1,7,1,1,16
1910181031,7,7,0,3,7,24
1910181032,2,6,2,4,2,16
1910181033,0,0,6,5,0,11
1910181034,1,1,5,0,8,15
1910181035,3,8,4,5,3,23
1910181036,6,3,0,2,1,12
1910181037,3,5,4,0,6,18
1910181038,8,9,9,2,1,29
1910181039,5,7,2,4,4,22
1910181040,2,4,6,0,6,18
1910181041,0,7,6,6,2,21
1910181042,3,0,4,7,7,21
1910181043,2,0,2,5,2,11
1910181044,3,7,8,6,7,31
1910181045,9,0,3,4,4,20
1910181046,9,6,9,2,7,33
1910181047,3,8,6,8,7,32
1910181048,4,5,7,5,9,30
1910181049,8,7,0,9,7,31
1910181050,2,0,0,8,6,16
1910181051,3,0,8,1,7,19
1910181052,7,7,2,2,2,20
1910181053,8,9,9,5,3,34
1910181054,4,5,5,1,4,19
1910181055,6,8,7,5,4,30
1910181056,0,1,8,8,5,22
1910181057,7,1,3,2,7,20
1910181058,0,2,9,7,7,25
1910181059,9,9,7,4,2,31
1910181060,5,3,4,2,0,14
1910181061,7,6,8,8,1,30
1910181062,0,4,4,2,5,15
1910181063,4,2,9,0,4,19
1910181064,2,5,9,2,0,18
1910181065,7,3,0,5,8,23
1910181066,1,7,5,3,7,23
1910181067,7,2,3,9,9,30
1910181068,3,3,7,6,4,23
1910181069,8,3,6,5,1,23
1910181070,6,1,0,5,0,12
1910181071,6,2,2,2,0,12
1910181072,0,7,4,3,8,22
1910181073,9,9,3,4,6,31
1910181074,4,1,8,3,3,19
1910181075,9,4,8,4,8,33
1910181076,5,7,1,7,4,24
1910181077,6,0,7,5,6,24
1910181078,3,3,7,7,6,26
1910181079,6,2,8,9,2,27
1910181080,1,1,2,3,7,14
1910181081,0,1,0,7,9,17
1910181082,0,8,6,2,9,25
1910181083,1,0,5,3,6,15
1910181084,5,0,2,4,8,19
1910181085,0,4,0,4,8,16
1910181086,1,2,3,7,5,18
1910181087,1,1,2,2,3,9
1910181088,4,3,3,9,7,26
1910181089,1,2,1,4,7,15
1910181090,4,3,2,7,3,19
1910181091,1,0,9,0,5,15
1910181092,3,5,9,1,5,23
1910181093,8,3,0,1,6,18
1910181094,8,6,9,3,0,26
1910181095,0,6,4,3,8,21
1910181096,8,0,2,4,4,18
1910181097,9,4,9,2,3,27
1910181098,2,4,8,4,1,19
1910181099,2,7,2,1,6,18
1910181100,4,5,4,3,3,19
1910181101,8,6,7,4,9,34
1910181102,3,3,6,5,9,26
1910181103,7,5,0,7,0,19
1910181104,6,1,7,5,1,20
1910181105,1,0,4,1,6,12
191019001,8,3,7,7,1,26
191019002,3,3,8,7,6,27
191019003,3,0,5,9,9,26
191019004,8,4,2,6,2,22
191019005,2,1,8,8,7,26
191019006,8,8,6,7,2,31
191019007,1,1,3,3,2,10
191019008,5,7,6,6,4,28
191019009,4,5,2,1,7,19
191019010,8,3,1,2,1,15
191019011,1,5,9,6,9,30
191019012,4,0,6,5,7,22
191019013,4,0,7,2,3,16
191019014,1,4,3,3,6,17
191019015,9,9,0,4,4,26
191019016,9,0,3,5,1,18
191019017,4,4,2,0,3,13
191019018,5,9,1,7,0,22
191019019,5,0,1,3,9,18
191019020,7,6,3,8,7,31
191019021,0,1,0,5,8,14
191019022,5,6,3,7,7,28
191019023,1,8,8,2,9,28
191019024,8,0,5,6,5,24
191019025,8,7,2,5,8,30
191019026,5,4,9,8,4,30
191019027,4,4,5,0,0,13
191019028,3,8,4,4,4,23
191019029,0,3,1,6,7,17
191019030,8,2,0,9,4,23
191019031,1,7,8,5,7,28
191019032,4,4,3,2,4,17
191019033,5,4,3,7,4,23
191019034,3,9,3,1,1,17
191019035,4,3,1,8,4,20
191019036,2,5,7,7,8,29
191019037,7,6,9,4,8,34
191019038,5,0,8,6,2,21
191019039,8,2,6,9,8,33
191019040,5,7,9,6,7,34
191019041,7,2,0,7,5,21
191019042,8,5,5,5,7,30
191019043,1,8,3,1,9,22
191019044,6,9,5,9,8,37
191019045,8,0,6,5,2,21
191019046,8,1,0,0,6,15
191019047,7,4,7,3,8,29
191019048,5,5,6,5,3,24
191019049,9,9,8,8,5,39
191019050,6,8,3,8,0,25
191019051,3,0,8,9,7,27
191019052,0,1,9,6,4,20
191019053,6,6,7,4,3,26
191019054,2,2,8,1,9,22
191019055,5,3,5,1,7,21
191019056,4,3,5,7,2,21
191019057,2,6,7,8,1,24
191019058,4,2,5,3,3,17
191019059,8,9,9,2,8,36
191019060,8,9,7,1,8,33
191019061,1,4,7,2,1,15
191019062,7,1,2,5,3,18
191019063,9,0,4,1,2,16
191019064,1,4,8,2,8,23
191019065,5,5,2,6,3,21
191019066,5,5,3,6,1,20
191019067,6,0,9,2,5,22
191019068,8,4,8,3,9,32
191019069,5,1,5,3,2,16
191019070,4,9,7,6,8,34
191019071,1,7,8,8,0,24
191019072,3,2,5,9,2,21
191019073,2,3,5,3,6,19
191019074,0,0,5,0,0,5
191019075,9,3,6,6,2,26
191019076,5,4,1,3,8,21
191019077,5,3,9,7,2,26
191019078,6,9,7,0,8,30
191019079,0,2,8,9,1,20
191019080,3,4,2,8,2,19
191019081,0,0,7,6,3,16
191019082,9,3,2,7,0,21
191019083,6,7,5,0,9,27
191019084,1,9,3,7,2,22
191019085,7,3,7,6,8,31
191019086,4,1,7,3,9,24
191019087,0,9,6,3,7,25
191019088,5,4,0,7,3,19
191019089,6,6,4,2,8,26
191019090,6,7,5,3,0,21
191019091,1,7,1,3,7,19
191019092,5,5,6,3,8,27
191019093,1,1,9,0,9,20
191019094,1,1,2,8,5,17
191019095,0,9,0,1,3,13
191019096,8,9,2,7,7,33
191019097,2,8,4,8,6,28
191019098,0,6,2,6,6,20
191019099,1,4,3,2,2,12
191019100,9,5,9,7,1,31
191019101,4,0,1,9,7,21
191019102,3,7,9,2,9,30
191019103,1,6,8,9,2,26
191019104,4,9,2,9,3,27
191019105,0,0,1,1,7,9
191019106,0,6,3,0,2,11
191019107,6,1,7,5,9,28
191019108,2,5,3,1,4,15
191019109,4,8,7,6,8,33
191019110,7,5,8,2,9,31
191019111,2,5,6,7,5,25
191019112,7,2,3,6,5,23
191019113,3,1,5,6,0,15
191019114,6,6,8,0,8,28
191019115,2,9,7,3,6,27
191019116,3,4,5,3,0,15
191019117,6,1,7,4,8,26
191019118,3,7,3,6,5,24
191019119,5,6,2,6,1,20
191019120,1,8,7,8,2,26
191019121,2,8,4,3,3,20
191019122,0,9,4,0,2,15
191019123,7,1,5,1,2,16
191019124,0,1,3,5,3,12
191019125,0,5,4,2,1,12
191019126,6,9,5,5,2,27
191019127,5,9,1,4,8,27
191019128,8,9,2,0,4,23
191019129,7,5,6,5,9,32
191019130,7,2,5,4,1,19
191019131,8,1,4,3,4,20
191019132,1,4,2,8,2,17
191019133,1,9,9,9,0,28
191019134,5,9,1,7,5,27
191019135,8,5,1,6,9,29
191019136,9,6,6,0,5,26
191019137,7,8,2,5,6,28
191019138,6,0,6,1,4,17
191019139,7,3,1,6,9,26
191019140,3,4,8,9,4,28
191019141,4,6,6,9,0,25
191019142,4,2,2,2,1,11
191019143,6,6,4,2,9,27
191019144,4,3,7,9,7,30
191019145,8,4,3,6,4,25
191019146,7,9,0,2,0,18
191019147,4,3,0,0,2,9
191019148,7,7,8,0,2,24
191019149,0,0,2,8,5,15
191019150,2,9,2,1,5,19
191019151,9,0,1,5,4,19
191019152,0,0,5,2,0,7
191019153,5,8,3,8,6,30
191019154,1,5,2,1,3,12
191019155,9,5,6,1,4,25
191019156,0,7,9,2,2,20
191019157,6,0,8,4,6,24
191019158,9,2,4,2,9,26
191019159,5,5,8,5,6,29
191019160,3,0,5,2,5,15
191019161,6,3,8,8,2,27
191019162,5,5,9,1,8,28
191019163,0,7,8,0,6,21
191019164,0,8,7,6,8,29
191019165,7,8,2,3,2,22
191019166,8,7,5,7,7,34
191019167,9,8,4,2,9,32
191019168,6,8,8,3,2,27
191019169,1,3,9,2,5,20
191019170,4,1,9,9,8,31
191019171,9,9,2,5,9,34
191019172,9,1,3,3,8,24
191019173,7,9,9,6,5,36
191019174,8,9,2,9,7,35
191019175,9,7,6,7,7,36
191019176,7,0,3,6,7,23
191019177,0,6,3,7,8,24
191019178,8,2,5,7,0,22
191019179,6,4,7,4,3,24
191019180,7,9,1,1,6,24
191019181,9,8,6,2,3,28
191019182,1,8,2,7,3,21
191019183,9,3,6,6,7,31
191019184,4,6,4,6,7,27
191019185,0,6,3,7,0,16
191019186,8,6,2,6,2,24
191019187,5,1,6,3,7,22
191019188,8,3,0,2,6,19
191019189,8,2,9,5,0,24
191019190,5,2,0,9,6,22
191019191,1,6,1,6,2,16
191019192,1,3,9,4,2,19
191019193,9,0,7,6,3,25
191019194,5,8,2,5,5,25
191019195,3,8,8,9,8,36
191019196,4,3,2,2,0,11
191019197,5,5,9,9,7,35
191019198,2,0,4,1,2,9
191019199,0,3,8,9,0,20
191019200,4,6,3,6,9,28
191019201,6,0,8,6,8,28
191019202,6,4,6,4,5,25
191019203,8,9,3,3,0,23
191019204,9,3,2,1,0,15
191019205,5,7,5,2,1,20
191019206,0,0,6,5,1,12
191019207,3,0,2,7,2,14
191019208,6,6,3,4,1,20
191019209,4,5,0,5,3,17
191019210,9,8,1,2,9,29
191019211,8,8,0,4,2,22
191019212,5,5,8,4,2,24
191019213,9,3,2,6,3,23
191019214,9,9,1,8,8,35
191019215,4,9,4,2,7,26
191019216,1,4,4,1,4,14
191019217,0,6,5,3,9,23
191019218,9,9,9,3,2,32
191019219,3,4,6,6,7,26
191019220,1,1,4,2,6,14
191019221,4,6,1,8,3,22
191019222,5,9,4,5,9,32
191019223,1,1,1,6,8,17
191019224,0,2,2,8,2,14
191019225,3,3,5,5,0,16
191019226,9,2,9,0,7,27
191019227,7,1,6,7,4,25
191019228,6,4,8,6,1,25
191019229,0,9,6,2,1,18
191019230,4,4,8,0,7,23
191019231,2,6,5,9,0,22
191019232,7,6,6,6,9,34
191019233,1,4,7,7,5,24
191019234,9,9,8,3,6,35
191019235,6,4,9,7,4,30
191019236,7,2,8,2,8,27
191019237,3,7,9,8,2,29
191019238,0,8,5,5,3,21
191019239,8,7,4,4,3,26
191019240,1,8,2,8,3,22
191019241,2,5,8,3,9,27
191019242,1,4,9,5,6,25
191019243,3,8,2,9,4,26
191019244,3,4,9,8,9,33
191019245,8,0,7,8,0,23
191019246,9,1,2,9,7,28
191019247,3,3,3,8,2,19
191019248,0,4,7,5,3,19
191019249,6,3,6,6,6,27
191019250,1,5,2,1,6,15
191019251,9,2,8,5,3,27
191019252,7,8,3,4,0,22
191019253,9,7,4,4,1,25
191019254,1,7,7,2,2,19
191019255,6,1,7,4,3,21
191019256,1,3,3,5,9,21
191019257,6,2,0,5,4,17
191019258,4,3,4,8,1,20
191019259,1,9,5,0,4,19
191019260,2,6,8,6,1,23
191019261,3,8,1,8,4,24
191019262,1,6,0,8,9,24
191019263,1,7,9,3,8,28
191019264,6,0,2,9,6,23
191019265,1,0,1,1,1,4
191019266,8,9,4,8,7,36
191019267,9,3,1,2,9,24
191019268,0,4,4,7,2,17
191019269,7,0,2,3,1,13
191019270,0,2,4,2,2,10
191019271,3,0,8,0,2,13
191019272,6,3,6,6,2,23
191019273,0,0,3,3,6,12
191019274,2,0,3,8,6,19
191019275,4,4,3,4,1,16
191019276,9,3,3,9,6,30
191019277,6,5,8,2,2,23
191019278,7,9,4,7,6,33
191019279,8,5,1,8,8,30
191019280,0,4,8,4,3,19
191019281,6,7,0,5,4,22
191019282,0,1,5,4,3,13
191019283,9,5,4,6,3,27
191019284,0,7,5,3,1,16
191019285,5,9,3,9,3,29
191019286,4,6,2,7,1,20
191019287,7,2,0,2,9,20
191019288,5,1,9,7,2,24
191019289,8,7,0,6,4,25
191019290,6,3,0,8,2,19
191019291,4,5,6,4,3,22
191019292,4,1,1,9,4,19
191019293,8,9,1,6,8,32
191019294,4,4,4,7,5,24
191019295,1,4,1,0,3,9
191019296,3,9,1,1,7,21
191019297,1,6,6,6,0,19
191019298,0,6,8,4,0,18
191019299,3,6,9,3,1,22
191019300,1,1,6,6,7,21
191019301,3,4,7,7,1,22
191019302,1,8,4,5,6,24
191019303,3,8,6,1,9,27
191019304,4,8,8,5,5,30
191019305,7,4,8,3,9,31
191019306,4,1,0,7,7,19
191019307,4,0,8,3,8,23
191019308,9,5,4,9,2,29
191019309,7,9,1,7,6,30
191019310,5,3,0,0,9,17
191019311,9,6,4,9,7,35
191019312,6,1,6,6,0,19
191019313,0,0,2,4,3,9
191019314,2,8,7,3,6,26
191019315,4,9,8,7,0,28
191019316,1,9,1,6,0,17
191019317,2,8,4,9,9,32
191019318,4,3,5,0,1,13
191019319,0,7,2,2,5,16
191019320,9,9,4,6,5,33
191019321,1,8,5,2,6,22
191019322,8,1,1,7,4,21
191019323,8,0,1,3,8,20
191019324,9,5,5,8,6,33
191019325,0,6,4,6,1,17
191019326,2,6,9,2,0,19
191019327,1,9,7,9,5,31
191019328,0,2,8,6,0,16
191019329,4,4,1,6,4,19
191019330,2,6,9,5,5,27
191019331,2,8,5,5,4,24
191019332,7,1,3,3,0,14
191019333,9,7,1,1,2,20
191019334,3,7,4,8,2,24
191019335,9,2,7,5,7,30
191019336,1,1,8,7,3,20
191019337,3,9,3,7,8,30
191019338,6,4,0,7,8,25
191019339,2,2,3,8,9,24
191019340,2,8,2,0,4,16
191019341,8,4,4,1,4,21
191019342,1,2,6,9,0,18
191019343,2,0,2,7,0,11
191019344,6,3,8,7,8,32
191019345,0,6,7,8,7,28
191019346,3,8,4,9,4,28
191019347,1,3,8,9,7,28
191019348,7,0,9,8,3,27
191019349,6,2,3,9,8,28
191019350,6,9,1,7,2,25
191019351,3,7,3,2,2,17
191019352,1,5,9,5,7,27
191019353,2,9,2,8,3,24
191019354,1,4,6,0,2,13
191019355,5,6,1,6,4,22
191019356,3,5,6,6,0,20
191019357,3,4,1,7,0,15
191019358,1,2,6,0,0,9
191019359,9,4,4,5,1,23
191019360,7,6,2,8,3,26
191019361,5,1,8,2,6,22
191019362,1,3,3,1,8,16
191019363,3,0,3,4,6,16
191019364,8,8,1,7,4,28
191019365,7,4,7,0,8,26
191019366,8,1,4,4,5,22
191019367,0,9,7,5,4,25
191019368,4,7,5,8,2,26
191019369,6,2,0,6,5,19
191019370,4,5,6,9,7,31
191019371,3,8,1,7,6,25
191019372,7,1,8,6,0,22
191019373,8,6,0,2,5,21
191019374,9,9,9,2,1,30
191019375,1,4,1,4,0,10
191019376,7,4,2,7,6,26
191019377,9,3,9,9,2,32
191019378,7,8,3,8,6,32
191019379,5,1,1,2,7,16
191019380,7,8,5,6,4,30
191019381,4,6,4,5,4,23
191019382,5,9,0,6,1,21
191019383,6,4,8,0,8,26
191019384,3,7,1,8,3,22
191019385,7,6,6,7,6,32
191019386,8,8,6,1,8,31
191019387,6,5,7,3,4,25
191019388,5,5,2,8,5,25
191019389,7,4,0,0,3,14
191019390,8,2,1,0,3,14
191019391,3,5,2,3,0,13
191019392,2,4,6,7,6,25
191019393,9,7,7,6,2,31
191019394,3,1,0,5,8,17
191019395,9,4,1,7,1,22
191019396,3,0,5,5,6,19
191019397,5,9,3,4,2,23
191019398,1,4,0,5,0,10
191019399,1,1,6,4,3,15
191019400,8,9,3,9,9,38
191019401,0,2,3,1,4,10
191019402,6,1,4,2,4,17
191019403,1,5,7,8,1,22
191019404,3,6,8,5,4,26
191019405,5,7,6,9,7,34
191019406,1,5,1,2,1,10
191019407,0,6,9,4,8,27
191019408,7,6,3,2,1,19
191019409,7,9,8,6,5,35
191019410,5,8,1,9,8,31
191019411,1,2,6,3,8,20
191019412,2,6,7,3,1,19
191019413,1,5,8,2,0,16
191019414,2,6,8,0,6,22
191019415,2,3,0,9,1,15
191019416,5,4,6,2,7,24
191019417,2,9,7,7,0,25
191019418,7,5,7,0,1,20
191019419,0,9,9,8,3,29
191019420,0,1,1,9,0,11
191019421,6,4,9,6,5,30
191019422,1,4,6,4,1,16
191019423,8,9,6,6,7,36
191019424,8,3,2,1,6,20
191019425,8,2,4,6,2,22
191019426,9,2,1,6,8,26
191019427,6,1,7,6,9,29
191019428,7,1,0,6,3,17
191019429,4,1,4,4,8,21
191019430,6,5,2,1,4,18
191019431,9,3,3,2,0,17
191019432,0,4,5,6,7,22
191019433,7,9,4,6,3,29
191019434,5,8,5,8,6,32
191019435,1,6,5,5,3,20
191019436,1,2,3,7,4,17
191019437,1,6,9,4,9,29
191019438,3,8,6,2,9,28
191019439,8,2,0,0,7,17
191019440,2,8,4,7,8,29
191019441,6,3,9,4,2,24
191019442,8,0,6,6,9,29
191019443,1,7,3,2,1,14
191019444,6,4,4,0,0,14
191019445,5,1,1,0,6,13
191019446,8,1,1,9,8,27
191019447,1,2,5,6,9,23
191019448,2,5,0,7,1,15
191019449,4,4,6,6,1,21
191019450,2,1,3,8,4,18
191019451,3,0,9,0,8,20
191019452,7,9,7,9,1,33
191019453,0,2,2,3,3,10
191019454,2,6,4,4,4,20
191019455,0,7,4,0,8,19
191019456,9,3,1,9,7,29
191019457,3,4,9,0,6,22
191019458,0,2,8,0,7,17
191019459,7,6,9,5,5,32
191019460,1,2,3,4,3,13
191019461,7,1,7,2,7,24
191019462,2,6,5,9,2,24
191019463,9,4,6,4,5,28
191019464,9,6,2,3,7,27
191019465,7,2,2,5,7,23
191019466,8,0,6,4,4,22
191019467,5,0,0,0,6,11
191019468,5,2,6,5,8,26
191019469,3,6,4,6,7,26
191019470,8,9,2,7,9,35
191019471,4,7,0,5,1,17
191019472,7,2,9,9,3,30
191019473,1,2,6,0,2,11
191019474,1,0,5,4,4,14
191019475,9,1,1,8,4,23
191019476,4,8,9,6,9,36
191019477,5,7,6,6,0,24
191019478,5,2,5,2,2,16
191019479,2,8,3,8,1,22
191019480,2,4,0,2,6,14
191019481,5,3,6,3,3,20
191019482,1,1,9,1,6,18
191019483,2,5,8,2,2,19
191019484,2,9,3,9,8,31
191019485,1,4,5,0,9,19
191019486,6,1,1,9,6,23
191019487,5,3,3,7,0,18
191019488,9,0,7,9,4,29
191019489,9,9,3,3,8,32
191019490,7,5,9,9,6,36
191019491,2,5,3,4,4,18
191019492,3,3,6,2,6,20
191019493,7,0,2,9,5,23
191019494,5,8,0,6,8,27
191019495,3,5,5,7,5,25
191019496,5,1,0,9,1,16
191019497,2,9,3,7,2,23
191019498,7,7,9,0,0,23
191019499,3,0,9,6,8,26
191019500,3,2,9,0,6,20
191019501,6,5,6,0,4,21
191019502,5,4,5,1,1,16
191019503,4,0,9,1,2,16
191019504,8,0,7,2,3,20
191019505,9,4,4,9,5,31
191019506,3,2,1,0,0,6
191019507,4,5,5,6,5,25
191019508,8,7,2,7,7,31
191019509,1,8,1,7,3,20
191019510,2,0,8,6,5,21
191019511,3,7,0,3,3,16
191019512,7,5,5,2,7,26
191019513,0,0,8,0,6,14
191019514,4,1,8,6,9,28
191019515,3,6,2,7,0,18
191019516,7,9,4,8,3,31
191019517,3,2,1,0,8,14
191019518,1,8,0,5,7,21
191019519,1,7,7,0,4,19
191019520,0,8,1,4,3,16
191019521,2,1,3,9,5,20
191019522,8,5,9,0,3,25
191019523,5,6,6,9,4,30
191019524,8,4,9,3,8,32
191019525,8,0,7,0,9,24
191019526,5,2,0,4,7,18
191019527,3,3,2,2,2,12
191019528,5,1,9,9,8,32
191019529,4,0,7,2,6,19
191019530,2,6,0,3,5,16
191019531,2,9,3,2,7,23
191019532,0,6,7,9,9,31
191019533,2,5,3,9,0,19
191019534,1,4,7,8,7,27
191019535,1,3,8,9,2,23
191019536,7,7,0,0,8,22
191019537,8,2,4,2,9,25
191019538,4,0,8,1,5,18
191019539,3,0,6,3,4,16
191019540,2,9,9,8,5,33
191019541,2,5,7,3,0,17
191019542,2,9,3,3,6,23
191019543,9,9,6,4,8,36
191019544,4,6,4,0,5,19
191019545,7,2,3,7,8,27
191019546,9,5,4,3,0,21
191019547,6,0,9,7,6,28
191019548,0,6,1,2,4,13
191019549,1,2,5,7,4,19
191019550,7,9,2,5,4,27
191019551,7,0,7,1,1,16
191019552,3,9,8,7,9,36
191019553,1,4,6,5,0,16
191019554,2,0,1,4,2,9
191019555,6,0,1,4,4,15
191019556,1,0,7,5,7,20
191019557,8,7,5,4,4,28
191019558,8,2,5,2,0,17
191019559,5,6,4,1,0,16
191019560,4,6,7,3,2,22
191019561,4,4,0,2,2,12
191019562,2,2,2,9,3,18
191019563,7,0,0,9,9,25
191019564,5,4,5,4,3,21
191019565,3,4,3,4,4,18
191019566,5,6,7,1,5,24
191019567,3,1,1,2,3,10
191019568,8,7,7,2,0,24
191019569,6,0,4,4,4,18
191019570,9,7,1,2,8,27
191019571,2,4,8,0,4,18
191019572,3,4,1,0,3,11
191019573,8,8,4,3,2,25
191019574,5,5,4,2,5,21
191019575,4,1,6,1,2,14
191019576,1,9,6,6,1,23
191019577,3,9,6,3,1,22
191019578,6,7,5,0,1,19
191019579,0,9,5,9,0,23
191019580,6,0,1,9,6,22
191019581,0,2,7,5,2,16
191019582,8,3,5,7,9,32
191019583,9,7,7,4,8,35
191019584,4,6,1,4,7,22
191019585,9,2,6,1,7,25
191019586,5,6,9,2,7,29
191019587,0,4,1,1,8,14
191019588,9,1,0,1,4,15
191019589,7,4,6,0,2,19
191019590,6,0,1,3,2,12
191019591,6,4,5,4,2,21
191019592,2,4,4,1,6,17
191019593,5,0,3,3,5,16
191019594,3,5,2,2,4,16
191019595,1,7,2,4,0,14
191019596,5,9,6,2,7,29
191019597,3,2,4,7,4,20
191019598,6,2,1,3,2,14
191019599,4,0,2,6,7,19
191019600,5,2,8,2,3,20
191019601,1,2,7,8,0,18
191019602,1,0,3,2,1,7
191019603,8,3,3,2,8,24
191019604,1,2,4,0,3,10
191019605,5,8,2,0,2,17
191019606,7,6,4,9,9,35
191019607,1,4,1,2,1,9
191019608,7,8,1,0,2,18
191019609,2,3,6,0,8,19
191019610,9,2,5,8,2,26
191019611,2,0,8,1,9,20
191019612,3,8,6,3,8,28
191019613,0,8,0,9,5,22
191019614,0,4,4,8,6,22
191019615,6,5,7,2,2,22
191019616,7,3,8,3,3,24
191019617,0,5,8,1,5,19
191019618,6,5,7,7,3,28
191019619,8,6,4,3,2,23
191019620,1,7,0,0,7,15
191019621,4,7,0,8,1,20
191019622,5,3,7,5,2,22
191019623,6,2,2,7,6,23
191019624,6,5,1,5,2,19
191019625,7,5,3,8,3,26
191019626,3,8,3,6,4,24
191019627,6,2,1,4,7,20
191019628,8,0,2,8,0,18
191019629,4,0,3,4,9,20
191019630,1,2,6,2,3,14
191019631,6,4,4,2,6,22
191019632,8,6,3,5,4,26
191019633,0,1,2,7,8,18
191019634,8,7,3,3,2,23
191019635,3,2,7,5,8,25
191019636,6,2,1,5,1,15
191019637,0,0,3,9,5,17
191019638,4,7,7,0,4,22
191019639,8,1,9,8,9,35
191019640,7,2,3,0,7,19
191019641,3,2,8,4,1,18
191019642,2,3,3,1,5,14
191019643,3,2,7,8,3,23
191019644,1,3,6,9,7,26
191019645,0,2,8,5,9,24
191019646,1,0,8,8,0,17
191019647,1,1,9,9,0,20
191019648,7,5,0,4,5,21
191019649,2,3,8,1,6,20
191019650,4,5,7,9,9,34
191019651,7,2,5,0,6,20
191019652,2,4,0,8,0,14
191019653,9,9,8,9,5,40
191019654,9,5,6,2,1,23
191019655,7,3,0,5,5,20
191019656,4,3,5,5,5,22
191019657,0,8,2,3,0,13
191019658,4,0,8,6,2,20
191019659,9,3,3,6,1,22
191019660,1,3,6,6,5,21
191019661,0,5,5,2,5,17
191019662,5,3,0,9,9,26
191019663,2,9,9,6,6,32
191019664,8,1,4,3,3,19
191019665,6,5,8,8,6,33
191019666,7,2,1,5,4,19
191019667,2,4,8,1,6,21
191019668,4,7,4,5,0,20
191019669,0,6,5,5,4,20
191019670,0,2,9,7,9,27
191019671,0,4,1,1,0,6
191019672,4,3,8,5,6,26
191019673,7,6,5,5,9,32
191019674,6,6,9,6,4,31
191019675,9,5,9,2,2,27
191019676,3,0,0,9,4,16
191019677,2,7,5,6,2,22
191019678,5,9,7,6,2,29
191019679,2,2,3,3,9,19
191019680,2,8,8,0,8,26
191019681,0,9,9,2,1,21
191019682,9,8,0,7,7,31
191019683,8,1,7,7,2,25
191019684,9,1,1,5,0,16
191019685,7,6,5,4,2,24
191019686,2,3,1,1,9,16
191019687,5,2,9,8,9,33
191019688,1,3,9,1,2,16
191019689,6,9,3,0,6,24
191019690,4,5,6,4,9,28
191019691,4,2,0,4,8,18
191019692,5,3,7,0,8,23
191019693,5,0,9,3,5,22
191019694,5,3,5,8,1,22
191019695,7,8,0,2,6,23
191019696,9,3,5,6,3,26
191019697,7,0,4,4,5,20
191019698,5,0,9,3,2,19
191019699,4,2,9,1,1,17
191019700,4,4,9,4,7,28
191019701,4,7,0,0,2,13
191019702,2,0,6,0,0,8
191019703,8,8,7,9,6,38
191019704,7,5,0,0,6,18
191019705,1,0,3,0,7,11
191019706,2,2,6,6,2,18
191019707,4,5,3,8,4,24
191019708,6,6,1,7,1,21
191019709,9,4,7,5,0,25
191019710,0,3,8,9,4,24
191019711,7,9,0,7,4,27
191019712,7,5,4,6,3,25
191019713,1,7,0,6,9,23
191019714,0,3,4,0,8,15
191019715,5,6,6,9,0,26
191019716,2,1,2,5,1,11
191019717,1,1,8,6,7,23
191019718,7,5,1,9,5,27
191019719,4,6,6,0,4,20
191019720,9,0,0,4,2,15
191019721,0,4,8,9,4,25
191019722,4,5,4,4,5,22
191019723,0,4,5,4,2,15
191019724,2,4,5,5,9,25
191019725,6,5,2,5,2,20
191019726,0,8,4,4,0,16
191019727,4,6,9,7,9,35
191019728,8,1,5,8,8,30
191019729,9,7,5,1,2,24
191019730,1,5,6,1,6,19
191019731,5,7,9,6,3,30
191019732,0,6,1,4,6,17
191019733,2,3,9,4,6,24
191019734,1,6,7,6,5,25
191019735,9,0,8,3,8,28
191019736,8,5,1,4,3,21
191019737,2,5,7,5,2,21
191019738,0,1,1,8,4,14
191019739,1,6,0,4,7,18
191019740,0,1,2,5,3,11
191019741,3,6,0,0,5,14
191019742,2,6,7,5,0,20
191019743,0,6,9,1,8,24
191019744,9,7,7,4,3,30
191019745,1,6,4,8,0,19
191019746,3,6,5,8,8,30
191019747,6,9,6,8,4,33
191019748,0,7,2,5,4,18
191019749,2,6,9,2,8,27
191019750,6,1,9,0,0,16
191019751,8,8,7,0,2,25
191019752,9,8,8,5,0,30
191019753,1,5,0,5,3,14
191019754,0,7,7,9,9,32
191019755,7,8,8,7,4,34
191019756,6,0,7,3,1,17
191019757,4,8,5,1,4,22
191019758,4,8,3,6,7,28
191019759,4,7,9,5,2,27
191019760,3,3,7,8,2,23
191019761,2,0,0,6,2,10
191019762,0,3,7,1,9,20
191019763,9,6,3,8,2,28
191019764,1,2,9,7,3,22
191019765,2,0,5,6,9,22
191019766,0,0,5,3,4,12
191019767,3,2,1,1,9,16
191019768,0,0,0,1,3,4
191019769,7,6,0,8,3,24
191019770,2,9,6,8,3,28
191019771,4,5,1,8,7,25
191019772,5,9,6,1,4,25
191019773,8,2,4,4,4,22
191019774,5,8,9,1,2,25
191019775,0,0,5,4,1,10
191019776,9,4,7,4,3,27
191019777,6,7,3,0,1,17
191019778,8,7,8,9,6,38
191019779,7,6,3,0,8,24
191019780,5,6,1,5,8,25
191019781,3,2,7,2,8,22
191019782,8,8,6,0,8,30
191019783,9,0,4,1,6,20
191019784,1,4,9,6,4,24
191019785,5,9,3,5,4,26
191019786,0,5,7,0,6,18
191019787,6,8,3,6,7,30
191019788,8,5,2,1,9,25
191019789,8,7,2,6,7,30
191019790,4,2,5,8,0,19
191019791,3,4,4,2,6,19
191019792,8,6,4,8,1,27
191019793,1,6,4,0,9,20
191019794,7,4,0,7,0,18
191019795,4,0,7,1,6,18
191019796,4,1,3,8,9,25
191019797,6,4,6,7,8,31
191019798,6,8,7,2,9,32
191019799,5,6,6,4,1,22
191019800,7,7,4,7,3,28
191019801,3,1,4,1,4,13
191019802,2,0,9,6,2,19
191019803,1,0,9,0,4,14
191019804,7,9,1,7,2,26
191019805,6,5,6,7,8,32
191019806,7,6,0,4,4,21
191019807,4,3,2,1,4,14
191019808,9,9,4,1,4,27
191019809,8,0,1,2,0,11
191019810,7,0,3,2,8,20
191019811,8,7,3,2,1,21
191019812,5,3,7,5,8,28
191019813,5,0,1,3,0,9
191019814,1,3,3,8,2,17
191019815,6,3,4,3,4,20
191019816,7,6,6,0,1,20
191019817,2,5,8,2,3,20
191019818,1,2,3,9,8,23
191019819,9,4,2,0,8,23
191019820,0,6,2,9,0,17
191019821,2,0,8,5,4,19
191019822,2,7,9,6,8,32
191019823,1,2,8,8,5,24
191019824,5,5,0,0,0,10
191019825,7,0,4,2,9,22
191019826,0,7,2,9,5,23
191019827,7,2,0,7,3,19
191019828,8,0,9,1,0,18
191019829,4,5,4,0,3,16
191019830,3,0,6,1,7,17
191019831,5,1,0,0,0,6
191019832,6,1,8,0,5,20
191019833,2,1,4,2,6,15
191019834,1,3,5,8,1,18
191019835,6,9,6,1,0,22
191019836,1,6,4,3,9,23
191019837,3,8,1,6,9,27
191019838,4,3,9,4,0,20
191019839,6,2,6,9,5,28
191019840,1,9,6,8,3,27
191019841,8,1,9,5,3,26
191019842,3,2,6,3,1,15
191019843,8,6,0,5,2,21
191019844,7,0,8,2,7,24
191019845,0,3,9,7,8,27
191019846,4,0,9,6,1,20
191019847,6,4,4,4,2,20
191019848,8,7,4,1,6,26
191019849,6,8,3,1,6,24
191019850,3,0,0,1,1,5
191019851,3,7,0,7,3,20
191019852,3,5,1,3,8,20
191019853,1,7,7,0,5,20
191019854,5,4,0,3,0,12
191019855,4,7,6,5,5,27
191019856,7,9,2,0,3,21
191019857,5,5,8,3,9,30
191019858,3,7,5,9,8,32
191019859,5,1,5,7,3,21
191019860,1,6,6,5,0,18
191019861,2,7,1,0,7,17
191019862,4,0,9,8,5,26
191019863,2,0,0,2,0,4
191019864,3,5,2,5,7,22
191019865,2,2,7,0,3,14
191019866,8,2,8,6,7,31
191019867,6,0,4,8,0,18
191019868,5,9,5,9,5,33
191019869,2,2,8,3,2,17
191019870,9,7,9,4,1,30
191019871,7,4,8,9,7,35
191019872,3,6,5,2,6,22
191019873,4,0,3,6,0,13
191019874,9,0,0,9,5,23
191019875,9,7,1,7,3,27
191019876,1,8,6,8,8,31
191019877,3,6,8,0,6,23
191019878,1,9,2,9,8,29
191019879,4,3,2,4,0,13
191019880,8,6,1,4,3,22
191019881,5,2,9,8,5,29
191019882,4,2,6,4,6,22
191019883,8,6,6,1,2,23
191019884,6,1,0,9,4,20
191019885,5,5,0,6,4,20
191019886,2,3,7,3,9,24
191019887,5,4,7,9,0,25
191019888,4,6,0,1,2,13
191019889,9,4,9,9,6,37
191019890,7,7,3,3,5,25
191019891,3,2,6,1,3,15
191019892,8,1,9,5,9,32
191019893,9,9,6,9,0,33
191019894,5,0,6,0,6,17
191019895,6,1,8,7,9,31
191019896,2,7,2,6,2,19
191019897,2,3,8,0,9,22
191019898,9,0,6,8,5,28
191019899,8,9,4,6,0,27
191019900,9,1,8,5,7,30
191019901,0,0,7,0,7,14
191019902,6,9,2,8,9,34
191019903,8,6,0,8,5,27
191019904,2,1,3,4,7,17
191019905,3,8,5,8,5,29
191019906,5,6,6,2,5,24
191019907,3,1,4,9,3,20
191019908,8,1,1,2,6,18
191019909,1,9,5,9,4,28
191019910,4,1,7,6,6,24
191019911,8,6,1,6,6,27
191019912,7,6,9,8,2,32
191019913,5,1,7,7,1,21
191019914,6,4,7,2,2,21
191019915,7,2,9,6,0,24
191019916,3,1,8,3,1,16
191019917,0,8,6,7,4,25
191019918,7,7,9,9,3,35
191019919,7,8,0,6,2,23
191019920,9,1,1,0,6,17
191019921,5,7,5,3,9,29
191019922,3,1,9,3,5,21
191019923,9,5,1,2,7,24
191019924,1,4,0,7,6,18
191019925,8,8,1,4,3,24
191019926,0,5,1,0,4,10
191019927,6,8,4,0,2,20
191019928,9,3,6,6,8,32
191019929,4,7,9,8,0,28
191019930,3,0,0,6,7,16
191019931,0,9,3,4,0,16
191019932,2,6,6,5,1,20
191019933,1,2,1,5,6,15
191019934,3,4,2,1,2,12
191019935,3,3,0,7,0,13
191019936,6,6,3,7,4,26
191019937,5,1,0,8,5,19
191019938,4,9,3,2,3,21
191019939,7,7,1,0,1,16
191019940,3,2,6,1,1,13
191019941,4,9,4,1,8,26
191019942,1,7,5,7,4,24
191019943,6,7,0,0,5,18
191019944,1,1,7,5,4,18
191019945,2,4,7,4,8,25
191019946,3,8,0,6,8,25
191019947,3,3,3,6,9,24
191019948,9,9,6,0,0,24
191019949,7,4,5,8,4,28
191019950,0,1,3,3,4,11
191019951,7,7,6,6,7,33
191019952,9,8,2,3,6,28
191019953,6,3,1,6,0,16
191019954,5,5,5,7,0,22
191019955,4,7,4,0,8,23
191019956,8,4,0,7,3,22
191019957,0,5,4,0,8,17
191019958,2,1,9,6,4,22
191019959,0,8,1,3,8,20
191019960,2,2,3,9,0,16
191019961,2,0,2,2,2,8
191019962,6,0,9,5,9,29
191019963,1,4,2,3,7,17
191019964,7,6,8,8,7,36
191019965,8,6,3,4,2,23
191019966,8,6,3,7,9,33
191019967,2,1,3,1,1,8
191019968,4,6,4,1,6,21
191019969,8,8,8,9,2,35
191019970,8,0,2,4,2,16
191019971,7,7,9,3,4,30
191019972,3,4,8,6,3,24
191019973,0,3,0,2,9,14
191019974,0,7,4,2,1,14
191019975,0,6,8,7,6,27
191019976,6,2,7,2,1,18
191019977,6,7,8,0,6,27
191019978,0,2,6,8,9,25
191019979,6,2,4,6,7,25
191019980,1,3,9,2,8,23
191019981,4,8,6,6,8,32
191019982,4,8,4,5,9,30
191019983,6,1,6,8,5,26
191019984,2,6,1,5,8,22
191019985,5,0,4,1,7,17
191019986,3,9,0,8,1,21
191019987,3,0,1,8,5,17
191019988,4,6,0,6,4,20
191019989,3,4,7,4,8,26
191019990,2,7,8,6,9,32
191019991,3,9,2,4,3,21
191019992,2,5,0,4,5,16
191019993,5,8,6,3,6,28
191019994,2,1,6,2,5,16
191019995,4,2,1,8,6,21
191019996,9,4,0,7,1,21
191019997,0,9,7,3,0,19
191019998,8,3,9,7,4,31
191019999,5,7,1,7,5,25
1910191000,6,8,5,8,3,30
1910191001,7,2,2,6,8,25
1910191002,6,6,9,4,0,25
1910191003,9,8,4,3,7,31
1910191004,4,4,4,9,4,25
1910191005,7,0,5,9,9,30
1910191006,0,6,0,6,3,15
1910191007,3,4,4,1,5,17
1910191008,0,3,5,8,9,25
1910191009,6,1,9,8,3,27
1910191010,1,7,2,6,3,19
1910191011,2,1,5,3,6,17
1910191012,1,8,1,8,0,18
1910191013,5,9,7,5,1,27
1910191014,7,3,5,7,1,23
1910191015,6,3,1,0,8,18
1910191016,3,9,0,8,3,23
1910191017,4,7,2,7,3,23
1910191018,4,4,6,8,2,24
1910191019,4,5,1,5,2,17
1910191020,4,3,3,7,9,26
1910191021,6,4,4,8,7,29
1910191022,2,1,1,0,5,9
1910191023,1,3,4,3,1,12
1910191024,5,4,7,4,0,20
1910191025,4,9,4,0,5,22
1910191026,9,3,5,2,5,24
1910191027,3,1,0,9,0,13
1910191028,5,1,6,3,5,20
1910191029,6,2,2,5,3,18
1910191030,4,2,5,1,0,12
1910191031,5,0,5,6,4,20
1910191032,5,7,6,1,3,22
1910191033,6,2,4,0,5,17
1910191034,2,8,2,3,3,18
1910191035,7,1,2,3,1,14
1910191036,7,7,7,4,0,25
1910191037,7,0,9,9,1,26
1910191038,0,0,0,5,2,7
1910191039,0,1,9,1,2,13
1910191040,9,2,5,9,8,33
1910191041,0,1,4,7,3,15
1910191042,6,1,8,9,9,33
1910191043,8,2,8,7,4,29
1910191044,1,6,7,9,1,24
1910191045,2,3,5,7,3,20
1910191046,4,9,0,1,6,20
1910191047,2,7,2,7,1,19
1910191048,6,2,5,3,0,16
1910191049,2,0,9,6,3,20
1910191050,0,1,6,1,5,13
1910191051,8,8,2,6,5,29
1910191052,6,2,4,3,8,23
1910191053,2,5,2,9,5,23
1910191054,0,9,5,0,9,23
1910191055,7,0,0,7,4,18
1910191056,4,3,3,7,4,21
1910191057,2,2,8,9,2,23
1910191058,7,9,8,9,1,34
1910191059,3,6,4,0,4,17
1910191060,1,1,9,7,9,27
1910191061,3,2,9,6,6,26
1910191062,9,0,1,0,0,10
1910191063,9,4,9,5,1,28
1910191064,4,9,3,8,6,30
1910191065,0,0,3,5,4,12
1910191066,1,4,6,6,9,26
1910191067,0,5,3,8,8,24
1910191068,5,0,7,8,9,29
1910191069,3,4,8,9,8,32
1910191070,0,6,0,5,7,18
1910191071,1,2,9,5,2,19
1910191072,7,0,4,4,0,15
1910191073,5,2,5,5,7,24
1910191074,0,3,2,8,2,15
1910191075,7,8,3,4,1,23
1910191076,2,6,4,6,6,24
1910191077,6,0,9,6,6,27
1910191078,2,7,0,8,7,24
1910191079,4,1,4,1,2,12
1910191080,5,0,7,9,0,21
1910191081,0,4,6,8,5,23
1910191082,0,1,6,4,7,18
1910191083,1,6,1,7,1,16
1910191084,4,7,4,1,8,24
1910191085,3,4,3,1,8,19
1910191086,6,4,1,6,7,24
1910191087,4,7,5,0,8,24
1910191088,7,0,1,8,2,18
1910191089,7,7,1,3,7,25
1910191090,0,4,1,1,3,9
1910191091,3,2,1,8,5,19
1910191092,6,3,3,5,5,22
1910191093,9,8,1,1,2,21
1910191094,3,0,4,5,9,21
1910191095,4,7,7,1,4,23
1910191096,7,2,0,7,8,24
1910191097,2,6,6,8,0,22
1910191098,3,1,2,6,0,12
1910191099,8,2,3,8,2,23
1910191100,3,3,6,3,7,22
1910191101,9,0,0,0,8,17
1910191102,9,4,5,7,4,29
1910191103,0,1,6,2,0,9
1910191104,4,6,3,3,6,22
1910191105,1,1,3,6,7,18
191020001,8,7,8,7,9,39
191020002,8,5,2,9,8,32
191020003,7,7,2,5,9,30
191020004,6,9,9,2,6,32
191020005,3,9,7,8,2,29
191020006,2,6,7,0,4,19
191020007,1,9,2,8,8,28
191020008,1,6,9,6,7,29
191020009,6,7,4,0,4,21
191020010,7,8,5,2,5,27
191020011,8,4,8,6,0,26
191020012,7,3,5,6,7,28
191020013,9,9,6,3,5,32
191020014,5,7,4,7,3,26
191020015,0,7,7,1,3,18
191020016,8,4,1,0,3,16
191020017,5,7,7,2,6,27
191020018,7,1,8,1,6,23
191020019,9,3,8,2,4,26
191020020,4,3,9,5,9,30
191020021,0,5,2,3,3,13
191020022,5,6,2,0,5,18
191020023,9,4,8,3,8,32
191020024,2,9,1,9,4,25
191020025,4,6,0,3,0,13
191020026,4,1,2,7,8,22
191020027,0,3,1,7,3,14
191020028,6,2,7,3,1,19
191020029,6,3,8,0,6,23
191020030,1,9,5,6,9,30
191020031,6,0,2,9,7,24
191020032,6,9,0,6,8,29
191020033,4,3,9,5,3,24
191020034,5,5,3,0,5,18
191020035,2,4,4,7,2,19
191020036,0,5,4,4,5,18
191020037,6,7,8,7,6,34
191020038,9,4,7,9,4,33
191020039,0,2,8,4,0,14
191020040,8,0,9,2,1,20
191020041,4,7,2,5,3,21
191020042,8,8,3,2,2,23
191020043,4,2,3,9,3,21
191020044,7,5,6,5,5,28
191020045,2,8,4,7,2,23
191020046,2,3,5,4,0,14
191020047,8,6,2,3,0,19
191020048,2,9,3,6,9,29
191020049,5,5,1,9,0,20
191020050,9,3,9,1,0,22
191020051,6,8,6,4,9,33
191020052,6,8,0,2,5,21
191020053,0,1,8,8,8,25
191020054,6,7,8,6,9,36
191020055,7,6,9,2,6,30
191020056,0,8,1,1,5,15
191020057,7,2,8,2,1,20
191020058,1,5,7,8,0,21
191020059,8,5,9,7,8,37
191020060,7,0,7,5,0,19
191020061,2,5,4,0,0,11
191020062,8,7,0,2,7,24
191020063,4,9,7,1,3,24
191020064,9,2,9,1,2,23
191020065,0,0,9,1,8,18
191020066,5,3,0,5,4,17
191020067,2,9,7,5,0,23
191020068,2,4,2,5,7,20
191020069,0,1,3,6,2,12
191020070,3,4,3,6,9,25
191020071,6,1,4,8,0,19
191020072,3,8,2,5,7,25
191020073,9,3,5,7,6,30
191020074,0,1,6,4,8,19
191020075,5,5,4,7,7,28
191020076,8,6,0,0,7,21
191020077,9,9,6,9,2,35
191020078,0,1,8,2,0,11
191020079,3,0,2,6,1,12
191020080,3,5,4,3,8,23
191020081,5,5,9,5,3,27
191020082,7,3,1,6,5,22
191020083,7,6,4,7,9,33
191020084,4,2,1,6,0,13
191020085,2,4,5,5,5,21
191020086,3,9,4,3,0,19
191020087,8,8,1,5,8,30
191020088,5,6,4,7,2,24
191020089,8,9,3,8,1,29
191020090,0,1,7,9,2,19
191020091,3,6,7,3,0,19
191020092,2,8,4,5,0,19
191020093,8,6,8,3,2,27
191020094,8,9,0,3,4,24
191020095,3,5,4,8,8,28
191020096,0,8,6,0,4,18
191020097,2,3,8,6,8,27
191020098,8,2,4,2,3,19
191020099,6,5,7,8,9,35
191020100,1,2,6,4,2,15
191020101,7,1,6,5,0,19
191020102,5,4,1,4,0,14
191020103,7,9,5,0,8,29
191020104,8,0,0,3,0,11
191020105,2,4,6,9,1,22
191020106,1,1,2,8,6,18
191020107,4,5,9,4,8,30
191020108,9,8,9,9,5,40
191020109,3,1,8,3,3,18
191020110,3,6,7,3,3,22
191020111,3,5,1,6,8,23
191020112,1,9,4,3,9,26
191020113,8,9,0,3,1,21
191020114,7,4,3,6,3,23
191020115,1,3,4,0,6,14
191020116,6,4,9,8,2,29
191020117,7,0,6,7,0,20
191020118,3,5,9,2,0,19
191020119,9,8,0,3,0,20
191020120,3,8,1,4,3,19
191020121,1,0,3,7,4,15
191020122,0,7,5,4,1,17
191020123,0,8,6,2,0,16
191020124,4,4,2,0,2,12
191020125,4,3,4,7,2,20
191020126,9,1,7,3,0,20
191020127,1,0,9,1,7,18
191020128,7,5,8,0,5,25
191020129,6,7,9,7,6,35
191020130,7,8,4,2,5,26
191020131,3,7,3,9,6,28
191020132,0,3,8,6,0,17
191020133,0,3,9,6,6,24
191020134,0,6,0,2,2,10
191020135,9,8,0,1,3,21
191020136,8,6,3,6,5,28
191020137,1,3,3,4,3,14
191020138,5,7,1,5,0,18
191020139,2,9,5,8,0,24
191020140,3,3,8,4,0,18
191020141,1,1,8,0,7,17
191020142,4,3,7,8,8,30
191020143,4,6,4,5,9,28
191020144,5,7,7,2,7,28
191020145,4,4,3,7,6,24
191020146,6,2,5,4,1,18
191020147,8,9,8,8,6,39
191020148,2,9,4,5,1,21
191020149,9,7,7,7,2,32
191020150,0,0,1,4,0,5
191020151,6,6,0,9,8,29
191020152,3,4,2,7,4,20
191020153,1,1,0,4,1,7
191020154,8,6,2,0,3,19
191020155,7,7,5,8,9,36
191020156,4,9,4,2,6,25
191020157,2,5,8,0,0,15
191020158,2,1,1,6,9,19
191020159,8,0,0,0,5,13
191020160,4,6,8,2,7,27
191020161,1,9,9,7,4,30
191020162,5,0,1,2,3,11
191020163,1,8,6,0,9,24
191020164,0,5,4,8,1,18
191020165,5,4,0,6,5,20
191020166,4,9,1,8,1,23
191020167,6,6,0,4,1,17
191020168,8,3,2,1,0,14
191020169,8,8,5,3,1,25
191020170,3,9,4,6,2,24
191020171,2,3,1,2,4,12
191020172,8,6,7,0,0,21
191020173,0,5,4,9,0,18
191020174,7,3,6,7,3,26
191020175,4,1,2,2,0,9
191020176,6,6,1,9,1,23
191020177,6,6,4,4,8,28
191020178,2,5,8,2,8,25
191020179,8,1,0,5,1,15
191020180,8,8,3,3,9,31
191020181,3,3,1,8,1,16
191020182,3,9,8,0,6,26
191020183,0,5,9,5,6,25
191020184,1,7,4,6,6,24
191020185,5,4,9,8,3,29
191020186,3,8,2,8,7,28
191020187,9,8,6,4,4,31
191020188,1,7,2,4,8,22
191020189,3,4,1,9,7,24
191020190,8,4,0,2,2,16
191020191,8,5,4,9,1,27
191020192,9,8,2,2,6,27
191020193,2,3,7,1,7,20
191020194,6,5,4,1,2,18
191020195,2,9,5,1,8,25
191020196,8,7,7,6,6,34
191020197,0,7,9,4,9,29
191020198,8,1,9,6,0,24
191020199,0,3,3,0,3,9
191020200,5,1,7,4,8,25
191020201,6,0,9,5,2,22
191020202,4,7,1,0,4,16
191020203,7,0,5,3,7,22
191020204,7,4,7,1,5,24
191020205,4,8,7,8,6,33
191020206,6,2,5,8,6,27
191020207,9,3,2,4,6,24
191020208,2,8,8,5,6,29
191020209,3,5,6,2,8,24
191020210,8,9,8,5,7,37
191020211,3,7,2,1,8,21
191020212,9,9,4,4,7,33
191020213,2,4,4,8,4,22
191020214,2,8,7,4,7,28
191020215,7,0,5,4,1,17
191020216,7,0,2,6,3,18
191020217,9,6,1,3,7,26
191020218,0,1,3,8,7,19
191020219,7,0,4,5,8,24
191020220,4,1,2,0,0,7
191020221,2,6,7,3,6,24
191020222,2,8,9,2,8,29
191020223,0,8,1,7,9,25
191020224,5,7,7,6,4,29
191020225,2,1,8,3,8,22
191020226,0,4,0,8,0,12
191020227,3,7,2,2,7,21
191020228,3,3,0,6,1,13
191020229,0,6,5,8,1,20
191020230,4,8,1,6,6,25
191020231,8,2,2,2,0,14
191020232,0,0,1,0,6,7
191020233,4,5,3,7,1,20
191020234,7,3,1,0,4,15
191020235,7,7,7,1,1,23
191020236,8,5,6,1,4,24
191020237,6,7,2,8,3,26
191020238,3,5,2,8,5,23
191020239,6,5,4,4,7,26
191020240,4,5,5,4,8,26
191020241,4,2,5,9,8,28
191020242,8,8,6,3,5,30
191020243,4,3,4,8,6,25
191020244,2,7,4,8,3,24
191020245,6,6,2,4,6,24
191020246,5,7,7,9,9,37
191020247,6,9,9,7,4,35
191020248,9,9,2,7,1,28
191020249,9,3,3,4,7,26
191020250,3,2,3,6,7,21
191020251,4,8,5,5,2,24
191020252,3,2,8,9,0,22
191020253,1,8,5,0,8,22
191020254,9,3,8,1,6,27
191020255,8,5,0,0,1,14
191020256,5,7,0,8,7,27
191020257,0,0,6,9,1,16
191020258,6,9,2,2,1,20
191020259,5,2,7,5,6,25
191020260,3,5,3,0,6,17
191020261,1,3,2,5,2,13
191020262,8,4,0,6,0,18
191020263,0,1,5,3,7,16
191020264,6,5,9,5,8,33
191020265,7,4,1,6,7,25
191020266,2,7,2,5,3,19
191020267,6,5,3,8,4,26
191020268,4,6,9,0,1,20
191020269,8,5,0,3,9,25
191020270,2,5,4,8,2,21
191020271,0,4,9,3,3,19
191020272,3,3,5,2,5,18
191020273,8,8,1,3,0,20
191020274,8,2,4,2,5,21
191020275,3,7,1,7,9,27
191020276,2,8,9,9,8,36
191020277,2,2,3,1,1,9
191020278,3,1,0,7,2,13
191020279,5,8,8,3,2,26
191020280,1,0,8,3,0,12
191020281,8,4,5,8,6,31
191020282,7,1,4,1,9,22
191020283,4,3,7,7,0,21
191020284,1,3,3,0,1,8
191020285,5,9,2,5,8,29
191020286,1,4,2,7,7,21
191020287,7,4,6,7,3,27
191020288,9,5,9,4,9,36
191020289,0,6,2,8,7,23
191020290,8,2,8,1,3,22
191020291,9,0,1,1,9,20
191020292,8,1,0,2,1,12
191020293,7,8,0,4,9,28
191020294,7,0,1,8,8,24
191020295,2,3,7,6,6,24
191020296,0,6,8,3,1,18
191020297,9,8,4,2,3,26
191020298,3,8,0,0,5,16
191020299,3,4,8,6,0,21
191020300,0,7,3,2,1,13
191020301,6,1,6,1,1,15
191020302,4,7,0,3,0,14
191020303,0,3,2,9,3,17
191020304,6,0,4,1,0,11
191020305,1,2,4,5,0,12
191020306,8,7,4,4,0,23
191020307,8,7,9,2,3,29
191020308,4,2,1,5,9,21
191020309,5,6,2,3,5,21
191020310,1,7,7,8,2,25
191020311,6,9,4,2,1,22
191020312,8,1,2,5,9,25
191020313,6,0,1,2,5,14
191020314,9,0,8,9,9,35
191020315,3,4,2,0,7,16
191020316,5,1,5,0,4,15
191020317,4,6,6,7,1,24
191020318,0,8,3,4,7,22
191020319,4,8,2,5,9,28
191020320,6,0,7,5,4,22
191020321,0,3,2,0,7,12
191020322,7,4,9,6,2,28
191020323,9,7,7,8,1,32
191020324,9,1,1,5,7,23
191020325,5,7,6,7,2,27
191020326,6,4,7,3,6,26
191020327,3,0,1,5,3,12
191020328,2,4,0,9,2,17
191020329,3,2,3,5,4,17
191020330,5,2,4,0,1,12
191020331,2,4,6,4,4,20
191020332,1,3,5,0,3,12
191020333,5,1,6,8,2,22
191020334,3,2,4,1,4,14
191020335,7,8,7,3,8,33
191020336,2,6,9,6,2,25
191020337,9,2,4,4,8,27
191020338,3,4,0,8,0,15
191020339,1,2,9,9,2,23
191020340,7,5,3,0,8,23
191020341,8,7,0,2,0,17
191020342,9,7,4,5,0,25
191020343,9,9,2,4,6,30
191020344,5,6,9,1,0,21
191020345,0,6,4,8,1,19
191020346,0,0,0,4,5,9
191020347,5,8,9,3,9,34
191020348,1,9,1,3,8,22
191020349,1,1,6,1,3,12
191020350,2,9,7,6,3,27
191020351,9,4,0,2,4,19
191020352,4,2,7,0,9,22
191020353,9,5,0,8,2,24
191020354,6,9,5,8,7,35
191020355,6,3,4,1,8,22
191020356,5,4,7,5,1,22
191020357,7,7,9,0,6,29
191020358,4,8,7,0,0,19
191020359,8,4,0,2,1,15
191020360,7,1,2,9,5,24
191020361,2,3,1,7,3,16
191020362,2,0,9,8,1,20
191020363,4,1,0,2,5,12
191020364,0,6,1,5,5,17
191020365,9,8,8,5,2,32
191020366,3,0,2,8,0,13
191020367,3,7,0,0,3,13
191020368,2,4,5,2,1,14
191020369,8,2,2,4,2,18
191020370,8,1,2,4,6,21
191020371,9,2,2,1,6,20
191020372,9,3,4,9,4,29
191020373,0,8,6,1,5,20
191020374,6,1,1,6,1,15
191020375,7,0,4,7,0,18
191020376,7,1,4,1,7,20
191020377,9,6,3,6,4,28
191020378,5,3,1,3,7,19
191020379,9,5,7,7,6,34
191020380,0,5,1,2,7,15
191020381,9,7,0,7,6,29
191020382,7,9,9,8,1,34
191020383,2,5,3,6,2,18
191020384,5,2,4,3,9,23
191020385,7,4,3,7,0,21
191020386,2,9,9,1,5,26
191020387,3,8,3,2,2,18
191020388,7,6,5,9,9,36
191020389,3,3,6,0,8,20
191020390,0,6,9,2,1,18
191020391,1,5,9,8,0,23
191020392,2,8,2,8,3,23
191020393,8,6,8,2,8,32
191020394,1,1,2,1,8,13
191020395,7,5,3,8,1,24
191020396,2,1,2,8,8,21
191020397,6,6,0,2,7,21
191020398,9,7,5,0,0,21
191020399,7,6,0,2,7,22
191020400,4,7,8,5,2,26
191020401,1,6,1,6,3,17
191020402,2,4,0,0,3,9
191020403,6,6,9,5,0,26
191020404,0,9,2,5,8,24
191020405,7,0,5,1,7,20
191020406,4,9,1,8,5,27
191020407,1,0,7,1,6,15
191020408,3,6,5,6,8,28
191020409,4,8,8,6,1,27
191020410,0,4,9,2,2,17
191020411,9,7,5,0,2,23
191020412,0,7,7,0,3,17
191020413,1,7,0,8,4,20
191020414,8,3,2,3,9,25
191020415,0,3,5,2,3,13
191020416,5,7,7,7,5,31
191020417,8,4,7,9,6,34
191020418,6,4,6,9,0,25
191020419,0,2,3,5,6,16
191020420,7,8,1,5,3,24
191020421,8,1,0,8,4,21
191020422,3,7,9,5,9,33
191020423,3,2,6,5,1,17
191020424,7,7,2,6,8,30
191020425,6,6,3,1,5,21
191020426,1,6,4,5,1,17
191020427,2,1,2,9,7,21
191020428,4,0,4,8,3,19
191020429,1,9,6,1,4,21
191020430,7,6,7,6,8,34
191020431,0,4,9,2,1,16
191020432,2,8,8,7,5,30
191020433,2,2,6,3,1,14
191020434,8,3,3,5,9,28
191020435,2,9,8,0,2,21
191020436,0,0,9,7,5,21
191020437,1,5,0,7,9,22
191020438,7,2,5,4,7,25
191020439,1,1,0,1,1,4
191020440,9,7,5,8,7,36
191020441,0,8,0,5,2,15
191020442,6,2,9,1,1,19
191020443,4,1,9,3,1,18
191020444,4,5,3,6,6,24
191020445,0,5,0,7,1,13
191020446,6,6,2,9,6,29
191020447,0,8,1,4,2,15
191020448,2,2,2,3,0,9
191020449,2,2,1,8,4,17
191020450,4,9,0,3,8,24
191020451,2,7,1,1,6,17
191020452,0,4,3,1,7,15
191020453,4,4,2,1,0,11
191020454,5,0,3,2,0,10
191020455,2,1,4,4,5,16
191020456,1,6,0,4,1,12
191020457,2,7,8,2,0,19
191020458,1,4,2,0,4,11
191020459,7,7,2,3,2,21
191020460,9,6,2,3,1,21
191020461,2,6,9,8,0,25
191020462,9,6,6,3,8,32
191020463,0,4,8,3,3,18
191020464,4,2,6,5,9,26
191020465,2,6,6,8,5,27
191020466,0,5,3,5,1,14
191020467,5,5,0,7,1,18
191020468,8,3,3,7,8,29
191020469,0,9,0,9,5,23
191020470,3,0,6,9,6,24
191020471,3,8,5,7,4,27
191020472,3,0,9,5,4,21
191020473,3,0,3,4,4,14
191020474,0,1,3,4,0,8
191020475,6,2,5,1,3,17
191020476,6,4,2,9,1,22
191020477,2,1,1,8,5,17
191020478,5,8,7,1,7,28
191020479,4,7,8,3,6,28
191020480,3,9,3,3,2,20
191020481,7,8,4,3,6,28
191020482,9,3,1,9,6,28
191020483,4,3,3,5,4,19
191020484,5,1,6,7,8,27
191020485,5,5,8,8,5,31
191020486,5,3,4,8,4,24
191020487,5,3,2,1,3,14
191020488,9,7,0,8,5,29
191020489,7,1,8,0,1,17
191020490,6,6,2,9,2,25
191020491,2,9,6,4,3,24
191020492,6,1,0,8,5,20
191020493,8,7,9,9,6,39
191020494,9,0,2,1,0,12
191020495,2,4,1,2,4,13
191020496,3,1,7,2,1,14
191020497,8,4,3,6,3,24
191020498,2,9,2,4,9,26
191020499,9,4,0,6,0,19
191020500,1,4,6,1,4,16
191020501,2,6,8,6,6,28
191020502,7,3,7,2,0,19
191020503,9,2,0,6,9,26
191020504,6,7,8,9,0,30
191020505,6,4,5,8,2,25
191020506,3,1,3,0,1,8
191020507,3,4,2,9,8,26
191020508,3,5,6,2,5,21
191020509,3,3,2,1,1,10
191020510,2,7,4,1,1,15
191020511,7,3,4,1,8,23
191020512,5,1,7,1,1,15
191020513,1,9,8,6,0,24
191020514,2,8,6,5,0,21
191020515,7,2,8,8,9,34
191020516,7,6,9,9,3,34
191020517,1,4,2,0,8,15
191020518,8,0,5,9,8,30
191020519,1,4,6,0,7,18
191020520,0,5,5,3,6,19
191020521,2,3,4,3,3,15
191020522,7,6,0,9,6,28
191020523,4,2,8,5,9,28
191020524,0,8,7,7,7,29
191020525,2,2,2,7,2,15
191020526,8,0,4,0,7,19
191020527,0,9,6,7,9,31
191020528,9,5,3,4,2,23
191020529,6,3,2,3,0,14
191020530,9,4,4,4,2,23
191020531,4,2,9,2,0,17
191020532,3,9,1,9,3,25
191020533,0,9,3,3,7,22
191020534,2,3,4,6,2,17
191020535,7,4,6,6,3,26
191020536,5,1,4,1,9,20
191020537,5,9,0,5,6,25
191020538,1,5,0,8,6,20
191020539,8,6,7,1,6,28
191020540,6,3,9,0,7,25
191020541,8,7,9,3,6,33
191020542,9,0,4,0,8,21
191020543,6,7,3,1,3,20
191020544,4,0,1,0,2,7
191020545,7,1,9,7,0,24
191020546,2,4,2,6,0,14
191020547,7,2,6,9,1,25
191020548,8,8,6,2,6,30
191020549,2,9,2,7,5,25
191020550,8,8,1,0,7,24
191020551,1,8,7,5,0,21
191020552,2,0,6,2,0,10
191020553,4,8,2,9,9,32
191020554,8,8,6,3,4,29
191020555,4,4,7,4,6,25
191020556,8,4,7,1,3,23
191020557,1,6,7,0,9,23
191020558,3,1,7,1,9,21
191020559,5,5,3,2,7,22
191020560,6,9,2,7,6,30
191020561,0,4,0,8,7,19
191020562,3,7,3,5,0,18
191020563,5,9,7,8,6,35
191020564,5,4,6,1,1,17
191020565,0,4,0,0,3,7
191020566,4,2,1,8,7,22
191020567,1,4,7,8,0,20
191020568,5,4,4,5,8,26
191020569,4,8,6,7,3,28
191020570,6,2,1,5,7,21
191020571,7,1,8,4,2,22
191020572,5,1,1,5,6,18
191020573,7,6,2,3,5,23
191020574,1,2,8,6,6,23
191020575,5,6,1,7,3,22
191020576,5,4,3,4,8,24
191020577,0,1,1,4,2,8
191020578,1,4,7,6,6,24
191020579,6,3,0,2,4,15
191020580,5,2,1,0,5,13
191020581,3,6,2,3,8,22
191020582,7,4,6,7,5,29
191020583,9,2,9,4,1,25
191020584,2,0,2,8,3,15
191020585,3,1,4,6,4,18
191020586,7,0,5,5,7,24
191020587,7,1,1,6,2,17
191020588,1,1,3,0,7,12
191020589,8,1,6,0,3,18
191020590,5,7,1,1,0,14
191020591,2,1,6,1,2,12
191020592,5,5,4,2,2,18
191020593,0,8,3,3,2,16
191020594,9,6,9,4,3,31
191020595,3,2,2,7,8,22
191020596,5,0,6,2,5,18
191020597,4,8,1,5,7,25
191020598,0,5,8,5,2,20
191020599,1,4,9,2,6,22
191020600,3,3,4,8,5,23
191020601,7,1,4,4,9,25
191020602,1,0,6,0,5,12
191020603,2,6,4,5,3,20
191020604,4,5,4,8,6,27
191020605,9,8,0,0,2,19
191020606,1,3,9,0,0,13
191020607,0,8,1,7,4,20
191020608,4,4,5,2,6,21
191020609,4,2,8,0,0,14
191020610,1,7,4,3,2,17
191020611,3,1,8,8,0,20
191020612,1,5,8,6,5,25
191020613,7,8,6,3,7,31
191020614,1,8,2,7,8,26
191020615,2,8,9,6,0,25
191020616,0,8,4,3,7,22
191020617,1,6,6,0,6,19
191020618,3,3,8,6,2,22
191020619,1,2,7,5,4,19
191020620,0,0,8,2,5,15
191020621,0,3,1,0,3,7
191020622,9,2,4,0,6,21
191020623,4,6,0,6,0,16
191020624,0,1,2,4,5,12
191020625,8,4,7,8,2,29
191020626,7,1,5,3,3,19
191020627,3,2,1,1,0,7
191020628,6,2,3,5,9,25
191020629,2,5,8,1,9,25
191020630,7,4,0,9,2,22
191020631,9,0,3,9,8,29
191020632,5,5,6,3,7,26
191020633,8,0,5,5,1,19
191020634,9,6,0,9,6,30
191020635,5,2,3,1,2,13
191020636,9,6,1,6,7,29
191020637,8,1,8,3,5,25
191020638,1,0,0,4,4,9
191020639,2,9,1,4,0,16
191020640,1,7,8,7,3,26
191020641,9,0,6,4,3,22
191020642,5,8,7,2,6,28
191020643,3,1,2,7,2,15
191020644,1,0,5,7,6,19
191020645,6,5,8,9,7,35
191020646,9,8,1,0,5,23
191020647,9,8,9,7,2,35
191020648,6,4,1,7,9,27
191020649,4,7,4,0,2,17
191020650,8,1,7,8,6,30
191020651,9,8,4,8,8,37
191020652,4,1,7,0,2,14
191020653,7,5,9,4,4,29
191020654,7,6,7,3,7,30
191020655,4,0,6,1,2,13
191020656,8,8,0,6,4,26
191020657,2,3,1,3,6,15
191020658,3,8,7,1,4,23
191020659,4,7,4,9,9,33
191020660,7,5,7,5,0,24
191020661,2,1,2,6,4,15
191020662,8,6,7,0,6,27
191020663,0,6,8,0,4,18
191020664,6,9,2,8,5,30
191020665,1,8,4,8,3,24
191020666,1,3,1,5,4,14
191020667,6,0,1,5,2,14
191020668,7,4,8,9,5,33
191020669,6,1,0,9,1,17
191020670,2,6,6,3,5,22
191020671,3,8,6,1,0,18
191020672,5,5,9,5,4,28
191020673,2,3,8,8,3,24
191020674,6,8,9,3,2,28
191020675,2,8,1,7,6,24
191020676,1,8,8,9,1,27
191020677,0,9,4,5,5,23
191020678,2,5,1,5,0,13
191020679,9,3,5,8,0,25
191020680,3,6,0,7,8,24
191020681,8,6,7,0,2,23
191020682,9,0,2,3,4,18
191020683,8,9,1,0,8,26
191020684,9,2,9,5,6,31
191020685,4,8,7,8,5,32
191020686,2,8,4,0,7,21
191020687,3,5,9,2,8,27
191020688,8,0,4,5,3,20
191020689,7,8,2,2,6,25
191020690,2,2,2,1,7,14
191020691,3,5,5,0,9,22
191020692,2,2,1,8,8,21
191020693,0,0,8,8,7,23
191020694,6,0,4,0,2,12
191020695,1,7,0,7,9,24
191020696,6,1,1,8,8,24
191020697,0,1,0,3,1,5
191020698,2,1,7,5,7,22
191020699,2,2,8,8,4,24
191020700,2,9,0,3,7,21
191020701,3,7,9,1,3,23
191020702,8,2,2,3,5,20
191020703,9,3,8,2,7,29
191020704,2,3,9,5,7,26
191020705,7,5,0,4,7,23
191020706,5,1,5,8,3,22
191020707,7,1,9,5,4,26
191020708,9,2,4,8,2,25
191020709,4,6,6,1,1,18
191020710,9,1,3,6,1,20
191020711,8,8,2,5,5,28
191020712,2,4,8,8,1,23
191020713,3,0,7,8,5,23
191020714,5,5,5,3,3,21
191020715,4,7,3,9,8,31
191020716,9,2,7,1,7,26
191020717,8,9,0,9,4,30
191020718,8,5,6,6,2,27
191020719,2,8,6,8,3,27
191020720,9,3,2,4,5,23
191020721,6,4,0,7,7,24
191020722,9,3,3,3,1,19
191020723,7,3,7,4,4,25
191020724,8,1,1,3,0,13
191020725,5,0,2,4,6,17
191020726,6,9,1,6,0,22
191020727,4,7,6,1,6,24
191020728,8,4,6,7,0,25
191020729,6,9,0,7,3,25
191020730,6,6,6,6,2,26
191020731,0,6,8,9,7,30
191020732,7,2,9,1,9,28
191020733,7,9,7,1,1,25
191020734,4,1,0,9,8,22
191020735,4,5,0,7,2,18
191020736,8,3,7,5,7,30
191020737,3,8,5,9,4,29
191020738,3,8,0,8,0,19
191020739,3,6,7,7,1,24
191020740,6,5,5,3,4,23
191020741,7,1,9,1,0,18
191020742,6,6,6,0,5,23
191020743,1,9,8,7,6,31
191020744,2,5,4,1,1,13
191020745,1,5,8,9,7,30
191020746,8,1,8,5,7,29
191020747,5,5,1,7,8,26
191020748,4,0,2,6,8,20
191020749,7,7,1,1,4,20
191020750,0,4,9,2,3,18
191020751,7,3,2,7,4,23
191020752,4,3,8,5,0,20
191020753,8,2,7,0,8,25
191020754,8,3,1,6,2,20
191020755,2,6,0,4,2,14
191020756,9,4,0,2,1,16
191020757,9,5,0,4,6,24
191020758,5,2,9,2,4,22
191020759,7,5,9,3,3,27
191020760,1,7,1,2,2,13
191020761,3,8,8,7,4,30
191020762,4,3,3,3,6,19
191020763,5,7,9,8,1,30
191020764,9,3,3,6,8,29
191020765,9,5,1,8,1,24
191020766,0,4,2,2,8,16
191020767,4,3,2,6,6,21
191020768,4,5,7,6,2,24
191020769,0,6,9,8,3,26
191020770,7,7,2,0,3,19
191020771,3,3,1,7,7,21
191020772,8,5,2,8,1,24
191020773,6,7,0,4,8,25
191020774,7,6,9,9,0,31
191020775,4,3,7,2,6,22
191020776,3,0,1,6,5,15
191020777,2,6,4,1,0,13
191020778,7,2,5,9,4,27
191020779,9,9,9,8,0,35
191020780,9,2,3,1,3,18
191020781,6,8,9,9,6,38
191020782,2,8,4,1,4,19
191020783,5,4,7,5,8,29
191020784,4,9,0,1,5,19
191020785,8,1,2,0,4,15
191020786,9,7,9,9,8,42
191020787,2,6,6,8,6,28
191020788,3,7,7,7,8,32
191020789,6,1,6,5,9,27
191020790,0,3,8,7,8,26
191020791,7,8,1,8,5,29
191020792,2,5,8,0,6,21
191020793,1,4,8,9,1,23
191020794,4,9,9,3,7,32
191020795,5,2,8,1,8,24
191020796,5,0,7,9,1,22
191020797,5,1,1,6,6,19
191020798,4,0,0,3,8,15
191020799,1,9,3,3,2,18
191020800,5,1,2,9,4,21
191020801,7,2,6,4,2,21
191020802,5,0,5,7,7,24
191020803,5,7,4,8,5,29
191020804,8,4,2,4,0,18
191020805,7,2,0,7,7,23
191020806,5,0,6,1,3,15
191020807,7,0,0,7,3,17
191020808,5,5,4,0,2,16
191020809,0,8,0,9,7,24
191020810,8,5,2,4,0,19
191020811,2,0,8,0,9,19
191020812,6,8,6,4,4,28
191020813,0,4,2,7,4,17
191020814,9,0,4,4,7,24
191020815,8,8,1,4,6,27
191020816,9,9,5,9,0,32
191020817,2,9,5,5,0,21
191020818,7,3,0,8,4,22
191020819,6,0,6,5,7,24
191020820,1,2,6,0,1,10
191020821,0,7,7,6,6,26
191020822,8,3,5,4,0,20
191020823,2,5,5,4,1,17
191020824,5,4,4,9,5,27
191020825,4,6,2,1,6,19
191020826,8,1,2,4,7,22
191020827,8,3,0,9,5,25
191020828,8,1,5,3,4,21
191020829,1,2,0,9,0,12
191020830,1,3,3,6,8,21
191020831,5,4,1,3,2,15
191020832,9,1,5,1,8,24
191020833,8,7,4,9,7,35
191020834,2,7,0,3,1,13
191020835,5,2,5,8,5,25
191020836,3,0,6,6,2,17
191020837,1,1,8,5,1,16
191020838,1,0,1,4,0,6
191020839,1,7,7,6,6,27
191020840,4,7,7,5,6,29
191020841,7,8,7,0,2,24
191020842,7,5,4,9,3,28
191020843,2,3,3,2,3,13
191020844,9,6,4,0,7,26
191020845,0,3,3,5,5,16
191020846,3,1,0,1,9,14
191020847,2,6,1,8,7,24
191020848,3,4,4,2,2,15
191020849,6,9,5,7,4,31
191020850,7,1,9,1,5,23
191020851,8,9,6,0,2,25
191020852,9,8,5,3,6,31
191020853,9,2,7,0,3,21
191020854,1,5,4,6,7,23
191020855,6,5,0,5,7,23
191020856,5,7,5,6,1,24
191020857,3,6,3,6,7,25
191020858,5,4,4,7,1,21
191020859,4,8,2,4,1,19
191020860,1,3,6,8,2,20
191020861,0,8,8,4,9,29
191020862,9,7,3,6,0,25
191020863,1,5,4,1,3,14
191020864,3,9,0,9,5,26
191020865,9,2,6,3,4,24
191020866,3,5,9,7,7,31
191020867,5,1,0,0,8,14
191020868,2,2,3,9,7,23
191020869,0,8,7,2,2,19
191020870,5,3,2,3,1,14
191020871,4,5,6,3,4,22
191020872,7,6,3,0,2,18
191020873,3,7,1,5,1,17
191020874,1,2,9,0,0,12
191020875,8,2,7,0,3,20
191020876,2,2,6,5,8,23
191020877,9,6,2,3,3,23
191020878,5,7,0,0,3,15
191020879,6,7,1,8,9,31
191020880,5,1,6,4,4,20
191020881,7,2,3,4,9,25
191020882,5,7,8,1,5,26
191020883,0,2,8,6,7,23
191020884,3,3,0,7,2,15
191020885,8,6,2,9,1,26
191020886,8,9,5,1,2,25
191020887,6,4,7,7,8,32
191020888,3,2,5,1,3,14
191020889,5,3,7,0,2,17
191020890,2,7,0,5,6,20
191020891,3,2,8,6,7,26
191020892,7,8,2,9,2,28
191020893,9,7,8,4,2,30
191020894,0,9,8,7,1,25
191020895,2,1,7,0,7,17
191020896,1,8,1,2,8,20
191020897,8,8,0,3,1,20
191020898,9,8,4,2,8,31
191020899,8,2,4,6,9,29
191020900,5,7,4,6,8,30
191020901,1,1,3,0,5,10
191020902,8,4,4,3,8,27
191020903,9,3,8,3,8,31
191020904,2,9,8,6,6,31
191020905,3,0,5,4,3,15
191020906,2,1,1,9,1,14
191020907,6,8,6,3,7,30
191020908,3,3,9,1,2,18
191020909,9,1,9,8,4,31
191020910,3,7,9,9,2,30
191020911,9,6,9,5,0,29
191020912,7,0,8,1,3,19
191020913,1,5,2,3,5,16
191020914,9,6,2,1,5,23
191020915,3,6,3,8,9,29
191020916,7,8,8,3,9,35
191020917,4,0,5,1,4,14
191020918,1,3,3,3,0,10
191020919,7,0,6,6,2,21
191020920,9,5,3,2,8,27
191020921,2,2,6,7,0,17
191020922,1,9,2,0,4,16
191020923,6,6,3,1,7,23
191020924,1,0,6,5,2,14
191020925,4,2,0,7,2,15
191020926,9,8,5,5,7,34
191020927,0,4,8,1,2,15
191020928,8,7,2,4,2,23
191020929,2,5,9,2,6,24
191020930,3,9,0,6,3,21
191020931,4,1,8,8,7,28
191020932,5,8,4,2,7,26
191020933,6,5,8,7,6,32
191020934,0,6,8,6,1,21
191020935,2,1,1,5,2,11
191020936,3,9,8,1,5,26
191020937,0,4,8,3,4,19
191020938,7,3,5,1,9,25
191020939,0,7,9,3,3,22
191020940,9,4,5,6,1,25
191020941,1,8,4,9,7,29
191020942,3,5,3,3,6,20
191020943,1,2,7,4,1,15
191020944,9,0,3,3,4,19
191020945,2,0,4,3,2,11
191020946,9,5,3,7,6,30
191020947,4,9,5,9,2,29
191020948,5,2,8,0,0,15
191020949,0,0,3,6,8,17
191020950,5,5,4,1,3,18
191020951,5,0,3,9,7,24
191020952,1,1,4,6,1,13
191020953,8,1,9,0,3,21
191020954,7,8,1,6,1,23
191020955,1,3,7,8,7,26
191020956,5,8,1,1,6,21
191020957,7,8,9,0,0,24
191020958,0,2,5,6,5,18
191020959,7,4,8,1,7,27
191020960,8,3,6,8,2,27
191020961,7,9,4,6,2,28
191020962,8,5,2,6,0,21
191020963,9,6,8,2,5,30
191020964,1,2,7,2,4,16
191020965,0,4,8,3,6,21
191020966,7,4,3,9,3,26
191020967,0,9,3,7,9,28
191020968,2,3,4,3,2,14
191020969,4,7,2,3,5,21
191020970,2,8,8,7,8,33
191020971,1,3,4,5,1,14
191020972,7,1,5,7,9,29
191020973,2,3,3,1,8,17
191020974,3,1,2,5,1,12
191020975,0,7,7,1,7,22
191020976,8,2,4,7,3,24
191020977,2,6,2,0,9,19
191020978,9,6,1,9,7,32
191020979,1,0,3,3,1,8
191020980,0,7,5,3,7,22
191020981,0,5,0,6,7,18
191020982,3,9,7,3,8,30
191020983,7,0,4,5,4,20
191020984,0,8,9,4,4,25
191020985,7,3,5,7,0,22
191020986,8,2,3,5,3,21
191020987,7,2,5,4,6,24
191020988,2,9,7,5,9,32
191020989,7,4,0,6,8,25
191020990,2,3,1,0,7,13
191020991,5,6,5,4,0,20
191020992,6,0,1,7,7,21
191020993,0,2,6,3,6,17
191020994,3,8,2,6,6,25
191020995,8,9,3,5,3,28
191020996,3,3,0,4,2,12
191020997,8,7,1,6,7,29
191020998,5,6,0,6,9,26
191020999,6,1,8,7,8,30
1910201000,3,1,6,4,3,17
1910201001,3,4,3,0,2,12
1910201002,3,8,7,3,5,26
1910201003,5,1,0,3,1,10
1910201004,3,1,4,3,1,12
1910201005,4,7,1,2,6,20
1910201006,3,5,8,9,7,32
1910201007,9,4,9,9,5,36
1910201008,5,7,4,6,0,22
1910201009,0,3,9,3,7,22
1910201010,1,5,4,3,9,22
1910201011,0,5,2,4,6,17
1910201012,3,3,9,1,7,23
1910201013,5,2,3,5,2,17
1910201014,4,1,6,3,9,23
1910201015,8,5,3,8,1,25
1910201016,8,4,3,5,7,27
1910201017,2,7,5,7,2,23
1910201018,9,5,3,8,2,27
1910201019,1,0,6,9,7,23
1910201020,1,2,9,7,8,27
1910201021,6,6,9,0,6,27
1910201022,2,1,1,3,3,10
1910201023,9,2,7,9,9,36
1910201024,8,4,3,9,8,32
1910201025,6,6,3,5,3,23
1910201026,8,8,4,8,1,29
1910201027,5,4,8,5,3,25
1910201028,9,1,4,9,3,26
1910201029,6,7,8,3,2,26
1910201030,3,5,2,8,9,27
1910201031,3,4,8,9,9,33
1910201032,7,0,7,1,4,19
1910201033,8,3,2,9,9,31
1910201034,2,5,2,3,6,18
1910201035,2,2,7,5,3,19
1910201036,3,9,5,0,0,17
1910201037,6,8,7,1,6,28
1910201038,6,6,1,2,1,16
1910201039,1,9,6,9,1,26
1910201040,5,8,3,5,4,25
1910201041,4,9,2,1,2,18
1910201042,8,6,4,7,0,25
1910201043,9,6,4,0,5,24
1910201044,3,4,4,5,7,23
1910201045,1,7,6,6,3,23
1910201046,5,1,8,8,3,25
1910201047,1,1,5,7,7,21
1910201048,9,9,4,2,1,25
1910201049,5,4,3,1,2,15
1910201050,2,3,2,8,8,23
1910201051,6,6,6,5,4,27
1910201052,6,1,2,2,6,17
1910201053,7,8,5,9,2,31
1910201054,9,0,1,5,0,15
1910201055,0,1,1,6,2,10
1910201056,8,2,2,8,0,20
1910201057,3,4,4,8,8,27
1910201058,6,3,4,3,7,23
1910201059,0,5,9,6,8,28
1910201060,3,8,6,7,8,32
1910201061,1,5,5,8,5,24
1910201062,6,7,3,4,5,25
1910201063,0,8,7,2,3,20
1910201064,3,0,8,4,7,22
1910201065,4,6,8,8,4,30
1910201066,5,2,6,4,4,21
1910201067,6,3,2,2,0,13
1910201068,4,2,3,5,2,16
1910201069,2,8,4,1,5,20
1910201070,3,4,5,2,8,22
1910201071,4,5,0,4,9,22
1910201072,1,9,1,5,9,25
1910201073,8,2,3,6,8,27
1910201074,1,7,8,3,0,19
1910201075,1,5,2,1,8,17
1910201076,5,6,5,5,6,27
1910201077,9,3,8,7,3,30
1910201078,4,1,2,2,5,14
1910201079,8,2,2,9,7,28
1910201080,5,3,3,6,2,19
1910201081,3,6,1,0,1,11
1910201082,2,9,1,4,1,17
1910201083,5,8,3,2,5,23
1910201084,0,0,2,7,6,15
1910201085,1,8,0,9,7,25
1910201086,9,0,3,7,0,19
1910201087,4,2,9,0,7,22
1910201088,4,0,8,6,9,27
1910201089,7,5,2,7,9,30
1910201090,1,9,6,8,5,29
1910201091,3,6,7,9,0,25
1910201092,7,2,4,9,8,30
1910201093,6,0,7,7,6,26
1910201094,0,7,7,3,3,20
1910201095,5,8,4,8,1,26
1910201096,6,6,9,7,7,35
1910201097,3,2,1,2,0,8
1910201098,1,6,4,8,4,23
1910201099,1,3,9,7,0,20
1910201100,3,1,2,6,9,21
1910201101,5,2,6,3,1,17
1910201102,7,8,3,2,5,25
1910201103,7,6,0,8,0,21
1910201104,1,8,6,6,3,24
1910201105,1,5,1,4,7,18
191021001,9,8,3,3,2,25
191021002,2,0,4,2,2,10
191021003,4,6,9,5,1,25
191021004,4,5,4,2,1,16
191021005,0,0,9,8,4,21
191021006,4,1,5,7,7,24
191021007,1,7,5,1,8,22
191021008,2,9,6,1,9,27
191021009,0,0,2,6,0,8
191021010,5,8,7,0,7,27
191021011,2,2,3,7,6,20
191021012,9,7,5,7,5,33
191021013,3,7,8,8,3,29
191021014,4,2,6,5,6,23
191021015,2,5,6,1,1,15
191021016,5,0,8,1,5,19
191021017,4,6,8,9,5,32
191021018,4,2,4,3,1,14
191021019,7,5,8,2,0,22
191021020,0,8,2,6,7,23
191021021,1,8,8,5,4,26
191021022,1,4,9,7,2,23
191021023,6,3,3,6,2,20
191021024,1,6,5,1,9,22
191021025,8,5,4,6,6,29
191021026,8,2,5,9,9,33
191021027,8,9,1,4,7,29
191021028,6,3,8,5,3,25
191021029,9,0,1,1,7,18
191021030,1,4,0,4,2,11
191021031,8,5,8,3,5,29
191021032,1,1,4,1,3,10
191021033,5,4,5,2,7,23
191021034,1,7,3,8,7,26
191021035,8,6,4,9,2,29
191021036,3,7,4,5,3,22
191021037,7,4,6,5,0,22
191021038,4,5,7,1,1,18
191021039,8,4,2,1,7,22
191021040,9,9,8,2,3,31
191021041,1,1,3,8,4,17
191021042,1,6,1,4,4,16
191021043,1,6,4,7,2,20
191021044,2,8,8,8,4,30
191021045,3,0,3,2,5,13
191021046,5,5,2,7,5,24
191021047,8,5,5,1,9,28
191021048,6,2,9,3,0,20
191021049,5,8,7,3,5,28
191021050,9,3,6,8,3,29
191021051,0,4,7,3,6,20
191021052,0,1,0,0,1,2
191021053,6,4,0,5,4,19
191021054,1,2,1,3,9,16
191021055,9,7,0,8,4,28
191021056,0,5,6,4,7,22
191021057,8,1,2,9,6,26
191021058,2,4,5,7,1,19
191021059,2,6,6,6,0,20
191021060,6,6,2,7,7,28
191021061,8,4,2,4,9,27
191021062,1,7,6,2,2,18
191021063,0,8,0,5,6,19
191021064,6,8,4,0,8,26
191021065,9,5,0,1,9,24
191021066,1,4,8,8,1,22
191021067,6,5,4,1,9,25
191021068,3,4,0,4,7,18
191021069,4,0,9,0,7,20
191021070,2,0,3,2,6,13
191021071,0,6,5,5,5,21
191021072,8,7,4,4,7,30
191021073,3,3,6,4,5,21
191021074,6,1,9,0,5,21
191021075,0,6,5,7,6,24
191021076,3,9,2,9,1,24
191021077,8,2,5,1,4,20
191021078,7,7,1,1,6,22
191021079,4,9,5,0,0,18
191021080,2,4,6,3,1,16
191021081,9,0,1,5,1,16
191021082,3,0,4,6,8,21
191021083,4,7,4,7,7,29
191021084,3,8,9,6,1,27
191021085,0,4,9,0,5,18
191021086,2,5,9,3,7,26
191021087,0,5,2,8,1,16
191021088,2,6,5,3,9,25
191021089,0,1,5,1,1,8
191021090,4,2,9,8,2,25
191021091,8,5,4,7,1,25
191021092,4,7,1,9,7,28
191021093,5,7,3,7,9,31
191021094,8,4,8,1,9,30
191021095,8,3,2,5,2,20
191021096,6,7,6,0,9,28
191021097,7,1,1,8,2,19
191021098,6,9,7,7,9,38
191021099,1,2,1,8,3,15
191021100,5,1,8,3,6,23
191021101,5,4,7,8,9,33
191021102,1,6,9,4,1,21
191021103,0,7,9,8,2,26
191021104,6,5,7,1,9,28
191021105,2,8,9,1,6,26
191021106,0,7,2,5,9,23
191021107,9,3,4,7,6,29
191021108,4,2,6,7,9,28
191021109,1,0,8,5,9,23
191021110,5,2,5,6,0,18
191021111,9,4,4,3,5,25
191021112,6,0,1,6,7,20
191021113,9,7,5,9,7,37
191021114,4,6,8,9,1,28
191021115,1,0,9,2,2,14
191021116,7,9,0,6,1,23
191021117,8,9,6,8,4,35
191021118,1,4,5,6,8,24
191021119,6,1,4,2,5,18
191021120,0,3,9,7,1,20
191021121,3,4,4,1,4,16
191021122,9,6,5,9,1,30
191021123,2,5,2,1,2,12
191021124,8,7,1,8,1,25
191021125,4,1,8,5,4,22
191021126,7,0,6,1,7,21
191021127,1,4,0,1,3,9
191021128,1,8,4,4,5,22
191021129,9,3,6,2,2,22
191021130,6,5,5,8,8,32
191021131,9,8,0,3,4,24
191021132,6,8,2,4,3,23
191021133,2,8,5,5,6,26
191021134,1,7,9,7,9,33
191021135,2,1,6,6,5,20
191021136,4,3,9,3,2,21
191021137,2,4,5,0,7,18
191021138,0,8,9,5,5,27
191021139,8,8,7,5,0,28
191021140,7,0,0,1,6,14
191021141,4,2,8,4,9,27
191021142,4,7,2,7,2,22
191021143,4,3,8,2,1,18
191021144,3,4,9,9,5,30
191021145,2,5,7,8,1,23
191021146,3,9,5,0,9,26
191021147,2,6,9,2,5,24
191021148,7,8,3,9,7,34
191021149,2,6,8,5,2,23
191021150,0,5,8,5,3,21
191021151,1,0,4,8,2,15
191021152,8,2,7,6,8,31
191021153,5,9,5,1,3,23
191021154,1,1,3,3,8,16
191021155,9,7,4,8,5,33
191021156,6,1,1,9,2,19
191021157,1,0,8,5,0,14
191021158,4,6,6,4,9,29
191021159,5,5,4,6,2,22
191021160,2,5,1,4,6,18
191021161,1,3,6,1,8,19
191021162,3,9,4,2,5,23
191021163,6,9,9,4,1,29
191021164,8,4,6,3,8,29
191021165,0,5,5,5,6,21
191021166,8,4,9,7,6,34
191021167,0,1,8,1,4,14
191021168,8,3,1,9,3,24
191021169,4,3,4,7,5,23
191021170,3,7,0,9,6,25
191021171,2,5,6,7,6,26
191021172,9,7,9,1,2,28
191021173,4,8,2,9,1,24
191021174,1,2,2,4,4,13
191021175,2,9,1,2,8,22
191021176,8,3,2,8,5,26
191021177,1,7,1,6,0,15
191021178,3,3,7,2,1,16
191021179,9,6,8,0,7,30
191021180,9,1,3,2,5,20
191021181,2,8,2,5,8,25
191021182,6,2,2,6,0,16
191021183,5,7,7,9,6,34
191021184,0,9,0,2,1,12
191021185,8,6,6,8,5,33
191021186,3,9,8,5,3,28
191021187,1,6,4,3,3,17
191021188,7,5,1,1,8,22
191021189,5,4,9,7,8,33
191021190,8,3,9,3,9,32
191021191,1,5,9,2,9,26
191021192,2,7,2,8,0,19
191021193,5,2,0,4,4,15
191021194,1,7,7,7,5,27
191021195,0,0,9,0,5,14
191021196,7,8,7,7,7,36
191021197,2,6,9,4,6,27
191021198,0,4,8,0,3,15
191021199,5,3,5,7,9,29
191021200,2,0,8,1,5,16
191021201,4,2,2,3,9,20
191021202,9,7,1,0,7,24
191021203,6,2,1,7,9,25
191021204,7,4,1,9,7,28
191021205,7,6,0,2,4,19
191021206,4,1,6,2,0,13
191021207,6,4,2,9,2,23
191021208,7,5,5,0,4,21
191021209,4,3,3,0,4,14
191021210,2,4,5,7,0,18
191021211,1,0,9,9,2,21
191021212,2,5,3,9,5,24
191021213,0,3,5,7,6,21
191021214,5,6,1,5,2,19
191021215,7,7,5,4,4,27
191021216,4,7,1,3,7,22
191021217,3,8,1,1,3,16
191021218,0,0,4,6,9,19
191021219,4,7,3,0,4,18
191021220,9,4,0,2,2,17
191021221,8,1,2,2,5,18
191021222,3,3,9,5,5,25
191021223,9,2,9,9,6,35
191021224,9,6,2,7,8,32
191021225,4,7,3,4,3,21
191021226,8,7,6,9,2,32
191021227,3,2,2,7,7,21
191021228,2,6,4,2,2,16
191021229,9,9,3,3,1,25
191021230,9,7,9,8,3,36
191021231,3,7,6,4,0,20
191021232,8,2,1,4,8,23
191021233,8,5,4,9,8,34
191021234,4,7,1,7,1,20
191021235,3,4,7,2,0,16
191021236,7,5,1,0,3,16
191021237,4,6,2,7,4,23
191021238,3,7,1,1,5,17
191021239,5,4,1,3,9,22
191021240,8,3,1,0,0,12
191021241,6,6,9,1,8,30
191021242,8,4,5,8,2,27
191021243,2,8,7,2,4,23
191021244,7,8,3,4,6,28
191021245,6,5,3,1,5,20
191021246,8,1,4,1,2,16
191021247,2,3,9,8,9,31
191021248,9,0,6,3,4,22
191021249,0,4,1,1,6,12
191021250,1,6,3,5,9,24
191021251,1,9,1,5,4,20
191021252,1,4,9,0,9,23
191021253,5,9,7,0,1,22
191021254,5,3,7,2,1,18
191021255,4,6,2,8,0,20
191021256,0,2,5,8,5,20
191021257,7,6,1,6,6,26
191021258,4,9,5,0,1,19
191021259,1,6,2,1,9,19
191021260,1,3,3,3,3,13
191021261,6,7,5,0,9,27
191021262,3,1,6,0,6,16
191021263,8,7,1,9,2,27
191021264,4,0,6,9,7,26
191021265,7,2,7,4,2,22
191021266,9,6,0,3,1,19
191021267,0,5,6,2,5,18
191021268,9,6,5,3,7,30
191021269,6,2,3,4,8,23
191021270,0,6,5,8,7,26
191021271,1,2,2,8,8,21
191021272,8,7,6,3,8,32
191021273,0,1,1,2,9,13
191021274,5,0,5,1,8,19
191021275,5,7,3,7,8,30
191021276,7,4,4,8,7,30
191021277,0,5,8,1,9,23
191021278,3,8,2,0,1,14
191021279,6,6,1,5,4,22
191021280,8,5,2,3,4,22
191021281,8,2,9,5,2,26
191021282,4,6,7,0,1,18
191021283,8,8,6,2,9,33
191021284,6,2,1,7,0,16
191021285,0,4,7,6,1,18
191021286,7,4,9,5,9,34
191021287,9,3,5,7,5,29
191021288,1,4,3,0,4,12
191021289,9,2,5,2,6,24
191021290,3,4,1,4,5,17
191021291,1,4,8,4,7,24
191021292,0,0,5,6,2,13
191021293,4,5,2,4,0,15
191021294,8,7,4,9,9,37
191021295,3,9,4,2,2,20
191021296,2,7,2,8,7,26
191021297,5,7,0,7,9,28
191021298,4,8,9,9,2,32
191021299,5,2,4,2,7,20
191021300,8,4,5,3,5,25
191021301,5,7,8,4,7,31
191021302,7,0,2,7,0,16
191021303,0,2,4,6,9,21
191021304,6,4,8,2,1,21
191021305,6,4,1,9,6,26
191021306,8,2,8,6,1,25
191021307,2,8,5,4,1,20
191021308,8,9,6,4,2,29
191021309,3,1,1,6,0,11
191021310,8,6,3,0,1,18
191021311,4,9,0,6,2,21
191021312,3,1,7,3,5,19
191021313,5,1,2,1,5,14
191021314,2,2,2,2,0,8
191021315,9,7,9,2,1,28
191021316,5,8,8,6,0,27
191021317,4,0,7,4,9,24
191021318,4,8,7,9,9,37
191021319,6,2,5,7,3,23
191021320,5,0,7,7,8,27
191021321,8,4,0,4,1,17
191021322,6,5,2,2,0,15
191021323,3,7,9,7,7,33
191021324,8,5,2,1,6,22
191021325,1,3,1,8,6,19
191021326,4,9,9,6,9,37
191021327,7,1,3,1,1,13
191021328,2,4,5,6,6,23
191021329,4,8,0,7,8,27
191021330,0,1,3,9,9,22
191021331,8,9,7,2,3,29
191021332,2,0,3,2,4,11
191021333,8,1,3,5,1,18
191021334,6,2,2,5,1,16
191021335,8,2,8,1,5,24
191021336,9,2,2,8,7,28
191021337,2,6,7,1,2,18
191021338,5,1,1,8,1,16
191021339,1,9,4,5,0,19
191021340,0,5,9,2,8,24
191021341,9,0,9,4,5,27
191021342,5,9,1,2,7,24
191021343,7,9,9,3,9,37
191021344,8,8,5,3,5,29
191021345,9,3,1,5,8,26
191021346,6,6,3,2,0,17
191021347,3,7,1,4,9,24
191021348,5,5,8,5,9,32
191021349,7,5,5,2,2,21
191021350,4,8,0,1,5,18
191021351,0,1,5,6,1,13
191021352,0,7,6,8,6,27
191021353,1,4,2,3,3,13
191021354,8,4,8,6,4,30
191021355,0,0,2,5,7,14
191021356,8,2,3,5,5,23
191021357,1,0,6,2,2,11
191021358,3,2,3,3,8,19
191021359,1,8,3,7,8,27
191021360,6,1,6,4,9,26
191021361,5,1,0,4,0,10
191021362,2,8,7,6,3,26
191021363,6,1,4,8,5,24
191021364,2,5,7,5,7,26
191021365,0,1,5,2,3,11
191021366,8,8,6,0,7,29
191021367,8,4,2,9,1,24
191021368,2,4,4,6,0,16
191021369,9,4,4,7,2,26
191021370,8,8,7,9,9,41
191021371,6,1,6,3,1,17
191021372,7,2,3,7,0,19
191021373,3,0,6,5,0,14
191021374,9,8,5,7,6,35
191021375,0,3,8,5,0,16
191021376,4,8,7,3,7,29
191021377,5,6,1,6,9,27
191021378,6,5,9,3,8,31
191021379,0,3,4,9,3,19
191021380,8,5,5,7,2,27
191021381,3,1,0,9,2,15
191021382,8,2,6,3,6,25
191021383,1,5,2,9,8,25
191021384,9,7,0,7,0,23
191021385,2,0,9,9,1,21
191021386,7,4,9,1,9,30
191021387,7,1,7,8,5,28
191021388,0,2,3,5,9,19
191021389,7,8,5,1,1,22
191021390,8,3,2,7,4,24
191021391,7,4,0,8,3,22
191021392,0,2,9,5,2,18
191021393,1,5,6,8,2,22
191021394,9,4,9,0,2,24
191021395,1,7,0,9,0,17
191021396,5,3,8,7,8,31
191021397,8,5,0,4,2,19
191021398,5,4,6,7,0,22
191021399,0,7,1,3,8,19
191021400,6,1,5,3,3,18
191021401,6,7,9,3,8,33
191021402,2,2,9,1,8,22
191021403,7,5,4,9,8,33
191021404,8,6,2,4,7,27
191021405,9,3,2,2,1,17
191021406,1,0,5,4,8,18
191021407,1,1,0,3,8,13
191021408,8,4,5,8,1,26
191021409,1,4,2,1,3,11
191021410,4,4,6,4,6,24
191021411,5,2,0,8,1,16
191021412,9,4,4,6,1,24
191021413,5,6,6,3,9,29
191021414,4,3,9,5,7,28
191021415,6,4,5,1,7,23
191021416,3,6,8,9,6,32
191021417,1,5,2,7,2,17
191021418,6,2,8,3,2,21
191021419,1,1,2,0,2,6
191021420,1,7,1,4,3,16
191021421,8,7,6,0,8,29
191021422,4,9,4,5,8,30
191021423,3,7,4,4,3,21
191021424,0,6,4,6,2,18
191021425,1,3,9,3,8,24
191021426,7,7,0,3,5,22
191021427,6,1,6,1,9,23
191021428,0,8,2,9,0,19
191021429,4,7,3,5,9,28
191021430,1,9,4,7,9,30
191021431,7,8,3,6,1,25
191021432,2,5,0,1,3,11
191021433,8,6,0,2,8,24
191021434,2,0,2,8,9,21
191021435,1,5,5,4,2,17
191021436,9,5,9,0,2,25
191021437,7,5,9,4,8,33
191021438,7,1,6,3,2,19
191021439,4,7,5,6,0,22
191021440,9,8,2,7,2,28
191021441,1,1,9,7,8,26
191021442,4,4,9,4,4,25
191021443,8,1,3,7,3,22
191021444,7,2,3,5,8,25
191021445,6,6,4,7,0,23
191021446,6,6,4,4,9,29
191021447,8,3,0,1,5,17
191021448,6,8,8,5,3,30
191021449,2,6,6,9,0,23
191021450,9,7,2,3,1,22
191021451,6,5,4,5,4,24
191021452,8,5,1,5,6,25
191021453,4,6,8,2,0,20
191021454,8,8,7,5,3,31
191021455,7,8,7,4,8,34
191021456,3,7,2,6,9,27
191021457,2,0,4,3,9,18
191021458,4,8,1,2,9,24
191021459,3,4,8,6,9,30
191021460,0,1,2,8,1,12
191021461,9,9,0,5,2,25
191021462,3,5,3,4,9,24
191021463,4,7,4,6,9,30
191021464,8,7,5,8,0,28
191021465,1,7,3,3,1,15
191021466,4,1,8,4,4,21
191021467,8,1,8,7,2,26
191021468,9,5,7,6,8,35
191021469,3,1,6,9,0,19
191021470,8,4,8,2,2,24
191021471,5,6,4,6,1,22
191021472,7,3,1,0,5,16
191021473,6,5,4,2,6,23
191021474,9,7,0,6,6,28
191021475,2,2,2,1,8,15
191021476,9,8,5,6,9,37
191021477,2,1,9,0,3,15
191021478,9,7,3,3,2,24
191021479,9,5,5,7,9,35
191021480,0,8,1,1,6,16
191021481,7,4,7,4,6,28
191021482,4,0,7,3,1,15
191021483,4,7,1,1,5,18
191021484,6,8,5,4,7,30
191021485,9,2,3,2,6,22
191021486,0,8,3,8,1,20
191021487,9,1,0,7,7,24
191021488,0,2,3,0,4,9
191021489,1,5,5,7,0,18
191021490,8,7,6,6,9,36
191021491,2,0,1,2,9,14
191021492,4,6,2,7,5,24
191021493,7,2,0,9,6,24
191021494,6,3,7,1,1,18
191021495,6,9,9,4,2,30
191021496,6,3,7,4,6,26
191021497,1,0,7,1,9,18
191021498,1,0,2,3,4,10
191021499,9,1,4,4,8,26
191021500,6,0,5,1,4,16
191021501,3,1,9,7,3,23
191021502,8,4,2,2,2,18
191021503,1,9,0,2,9,21
191021504,7,5,8,6,2,28
191021505,8,5,1,5,4,23
191021506,9,0,6,0,0,15
191021507,8,9,4,2,7,30
191021508,3,7,1,8,2,21
191021509,3,5,1,0,0,9
191021510,8,5,0,3,6,22
191021511,3,7,1,3,5,19
191021512,3,1,6,3,1,14
191021513,5,6,0,7,0,18
191021514,0,7,3,4,2,16
191021515,9,8,0,0,6,23
191021516,1,2,7,3,8,21
191021517,3,9,6,6,8,32
191021518,3,5,8,0,8,24
191021519,1,1,8,6,8,24
191021520,3,8,6,0,8,25
191021521,6,3,4,4,3,20
191021522,9,9,2,6,5,31
191021523,1,3,8,8,5,25
191021524,5,0,5,9,5,24
191021525,9,8,4,0,0,21
191021526,7,9,3,6,5,30
191021527,4,1,7,3,1,16
191021528,5,0,9,8,3,25
191021529,7,8,0,7,5,27
191021530,5,5,0,8,0,18
191021531,2,3,0,1,2,8
191021532,8,7,3,0,5,23
191021533,9,2,5,2,8,26
191021534,1,1,6,0,0,8
191021535,8,0,4,9,6,27
191021536,5,9,2,9,8,33
191021537,4,3,6,2,2,17
191021538,8,9,4,9,9,39
191021539,9,9,8,5,9,40
191021540,2,0,1,0,1,4
191021541,5,2,9,4,8,28
191021542,9,2,7,9,8,35
191021543,0,2,2,5,5,14
191021544,7,1,0,0,3,11
191021545,7,1,0,8,3,19
191021546,7,7,8,5,0,27
191021547,0,3,4,4,1,12
191021548,0,0,2,1,4,7
191021549,3,2,7,2,4,18
191021550,6,9,7,7,6,35
191021551,6,9,0,4,2,21
191021552,4,8,2,2,7,23
191021553,2,5,7,5,8,27
191021554,3,7,4,6,4,24
191021555,9,5,2,5,4,25
191021556,6,8,7,4,6,31
191021557,7,2,2,3,8,22
191021558,9,3,4,2,5,23
191021559,2,0,3,0,4,9
191021560,1,8,9,4,5,27
191021561,6,7,8,3,6,30
191021562,8,4,3,6,7,28
191021563,2,3,5,8,8,26
191021564,7,0,9,1,4,21
191021565,1,2,7,6,1,17
191021566,0,2,3,8,0,13
191021567,7,4,1,9,4,25
191021568,6,0,5,2,1,14
191021569,5,9,3,2,5,24
191021570,6,4,6,0,7,23
191021571,8,4,0,1,3,16
191021572,0,5,2,4,7,18
191021573,8,0,5,9,4,26
191021574,6,5,9,3,2,25
191021575,8,0,3,1,4,16
191021576,6,7,4,6,0,23
191021577,1,4,6,2,1,14
191021578,5,2,7,5,4,23
191021579,2,2,3,3,3,13
191021580,3,3,7,4,9,26
191021581,1,9,7,7,2,26
191021582,0,3,5,6,8,22
191021583,5,6,3,7,2,23
191021584,7,1,8,8,1,25
191021585,2,4,3,0,9,18
191021586,8,9,0,6,6,29
191021587,3,9,3,8,6,29
191021588,8,1,1,9,5,24
191021589,9,0,3,9,9,30
191021590,9,9,3,2,2,25
191021591,4,2,5,5,3,19
191021592,7,3,2,6,0,18
191021593,8,5,5,6,0,24
191021594,4,7,6,4,1,22
191021595,9,4,8,7,7,35
191021596,8,3,7,2,6,26
191021597,4,3,3,9,7,26
191021598,0,8,7,5,1,21
191021599,8,4,8,1,8,29
191021600,4,0,3,5,8,20
191021601,9,9,7,6,0,31
191021602,8,7,1,1,3,20
191021603,6,8,5,6,1,26
191021604,5,7,1,0,7,20
191021605,5,3,8,8,0,24
191021606,0,9,6,7,2,24
191021607,9,5,3,1,6,24
191021608,6,1,1,6,8,22
191021609,4,7,5,8,6,30
191021610,4,8,6,5,8,31
191021611,3,7,7,7,1,25
191021612,5,3,6,9,8,31
191021613,8,9,6,1,0,24
191021614,5,4,8,5,1,23
191021615,1,8,3,3,0,15
191021616,5,8,8,3,7,31
191021617,1,5,7,3,8,24
191021618,3,4,2,6,6,21
191021619,3,2,2,1,6,14
191021620,4,8,2,8,5,27
191021621,5,3,2,0,7,17
191021622,7,2,1,1,6,17
191021623,5,9,3,3,0,20
191021624,9,6,8,3,3,29
191021625,9,1,2,1,8,21
191021626,7,7,7,8,9,38
191021627,8,9,6,2,7,32
191021628,8,5,4,7,7,31
191021629,0,2,7,3,7,19
191021630,9,0,2,3,7,21
191021631,4,4,4,7,6,25
191021632,0,2,8,1,8,19
191021633,8,4,0,1,9,22
191021634,4,3,7,2,0,16
191021635,8,5,9,1,7,30
191021636,1,2,7,8,2,20
191021637,4,0,6,6,4,20
191021638,6,4,8,3,6,27
191021639,5,7,9,1,4,26
191021640,6,3,1,8,4,22
191021641,6,5,8,7,8,34
191021642,3,2,1,4,1,11
191021643,5,9,4,0,1,19
191021644,8,2,6,8,5,29
191021645,4,2,8,4,7,25
191021646,5,9,8,7,0,29
191021647,4,8,4,0,0,16
191021648,0,6,6,7,2,21
191021649,5,3,3,3,6,20
191021650,4,3,6,6,4,23
191021651,0,3,4,7,6,20
191021652,1,5,3,4,3,16
191021653,2,2,9,6,5,24
191021654,4,2,7,1,4,18
191021655,8,2,1,3,9,23
191021656,6,8,7,7,5,33
191021657,1,6,6,0,3,16
191021658,4,6,0,4,5,19
191021659,7,7,6,1,1,22
191021660,7,1,8,3,1,20
191021661,6,1,1,6,0,14
191021662,2,6,8,4,9,29
191021663,0,6,4,1,5,16
191021664,4,4,3,8,6,25
191021665,4,0,6,5,3,18
191021666,8,9,8,1,7,33
191021667,8,0,9,9,7,33
191021668,0,7,7,7,6,27
191021669,3,0,3,7,8,21
191021670,0,7,9,8,4,28
191021671,3,6,4,1,6,20
191021672,5,1,2,6,7,21
191021673,3,2,8,6,6,25
191021674,5,8,9,5,4,31
191021675,5,5,5,5,4,24
191021676,6,8,0,9,6,29
191021677,4,1,2,7,2,16
191021678,7,3,4,3,8,25
191021679,0,6,0,2,5,13
191021680,5,4,5,1,5,20
191021681,0,1,9,5,6,21
191021682,0,6,6,4,0,16
191021683,3,3,6,7,4,23
191021684,2,7,4,0,6,19
191021685,3,4,3,8,1,19
191021686,8,8,3,4,0,23
191021687,1,2,8,3,1,15
191021688,2,4,9,6,4,25
191021689,8,5,1,4,6,24
191021690,2,5,1,1,3,12
191021691,6,2,9,5,3,25
191021692,0,1,9,8,4,22
191021693,3,5,9,4,5,26
191021694,3,5,9,0,9,26
191021695,2,6,9,2,9,28
191021696,4,6,1,7,3,21
191021697,0,6,7,6,9,28
191021698,0,9,4,1,7,21
191021699,8,6,1,4,6,25
191021700,6,1,4,3,5,19
191021701,5,6,4,3,9,27
191021702,2,8,3,0,5,18
191021703,7,8,0,1,3,19
191021704,9,1,2,2,6,20
191021705,3,8,7,7,0,25
191021706,2,9,4,9,0,24
191021707,6,6,5,6,8,31
191021708,2,4,7,6,7,26
191021709,6,9,1,8,6,30
191021710,6,7,6,3,6,28
191021711,5,7,9,5,7,33
191021712,4,5,4,1,3,17
191021713,3,8,0,1,0,12
191021714,0,3,4,9,1,17
191021715,0,1,0,1,1,3
191021716,6,0,7,6,8,27
191021717,9,6,9,2,2,28
191021718,3,2,4,0,1,10
191021719,1,7,6,6,9,29
191021720,9,4,7,9,2,31
191021721,6,2,8,8,1,25
191021722,9,7,4,8,8,36
191021723,7,7,7,2,0,23
191021724,5,0,0,5,7,17
191021725,3,2,1,5,5,16
191021726,7,0,1,9,4,21
191021727,9,0,9,3,0,21
191021728,4,0,7,8,3,22
191021729,7,6,9,9,7,38
191021730,2,5,5,4,5,21
191021731,3,2,6,8,2,21
191021732,8,9,1,6,2,26
191021733,6,6,9,2,7,30
191021734,6,9,1,5,3,24
191021735,2,9,7,0,9,27
191021736,5,1,8,5,9,28
191021737,7,6,8,1,2,24
191021738,4,5,4,9,9,31
191021739,3,0,9,2,7,21
191021740,9,4,7,7,3,30
191021741,9,2,1,9,3,24
191021742,8,7,5,5,7,32
191021743,6,2,9,0,8,25
191021744,2,2,9,9,4,26
191021745,5,6,6,5,7,29
191021746,8,0,8,3,6,25
191021747,4,8,8,5,5,30
191021748,1,6,1,3,0,11
191021749,3,8,9,8,8,36
191021750,1,0,0,6,5,12
191021751,7,6,2,4,3,22
191021752,6,7,7,1,5,26
191021753,8,6,6,1,7,28
191021754,2,0,2,9,9,22
191021755,3,9,6,9,7,34
191021756,4,5,3,2,7,21
191021757,7,4,1,2,8,22
191021758,3,1,2,2,5,13
191021759,4,3,4,0,8,19
191021760,3,6,2,7,0,18
191021761,7,9,1,0,8,25
191021762,1,5,2,5,8,21
191021763,3,1,6,1,5,16
191021764,1,0,2,5,3,11
191021765,0,5,8,7,6,26
191021766,3,9,1,7,8,28
191021767,5,5,2,3,0,15
191021768,4,1,7,7,8,27
191021769,8,2,8,6,4,28
191021770,7,6,6,3,9,31
191021771,9,3,9,4,8,33
191021772,4,9,9,8,7,37
191021773,3,8,5,1,5,22
191021774,6,4,1,8,8,27
191021775,6,7,3,4,1,21
191021776,2,2,9,8,1,22
191021777,8,6,9,2,7,32
191021778,9,7,4,7,3,30
191021779,5,5,8,4,4,26
191021780,5,1,3,2,9,20
191021781,0,3,7,0,4,14
191021782,0,3,3,1,9,16
191021783,9,2,3,0,7,21
191021784,4,2,6,5,3,20
191021785,5,4,8,0,4,21
191021786,0,0,1,2,8,11
191021787,4,4,2,4,5,19
191021788,4,8,5,5,4,26
191021789,2,2,4,8,1,17
191021790,4,8,6,6,4,28
191021791,2,1,2,8,1,14
191021792,2,6,1,3,9,21
191021793,7,0,7,7,9,30
191021794,0,8,6,4,9,27
191021795,1,4,1,6,9,21
191021796,1,5,7,8,8,29
191021797,9,8,7,6,4,34
191021798,6,9,8,3,6,32
191021799,8,1,0,1,2,12
191021800,4,4,5,3,0,16
191021801,8,9,4,3,4,28
191021802,3,9,3,5,6,26
191021803,0,2,3,1,7,13
191021804,2,3,6,2,4,17
191021805,7,4,5,5,4,25
191021806,4,1,0,5,5,15
191021807,1,5,5,4,0,15
191021808,2,4,0,6,2,14
191021809,3,6,4,0,7,20
191021810,4,2,7,6,8,27
191021811,1,5,7,8,9,30
191021812,4,5,0,2,6,17
191021813,3,7,7,2,0,19
191021814,0,3,2,4,0,9
191021815,6,0,7,2,9,24
191021816,6,0,3,6,1,16
191021817,1,0,1,1,4,7
191021818,3,4,9,6,1,23
191021819,1,6,0,1,1,9
191021820,0,6,0,6,4,16
191021821,9,1,0,8,9,27
191021822,7,4,1,4,8,24
191021823,6,5,0,9,4,24
191021824,8,2,8,9,6,33
191021825,1,9,0,8,2,20
191021826,3,4,4,2,0,13
191021827,4,5,7,3,3,22
191021828,8,0,7,2,0,17
191021829,3,4,4,9,5,25
191021830,1,4,8,1,7,21
191021831,5,9,5,2,1,22
191021832,1,1,2,7,8,19
191021833,6,8,3,7,9,33
191021834,8,8,1,5,0,22
191021835,4,0,0,8,6,18
191021836,8,8,7,2,5,30
191021837,8,2,7,8,7,32
191021838,0,3,6,1,6,16
191021839,0,5,9,0,5,19
191021840,6,7,1,8,3,25
191021841,1,2,3,4,5,15
191021842,5,4,6,0,0,15
191021843,2,7,0,3,4,16
191021844,8,1,9,3,8,29
191021845,3,4,0,7,9,23
191021846,4,4,2,3,9,22
191021847,3,9,2,8,5,27
191021848,7,3,1,1,3,15
191021849,6,3,0,1,9,19
191021850,8,9,4,4,8,33
191021851,3,9,1,7,1,21
191021852,0,1,0,8,9,18
191021853,6,7,2,6,5,26
191021854,3,2,4,0,7,16
191021855,5,3,7,2,0,17
191021856,5,8,4,6,7,30
191021857,2,1,4,0,7,14
191021858,3,9,5,0,7,24
191021859,1,1,5,6,1,14
191021860,6,5,7,4,5,27
191021861,4,4,2,3,1,14
191021862,4,3,8,0,2,17
191021863,6,9,8,2,0,25
191021864,1,6,4,0,7,18
191021865,2,7,8,5,3,25
191021866,6,5,2,3,1,17
191021867,1,5,2,9,5,22
191021868,0,2,5,2,6,15
191021869,2,6,9,3,2,22
191021870,4,8,7,5,9,33
191021871,7,2,9,6,4,28
191021872,5,2,3,3,5,18
191021873,7,2,0,8,7,24
191021874,2,0,7,9,7,25
191021875,9,0,4,9,2,24
191021876,4,9,5,0,3,21
191021877,0,1,4,0,8,13
191021878,1,6,2,4,3,16
191021879,7,5,6,9,3,30
191021880,3,8,3,0,2,16
191021881,1,8,5,9,1,24
191021882,1,1,7,7,5,21
191021883,9,6,5,3,4,27
191021884,9,3,4,8,7,31
191021885,2,7,3,8,3,23
191021886,7,8,5,2,1,23
191021887,1,0,3,0,8,12
191021888,0,6,2,3,6,17
191021889,2,6,7,5,3,23
191021890,0,6,0,9,5,20
191021891,1,1,6,2,7,17
191021892,3,1,5,6,0,15
191021893,7,5,0,5,4,21
191021894,1,4,1,7,0,13
191021895,8,7,1,0,5,21
191021896,3,5,3,4,5,20
191021897,8,2,2,9,3,24
191021898,5,1,8,6,9,29
191021899,7,9,8,7,8,39
191021900,3,5,7,0,0,15
191021901,7,2,3,7,4,23
191021902,8,5,8,1,3,25
191021903,9,2,7,9,0,27
191021904,4,8,6,9,9,36
191021905,6,0,9,1,2,18
191021906,9,8,4,1,2,24
191021907,2,0,5,6,7,20
191021908,6,8,9,8,1,32
191021909,2,8,5,9,0,24
191021910,2,2,7,5,1,17
191021911,7,1,9,3,0,20
191021912,5,9,9,8,2,33
191021913,4,8,4,1,4,21
191021914,2,4,4,8,0,18
191021915,9,5,3,2,3,22
191021916,7,0,9,8,3,27
191021917,4,1,6,9,3,23
191021918,7,8,2,4,8,29
191021919,5,7,6,8,2,28
191021920,6,1,3,4,1,15
191021921,2,4,6,5,3,20
191021922,2,5,9,6,6,28
191021923,1,0,2,8,2,13
191021924,4,2,4,0,7,17
191021925,8,9,4,6,9,36
191021926,6,8,6,9,0,29
191021927,6,4,8,4,4,26
191021928,8,9,3,8,5,33
191021929,9,0,3,2,6,20
191021930,5,0,2,2,2,11
191021931,3,3,7,3,1,17
191021932,7,1,4,2,5,19
191021933,6,4,1,0,6,17
191021934,7,3,4,3,0,17
191021935,0,4,3,2,5,14
191021936,9,5,3,6,0,23
191021937,3,1,3,3,6,16
191021938,9,8,9,2,6,34
191021939,1,9,8,0,1,19
191021940,8,0,3,9,5,25
191021941,7,1,8,6,5,27
191021942,8,3,4,2,8,25
191021943,0,6,8,9,0,23
191021944,5,3,8,9,8,33
191021945,4,7,3,4,4,22
191021946,6,8,6,4,2,26
191021947,3,7,4,9,9,32
191021948,1,6,7,4,3,21
191021949,3,7,5,2,9,26
191021950,2,8,0,5,0,15
191021951,7,6,7,1,0,21
191021952,0,7,3,5,2,17
191021953,7,0,5,4,6,22
191021954,5,0,4,5,9,23
191021955,3,3,7,6,8,27
191021956,6,4,7,6,1,24
191021957,9,7,9,2,7,34
191021958,8,3,3,0,0,14
191021959,2,4,3,3,2,14
191021960,5,4,9,2,3,23
191021961,6,4,7,9,9,35
191021962,3,2,0,2,9,16
191021963,6,7,1,9,9,32
191021964,3,3,9,0,0,15
191021965,3,5,9,2,9,28
191021966,6,4,9,7,4,30
191021967,1,5,8,4,2,20
191021968,3,7,6,1,4,21
191021969,2,5,8,2,2,19
191021970,0,9,7,4,6,26
191021971,5,5,0,7,2,19
191021972,7,3,1,8,9,28
191021973,6,7,1,5,9,28
191021974,0,0,8,4,3,15
191021975,3,1,2,0,3,9
191021976,6,2,4,0,9,21
191021977,9,4,5,5,5,28
191021978,6,3,1,7,4,21
191021979,3,6,6,0,8,23
191021980,0,5,5,5,0,15
191021981,1,6,5,6,8,26
191021982,6,8,3,8,3,28
191021983,4,2,2,5,5,18
191021984,5,0,8,3,1,17
191021985,3,3,7,9,4,26
191021986,2,7,3,2,6,20
191021987,6,4,9,3,1,23
191021988,3,3,5,1,8,20
191021989,3,9,6,1,5,24
191021990,4,0,3,3,4,14
191021991,7,9,7,3,1,27
191021992,1,5,6,2,8,22
191021993,3,1,7,7,4,22
191021994,8,4,8,6,6,32
191021995,0,7,4,0,8,19
191021996,9,1,1,2,3,16
191021997,6,4,8,8,5,31
191021998,3,0,5,4,0,12
191021999,4,0,6,2,8,20
1910211000,8,3,7,6,2,26
1910211001,2,7,3,3,7,22
1910211002,2,2,1,2,3,10
1910211003,3,8,2,4,5,22
1910211004,1,3,7,2,1,14
1910211005,4,2,2,6,3,17
1910211006,5,5,7,9,5,31
1910211007,7,1,8,2,8,26
1910211008,7,9,4,5,0,25
1910211009,2,9,3,8,8,30
1910211010,8,7,8,5,6,34
1910211011,8,0,2,5,3,18
1910211012,1,5,4,9,2,21
1910211013,4,2,7,1,6,20
1910211014,7,6,8,6,1,28
1910211015,5,6,1,9,1,22
1910211016,7,8,9,5,1,30
1910211017,5,3,4,1,0,13
1910211018,1,6,9,7,5,28
1910211019,9,2,7,8,3,29
1910211020,5,1,3,3,0,12
1910211021,6,7,9,8,4,34
1910211022,1,2,5,9,8,25
1910211023,5,3,7,7,7,29
1910211024,0,7,8,8,6,29
1910211025,3,1,5,2,1,12
1910211026,8,0,8,7,2,25
1910211027,5,2,8,6,6,27
1910211028,7,2,8,9,7,33
1910211029,8,4,4,3,0,19
1910211030,3,8,9,8,2,30
1910211031,4,2,1,4,4,15
1910211032,7,7,3,1,3,21
1910211033,7,2,8,2,7,26
1910211034,8,4,2,3,8,25
1910211035,5,2,8,3,0,18
1910211036,1,1,9,9,6,26
1910211037,4,6,7,9,3,29
1910211038,7,4,2,3,3,19
1910211039,5,4,3,7,3,22
1910211040,4,9,8,2,1,24
1910211041,5,0,3,7,7,22
1910211042,6,3,8,7,7,31
1910211043,8,9,1,5,2,25
1910211044,4,4,9,1,5,23
1910211045,2,0,2,1,6,11
1910211046,6,8,4,6,3,27
1910211047,2,2,9,8,6,27
1910211048,1,4,1,8,4,18
1910211049,5,8,5,6,3,27
1910211050,2,3,7,6,1,19
1910211051,7,2,2,1,9,21
1910211052,9,3,0,3,9,24
1910211053,1,5,4,6,2,18
1910211054,9,2,0,5,9,25
1910211055,8,7,4,4,4,27
1910211056,9,7,2,7,5,30
1910211057,3,7,6,4,9,29
1910211058,4,0,6,2,1,13
1910211059,8,6,5,2,8,29
1910211060,5,2,1,0,9,17
1910211061,5,2,4,4,2,17
1910211062,0,9,5,9,6,29
1910211063,1,6,6,5,5,23
1910211064,7,9,3,5,3,27
1910211065,9,5,7,8,5,34
1910211066,2,4,7,0,6,19
1910211067,8,9,6,4,8,35
1910211068,6,4,7,5,4,26
1910211069,5,2,2,2,3,14
1910211070,9,6,6,9,7,37
1910211071,1,0,5,2,7,15
1910211072,5,2,8,4,0,19
1910211073,2,8,9,9,7,35
1910211074,0,7,0,0,5,12
1910211075,9,4,8,2,6,29
1910211076,1,8,5,3,1,18
1910211077,8,8,7,3,1,27
1910211078,5,2,7,1,3,18
1910211079,8,3,7,8,8,34
1910211080,1,6,8,8,5,28
1910211081,6,8,0,7,8,29
1910211082,9,9,9,5,4,36
1910211083,5,5,3,4,7,24
1910211084,6,0,1,2,3,12
1910211085,3,8,3,7,0,21
1910211086,1,4,9,2,4,20
1910211087,7,6,9,2,8,32
1910211088,8,3,3,4,0,18
1910211089,2,4,6,0,9,21
1910211090,3,2,8,5,4,22
1910211091,1,3,3,5,5,17
1910211092,8,4,7,9,7,35
1910211093,1,4,3,3,6,17
1910211094,0,8,1,2,4,15
1910211095,7,7,2,6,5,27
1910211096,0,3,7,9,1,20
1910211097,2,7,1,3,2,15
1910211098,7,8,0,0,4,19
1910211099,7,6,0,2,5,20
1910211100,1,9,4,5,1,20
1910211101,9,9,8,7,0,33
1910211102,0,3,9,5,5,22
1910211103,4,5,0,3,6,18
1910211104,7,0,7,4,7,25
1910211105,1,1,7,4,6,19
191022001,7,6,9,1,3,26
191022002,2,8,5,7,2,24
191022003,3,4,2,1,6,16
191022004,0,0,4,0,3,7
191022005,2,0,6,8,6,22
191022006,8,6,1,3,2,20
191022007,2,8,9,6,9,34
191022008,5,3,8,0,6,22
191022009,1,2,3,2,1,9
191022010,8,5,5,8,6,32
191022011,9,6,2,5,5,27
191022012,4,7,4,1,7,23
191022013,8,2,6,0,5,21
191022014,5,7,4,0,3,19
191022015,1,5,5,6,3,20
191022016,8,9,4,1,2,24
191022017,4,3,7,2,5,21
191022018,9,9,7,0,3,28
191022019,1,9,6,6,8,30
191022020,9,8,4,0,8,29
191022021,4,2,0,3,9,18
191022022,2,9,6,2,0,19
191022023,4,3,2,0,2,11
191022024,4,1,2,7,1,15
191022025,9,1,9,6,0,25
191022026,5,9,1,9,6,30
191022027,9,1,9,3,2,24
191022028,3,3,6,6,5,23
191022029,6,2,2,1,3,14
191022030,4,9,4,6,0,23
191022031,6,7,8,0,2,23
191022032,9,3,8,2,0,22
191022033,0,6,5,3,5,19
191022034,2,0,0,5,9,16
191022035,6,0,6,7,7,26
191022036,0,5,7,6,3,21
191022037,2,1,2,7,0,12
191022038,9,0,3,7,2,21
191022039,0,8,1,5,4,18
191022040,4,6,5,8,1,24
191022041,7,0,9,4,4,24
191022042,4,2,4,6,1,17
191022043,5,8,7,9,8,37
191022044,8,4,5,7,1,25
191022045,8,0,6,0,5,19
191022046,1,6,8,0,2,17
191022047,0,0,6,9,0,15
191022048,1,6,8,3,5,23
191022049,7,4,9,4,7,31
191022050,0,8,3,2,8,21
191022051,0,5,0,9,3,17
191022052,3,0,6,3,6,18
191022053,1,1,7,6,9,24
191022054,0,4,8,7,7,26
191022055,6,2,1,6,8,23
191022056,6,0,5,2,3,16
191022057,5,6,4,0,5,20
191022058,2,3,7,7,7,26
191022059,4,8,1,8,8,29
191022060,0,8,0,1,1,10
191022061,8,7,0,9,4,28
191022062,9,9,7,7,6,38
191022063,3,8,5,0,5,21
191022064,2,6,8,7,1,24
191022065,9,4,6,1,5,25
191022066,5,6,4,4,6,25
191022067,0,6,4,7,6,23
191022068,4,9,1,5,3,22
191022069,5,0,5,4,5,19
191022070,6,4,2,1,7,20
191022071,5,6,6,8,0,25
191022072,5,2,2,5,3,17
191022073,4,3,1,0,4,12
191022074,0,1,1,6,8,16
191022075,0,5,8,4,5,22
191022076,8,8,8,5,2,31
191022077,1,5,3,4,8,21
191022078,4,5,1,2,7,19
191022079,5,6,1,7,7,26
191022080,3,2,1,9,2,17
191022081,1,3,3,7,2,16
191022082,3,1,1,6,7,18
191022083,4,1,5,2,4,16
191022084,6,8,4,4,6,28
191022085,2,3,1,2,9,17
191022086,6,8,6,6,9,35
191022087,6,3,0,5,3,17
191022088,2,2,7,1,8,20
191022089,2,9,3,9,8,31
191022090,0,4,0,7,0,11
191022091,2,5,7,3,6,23
191022092,8,0,9,3,8,28
191022093,5,5,0,8,3,21
191022094,2,2,1,9,3,17
191022095,2,8,2,8,9,29
191022096,5,5,3,3,5,21
191022097,2,8,2,4,3,19
191022098,7,6,3,3,5,24
191022099,2,0,9,8,9,28
191022100,1,6,0,0,6,13
191022101,3,9,9,9,0,30
191022102,1,8,4,0,3,16
191022103,4,5,2,1,9,21
191022104,1,5,0,6,2,14
191022105,0,2,5,1,3,11
191022106,3,1,4,6,1,15
191022107,3,6,8,4,2,23
191022108,3,7,7,1,5,23
191022109,2,1,6,2,6,17
191022110,0,8,2,6,6,22
191022111,3,8,0,8,9,28
191022112,9,2,9,5,1,26
191022113,3,4,1,6,4,18
191022114,9,3,9,1,7,29
191022115,5,3,6,3,0,17
191022116,8,3,1,2,1,15
191022117,6,9,6,0,9,30
191022118,8,0,7,6,3,24
191022119,0,2,6,3,8,19
191022120,3,5,2,9,6,25
191022121,7,7,6,3,8,31
191022122,1,7,2,1,8,19
191022123,9,3,7,9,7,35
191022124,9,2,6,4,3,24
191022125,1,9,2,6,9,27
191022126,3,2,6,6,6,23
191022127,8,6,1,2,4,21
191022128,6,6,2,4,2,20
191022129,2,3,1,8,9,23
191022130,5,1,4,0,5,15
191022131,7,0,7,1,0,15
191022132,2,1,3,4,5,15
191022133,2,2,0,0,4,8
191022134,0,8,7,2,0,17
191022135,4,6,2,7,6,25
191022136,4,9,2,5,5,25
191022137,1,9,3,6,1,20
191022138,6,3,3,6,8,26
191022139,2,4,3,5,9,23
191022140,3,6,2,4,7,22
191022141,6,3,2,7,1,19
191022142,0,3,6,2,6,17
191022143,7,3,5,6,0,21
191022144,4,6,9,5,9,33
191022145,0,1,7,1,7,16
191022146,0,5,8,5,4,22
191022147,1,4,0,9,2,16
191022148,8,4,0,7,5,24
191022149,9,2,0,7,4,22
191022150,9,7,0,6,9,31
191022151,8,7,2,7,8,32
191022152,5,7,0,4,8,24
191022153,6,5,6,2,0,19
191022154,6,4,4,8,8,30
191022155,7,5,0,3,6,21
191022156,3,6,9,6,3,27
191022157,7,3,6,0,4,20
191022158,4,0,9,9,7,29
191022159,9,4,4,6,8,31
191022160,0,3,1,2,8,14
191022161,8,3,0,4,3,18
191022162,8,7,9,9,0,33
191022163,1,5,8,0,8,22
191022164,9,0,7,1,5,22
191022165,2,4,0,5,3,14
191022166,1,0,8,0,2,11
191022167,1,3,3,6,5,18
191022168,7,0,1,7,4,19
191022169,7,9,0,8,9,33
191022170,8,6,0,1,7,22
191022171,7,7,9,4,0,27
191022172,0,8,8,0,5,21
191022173,1,9,6,6,5,27
191022174,2,7,5,0,7,21
191022175,2,6,2,4,9,23
191022176,9,6,9,0,1,25
191022177,7,2,2,4,8,23
191022178,0,7,0,3,8,18
191022179,8,6,6,0,8,28
191022180,3,6,5,7,0,21
191022181,3,9,7,3,0,22
191022182,1,5,2,4,1,13
191022183,6,7,8,7,1,29
191022184,4,3,0,1,8,16
191022185,2,4,8,1,9,24
191022186,1,9,2,1,3,16
191022187,8,8,7,7,9,39
191022188,6,8,4,6,1,25
191022189,0,7,5,5,9,26
191022190,6,2,2,9,7,26
191022191,2,6,3,1,2,14
191022192,5,2,3,0,5,15
191022193,8,4,9,0,3,24
191022194,8,4,9,6,1,28
191022195,4,1,6,8,3,22
191022196,1,5,2,7,9,24
191022197,0,1,3,5,9,18
191022198,3,0,7,5,5,20
191022199,9,0,5,9,6,29
191022200,9,0,9,7,5,30
191022201,7,5,2,1,5,20
191022202,5,1,1,9,2,18
191022203,2,4,3,3,4,16
191022204,1,3,3,0,8,15
191022205,8,4,1,8,2,23
191022206,8,7,7,1,2,25
191022207,3,8,4,0,8,23
191022208,2,3,6,7,5,23
191022209,7,8,1,2,8,26
191022210,4,6,7,3,5,25
191022211,6,6,9,4,7,32
191022212,5,3,2,5,8,23
191022213,9,8,3,6,4,30
191022214,8,3,6,0,7,24
191022215,4,4,1,5,0,14
191022216,5,5,8,1,3,22
191022217,6,2,3,0,0,11
191022218,3,8,5,4,0,20
191022219,7,8,4,6,0,25
191022220,2,0,9,4,7,22
191022221,7,5,1,0,5,18
191022222,8,3,0,2,1,14
191022223,8,6,6,1,1,22
191022224,7,5,5,5,4,26
191022225,1,1,7,6,7,22
191022226,0,9,8,2,7,26
191022227,3,6,5,4,5,23
191022228,4,0,0,8,1,13
191022229,9,1,8,2,4,24
191022230,8,9,8,5,8,38
191022231,1,1,9,5,5,21
191022232,8,0,0,7,1,16
191022233,2,9,2,0,6,19
191022234,8,8,9,9,5,39
191022235,9,7,1,7,4,28
191022236,6,0,3,1,4,14
191022237,2,0,2,4,4,12
191022238,4,3,9,1,0,17
191022239,3,6,9,6,2,26
191022240,7,6,9,2,7,31
191022241,3,5,2,8,3,21
191022242,0,6,7,5,3,21
191022243,4,8,6,0,1,19
191022244,6,2,0,8,8,24
191022245,2,5,1,6,9,23
191022246,5,3,9,1,1,19
191022247,2,9,4,8,6,29
191022248,1,8,2,1,9,21
191022249,9,1,8,5,5,28
191022250,0,7,1,4,4,16
191022251,4,0,5,3,0,12
191022252,1,5,7,2,9,24
191022253,7,4,6,3,6,26
191022254,4,5,0,5,1,15
191022255,1,8,6,0,9,24
191022256,6,2,3,8,1,20
191022257,4,5,6,7,2,24
191022258,9,1,5,4,3,22
191022259,4,5,9,9,3,30
191022260,6,8,8,2,6,30
191022261,2,4,9,5,5,25
191022262,7,2,9,7,8,33
191022263,1,3,6,5,0,15
191022264,1,2,1,8,6,18
191022265,0,5,1,4,4,14
191022266,3,8,9,1,0,21
191022267,3,1,1,1,4,10
191022268,8,4,9,6,3,30
191022269,7,2,6,7,3,25
191022270,5,2,1,1,2,11
191022271,6,3,7,1,7,24
191022272,7,6,3,8,1,25
191022273,0,5,6,7,3,21
191022274,9,7,6,6,5,33
191022275,7,3,4,0,0,14
191022276,8,4,6,1,1,20
191022277,5,9,5,1,8,28
191022278,5,9,3,5,6,28
191022279,4,6,1,5,2,18
191022280,6,6,2,9,8,31
191022281,7,0,0,0,7,14
191022282,8,9,9,6,7,39
191022283,1,3,0,1,8,13
191022284,4,0,9,2,0,15
191022285,7,6,0,4,1,18
191022286,8,6,4,2,4,24
191022287,7,1,7,2,3,20
191022288,2,2,9,3,8,24
191022289,7,4,1,9,0,21
191022290,5,4,3,6,3,21
191022291,6,2,4,1,8,21
191022292,0,7,0,0,2,9
191022293,5,3,5,0,0,13
191022294,1,5,5,2,8,21
191022295,4,9,3,3,6,25
191022296,3,8,8,1,7,27
191022297,0,9,7,0,0,16
191022298,7,9,1,2,2,21
191022299,7,4,5,5,7,28
191022300,2,6,8,1,8,25
191022301,3,7,5,9,5,29
191022302,9,3,7,7,1,27
191022303,3,3,5,9,6,26
191022304,6,9,1,7,5,28
191022305,2,5,1,3,5,16
191022306,9,3,8,3,1,24
191022307,4,5,5,7,5,26
191022308,7,4,4,6,4,25
191022309,9,2,9,0,3,23
191022310,4,2,3,6,5,20
191022311,7,5,6,4,6,28
191022312,3,0,3,5,6,17
191022313,8,3,3,3,5,22
191022314,5,9,3,8,5,30
191022315,9,6,4,7,6,32
191022316,2,6,8,5,0,21
191022317,9,2,4,6,4,25
191022318,9,8,1,4,6,28
191022319,9,5,0,4,0,18
191022320,2,3,5,2,5,17
191022321,8,1,6,1,2,18
191022322,0,4,8,9,6,27
191022323,2,8,5,9,8,32
191022324,3,3,1,5,6,18
191022325,2,5,1,1,9,18
191022326,9,5,3,8,5,30
191022327,9,9,3,8,1,30
191022328,8,8,8,8,2,34
191022329,9,5,2,8,9,33
191022330,6,6,5,0,4,21
191022331,0,2,9,3,3,17
191022332,0,6,0,8,8,22
191022333,0,3,9,3,1,16
191022334,9,0,7,9,2,27
191022335,9,1,4,0,5,19
191022336,0,8,6,2,1,17
191022337,2,1,1,7,8,19
191022338,9,1,5,8,3,26
191022339,4,7,2,1,1,15
191022340,6,1,2,5,4,18
191022341,9,0,8,0,2,19
191022342,8,5,4,2,3,22
191022343,8,3,4,8,9,32
191022344,8,7,9,8,2,34
191022345,9,5,7,1,6,28
191022346,3,4,5,8,9,29
191022347,4,0,9,4,4,21
191022348,7,9,7,4,5,32
191022349,1,5,4,5,7,22
191022350,6,3,3,6,9,27
191022351,5,7,8,0,1,21
191022352,0,2,8,8,5,23
191022353,7,4,8,7,9,35
191022354,4,4,0,3,9,20
191022355,5,0,1,6,5,17
191022356,7,5,5,1,4,22
191022357,9,9,1,8,7,34
191022358,1,2,9,8,0,20
191022359,8,3,9,3,1,24
191022360,9,9,2,2,0,22
191022361,9,5,2,7,8,31
191022362,4,5,3,8,3,23
191022363,1,5,2,2,2,12
191022364,7,7,8,1,1,24
191022365,8,6,4,3,2,23
191022366,1,9,6,2,1,19
191022367,9,8,6,4,5,32
191022368,6,6,3,5,6,26
191022369,7,1,9,6,8,31
191022370,3,2,4,1,3,13
191022371,9,5,6,0,7,27
191022372,6,6,8,2,2,24
191022373,0,6,6,7,4,23
191022374,6,3,5,4,4,22
191022375,5,8,1,4,0,18
191022376,3,4,7,0,1,15
191022377,3,4,2,3,9,21
191022378,3,9,7,2,2,23
191022379,2,4,6,2,1,15
191022380,6,0,2,8,3,19
191022381,6,3,3,6,0,18
191022382,8,9,7,2,6,32
191022383,7,9,7,8,4,35
191022384,6,1,8,3,2,20
191022385,6,6,3,2,4,21
191022386,5,7,1,3,8,24
191022387,8,2,1,6,3,20
191022388,8,2,4,0,4,18
191022389,2,0,2,0,7,11
191022390,7,3,5,7,2,24
191022391,3,6,6,9,7,31
191022392,6,8,2,8,7,31
191022393,0,5,6,7,6,24
191022394,5,4,8,5,9,31
191022395,9,9,8,5,1,32
191022396,9,8,3,1,9,30
191022397,5,0,5,8,6,24
191022398,7,0,8,3,4,22
191022399,1,3,5,2,7,18
191022400,6,7,8,3,4,28
191022401,1,0,1,4,6,12
191022402,8,0,2,9,2,21
191022403,4,5,6,1,9,25
191022404,9,8,5,2,4,28
191022405,7,1,1,5,9,23
191022406,7,5,9,3,7,31
191022407,5,9,1,7,6,28
191022408,3,4,8,5,9,29
191022409,7,7,3,7,2,26
191022410,8,8,0,7,2,25
191022411,9,2,1,2,8,22
191022412,1,2,2,8,3,16
191022413,8,5,4,3,6,26
191022414,0,9,9,7,0,25
191022415,2,8,3,5,2,20
191022416,0,5,1,1,3,10
191022417,3,7,0,9,7,26
191022418,6,4,1,9,9,29
191022419,3,6,2,8,3,22
191022420,3,5,0,7,6,21
191022421,2,0,5,3,1,11
191022422,2,2,8,1,3,16
191022423,9,6,6,3,3,27
191022424,6,2,1,4,7,20
191022425,6,4,0,9,8,27
191022426,2,0,6,6,2,16
191022427,9,4,1,7,8,29
191022428,2,1,7,6,0,16
191022429,9,9,4,9,9,40
191022430,8,9,1,7,3,28
191022431,3,3,7,5,4,22
191022432,1,7,1,8,4,21
191022433,4,5,0,9,9,27
191022434,1,8,1,7,4,21
191022435,7,0,6,6,3,22
191022436,6,7,7,5,8,33
191022437,5,8,4,8,4,29
191022438,1,6,7,1,4,19
191022439,5,4,3,8,1,21
191022440,1,0,6,5,9,21
191022441,0,7,5,4,7,23
191022442,0,9,0,9,4,22
191022443,0,0,1,8,0,9
191022444,0,5,0,5,0,10
191022445,0,9,5,3,5,22
191022446,8,0,3,0,8,19
191022447,0,2,6,8,5,21
191022448,9,5,6,0,4,24
191022449,2,3,3,9,0,17
191022450,0,6,7,6,5,24
191022451,3,8,7,7,9,34
191022452,4,4,7,2,9,26
191022453,8,7,0,7,5,27
191022454,6,5,4,3,0,18
191022455,2,9,5,3,1,20
191022456,7,5,1,4,6,23
191022457,3,2,8,2,7,22
191022458,0,3,1,0,8,12
191022459,8,5,2,3,2,20
191022460,8,3,0,9,9,29
191022461,0,4,0,7,6,17
191022462,8,2,3,3,5,21
191022463,1,7,2,2,5,17
191022464,1,1,2,2,8,14
191022465,2,8,3,6,0,19
191022466,5,4,2,7,2,20
191022467,5,7,0,0,8,20
191022468,6,9,0,1,8,24
191022469,1,5,1,0,1,8
191022470,0,3,7,3,3,16
191022471,5,2,4,9,0,20
191022472,1,9,8,2,4,24
191022473,5,7,1,6,1,20
191022474,0,2,3,5,5,15
191022475,9,6,0,4,5,24
191022476,5,4,0,1,8,18
191022477,8,7,2,6,0,23
191022478,5,7,7,6,7,32
191022479,2,2,4,2,4,14
191022480,2,7,4,2,4,19
191022481,4,1,9,4,2,20
191022482,5,6,1,4,6,22
191022483,5,6,9,1,3,24
191022484,3,5,5,1,4,18
191022485,0,3,3,3,8,17
191022486,7,2,7,8,1,25
191022487,4,5,5,9,7,30
191022488,4,3,4,7,1,19
191022489,6,3,8,3,3,23
191022490,2,9,1,6,3,21
191022491,2,7,4,4,5,22
191022492,3,3,7,4,1,18
191022493,1,8,6,9,9,33
191022494,1,6,5,6,9,27
191022495,6,5,8,7,1,27
191022496,5,8,9,1,2,25
191022497,9,3,8,0,5,25
191022498,6,0,9,4,1,20
191022499,7,8,0,5,7,27
191022500,0,7,0,4,2,13
191022501,8,9,8,6,0,31
191022502,5,4,5,7,2,23
191022503,4,5,5,7,7,28
191022504,7,8,9,5,8,37
191022505,4,2,1,7,2,16
191022506,7,7,9,3,1,27
191022507,4,1,5,0,2,12
191022508,3,7,7,4,7,28
191022509,8,0,8,1,3,20
191022510,2,8,3,9,5,27
191022511,4,9,0,2,0,15
191022512,1,4,6,9,9,29
191022513,8,0,9,1,2,20
191022514,7,9,1,7,6,30
191022515,1,9,8,2,5,25
191022516,1,2,6,7,7,23
191022517,9,0,9,4,8,30
191022518,9,3,7,4,6,29
191022519,2,4,6,9,8,29
191022520,7,6,9,0,1,23
191022521,8,8,5,1,0,22
191022522,8,5,6,1,4,24
191022523,4,0,2,4,3,13
191022524,8,9,0,9,6,32
191022525,4,1,2,0,7,14
191022526,0,8,1,2,8,19
191022527,2,0,9,0,2,13
191022528,5,9,8,7,3,32
191022529,1,5,4,8,1,19
191022530,7,2,0,0,6,15
191022531,9,1,5,8,4,27
191022532,6,1,7,5,2,21
191022533,1,4,2,5,1,13
191022534,3,0,2,2,3,10
191022535,7,5,5,7,0,24
191022536,2,5,4,0,2,13
191022537,6,4,9,4,5,28
191022538,2,4,2,4,9,21
191022539,7,2,2,1,1,13
191022540,1,6,5,4,4,20
191022541,1,0,7,7,0,15
191022542,8,0,2,3,5,18
191022543,4,5,8,3,8,28
191022544,7,1,5,2,1,16
191022545,5,1,0,0,4,10
191022546,9,4,8,9,6,36
191022547,3,2,1,2,1,9
191022548,8,2,3,2,3,18
191022549,0,3,0,0,4,7
191022550,2,7,5,9,5,28
191022551,6,6,6,0,6,24
191022552,6,1,1,2,9,19
191022553,4,9,9,8,6,36
191022554,6,0,6,7,0,19
191022555,1,6,4,1,4,16
191022556,0,4,7,4,1,16
191022557,7,6,0,9,2,24
191022558,0,9,7,4,1,21
191022559,7,2,8,9,6,32
191022560,7,1,4,6,4,22
191022561,2,9,9,2,6,28
191022562,7,2,9,3,2,23
191022563,5,2,7,9,3,26
191022564,9,7,9,6,8,39
191022565,5,9,4,1,7,26
191022566,8,6,2,8,3,27
191022567,3,2,4,1,7,17
191022568,7,9,6,7,0,29
191022569,2,4,4,9,1,20
191022570,9,6,9,7,8,39
191022571,1,6,7,0,3,17
191022572,8,4,8,1,7,28
191022573,8,7,5,8,6,34
191022574,7,8,6,3,8,32
191022575,0,3,7,2,7,19
191022576,3,2,3,9,1,18
191022577,0,0,0,3,1,4
191022578,4,7,4,2,4,21
191022579,3,5,8,8,5,29
191022580,8,0,7,3,4,22
191022581,5,0,2,5,0,12
191022582,7,9,2,6,2,26
191022583,2,6,5,8,9,30
191022584,3,4,9,2,0,18
191022585,5,0,0,9,1,15
191022586,4,9,7,8,3,31
191022587,3,5,3,1,3,15
191022588,9,5,7,8,3,32
191022589,5,0,7,7,4,23
191022590,0,4,1,4,7,16
191022591,7,0,1,3,2,13
191022592,2,5,7,5,6,25
191022593,5,0,0,4,7,16
191022594,1,3,1,5,6,16
191022595,9,9,4,1,1,24
191022596,1,5,2,7,3,18
191022597,1,9,8,0,2,20
191022598,4,5,5,8,7,29
191022599,2,2,6,4,5,19
191022600,9,0,5,1,0,15
191022601,4,4,0,8,1,17
191022602,4,5,3,4,6,22
191022603,8,8,5,9,2,32
191022604,2,9,2,0,4,17
191022605,9,5,1,9,1,25
191022606,9,7,4,1,0,21
191022607,7,6,2,0,3,18
191022608,6,4,7,7,1,25
191022609,1,5,3,0,2,11
191022610,8,2,7,2,0,19
191022611,3,1,4,2,8,18
191022612,2,5,3,7,7,24
191022613,0,2,0,7,9,18
191022614,5,0,6,3,3,17
191022615,1,8,9,0,1,19
191022616,1,7,4,2,8,22
191022617,4,5,8,3,2,22
191022618,5,5,8,9,3,30
191022619,9,3,3,0,0,15
191022620,9,7,1,5,5,27
191022621,9,2,7,2,9,29
191022622,9,1,4,6,1,21
191022623,3,0,6,1,6,16
191022624,3,6,1,7,8,25
191022625,1,2,0,7,4,14
191022626,7,5,6,1,8,27
191022627,5,4,4,2,5,20
191022628,1,9,5,2,6,23
191022629,3,1,0,1,0,5
191022630,1,7,0,5,8,21
191022631,9,1,4,5,5,24
191022632,5,0,4,1,4,14
191022633,9,4,4,3,1,21
191022634,6,1,3,7,1,18
191022635,5,4,3,8,6,26
191022636,2,3,4,1,1,11
191022637,0,0,5,6,0,11
191022638,9,5,5,0,0,19
191022639,0,6,9,6,8,29
191022640,2,0,6,0,0,8
191022641,2,9,4,1,0,16
191022642,6,3,7,4,1,21
191022643,7,5,1,6,9,28
191022644,8,7,3,7,3,28
191022645,1,1,6,9,6,23
191022646,4,6,4,1,0,15
191022647,4,6,9,6,0,25
191022648,1,2,7,7,4,21
191022649,3,7,4,9,8,31
191022650,6,7,6,5,4,28
191022651,8,8,9,3,3,31
191022652,8,5,4,2,2,21
191022653,5,5,6,6,8,30
191022654,7,8,5,7,1,28
191022655,9,3,7,5,8,32
191022656,7,3,6,5,1,22
191022657,6,9,3,4,9,31
191022658,5,1,5,4,8,23
191022659,0,8,0,7,7,22
191022660,6,6,3,1,9,25
191022661,4,4,5,0,0,13
191022662,9,5,5,4,5,28
191022663,1,8,6,1,3,19
191022664,7,5,0,9,3,24
191022665,6,5,0,6,8,25
191022666,3,1,9,6,8,27
191022667,2,8,0,7,7,24
191022668,1,3,9,2,9,24
191022669,5,3,8,6,5,27
191022670,4,1,3,9,4,21
191022671,1,5,1,1,9,17
191022672,9,3,3,8,2,25
191022673,8,4,7,2,9,30
191022674,6,2,7,1,5,21
191022675,9,2,0,1,8,20
191022676,3,0,1,2,2,8
191022677,2,3,9,1,8,23
191022678,0,2,2,0,1,5
191022679,0,7,7,7,4,25
191022680,6,5,4,7,2,24
191022681,3,4,2,2,0,11
191022682,7,6,0,6,0,19
191022683,0,2,7,7,6,22
191022684,5,1,7,2,3,18
191022685,7,1,8,5,2,23
191022686,9,7,0,7,5,28
191022687,7,2,0,4,4,17
191022688,8,8,1,5,2,24
191022689,1,7,7,2,9,26
191022690,8,0,6,6,7,27
191022691,2,8,6,7,0,23
191022692,8,0,9,2,8,27
191022693,2,6,3,4,0,15
191022694,7,2,7,7,0,23
191022695,5,9,4,2,6,26
191022696,7,7,5,2,9,30
191022697,8,6,6,1,8,29
191022698,2,4,9,4,1,20
191022699,7,0,9,8,6,30
191022700,9,2,7,2,1,21
191022701,8,5,1,0,4,18
191022702,4,3,8,3,2,20
191022703,6,0,6,6,9,27
191022704,8,2,3,3,1,17
191022705,8,5,2,7,6,28
191022706,8,9,9,1,2,29
191022707,1,0,5,8,6,20
191022708,6,9,0,9,0,24
191022709,1,8,3,9,7,28
191022710,4,1,4,0,5,14
191022711,9,4,0,9,7,29
191022712,7,9,5,1,0,22
191022713,5,5,9,7,2,28
191022714,3,4,5,9,1,22
191022715,0,1,7,0,6,14
191022716,5,6,6,4,5,26
191022717,9,8,6,3,1,27
191022718,3,3,4,4,5,19
191022719,6,5,4,9,8,32
191022720,5,5,8,2,6,26
191022721,6,4,4,5,6,25
191022722,8,7,8,0,3,26
191022723,0,5,3,0,0,8
191022724,8,0,7,5,2,22
191022725,4,1,0,3,9,17
191022726,3,3,7,8,7,28
191022727,8,3,4,0,0,15
191022728,4,8,2,5,2,21
191022729,0,3,5,8,6,22
191022730,7,1,8,1,8,25
191022731,6,6,1,9,9,31
191022732,9,2,9,4,4,28
191022733,1,9,3,0,9,22
191022734,1,8,1,1,4,15
191022735,8,2,4,3,3,20
191022736,1,6,5,0,9,21
191022737,8,2,9,1,3,23
191022738,3,2,3,6,9,23
191022739,8,1,5,1,8,23
191022740,2,2,6,7,8,25
191022741,8,6,4,3,9,30
191022742,0,4,4,8,5,21
191022743,8,7,9,5,9,38
191022744,9,3,9,5,7,33
191022745,6,5,1,7,6,25
191022746,3,5,8,1,2,19
191022747,3,3,9,9,5,29
191022748,6,1,4,0,3,14
191022749,8,6,4,7,2,27
191022750,6,7,6,6,9,34
191022751,1,4,6,3,9,23
191022752,5,6,8,8,2,29
191022753,8,7,6,7,1,29
191022754,3,1,5,7,9,25
191022755,7,8,6,8,6,35
191022756,4,3,7,3,9,26
191022757,5,1,9,3,8,26
191022758,0,2,5,8,3,18
191022759,9,1,2,6,4,22
191022760,9,5,8,1,1,24
191022761,4,3,2,9,7,25
191022762,1,0,1,3,1,6
191022763,9,7,5,0,7,28
191022764,6,3,7,2,0,18
191022765,1,4,5,2,6,18
191022766,5,5,7,3,1,21
191022767,2,8,0,2,1,13
191022768,0,6,0,0,2,8
191022769,8,2,5,0,0,15
191022770,4,1,0,1,6,12
191022771,1,3,0,3,8,15
191022772,7,5,4,5,3,24
191022773,1,8,1,6,5,21
191022774,6,5,8,1,6,26
191022775,6,5,5,1,9,26
191022776,4,0,6,3,5,18
191022777,3,1,3,4,8,19
191022778,9,5,3,6,2,25
191022779,1,5,3,6,0,15
191022780,2,2,4,2,7,17
191022781,6,4,2,3,8,23
191022782,6,7,3,0,9,25
191022783,3,2,5,5,1,16
191022784,3,1,7,2,8,21
191022785,9,1,6,0,2,18
191022786,6,2,6,9,8,31
191022787,6,8,2,9,7,32
191022788,1,9,1,9,9,29
191022789,1,8,0,9,6,24
191022790,8,5,7,0,7,27
191022791,7,6,4,2,3,22
191022792,0,1,4,8,5,18
191022793,3,7,3,7,0,20
191022794,5,8,3,8,9,33
191022795,4,3,0,3,2,12
191022796,6,1,2,0,7,16
191022797,4,2,4,5,9,24
191022798,8,9,2,3,1,23
191022799,7,2,8,8,5,30
191022800,8,9,9,0,1,27
191022801,6,0,0,2,8,16
191022802,7,0,4,5,1,17
191022803,2,8,6,7,2,25
191022804,0,5,8,0,7,20
191022805,9,4,2,2,8,25
191022806,6,6,2,1,1,16
191022807,4,9,4,3,9,29
191022808,3,0,4,7,1,15
191022809,6,5,4,8,0,23
191022810,6,4,2,0,3,15
191022811,0,4,3,8,7,22
191022812,4,5,9,4,5,27
191022813,6,9,7,5,2,29
191022814,7,0,6,5,3,21
191022815,6,1,9,8,9,33
191022816,9,2,4,0,1,16
191022817,6,6,5,7,2,26
191022818,6,0,5,3,0,14
191022819,1,6,2,7,2,18
191022820,8,8,3,7,2,28
191022821,1,6,5,2,4,18
191022822,8,8,0,2,9,27
191022823,2,2,9,4,3,20
191022824,4,6,7,9,9,35
191022825,6,4,6,8,7,31
191022826,4,4,7,1,1,17
191022827,1,4,7,2,6,20
191022828,9,0,0,0,3,12
191022829,0,2,2,4,1,9
191022830,7,4,4,9,0,24
191022831,4,3,2,9,8,26
191022832,9,1,6,5,4,25
191022833,7,2,9,5,4,27
191022834,6,8,3,5,2,24
191022835,8,1,9,5,5,28
191022836,8,1,9,1,3,22
191022837,5,0,8,3,9,25
191022838,4,7,5,0,8,24
191022839,1,3,8,8,0,20
191022840,2,2,0,5,1,10
191022841,3,5,6,3,8,25
191022842,2,4,9,5,1,21
191022843,7,8,2,6,1,24
191022844,9,3,6,7,0,25
191022845,9,6,3,6,6,30
191022846,6,7,2,7,2,24
191022847,8,6,1,5,8,28
191022848,4,5,7,4,7,27
191022849,5,8,6,2,2,23
191022850,5,2,6,3,6,22
191022851,6,1,4,3,3,17
191022852,8,7,9,2,5,31
191022853,4,8,0,2,5,19
191022854,7,7,2,8,6,30
191022855,9,8,5,1,0,23
191022856,9,2,0,0,8,19
191022857,5,7,6,5,9,32
191022858,7,8,2,0,2,19
191022859,4,3,4,2,9,22
191022860,4,8,5,2,5,24
191022861,0,4,8,0,2,14
191022862,6,6,1,4,6,23
191022863,3,1,7,9,8,28
191022864,6,0,0,3,1,10
191022865,2,9,5,7,1,24
191022866,1,1,1,7,1,11
191022867,0,5,4,4,0,13
191022868,3,4,4,2,3,16
191022869,6,1,6,2,6,21
191022870,8,7,3,9,2,29
191022871,1,8,3,4,9,25
191022872,7,4,1,4,9,25
191022873,5,3,2,8,9,27
191022874,7,5,1,1,3,17
191022875,6,1,2,8,2,19
191022876,0,3,9,9,5,26
191022877,1,5,4,6,5,21
191022878,5,6,9,2,3,25
191022879,1,9,9,8,1,28
191022880,4,4,6,3,0,17
191022881,1,4,5,2,3,15
191022882,1,1,3,2,3,10
191022883,8,6,5,9,8,36
191022884,4,7,7,9,5,32
191022885,6,9,8,3,2,28
191022886,7,2,0,7,3,19
191022887,5,3,9,6,7,30
191022888,5,0,1,6,0,12
191022889,4,4,0,2,1,11
191022890,6,1,5,4,7,23
191022891,1,2,2,8,4,17
191022892,0,9,8,0,6,23
191022893,7,4,3,6,0,20
191022894,2,1,5,4,5,17
191022895,3,8,4,1,3,19
191022896,4,6,4,1,6,21
191022897,9,9,9,3,9,39
191022898,5,1,7,3,5,21
191022899,7,2,8,5,6,28
191022900,3,5,6,3,4,21
191022901,6,7,0,7,7,27
191022902,1,7,4,9,3,24
191022903,7,6,5,4,4,26
191022904,0,8,4,3,7,22
191022905,3,6,1,0,3,13
191022906,5,9,1,4,2,21
191022907,2,6,1,4,1,14
191022908,5,9,0,5,8,27
191022909,1,6,6,4,2,19
191022910,3,0,8,1,8,20
191022911,5,2,8,5,9,29
191022912,1,2,2,3,3,11
191022913,5,5,3,7,0,20
191022914,7,5,2,4,3,21
191022915,5,4,0,8,5,22
191022916,7,8,6,5,8,34
191022917,7,2,6,0,1,16
191022918,4,0,2,7,6,19
191022919,9,6,0,1,2,18
191022920,8,4,0,6,4,22
191022921,2,8,0,6,8,24
191022922,6,1,7,2,9,25
191022923,5,7,1,4,3,20
191022924,2,0,1,1,6,10
191022925,2,1,4,9,0,16
191022926,1,5,7,6,9,28
191022927,3,2,3,0,8,16
191022928,9,1,5,9,9,33
191022929,7,0,2,4,2,15
191022930,7,3,7,1,2,20
191022931,6,4,1,0,0,11
191022932,3,3,7,5,8,26
191022933,3,4,6,1,2,16
191022934,7,6,1,9,5,28
191022935,7,2,5,9,1,24
191022936,9,4,0,9,5,27
191022937,0,5,7,3,1,16
191022938,6,3,8,8,4,29
191022939,3,6,0,8,7,24
191022940,6,2,8,6,0,22
191022941,3,9,8,7,6,33
191022942,0,0,6,4,9,19
191022943,4,3,4,8,1,20
191022944,2,3,1,9,9,24
191022945,7,4,8,3,0,22
191022946,6,6,9,3,4,28
191022947,5,6,6,4,7,28
191022948,3,5,1,2,5,16
191022949,2,6,9,6,5,28
191022950,9,6,1,1,2,19
191022951,4,6,1,0,9,20
191022952,7,2,8,7,0,24
191022953,3,3,1,3,8,18
191022954,6,3,5,4,3,21
191022955,4,6,1,1,5,17
191022956,4,3,4,9,4,24
191022957,9,7,3,8,2,29
191022958,3,6,6,4,0,19
191022959,6,8,6,6,1,27
191022960,5,2,3,5,7,22
191022961,5,5,0,6,6,22
191022962,5,1,3,5,6,20
191022963,7,6,0,3,8,24
191022964,4,8,1,3,9,25
191022965,1,1,8,4,5,19
191022966,6,0,6,8,7,27
191022967,9,3,2,2,7,23
191022968,0,4,3,2,6,15
191022969,6,3,3,7,2,21
191022970,6,1,2,4,7,20
191022971,7,8,0,3,1,19
191022972,6,5,9,6,6,32
191022973,6,0,6,5,8,25
191022974,1,2,4,6,9,22
191022975,1,4,6,8,2,21
191022976,6,3,6,1,3,19
191022977,9,8,0,1,6,24
191022978,3,1,7,1,5,17
191022979,2,5,3,6,4,20
191022980,8,6,2,2,6,24
191022981,1,5,7,5,3,21
191022982,7,6,8,2,3,26
191022983,4,0,7,6,9,26
191022984,5,9,5,7,3,29
191022985,6,8,2,3,1,20
191022986,4,9,7,0,0,20
191022987,6,3,1,1,9,20
191022988,6,3,1,5,7,22
191022989,7,1,6,4,5,23
191022990,2,4,6,3,7,22
191022991,3,3,6,2,0,14
191022992,6,4,8,7,9,34
191022993,7,8,4,2,8,29
191022994,4,4,4,2,6,20
191022995,8,3,6,7,9,33
191022996,0,2,9,6,3,20
191022997,4,2,5,8,1,20
191022998,0,1,1,8,4,14
191022999,5,6,3,7,1,22
1910221000,3,4,7,0,6,20
1910221001,1,9,8,7,6,31
1910221002,1,6,3,1,8,19
1910221003,1,7,8,0,2,18
1910221004,1,8,2,0,5,16
1910221005,2,9,3,4,1,19
1910221006,4,0,6,9,4,23
1910221007,7,2,5,5,3,22
1910221008,4,6,0,7,3,20
1910221009,6,4,7,5,8,30
1910221010,8,4,2,9,8,31
1910221011,8,7,2,1,5,23
1910221012,4,5,8,4,9,30
1910221013,4,2,4,1,6,17
1910221014,0,6,4,6,7,23
1910221015,7,7,6,8,5,33
1910221016,8,6,9,3,4,30
1910221017,4,4,8,5,6,27
1910221018,6,6,4,1,0,17
1910221019,5,0,4,0,4,13
1910221020,0,9,5,2,8,24
1910221021,0,2,6,9,4,21
1910221022,4,8,9,9,8,38
1910221023,9,0,5,7,5,26
1910221024,7,8,7,9,5,36
1910221025,3,4,9,0,7,23
1910221026,7,8,0,3,6,24
1910221027,9,5,2,2,0,18
1910221028,1,7,9,2,9,28
1910221029,9,3,1,4,5,22
1910221030,4,0,4,7,2,17
1910221031,2,8,7,0,1,18
1910221032,5,8,9,2,9,33
1910221033,6,1,8,3,9,27
1910221034,0,1,0,9,1,11
1910221035,7,2,3,1,3,16
1910221036,1,2,5,4,0,12
1910221037,6,2,8,8,7,31
1910221038,7,5,0,8,2,22
1910221039,9,8,6,0,8,31
1910221040,6,4,9,2,6,27
1910221041,9,5,7,3,0,24
1910221042,4,9,1,2,4,20
1910221043,8,1,6,4,4,23
1910221044,1,8,3,3,7,22
1910221045,9,3,8,5,8,33
1910221046,6,1,8,8,4,27
1910221047,6,9,8,4,8,35
1910221048,3,3,3,5,3,17
1910221049,3,1,6,4,6,20
1910221050,2,8,4,8,2,24
1910221051,8,8,9,8,0,33
1910221052,8,6,4,8,6,32
1910221053,8,8,8,5,4,33
1910221054,5,0,4,3,7,19
1910221055,2,2,0,6,5,15
1910221056,5,9,8,2,3,27
1910221057,7,2,4,4,3,20
1910221058,8,5,4,4,4,25
1910221059,3,7,9,7,3,29
1910221060,1,8,3,8,6,26
1910221061,7,1,3,8,5,24
1910221062,9,7,7,8,0,31
1910221063,1,5,3,8,3,20
1910221064,7,3,6,3,5,24
1910221065,9,4,2,9,0,24
1910221066,1,0,7,2,4,14
1910221067,2,9,5,3,5,24
1910221068,9,8,5,7,0,29
1910221069,9,8,7,9,5,38
1910221070,0,2,7,0,7,16
1910221071,1,9,9,9,0,28
1910221072,4,6,9,3,4,26
1910221073,9,8,9,7,9,42
1910221074,4,4,5,8,0,21
1910221075,6,3,1,9,8,27
1910221076,7,1,1,2,3,14
1910221077,6,1,2,8,6,23
1910221078,1,7,6,9,4,27
1910221079,7,7,8,3,8,33
1910221080,9,3,7,7,5,31
1910221081,5,2,1,7,6,21
1910221082,5,5,8,3,3,24
1910221083,5,5,9,9,1,29
1910221084,8,0,7,8,3,26
1910221085,4,4,9,1,4,22
1910221086,4,7,5,0,2,18
1910221087,4,3,8,2,6,23
1910221088,6,9,0,9,5,29
1910221089,4,1,8,9,0,22
1910221090,5,6,1,9,6,27
1910221091,7,4,5,5,9,30
1910221092,5,3,2,9,9,28
1910221093,1,0,3,4,3,11
1910221094,2,2,8,2,6,20
1910221095,3,3,8,0,3,17
1910221096,5,7,2,8,3,25
1910221097,1,4,9,9,4,27
1910221098,7,5,9,9,9,39
1910221099,4,5,0,2,1,12
1910221100,9,5,6,2,3,25
1910221101,9,7,5,3,9,33
1910221102,9,6,3,8,3,29
1910221103,7,9,5,1,4,26
1910221104,0,9,1,1,5,16
1910221105,3,9,8,2,8,30
191023001,3,6,3,2,2,16
191023002,7,0,6,3,7,23
191023003,6,0,2,2,3,13
191023004,5,7,0,4,9,25
191023005,5,3,2,8,8,26
191023006,8,9,5,0,1,23
191023007,2,3,3,3,0,11
191023008,7,3,2,1,4,17
191023009,4,1,7,1,8,21
191023010,0,0,9,5,5,19
191023011,2,3,5,4,3,17
191023012,9,1,0,4,3,17
191023013,0,6,3,7,9,25
191023014,1,6,9,5,1,22
191023015,5,2,3,4,2,16
191023016,8,3,4,5,4,24
191023017,8,9,6,9,3,35
191023018,8,5,4,6,8,31
191023019,2,4,8,4,6,24
191023020,8,9,9,2,2,30
191023021,7,6,9,2,9,33
191023022,6,8,2,3,9,28
191023023,6,5,2,8,1,22
191023024,2,4,8,1,4,19
191023025,3,3,1,0,2,9
191023026,9,1,9,8,8,35
191023027,0,2,3,4,2,11
191023028,0,4,0,2,0,6
191023029,6,9,7,5,1,28
191023030,8,8,8,4,6,34
191023031,2,0,9,7,4,22
191023032,8,4,5,3,0,20
191023033,1,2,9,5,3,20
191023034,3,0,8,1,0,12
191023035,1,2,8,4,9,24
191023036,0,2,6,0,7,15
191023037,8,0,9,4,8,29
191023038,6,9,5,9,6,35
191023039,8,0,5,9,8,30
191023040,0,4,7,5,0,16
191023041,6,2,3,4,1,16
191023042,6,8,3,5,8,30
191023043,8,1,0,8,3,20
191023044,4,5,4,3,7,23
191023045,1,5,2,0,1,9
191023046,5,0,3,8,6,22
191023047,3,2,1,1,3,10
191023048,8,6,9,7,6,36
191023049,9,0,1,2,4,16
191023050,8,4,9,2,5,28
191023051,5,6,0,6,4,21
191023052,6,0,8,6,7,27
191023053,0,0,0,2,9,11
191023054,5,7,0,9,0,21
191023055,6,4,7,1,9,27
191023056,7,8,7,9,4,35
191023057,1,2,3,4,9,19
191023058,3,9,4,5,8,29
191023059,8,4,4,0,4,20
191023060,9,0,6,6,7,28
191023061,8,6,2,4,6,26
191023062,1,8,1,5,0,15
191023063,7,9,7,6,9,38
191023064,3,5,8,1,1,18
191023065,1,3,0,5,7,16
191023066,1,8,5,1,0,15
191023067,6,2,6,9,1,24
191023068,6,8,7,2,3,26
191023069,0,6,0,1,0,7
191023070,8,7,6,4,3,28
191023071,5,0,2,6,2,15
191023072,6,8,7,5,0,26
191023073,4,8,9,4,6,31
191023074,7,3,5,7,4,26
191023075,9,4,0,4,2,19
191023076,7,7,3,6,5,28
191023077,9,4,3,1,7,24
191023078,4,1,8,8,2,23
191023079,4,3,9,1,8,25
191023080,2,4,7,3,5,21
191023081,4,1,5,4,2,16
191023082,9,0,3,7,4,23
191023083,1,6,2,1,1,11
191023084,5,2,7,4,2,20
191023085,1,7,0,5,0,13
191023086,3,3,6,1,8,21
191023087,7,4,1,4,4,20
191023088,6,5,0,4,2,17
191023089,2,3,7,3,9,24
191023090,3,0,7,5,9,24
191023091,4,3,3,1,9,20
191023092,8,8,2,3,8,29
191023093,2,9,3,8,2,24
191023094,8,6,9,6,1,30
191023095,8,2,6,7,3,26
191023096,0,9,2,3,8,22
191023097,3,8,3,2,6,22
191023098,9,0,7,3,7,26
191023099,0,0,1,8,2,11
191023100,3,3,3,9,0,18
191023101,8,9,8,0,5,30
191023102,4,9,0,7,9,29
191023103,0,0,9,5,6,20
191023104,5,1,9,3,3,21
191023105,6,2,7,0,3,18
191023106,4,9,2,2,8,25
191023107,8,0,6,3,4,21
191023108,6,7,6,6,7,32
191023109,0,6,2,9,5,22
191023110,0,1,9,4,9,23
191023111,6,1,4,5,2,18
191023112,7,4,0,2,7,20
191023113,6,1,4,6,5,22
191023114,1,0,1,7,3,12
191023115,4,8,2,1,7,22
191023116,6,5,5,1,8,25
191023117,1,6,5,0,6,18
191023118,1,2,3,0,3,9
191023119,7,9,2,7,1,26
191023120,3,8,5,0,2,18
191023121,2,3,2,6,2,15
191023122,3,9,9,6,0,27
191023123,4,0,3,1,2,10
191023124,5,5,5,3,5,23
191023125,2,8,2,6,3,21
191023126,7,4,7,8,9,35
191023127,0,3,3,0,6,12
191023128,7,8,6,4,4,29
191023129,7,8,9,6,7,37
191023130,2,9,1,8,3,23
191023131,0,6,0,1,3,10
191023132,1,8,5,6,3,23
191023133,2,1,9,8,9,29
191023134,5,1,8,7,0,21
191023135,9,2,6,3,4,24
191023136,7,7,5,9,5,33
191023137,3,4,6,6,6,25
191023138,6,0,0,1,9,16
191023139,1,9,9,3,4,26
191023140,3,6,3,0,5,17
191023141,2,1,9,3,0,15
191023142,7,1,5,0,9,22
191023143,9,5,8,6,6,34
191023144,4,6,1,4,7,22
191023145,8,6,4,0,6,24
191023146,4,4,9,7,4,28
191023147,0,6,1,8,1,16
191023148,0,9,2,9,4,24
191023149,1,3,1,1,6,12
191023150,8,0,6,0,1,15
191023151,5,4,8,6,7,30
191023152,7,0,7,0,1,15
191023153,8,5,7,3,7,30
191023154,6,1,3,2,1,13
191023155,0,2,1,5,5,13
191023156,4,4,9,0,4,21
191023157,3,9,7,7,9,35
191023158,6,0,6,2,0,14
191023159,3,0,7,6,3,19
191023160,9,5,5,1,4,24
191023161,9,9,8,4,8,38
191023162,4,3,7,7,8,29
191023163,1,7,3,7,5,23
191023164,2,5,8,3,6,24
191023165,2,4,3,2,7,18
191023166,1,1,2,6,1,11
191023167,5,7,6,8,9,35
191023168,2,7,5,1,3,18
191023169,9,2,6,4,5,26
191023170,5,0,7,1,7,20
191023171,1,7,9,9,4,30
191023172,4,7,4,5,1,21
191023173,0,1,6,3,0,10
191023174,5,4,2,0,3,14
191023175,0,7,3,4,6,20
191023176,7,9,6,8,8,38
191023177,9,0,4,5,0,18
191023178,3,1,3,4,4,15
191023179,8,8,4,5,4,29
191023180,6,9,3,3,1,22
191023181,5,6,1,1,8,21
191023182,9,8,4,1,3,25
191023183,5,1,4,7,7,24
191023184,5,4,6,8,8,31
191023185,3,8,4,6,3,24
191023186,2,4,3,9,4,22
191023187,2,6,5,9,0,22
191023188,0,6,6,2,4,18
191023189,5,0,2,2,9,18
191023190,9,5,9,0,9,32
191023191,2,7,7,3,3,22
191023192,1,6,8,3,1,19
191023193,5,7,5,8,8,33
191023194,8,1,5,7,8,29
191023195,5,4,2,4,5,20
191023196,1,6,9,4,8,28
191023197,7,1,7,3,0,18
191023198,3,0,4,8,9,24
191023199,6,9,6,5,6,32
191023200,0,4,4,5,1,14
191023201,3,2,4,2,8,19
191023202,1,7,9,9,9,35
191023203,3,1,0,3,1,8
191023204,1,8,8,9,3,29
191023205,0,5,4,8,9,26
191023206,8,0,6,4,5,23
191023207,7,4,6,5,8,30
191023208,1,9,9,3,9,31
191023209,0,8,7,7,9,31
191023210,8,5,5,3,2,23
191023211,2,8,8,1,0,19
191023212,6,2,6,5,4,23
191023213,3,4,9,3,7,26
191023214,2,9,1,8,7,27
191023215,3,2,8,4,9,26
191023216,2,3,1,5,5,16
191023217,8,7,8,2,2,27
191023218,9,9,9,1,1,29
191023219,4,1,5,7,0,17
191023220,5,5,1,5,5,21
191023221,2,2,7,1,4,16
191023222,5,4,0,3,8,20
191023223,6,3,5,0,2,16
191023224,0,9,4,1,2,16
191023225,3,0,4,8,6,21
191023226,0,5,0,9,1,15
191023227,0,4,1,7,2,14
191023228,5,4,6,9,9,33
191023229,6,8,7,2,8,31
191023230,1,8,3,6,4,22
191023231,5,0,1,6,6,18
191023232,7,7,5,6,1,26
191023233,4,6,1,2,6,19
191023234,7,2,8,4,2,23
191023235,8,5,3,1,6,23
191023236,4,1,6,7,0,18
191023237,0,0,5,2,0,7
191023238,8,2,0,8,8,26
191023239,5,0,9,1,3,18
191023240,6,3,5,4,9,27
191023241,1,9,4,2,6,22
191023242,4,9,7,7,3,30
191023243,3,6,1,9,7,26
191023244,6,3,2,0,9,20
191023245,6,4,5,0,4,19
191023246,2,3,4,1,7,17
191023247,9,6,0,7,0,22
191023248,1,4,9,6,3,23
191023249,1,3,2,0,4,10
191023250,0,7,7,8,1,23
191023251,2,0,2,4,5,13
191023252,9,5,0,4,2,20
191023253,8,6,4,8,9,35
191023254,9,0,5,2,7,23
191023255,3,3,8,0,6,20
191023256,6,1,5,5,7,24
191023257,4,3,1,1,4,13
191023258,0,7,9,3,6,25
191023259,6,4,5,7,8,30
191023260,6,7,2,3,6,24
191023261,2,3,0,7,8,20
191023262,5,6,2,8,9,30
191023263,9,2,8,8,2,29
191023264,2,7,1,2,2,14
191023265,2,9,3,6,6,26
191023266,1,5,7,8,4,25
191023267,3,4,0,9,9,25
191023268,6,4,9,5,5,29
191023269,5,9,9,9,6,38
191023270,2,1,0,7,5,15
191023271,5,4,8,4,8,29
191023272,4,3,4,7,7,25
191023273,5,5,6,2,5,23
191023274,1,7,4,5,5,22
191023275,6,1,6,6,6,25
191023276,7,5,1,0,1,14
191023277,7,5,3,5,4,24
191023278,2,5,5,4,3,19
191023279,6,2,5,0,1,14
191023280,7,3,9,1,7,27
191023281,1,6,2,4,8,21
191023282,5,6,6,5,6,28
191023283,5,8,7,7,7,34
191023284,3,2,3,2,9,19
191023285,3,3,3,6,3,18
191023286,6,0,4,8,6,24
191023287,4,0,5,6,7,22
191023288,2,9,2,1,3,17
191023289,9,6,4,9,1,29
191023290,1,8,9,6,8,32
191023291,1,7,7,7,4,26
191023292,9,0,1,5,1,16
191023293,4,4,5,0,7,20
191023294,1,9,5,1,1,17
191023295,5,6,0,1,2,14
191023296,8,1,9,2,4,24
191023297,7,1,9,4,8,29
191023298,2,0,9,9,3,23
191023299,2,1,2,8,9,22
191023300,3,5,7,9,9,33
191023301,5,3,2,9,1,20
191023302,1,7,5,8,9,30
191023303,4,2,0,3,6,15
191023304,3,6,6,7,4,26
191023305,6,4,4,0,6,20
191023306,7,2,6,5,6,26
191023307,7,9,3,7,2,28
191023308,7,3,8,4,7,29
191023309,5,2,3,6,9,25
191023310,5,6,3,9,6,29
191023311,7,8,4,0,1,20
191023312,7,8,2,0,8,25
191023313,1,5,7,6,8,27
191023314,7,4,0,1,3,15
191023315,3,4,6,3,4,20
191023316,9,1,8,5,0,23
191023317,7,9,9,9,2,36
191023318,3,1,7,0,2,13
191023319,8,8,5,8,0,29
191023320,5,8,8,0,6,27
191023321,5,9,1,7,5,27
191023322,8,0,2,9,7,26
191023323,2,6,1,8,2,19
191023324,4,9,8,3,9,33
191023325,8,5,5,9,7,34
191023326,6,7,1,8,5,27
191023327,4,3,5,4,7,23
191023328,1,6,0,9,6,22
191023329,6,6,1,9,1,23
191023330,8,0,4,7,6,25
191023331,2,8,8,8,5,31
191023332,0,1,1,7,1,10
191023333,7,6,7,0,8,28
191023334,3,5,8,0,2,18
191023335,0,2,2,6,2,12
191023336,7,3,2,7,4,23
191023337,0,7,0,7,4,18
191023338,4,8,7,7,8,34
191023339,7,8,2,0,7,24
191023340,2,9,9,4,3,27
191023341,3,3,2,1,6,15
191023342,0,0,8,0,6,14
191023343,8,9,9,7,5,38
191023344,9,5,2,2,4,22
191023345,8,7,7,8,7,37
191023346,6,8,4,2,5,25
191023347,9,7,6,5,6,33
191023348,0,2,7,6,6,21
191023349,0,2,5,1,7,15
191023350,7,1,6,6,3,23
191023351,5,6,7,9,5,32
191023352,1,1,8,9,5,24
191023353,1,2,4,5,7,19
191023354,0,4,3,9,8,24
191023355,8,7,7,8,3,33
191023356,8,0,2,7,2,19
191023357,4,6,6,7,7,30
191023358,0,8,6,5,1,20
191023359,0,0,6,3,3,12
191023360,3,4,3,5,8,23
191023361,2,1,2,2,5,12
191023362,3,6,7,4,8,28
191023363,9,0,3,5,0,17
191023364,2,8,0,1,2,13
191023365,9,7,0,2,6,24
191023366,1,4,3,9,0,17
191023367,0,9,5,7,9,30
191023368,6,3,9,9,2,29
191023369,4,7,2,7,1,21
191023370,6,9,4,8,6,33
191023371,1,7,3,4,2,17
191023372,4,9,0,2,7,22
191023373,0,8,1,2,9,20
191023374,9,7,8,4,9,37
191023375,4,5,2,9,3,23
191023376,3,4,9,2,8,26
191023377,9,3,3,9,5,29
191023378,6,2,1,5,6,20
191023379,8,9,2,0,9,28
191023380,6,7,5,1,6,25
191023381,6,7,1,8,8,30
191023382,7,9,4,1,8,29
191023383,7,9,2,2,9,29
191023384,3,3,8,4,4,22
191023385,7,0,5,5,6,23
191023386,5,8,8,0,2,23
191023387,7,4,2,4,0,17
191023388,7,9,2,7,0,25
191023389,0,0,0,8,1,9
191023390,5,4,9,0,8,26
191023391,1,6,5,2,3,17
191023392,8,5,5,0,1,19
191023393,6,5,4,1,2,18
191023394,2,3,0,6,3,14
191023395,0,4,8,1,3,16
191023396,8,8,7,9,0,32
191023397,9,9,4,1,6,29
191023398,4,3,4,3,8,22
191023399,4,7,0,3,5,19
191023400,9,7,2,0,8,26
191023401,8,5,0,4,3,20
191023402,9,9,0,3,8,29
191023403,9,4,6,9,8,36
191023404,7,1,5,7,1,21
191023405,5,2,8,9,3,27
191023406,8,3,0,5,8,24
191023407,4,1,2,6,9,22
191023408,2,9,3,9,0,23
191023409,3,4,1,7,6,21
191023410,2,1,3,6,2,14
191023411,9,7,3,1,3,23
191023412,6,9,5,4,1,25
191023413,7,1,2,2,1,13
191023414,7,5,6,7,8,33
191023415,5,4,5,6,3,23
191023416,4,1,3,8,1,17
191023417,1,7,7,2,3,20
191023418,5,4,4,6,5,24
191023419,9,0,4,9,9,31
191023420,0,9,6,4,8,27
191023421,0,8,6,9,5,28
191023422,8,2,0,3,0,13
191023423,5,8,6,1,0,20
191023424,2,4,7,8,3,24
191023425,2,4,7,5,4,22
191023426,7,5,6,1,0,19
191023427,9,7,5,2,9,32
191023428,6,2,1,9,1,19
191023429,7,5,5,1,5,23
191023430,0,1,3,6,8,18
191023431,6,2,6,1,1,16
191023432,5,1,1,0,0,7
191023433,1,7,6,4,6,24
191023434,0,9,3,0,4,16
191023435,4,1,9,0,5,19
191023436,3,9,2,4,0,18
191023437,4,5,7,1,4,21
191023438,3,2,0,3,3,11
191023439,0,7,6,2,3,18
191023440,6,6,8,3,5,28
191023441,9,4,7,6,8,34
191023442,5,5,7,8,0,25
191023443,2,9,9,7,9,36
191023444,6,8,5,5,6,30
191023445,6,8,7,0,6,27
191023446,8,9,5,6,0,28
191023447,7,2,7,6,3,25
191023448,9,0,4,5,7,25
191023449,8,3,5,3,7,26
191023450,8,0,7,7,5,27
191023451,7,2,7,0,2,18
191023452,1,8,0,3,3,15
191023453,3,4,1,8,7,23
191023454,1,4,0,6,0,11
191023455,6,0,5,5,3,19
191023456,5,0,9,1,4,19
191023457,3,4,0,6,6,19
191023458,7,0,4,2,5,18
191023459,6,1,1,5,4,17
191023460,0,6,0,8,0,14
191023461,6,4,8,4,6,28
191023462,6,4,3,6,3,22
191023463,2,6,1,0,5,14
191023464,1,2,3,1,3,10
191023465,0,2,9,3,0,14
191023466,6,7,9,1,6,29
191023467,1,8,9,3,2,23
191023468,3,0,9,1,5,18
191023469,9,0,5,0,9,23
191023470,6,3,5,9,4,27
191023471,1,1,0,3,1,6
191023472,7,8,8,7,0,30
191023473,9,9,6,6,0,30
191023474,7,3,5,3,3,21
191023475,8,1,5,4,3,21
191023476,2,9,4,2,1,18
191023477,0,8,1,1,5,15
191023478,7,9,0,2,2,20
191023479,7,7,1,8,9,32
191023480,3,5,5,9,6,28
191023481,8,3,2,5,8,26
191023482,5,6,2,6,6,25
191023483,2,5,3,5,9,24
191023484,8,3,6,0,0,17
191023485,4,1,5,2,8,20
191023486,6,2,7,4,0,19
191023487,7,2,4,9,2,24
191023488,2,0,0,6,1,9
191023489,8,6,3,0,2,19
191023490,1,1,1,1,7,11
191023491,6,8,5,4,3,26
191023492,3,0,6,8,1,18
191023493,1,5,6,8,3,23
191023494,5,3,3,3,8,22
191023495,4,8,7,4,6,29
191023496,1,6,6,5,6,24
191023497,2,8,0,6,9,25
191023498,1,8,6,1,1,17
191023499,9,7,7,0,1,24
191023500,8,3,7,7,6,31
191023501,5,9,9,6,5,34
191023502,4,5,0,8,2,19
191023503,0,1,9,8,9,27
191023504,0,4,5,1,3,13
191023505,9,5,2,4,9,29
191023506,1,3,0,7,0,11
191023507,8,0,4,4,8,24
191023508,9,2,9,5,4,29
191023509,4,1,1,4,3,13
191023510,6,5,4,6,0,21
191023511,1,2,7,0,6,16
191023512,3,8,2,1,8,22
191023513,4,1,3,9,9,26
191023514,8,9,5,2,6,30
191023515,4,7,9,6,0,26
191023516,5,1,8,9,7,30
191023517,0,9,3,1,0,13
191023518,1,8,8,9,4,30
191023519,3,2,6,9,7,27
191023520,2,1,2,8,0,13
191023521,0,8,3,4,8,23
191023522,7,0,8,8,9,32
191023523,0,6,2,0,4,12
191023524,2,1,9,6,7,25
191023525,3,6,3,1,9,22
191023526,2,4,8,4,0,18
191023527,7,5,6,7,6,31
191023528,5,5,7,8,4,29
191023529,7,7,0,5,7,26
191023530,4,3,3,3,6,19
191023531,7,2,4,0,2,15
191023532,7,5,5,6,1,24
191023533,9,8,5,5,3,30
191023534,1,6,8,2,1,18
191023535,7,0,1,3,5,16
191023536,6,5,3,4,8,26
191023537,3,4,3,8,0,18
191023538,7,3,8,0,7,25
191023539,0,5,6,7,9,27
191023540,4,9,1,9,4,27
191023541,4,9,0,8,7,28
191023542,8,2,5,1,0,16
191023543,9,8,7,2,6,32
191023544,0,5,7,6,2,20
191023545,6,1,7,5,9,28
191023546,4,6,0,4,3,17
191023547,0,2,0,1,7,10
191023548,3,5,0,4,9,21
191023549,5,4,1,0,0,10
191023550,5,1,7,6,5,24
191023551,5,7,7,9,8,36
191023552,9,4,7,8,8,36
191023553,0,8,4,1,5,18
191023554,3,2,3,5,3,16
191023555,1,8,2,3,8,22
191023556,2,5,2,4,2,15
191023557,0,8,3,2,2,15
191023558,2,0,6,1,9,18
191023559,2,1,1,3,5,12
191023560,3,7,9,9,5,33
191023561,5,8,6,1,7,27
191023562,9,1,1,8,3,22
191023563,4,2,6,6,0,18
191023564,6,8,9,3,1,27
191023565,6,7,7,8,7,35
191023566,2,5,1,4,6,18
191023567,1,9,8,6,0,24
191023568,7,4,9,4,6,30
191023569,3,2,5,3,0,13
191023570,5,4,4,1,0,14
191023571,1,5,7,0,9,22
191023572,1,2,4,6,7,20
191023573,7,1,8,0,2,18
191023574,5,8,7,0,0,20
191023575,7,6,6,9,9,37
191023576,6,5,7,1,0,19
191023577,8,8,6,9,6,37
191023578,3,9,4,3,0,19
191023579,3,1,6,3,4,17
191023580,9,1,0,0,8,18
191023581,8,8,9,0,5,30
191023582,7,5,8,4,1,25
191023583,0,2,1,1,1,5
191023584,0,4,9,9,8,30
191023585,1,0,1,7,4,13
191023586,8,5,8,9,5,35
191023587,2,1,6,4,1,14
191023588,0,9,0,4,8,21
191023589,1,5,6,6,6,24
191023590,7,9,5,5,5,31
191023591,1,7,2,5,6,21
191023592,8,6,7,2,9,32
191023593,6,5,8,5,4,28
191023594,7,1,0,7,8,23
191023595,8,6,6,4,2,26
191023596,3,1,2,0,9,15
191023597,4,6,8,8,8,34
191023598,0,9,5,2,7,23
191023599,3,1,8,5,9,26
191023600,7,1,3,9,7,27
191023601,4,5,8,4,6,27
191023602,5,2,7,8,1,23
191023603,3,5,1,0,8,17
191023604,3,6,2,4,6,21
191023605,5,8,7,3,1,24
191023606,9,7,5,9,4,34
191023607,7,0,2,2,2,13
191023608,3,9,5,7,5,29
191023609,7,9,7,5,4,32
191023610,8,6,6,0,0,20
191023611,7,8,3,7,3,28
191023612,2,9,7,5,0,23
191023613,3,4,7,6,7,27
191023614,4,5,6,1,1,17
191023615,8,1,0,2,2,13
191023616,8,7,9,8,6,38
191023617,9,8,6,6,3,32
191023618,4,4,1,3,1,13
191023619,6,2,9,5,0,22
191023620,6,9,4,1,3,23
191023621,2,5,3,4,3,17
191023622,6,3,3,1,1,14
191023623,9,6,0,8,6,29
191023624,2,9,6,8,1,26
191023625,9,2,5,2,0,18
191023626,6,8,6,7,4,31
191023627,3,9,1,3,2,18
191023628,4,5,7,4,6,26
191023629,8,9,7,9,3,36
191023630,7,2,7,9,4,29
191023631,0,7,6,5,3,21
191023632,5,0,5,6,8,24
191023633,2,6,0,2,1,11
191023634,4,5,0,9,1,19
191023635,9,3,9,1,6,28
191023636,9,6,4,1,7,27
191023637,7,2,4,9,3,25
191023638,6,5,5,1,3,20
191023639,2,7,7,9,5,30
191023640,0,5,8,4,9,26
191023641,2,1,8,6,3,20
191023642,8,0,6,2,4,20
191023643,7,0,7,2,3,19
191023644,1,8,4,1,7,21
191023645,8,6,9,5,2,30
191023646,2,0,8,5,4,19
191023647,7,4,3,8,4,26
191023648,3,4,9,8,3,27
191023649,6,9,1,1,3,20
191023650,8,4,2,0,6,20
191023651,8,2,7,7,8,32
191023652,9,0,9,9,7,34
191023653,4,2,3,0,4,13
191023654,7,6,9,6,3,31
191023655,1,8,2,1,5,17
191023656,0,9,5,3,9,26
191023657,4,5,9,2,5,25
191023658,2,9,6,3,7,27
191023659,1,2,0,5,0,8
191023660,6,9,5,7,8,35
191023661,3,1,2,8,4,18
191023662,7,0,6,9,6,28
191023663,4,2,2,0,1,9
191023664,7,8,4,2,1,22
191023665,1,6,2,9,9,27
191023666,9,1,3,9,2,24
191023667,6,9,0,3,3,21
191023668,2,8,7,1,0,18
191023669,8,1,5,0,4,18
191023670,5,4,0,9,1,19
191023671,5,5,1,4,4,19
191023672,8,9,5,7,3,32
191023673,7,6,8,9,1,31
191023674,1,2,1,8,8,20
191023675,2,4,9,6,2,23
191023676,3,8,5,2,6,24
191023677,5,1,7,5,8,26
191023678,8,7,3,4,2,24
191023679,5,5,8,1,8,27
191023680,4,8,7,4,2,25
191023681,8,0,6,1,1,16
191023682,4,4,2,2,0,12
191023683,7,9,2,8,6,32
191023684,1,3,1,5,9,19
191023685,3,3,7,9,0,22
191023686,9,9,1,5,6,30
191023687,2,1,1,1,4,9
191023688,5,4,6,7,6,28
191023689,4,4,1,5,9,23
191023690,1,6,9,6,8,30
191023691,5,4,6,4,8,27
191023692,0,7,2,4,7,20
191023693,9,5,3,4,7,28
191023694,0,2,5,0,4,11
191023695,8,4,9,8,9,38
191023696,7,5,6,9,6,33
191023697,3,0,3,7,5,18
191023698,3,3,3,4,4,17
191023699,0,1,1,6,5,13
191023700,9,6,9,1,4,29
191023701,5,0,7,7,8,27
191023702,4,4,3,4,4,19
191023703,8,3,5,7,0,23
191023704,4,7,3,5,8,27
191023705,7,0,8,9,6,30
191023706,0,7,9,8,5,29
191023707,9,1,9,5,2,26
191023708,8,9,1,4,0,22
191023709,3,9,7,2,4,25
191023710,7,4,4,8,5,28
191023711,4,4,2,1,2,13
191023712,7,1,5,7,4,24
191023713,6,2,6,8,1,23
191023714,4,7,2,9,4,26
191023715,6,0,1,4,9,20
191023716,2,5,5,3,6,21
191023717,9,2,0,4,0,15
191023718,5,3,3,1,4,16
191023719,6,3,4,2,4,19
191023720,1,0,1,4,1,7
191023721,8,0,5,9,7,29
191023722,0,0,4,7,7,18
191023723,9,6,8,7,2,32
191023724,9,6,5,9,1,30
191023725,7,7,9,4,6,33
191023726,2,7,9,8,4,30
191023727,2,2,5,4,9,22
191023728,8,1,1,7,4,21
191023729,3,5,8,0,1,17
191023730,8,4,9,4,9,34
191023731,4,0,8,6,0,18
191023732,7,7,8,5,7,34
191023733,9,4,8,4,0,25
191023734,1,8,8,1,1,19
191023735,0,5,0,6,3,14
191023736,1,4,9,6,7,27
191023737,4,5,8,9,3,29
191023738,8,0,7,8,6,29
191023739,1,4,6,4,7,22
191023740,7,7,9,5,3,31
191023741,2,9,3,9,7,30
191023742,8,5,3,9,2,27
191023743,7,0,1,8,4,20
191023744,3,6,1,5,4,19
191023745,0,7,0,5,4,16
191023746,9,3,5,7,4,28
191023747,2,5,1,9,5,22
191023748,5,5,3,5,2,20
191023749,2,5,6,2,3,18
191023750,0,0,5,2,4,11
191023751,6,3,7,6,7,29
191023752,2,5,4,1,1,13
191023753,6,6,6,4,2,24
191023754,2,9,5,8,2,26
191023755,4,0,3,3,7,17
191023756,6,3,2,5,8,24
191023757,5,1,6,1,3,16
191023758,5,8,8,4,3,28
191023759,5,8,8,1,9,31
191023760,8,8,0,9,1,26
191023761,5,4,6,2,0,17
191023762,9,7,6,9,7,38
191023763,4,4,0,4,0,12
191023764,8,6,1,4,1,20
191023765,6,3,9,6,2,26
191023766,1,8,9,9,8,35
191023767,3,6,5,8,7,29
191023768,7,4,8,6,2,27
191023769,1,1,8,4,1,15
191023770,1,4,6,9,3,23
191023771,7,1,5,6,4,23
191023772,0,1,4,6,9,20
191023773,9,4,0,4,3,20
191023774,0,4,8,1,8,21
191023775,4,6,4,5,1,20
191023776,8,4,9,3,5,29
191023777,8,6,3,6,2,25
191023778,3,9,0,7,1,20
191023779,8,3,1,1,0,13
191023780,6,7,3,8,0,24
191023781,0,1,6,7,5,19
191023782,4,9,2,5,3,23
191023783,4,7,6,1,7,25
191023784,5,9,2,3,8,27
191023785,7,9,6,8,2,32
191023786,5,7,5,6,4,27
191023787,6,6,4,7,3,26
191023788,9,8,8,8,2,35
191023789,9,2,6,2,5,24
191023790,3,8,5,7,0,23
191023791,8,0,9,4,5,26
191023792,6,3,4,7,8,28
191023793,6,6,0,8,6,26
191023794,8,7,8,5,5,33
191023795,0,1,7,8,1,17
191023796,8,1,6,7,1,23
191023797,6,1,2,0,8,17
191023798,5,0,6,6,2,19
191023799,9,9,5,7,8,38
191023800,7,0,1,7,6,21
191023801,3,8,9,9,1,30
191023802,0,7,8,5,5,25
191023803,3,5,0,7,0,15
191023804,5,7,7,6,4,29
191023805,8,8,7,4,9,36
191023806,4,8,8,6,0,26
191023807,0,4,3,8,3,18
191023808,2,3,9,5,8,27
191023809,5,4,0,7,6,22
191023810,1,7,7,2,6,23
191023811,4,2,5,6,5,22
191023812,1,2,6,9,4,22
191023813,5,8,3,1,0,17
191023814,4,2,5,7,0,18
191023815,7,0,0,2,7,16
191023816,6,0,9,0,9,24
191023817,5,8,4,6,5,28
191023818,7,5,1,5,2,20
191023819,3,9,7,9,9,37
191023820,7,9,4,6,6,32
191023821,3,4,0,2,1,10
191023822,8,0,8,5,1,22
191023823,9,3,3,0,3,18
191023824,5,8,6,5,4,28
191023825,0,0,4,9,3,16
191023826,0,4,5,3,6,18
191023827,8,2,6,6,3,25
191023828,6,6,7,6,1,26
191023829,3,6,4,3,1,17
191023830,9,6,1,1,3,20
191023831,9,2,5,0,7,23
191023832,1,6,6,9,0,22
191023833,9,1,6,3,2,21
191023834,0,3,0,1,6,10
191023835,8,0,4,1,6,19
191023836,4,1,4,9,4,22
191023837,4,6,2,4,3,19
191023838,5,9,6,0,9,29
191023839,7,7,1,6,3,24
191023840,7,8,8,6,9,38
191023841,0,9,7,0,3,19
191023842,1,8,4,8,0,21
191023843,9,3,5,6,2,25
191023844,4,2,1,6,0,13
191023845,8,3,5,7,3,26
191023846,0,6,0,7,2,15
191023847,5,3,7,7,2,24
191023848,1,4,7,6,1,19
191023849,6,1,0,2,5,14
191023850,9,8,9,0,8,34
191023851,0,5,3,6,7,21
191023852,6,5,2,2,3,18
191023853,6,6,8,1,3,24
191023854,6,4,2,2,5,19
191023855,8,1,9,8,2,28
191023856,6,6,9,5,3,29
191023857,0,4,1,1,8,14
191023858,8,8,4,4,7,31
191023859,6,2,2,4,1,15
191023860,9,8,3,0,0,20
191023861,9,1,6,9,3,28
191023862,8,4,1,3,5,21
191023863,2,2,7,5,9,25
191023864,4,4,9,6,4,27
191023865,2,1,3,7,6,19
191023866,0,6,9,6,4,25
191023867,6,0,3,9,6,24
191023868,4,6,4,4,5,23
191023869,7,5,7,5,0,24
191023870,1,0,8,6,5,20
191023871,9,6,0,3,3,21
191023872,7,0,8,0,8,23
191023873,4,3,4,4,3,18
191023874,4,6,9,9,6,34
191023875,2,0,2,2,1,7
191023876,3,2,0,4,1,10
191023877,3,7,0,2,5,17
191023878,0,4,8,6,2,20
191023879,3,4,5,6,3,21
191023880,5,8,6,1,9,29
191023881,8,2,4,4,9,27
191023882,3,3,9,4,3,22
191023883,2,6,9,6,9,32
191023884,1,4,2,5,8,20
191023885,2,2,1,9,1,15
191023886,1,1,5,4,0,11
191023887,3,8,6,7,6,30
191023888,3,4,3,5,7,22
191023889,7,1,2,7,1,18
191023890,6,5,6,8,4,29
191023891,7,3,7,4,7,28
191023892,0,4,9,4,7,24
191023893,0,5,8,5,0,18
191023894,9,4,2,9,5,29
191023895,6,3,4,2,3,18
191023896,3,3,3,1,9,19
191023897,4,3,2,6,9,24
191023898,5,4,9,1,1,20
191023899,0,1,4,0,5,10
191023900,9,3,2,2,1,17
191023901,1,7,9,4,2,23
191023902,4,6,4,6,1,21
191023903,8,8,1,6,3,26
191023904,0,9,8,4,2,23
191023905,8,7,8,3,8,34
191023906,7,0,3,1,0,11
191023907,0,7,8,6,1,22
191023908,4,9,8,4,9,34
191023909,0,4,2,3,4,13
191023910,0,2,9,6,8,25
191023911,4,3,6,7,9,29
191023912,1,7,3,3,5,19
191023913,7,0,9,8,7,31
191023914,0,0,4,5,2,11
191023915,3,7,1,2,3,16
191023916,5,2,6,0,4,17
191023917,3,9,9,0,9,30
191023918,7,4,7,4,0,22
191023919,3,2,6,7,5,23
191023920,4,8,4,2,6,24
191023921,4,6,8,4,8,30
191023922,3,6,0,6,5,20
191023923,0,3,3,4,2,12
191023924,2,3,2,2,8,17
191023925,2,1,6,6,7,22
191023926,4,9,0,8,8,29
191023927,1,5,6,5,1,18
191023928,8,1,0,8,1,18
191023929,9,9,0,5,4,27
191023930,3,9,2,4,7,25
191023931,8,2,4,3,2,19
191023932,1,7,4,0,4,16
191023933,9,4,6,4,7,30
191023934,3,7,5,8,8,31
191023935,2,6,5,3,8,24
191023936,3,5,3,2,1,14
191023937,7,5,3,8,1,24
191023938,6,0,5,5,8,24
191023939,1,4,4,2,4,15
191023940,3,4,9,5,0,21
191023941,5,3,0,9,4,21
191023942,4,0,6,1,7,18
191023943,1,7,8,6,0,22
191023944,2,7,8,1,2,20
191023945,5,0,4,9,2,20
191023946,7,4,6,4,2,23
191023947,1,0,4,3,9,17
191023948,9,2,8,0,0,19
191023949,5,2,5,4,4,20
191023950,7,9,8,3,0,27
191023951,0,8,0,9,5,22
191023952,9,0,9,1,6,25
191023953,6,2,7,6,4,25
191023954,0,5,7,1,9,22
191023955,7,5,5,4,1,22
191023956,9,1,7,3,0,20
191023957,6,6,6,2,4,24
191023958,5,3,6,4,4,22
191023959,6,8,0,6,7,27
191023960,0,2,7,9,0,18
191023961,4,7,5,9,7,32
191023962,6,6,9,5,0,26
191023963,4,1,5,0,1,11
191023964,8,0,5,5,7,25
191023965,7,0,9,6,3,25
191023966,2,4,0,8,6,20
191023967,6,1,6,4,2,19
191023968,0,8,4,7,7,26
191023969,5,1,6,4,4,20
191023970,8,6,3,9,6,32
191023971,4,3,1,7,1,16
191023972,4,4,2,6,0,16
191023973,0,7,8,3,3,21
191023974,9,9,9,5,1,33
191023975,7,5,2,7,7,28
191023976,7,6,9,2,0,24
191023977,6,0,4,1,1,12
191023978,0,9,7,1,8,25
191023979,2,5,7,9,2,25
191023980,1,1,5,4,1,12
191023981,9,8,2,1,0,20
191023982,2,5,4,4,6,21
191023983,5,6,5,9,0,25
191023984,5,1,8,0,8,22
191023985,6,3,7,6,6,28
191023986,5,8,5,5,3,26
191023987,8,8,8,3,8,35
191023988,0,9,9,0,5,23
191023989,8,6,1,6,1,22
191023990,3,4,0,5,8,20
191023991,4,0,7,2,0,13
191023992,9,7,8,4,3,31
191023993,7,3,4,3,6,23
191023994,8,8,2,3,6,27
191023995,4,3,3,3,2,15
191023996,3,0,3,9,7,22
191023997,5,4,3,0,1,13
191023998,7,3,0,1,7,18
191023999,8,7,5,7,3,30
1910231000,6,0,7,5,0,18
1910231001,9,6,1,3,6,25
1910231002,2,9,1,4,6,22
1910231003,8,7,9,9,7,40
1910231004,9,1,0,0,0,10
1910231005,7,4,2,2,6,21
1910231006,7,4,8,7,5,31
1910231007,8,2,1,0,9,20
1910231008,2,8,9,7,1,27
1910231009,8,4,7,8,3,30
1910231010,8,0,9,6,5,28
1910231011,8,3,9,1,3,24
1910231012,5,8,2,3,4,22
1910231013,5,5,3,9,9,31
1910231014,5,1,0,5,1,12
1910231015,4,5,6,5,9,29
1910231016,9,0,9,4,0,22
1910231017,2,0,0,3,7,12
1910231018,4,8,1,8,1,22
1910231019,5,7,0,8,9,29
1910231020,7,4,6,6,2,25
1910231021,0,5,9,7,6,27
1910231022,3,5,3,7,3,21
1910231023,1,7,7,4,5,24
1910231024,8,4,2,4,1,19
1910231025,2,3,9,7,7,28
1910231026,9,6,4,8,3,30
1910231027,7,7,5,1,7,27
1910231028,6,0,5,0,8,19
1910231029,3,7,3,9,7,29
1910231030,5,5,2,3,2,17
1910231031,5,2,0,6,3,16
1910231032,8,0,9,4,6,27
1910231033,4,4,0,7,3,18
1910231034,7,7,2,9,5,30
1910231035,2,2,0,0,3,7
1910231036,6,9,6,1,4,26
1910231037,1,4,4,1,6,16
1910231038,4,4,7,4,7,26
1910231039,8,1,5,7,4,25
1910231040,6,0,5,5,1,17
1910231041,5,7,2,7,8,29
1910231042,6,8,8,3,3,28
1910231043,0,4,2,8,8,22
1910231044,1,7,6,1,6,21
1910231045,9,5,5,5,5,29
1910231046,9,9,4,6,5,33
1910231047,8,7,0,9,6,30
1910231048,5,1,3,3,7,19
1910231049,0,0,5,9,2,16
1910231050,4,9,9,6,0,28
1910231051,3,5,4,8,7,27
1910231052,6,4,1,3,8,22
1910231053,2,3,5,0,7,17
1910231054,3,2,3,7,0,15
1910231055,3,6,9,6,9,33
1910231056,8,3,2,8,0,21
1910231057,1,1,6,9,7,24
1910231058,4,0,3,2,3,12
1910231059,9,2,2,4,3,20
1910231060,1,1,1,9,3,15
1910231061,1,2,1,9,0,13
1910231062,0,4,5,5,6,20
1910231063,5,1,6,2,4,18
1910231064,1,7,2,5,0,15
1910231065,1,8,0,0,1,10
1910231066,9,6,7,3,0,25
1910231067,5,2,6,6,7,26
1910231068,4,3,9,2,8,26
1910231069,8,6,3,1,5,23
1910231070,8,2,6,5,1,22
1910231071,9,8,8,5,7,37
1910231072,8,5,6,7,3,29
1910231073,2,0,8,0,9,19
1910231074,4,5,3,0,1,13
1910231075,6,1,2,0,6,15
1910231076,7,2,3,3,6,21
1910231077,7,0,8,2,2,19
1910231078,4,4,7,0,0,15
1910231079,2,6,7,6,9,30
1910231080,1,6,2,0,7,16
1910231081,9,0,4,3,3,19
1910231082,0,7,7,7,0,21
1910231083,2,7,2,0,6,17
1910231084,7,8,1,8,0,24
1910231085,9,1,7,8,9,34
1910231086,1,6,6,2,3,18
1910231087,9,7,2,6,4,28
1910231088,4,4,3,6,4,21
1910231089,5,1,4,8,1,19
1910231090,4,8,9,8,5,34
1910231091,4,1,1,0,8,14
1910231092,5,6,9,3,0,23
1910231093,0,9,1,7,3,20
1910231094,3,5,9,7,4,28
1910231095,8,9,8,0,0,25
1910231096,3,2,4,3,2,14
1910231097,5,2,8,5,4,24
1910231098,2,5,6,9,2,24
1910231099,7,9,1,5,6,28
1910231100,9,8,6,1,7,31
1910231101,3,4,2,8,3,20
1910231102,6,2,3,1,3,15
1910231103,4,5,9,7,6,31
1910231104,9,1,5,0,3,18
1910231105,0,7,9,0,1,17
191024001,5,7,9,0,1,22
191024002,1,8,3,7,7,26
191024003,4,3,6,1,9,23
191024004,6,2,1,0,1,10
191024005,4,0,5,2,3,14
191024006,4,4,8,5,9,30
191024007,0,1,5,0,1,7
191024008,0,7,0,5,7,19
191024009,8,8,3,7,0,26
191024010,8,3,2,0,2,15
191024011,8,3,3,0,2,16
191024012,3,8,2,5,2,20
191024013,8,9,9,9,6,41
191024014,5,7,9,5,7,33
191024015,1,4,5,7,8,25
191024016,3,0,0,0,8,11
191024017,1,0,8,6,2,17
191024018,1,1,9,2,8,21
191024019,6,3,9,5,7,30
191024020,0,7,5,7,2,21
191024021,8,4,7,2,4,25
191024022,0,0,8,8,0,16
191024023,2,1,1,8,6,18
191024024,7,7,4,1,8,27
191024025,9,7,2,2,7,27
191024026,4,3,3,6,3,19
191024027,7,2,7,8,6,30
191024028,1,9,4,2,5,21
191024029,2,8,4,5,9,28
191024030,7,6,4,3,6,26
191024031,3,3,1,1,7,15
191024032,9,4,0,4,4,21
191024033,7,6,6,9,6,34
191024034,1,7,3,7,2,20
191024035,1,6,8,8,4,27
191024036,3,2,1,5,3,14
191024037,3,5,9,6,6,29
191024038,2,5,5,2,6,20
191024039,1,9,3,1,6,20
191024040,8,0,5,0,3,16
191024041,8,3,1,2,2,16
191024042,3,9,1,3,3,19
191024043,4,8,0,9,7,28
191024044,7,6,3,4,8,28
191024045,3,5,6,4,7,25
191024046,4,7,6,2,3,22
191024047,5,5,7,3,7,27
191024048,6,8,8,2,8,32
191024049,3,2,6,3,3,17
191024050,8,7,0,0,1,16
191024051,5,1,2,9,1,18
191024052,3,3,5,1,7,19
191024053,7,7,6,1,6,27
191024054,1,6,8,8,9,32
191024055,6,7,4,9,7,33
191024056,2,1,7,3,2,15
191024057,5,7,5,2,6,25
191024058,0,5,8,6,8,27
191024059,2,3,9,2,9,25
191024060,7,8,8,3,4,30
191024061,8,8,8,1,1,26
191024062,5,7,4,7,4,27
191024063,5,3,7,2,7,24
191024064,7,7,0,1,1,16
191024065,3,2,7,7,5,24
191024066,0,4,1,0,7,12
191024067,9,9,3,1,3,25
191024068,0,4,7,2,1,14
191024069,7,9,9,4,2,31
191024070,7,9,1,5,1,23
191024071,7,2,0,9,0,18
191024072,1,6,2,7,6,22
191024073,0,1,7,0,1,9
191024074,9,1,0,4,6,20
191024075,1,1,9,2,4,17
191024076,7,0,8,3,8,26
191024077,0,2,5,8,6,21
191024078,1,1,9,5,9,25
191024079,5,5,5,8,6,29
191024080,4,1,9,7,8,29
191024081,6,2,2,2,6,18
191024082,7,0,6,5,9,27
191024083,6,4,7,5,3,25
191024084,0,9,6,2,3,20
191024085,8,3,3,6,2,22
191024086,4,4,4,4,2,18
191024087,7,5,6,5,7,30
191024088,7,9,3,9,0,28
191024089,2,5,7,2,7,23
191024090,9,3,9,2,9,32
191024091,5,0,6,9,3,23
191024092,7,9,7,5,8,36
191024093,2,4,6,1,2,15
191024094,5,1,9,2,7,24
191024095,6,3,2,3,1,15
191024096,2,7,8,8,0,25
191024097,2,4,5,0,3,14
191024098,8,0,8,2,8,26
191024099,7,8,2,7,0,24
191024100,2,5,5,1,1,14
191024101,9,5,5,2,7,28
191024102,9,8,7,1,3,28
191024103,5,8,2,1,6,22
191024104,7,4,2,7,0,20
191024105,3,3,7,2,3,18
191024106,2,6,7,5,4,24
191024107,4,6,4,9,1,24
191024108,5,3,8,4,4,24
191024109,5,8,1,2,6,22
191024110,7,0,3,1,5,16
191024111,6,7,9,9,2,33
191024112,2,9,7,7,8,33
191024113,1,3,4,7,2,17
191024114,7,2,5,7,7,28
191024115,5,8,6,4,5,28
191024116,7,9,9,2,4,31
191024117,7,3,2,9,9,30
191024118,2,5,7,5,9,28
191024119,5,4,4,8,4,25
191024120,0,0,2,3,2,7
191024121,0,1,2,7,3,13
191024122,5,3,6,8,4,26
191024123,8,5,8,7,1,29
191024124,3,4,7,3,8,25
191024125,5,9,1,0,7,22
191024126,6,8,5,9,5,33
191024127,9,0,3,8,0,20
191024128,7,5,6,3,9,30
191024129,3,9,8,0,8,28
191024130,5,8,6,3,5,27
191024131,0,6,9,0,9,24
191024132,9,5,5,6,6,31
191024133,6,7,9,3,8,33
191024134,0,4,5,4,3,16
191024135,3,0,4,5,0,12
191024136,7,7,9,8,7,38
191024137,9,6,2,9,5,31
191024138,8,1,5,1,7,22
191024139,0,8,2,0,9,19
191024140,1,5,1,8,6,21
191024141,6,1,1,6,1,15
191024142,9,1,7,6,2,25
191024143,4,9,3,6,5,27
191024144,9,4,6,1,0,20
191024145,0,9,6,5,3,23
191024146,9,3,8,0,7,27
191024147,3,6,1,3,9,22
191024148,0,5,3,2,7,17
191024149,9,1,4,8,3,25
191024150,2,5,5,8,1,21
191024151,8,9,6,2,0,25
191024152,2,1,6,2,8,19
191024153,1,8,8,2,0,19
191024154,0,2,0,1,1,4
191024155,4,1,2,3,3,13
191024156,4,5,2,4,2,17
191024157,3,4,2,6,3,18
191024158,9,0,0,4,3,16
191024159,6,6,9,4,4,29
191024160,2,6,7,6,1,22
191024161,7,9,1,4,1,22
191024162,6,8,9,8,4,35
191024163,2,0,2,3,4,11
191024164,6,5,8,3,5,27
191024165,9,8,9,1,2,29
191024166,6,9,9,7,7,38
191024167,9,5,6,6,7,33
191024168,7,0,3,0,6,16
191024169,2,2,5,4,4,17
191024170,8,6,6,8,4,32
191024171,9,0,0,5,3,17
191024172,2,0,4,4,1,11
191024173,2,3,4,1,5,15
191024174,2,4,3,4,4,17
191024175,6,8,3,9,1,27
191024176,9,2,6,1,1,19
191024177,7,6,6,6,7,32
191024178,8,4,8,6,0,26
191024179,2,8,4,5,5,24
191024180,6,8,1,4,2,21
191024181,4,5,3,7,4,23
191024182,7,1,8,8,5,29
191024183,0,7,7,6,7,27
191024184,7,4,4,1,5,21
191024185,7,4,7,7,1,26
191024186,9,7,4,0,5,25
191024187,7,8,0,2,5,22
191024188,3,0,2,7,8,20
191024189,3,3,4,7,1,18
191024190,0,5,7,5,5,22
191024191,9,0,6,4,2,21
191024192,8,1,2,1,3,15
191024193,5,0,4,5,9,23
191024194,0,7,6,5,4,22
191024195,1,0,1,5,0,7
191024196,2,1,5,3,8,19
191024197,7,2,5,0,2,16
191024198,6,8,1,4,5,24
191024199,2,7,6,6,4,25
191024200,2,2,0,3,2,9
191024201,8,3,3,2,4,20
191024202,5,9,7,3,3,27
191024203,1,1,2,4,8,16
191024204,8,2,6,9,1,26
191024205,3,5,0,9,6,23
191024206,2,4,3,5,9,23
191024207,7,0,3,3,6,19
191024208,6,8,6,6,6,32
191024209,7,4,8,2,1,22
191024210,1,7,7,5,7,27
191024211,7,0,2,3,1,13
191024212,5,2,2,7,8,24
191024213,8,9,3,4,2,26
191024214,7,2,2,5,5,21
191024215,6,1,2,2,1,12
191024216,7,5,0,4,5,21
191024217,7,3,3,5,7,25
191024218,4,8,7,1,5,25
191024219,8,4,0,1,1,14
191024220,4,1,1,9,8,23
191024221,2,3,8,3,4,20
191024222,0,6,1,3,5,15
191024223,0,3,7,9,8,27
191024224,1,7,5,5,1,19
191024225,5,2,7,9,7,30
191024226,4,3,7,8,8,30
191024227,5,4,8,5,3,25
191024228,8,2,1,6,9,26
191024229,9,2,7,4,2,24
191024230,7,7,3,2,7,26
191024231,1,6,0,4,8,19
191024232,9,7,3,0,0,19
191024233,8,9,6,4,8,35
191024234,6,0,0,0,8,14
191024235,3,4,6,1,8,22
191024236,9,1,6,6,5,27
191024237,9,0,4,0,6,19
191024238,4,0,6,3,0,13
191024239,0,8,7,9,3,27
191024240,5,3,2,8,6,24
191024241,5,2,0,4,0,11
191024242,9,9,4,6,6,34
191024243,7,6,6,5,0,24
191024244,6,1,9,6,2,24
191024245,5,2,1,4,8,20
191024246,4,8,4,4,5,25
191024247,8,8,1,8,3,28
191024248,5,7,6,9,9,36
191024249,6,9,3,5,4,27
191024250,5,2,4,0,3,14
191024251,0,1,4,2,4,11
191024252,7,9,4,3,5,28
191024253,6,2,1,6,7,22
191024254,7,1,4,8,5,25
191024255,0,2,4,7,2,15
191024256,0,5,0,9,8,22
191024257,3,5,6,0,1,15
191024258,8,3,5,9,2,27
191024259,6,9,2,6,1,24
191024260,6,5,2,9,3,25
191024261,9,4,7,9,8,37
191024262,5,1,7,9,0,22
191024263,2,0,4,6,3,15
191024264,4,4,2,9,1,20
191024265,6,2,7,4,1,20
191024266,8,6,2,1,5,22
191024267,2,3,2,9,3,19
191024268,1,0,4,4,9,18
191024269,3,9,5,8,6,31
191024270,2,4,9,6,7,28
191024271,5,8,9,4,1,27
191024272,8,8,9,8,5,38
191024273,9,5,9,0,0,23
191024274,0,9,8,0,3,20
191024275,7,6,5,9,6,33
191024276,3,3,5,5,8,24
191024277,7,7,2,1,6,23
191024278,3,0,0,6,9,18
191024279,5,5,0,4,6,20
191024280,8,9,9,2,9,37
191024281,6,3,3,1,3,16
191024282,1,1,2,0,1,5
191024283,0,6,5,9,6,26
191024284,5,7,0,8,2,22
191024285,3,8,7,5,8,31
191024286,9,3,9,5,6,32
191024287,3,9,9,8,2,31
191024288,5,4,9,1,9,28
191024289,6,2,1,3,8,20
191024290,7,9,0,9,6,31
191024291,1,9,8,8,5,31
191024292,6,9,3,8,1,27
191024293,5,1,7,9,9,31
191024294,4,0,8,9,7,28
191024295,7,6,1,6,3,23
191024296,1,5,8,6,5,25
191024297,7,7,4,5,0,23
191024298,4,8,2,1,1,16
191024299,0,2,2,0,9,13
191024300,0,0,5,4,5,14
191024301,8,1,1,5,7,22
191024302,9,5,9,6,7,36
191024303,4,0,4,5,8,21
191024304,5,3,4,8,6,26
191024305,2,4,7,5,0,18
191024306,0,9,6,9,5,29
191024307,8,1,9,3,0,21
191024308,1,2,1,3,3,10
191024309,0,6,2,9,9,26
191024310,5,3,8,4,1,21
191024311,1,5,0,9,9,24
191024312,6,3,5,6,9,29
191024313,9,5,9,7,0,30
191024314,1,3,6,0,4,14
191024315,3,5,0,8,0,16
191024316,1,6,3,4,2,16
191024317,6,5,4,4,2,21
191024318,1,0,8,1,9,19
191024319,2,8,0,5,4,19
191024320,3,4,7,3,0,17
191024321,7,6,2,5,7,27
191024322,7,7,4,0,5,23
191024323,1,7,8,3,6,25
191024324,8,6,6,4,0,24
191024325,0,0,1,4,4,9
191024326,3,3,5,5,9,25
191024327,0,4,0,9,2,15
191024328,1,2,0,7,7,17
191024329,1,0,7,6,6,20
191024330,9,0,9,3,9,30
191024331,8,9,6,8,8,39
191024332,3,6,3,2,5,19
191024333,7,6,5,5,3,26
191024334,0,4,2,9,1,16
191024335,6,1,2,4,8,21
191024336,1,5,3,2,8,19
191024337,4,8,2,3,3,20
191024338,6,3,2,7,0,18
191024339,9,8,8,2,3,30
191024340,6,3,1,9,4,23
191024341,9,7,6,7,8,37
191024342,2,7,1,0,8,18
191024343,3,5,7,0,1,16
191024344,7,8,6,9,8,38
191024345,0,4,3,2,7,16
191024346,4,7,7,5,3,26
191024347,3,4,8,0,8,23
191024348,0,4,5,8,3,20
191024349,4,3,8,8,5,28
191024350,3,7,2,8,8,28
191024351,2,8,4,8,8,30
191024352,9,9,3,0,9,30
191024353,8,0,8,0,4,20
191024354,8,8,9,2,2,29
191024355,0,6,2,9,7,24
191024356,8,3,6,4,2,23
191024357,8,3,9,8,6,34
191024358,9,2,2,0,0,13
191024359,2,6,5,6,0,19
191024360,8,1,3,6,8,26
191024361,8,1,3,4,8,24
191024362,3,3,3,4,5,18
191024363,4,1,9,1,2,17
191024364,1,5,2,0,3,11
191024365,5,3,3,0,7,18
191024366,3,8,6,4,7,28
191024367,9,4,4,3,8,28
191024368,6,5,1,8,7,27
191024369,6,9,7,4,9,35
191024370,3,8,7,8,2,28
191024371,0,8,9,4,8,29
191024372,8,9,6,2,7,32
191024373,7,0,7,7,8,29
191024374,6,7,0,3,1,17
191024375,0,1,4,7,8,20
191024376,5,6,1,7,9,28
191024377,7,1,1,5,8,22
191024378,4,9,8,4,4,29
191024379,9,9,1,9,7,35
191024380,5,5,2,6,5,23
191024381,5,8,1,5,0,19
191024382,4,4,2,1,8,19
191024383,0,1,1,2,4,8
191024384,2,9,8,2,8,29
191024385,6,7,9,3,3,28
191024386,6,0,1,7,8,22
191024387,7,8,8,4,1,28
191024388,9,3,2,6,5,25
191024389,5,5,2,8,1,21
191024390,6,7,5,7,8,33
191024391,3,5,5,9,2,24
191024392,6,9,8,9,8,40
191024393,6,2,7,3,5,23
191024394,5,9,6,5,5,30
191024395,8,4,4,1,7,24
191024396,2,3,3,5,4,17
191024397,8,4,2,9,2,25
191024398,0,3,2,0,9,14
191024399,0,4,8,0,0,12
191024400,1,4,5,2,0,12
191024401,9,2,0,2,8,21
191024402,0,7,8,3,1,19
191024403,2,1,3,1,0,7
191024404,6,3,0,6,7,22
191024405,0,4,7,2,5,18
191024406,4,7,9,0,5,25
191024407,6,0,6,7,9,28
191024408,3,2,5,5,9,24
191024409,6,6,3,9,6,30
191024410,5,1,2,0,0,8
191024411,7,0,9,5,9,30
191024412,2,4,2,9,5,22
191024413,0,1,5,6,5,17
191024414,1,2,6,6,4,19
191024415,8,9,2,5,7,31
191024416,4,3,4,4,1,16
191024417,4,8,5,0,8,25
191024418,4,2,2,1,8,17
191024419,7,7,1,1,4,20
191024420,8,3,5,4,0,20
191024421,5,1,7,9,2,24
191024422,4,2,4,9,2,21
191024423,1,0,8,3,3,15
191024424,7,1,0,4,2,14
191024425,5,3,0,1,6,15
191024426,3,6,5,0,6,20
191024427,7,4,1,3,5,20
191024428,4,5,3,1,6,19
191024429,3,7,1,6,8,25
191024430,3,2,8,8,0,21
191024431,0,1,9,4,1,15
191024432,5,8,4,2,0,19
191024433,6,7,0,1,9,23
191024434,2,7,8,8,2,27
191024435,2,7,0,6,9,24
191024436,7,3,4,2,5,21
191024437,8,8,5,3,4,28
191024438,9,0,6,6,4,25
191024439,5,2,7,7,6,27
191024440,9,9,6,3,8,35
191024441,9,2,1,5,4,21
191024442,2,5,0,9,1,17
191024443,0,1,9,5,6,21
191024444,4,6,8,1,8,27
191024445,9,4,6,8,7,34
191024446,9,2,0,9,5,25
191024447,2,1,7,3,8,21
191024448,4,6,4,9,9,32
191024449,1,8,0,3,0,12
191024450,9,7,6,6,8,36
191024451,4,5,8,1,8,26
191024452,1,3,0,3,7,14
191024453,2,0,2,6,8,18
191024454,5,3,9,1,5,23
191024455,7,8,1,6,7,29
191024456,6,6,3,2,6,23
191024457,0,7,9,1,1,18
191024458,6,8,7,6,9,36
191024459,7,1,8,3,3,22
191024460,3,1,8,5,0,17
191024461,3,7,9,1,6,26
191024462,5,1,5,6,4,21
191024463,3,9,7,4,5,28
191024464,7,6,4,2,4,23
191024465,4,7,6,3,3,23
191024466,7,2,0,9,1,19
191024467,9,4,1,8,4,26
191024468,3,5,3,2,4,17
191024469,7,7,6,1,2,23
191024470,1,0,1,1,0,3
191024471,7,5,4,1,9,26
191024472,3,8,8,2,9,30
191024473,6,8,9,6,2,31
191024474,7,1,1,5,3,17
191024475,8,1,7,8,3,27
191024476,8,2,4,6,9,29
191024477,9,7,5,2,4,27
191024478,5,9,8,3,8,33
191024479,9,8,8,1,7,33
191024480,5,1,1,7,1,15
191024481,4,8,7,7,6,32
191024482,0,2,4,3,1,10
191024483,3,7,9,6,9,34
191024484,6,9,6,7,1,29
191024485,2,6,8,2,9,27
191024486,8,8,2,5,9,32
191024487,3,7,6,4,9,29
191024488,7,4,7,0,0,18
191024489,3,0,9,9,5,26
191024490,2,6,8,6,9,31
191024491,8,7,7,6,8,36
191024492,7,7,0,0,9,23
191024493,6,0,6,5,5,22
191024494,1,6,8,5,6,26
191024495,4,7,9,5,5,30
191024496,8,1,7,9,1,26
191024497,3,9,6,2,8,28
191024498,4,9,7,6,8,34
191024499,9,4,5,3,4,25
191024500,0,1,8,9,8,26
191024501,1,2,5,7,0,15
191024502,1,4,1,2,5,13
191024503,9,9,5,2,4,29
191024504,5,6,2,4,1,18
191024505,5,5,9,9,2,30
191024506,8,7,1,5,6,27
191024507,7,5,5,2,8,27
191024508,3,6,8,7,3,27
191024509,4,0,6,9,9,28
191024510,8,5,3,6,2,24
191024511,5,8,8,3,7,31
191024512,6,4,1,4,5,20
191024513,0,0,5,6,1,12
191024514,0,6,2,6,7,21
191024515,3,7,2,9,7,28
191024516,3,1,0,2,6,12
191024517,0,7,7,9,7,30
191024518,7,8,7,6,6,34
191024519,8,8,1,1,7,25
191024520,9,8,1,3,8,29
191024521,2,7,7,4,5,25
191024522,9,9,0,1,8,27
191024523,0,5,6,8,5,24
191024524,6,8,3,1,1,19
191024525,3,0,1,6,7,17
191024526,2,4,5,0,1,12
191024527,6,4,4,7,5,26
191024528,1,5,1,6,7,20
191024529,8,9,6,9,0,32
191024530,1,1,2,2,3,9
191024531,3,1,7,9,9,29
191024532,4,6,6,4,6,26
191024533,1,3,5,3,2,14
191024534,2,0,4,6,9,21
191024535,9,9,7,7,4,36
191024536,1,8,8,9,8,34
191024537,6,6,3,1,8,24
191024538,4,9,5,4,0,22
191024539,2,0,4,0,5,11
191024540,2,4,3,6,0,15
191024541,2,0,7,3,4,16
191024542,6,5,0,4,1,16
191024543,5,5,5,0,3,18
191024544,8,5,8,0,5,26
191024545,4,1,6,2,2,15
191024546,6,7,0,4,7,24
191024547,4,0,6,5,9,24
191024548,6,4,9,0,0,19
191024549,6,0,7,8,8,29
191024550,5,2,4,3,0,14
191024551,8,4,9,1,4,26
191024552,6,7,3,2,6,24
191024553,2,6,9,3,1,21
191024554,2,0,6,6,0,14
191024555,0,2,4,0,1,7
191024556,6,6,7,6,4,29
191024557,7,1,7,0,5,20
191024558,3,9,0,5,1,18
191024559,2,4,6,7,3,22
191024560,7,2,3,6,1,19
191024561,3,4,7,1,0,15
191024562,2,9,4,3,9,27
191024563,2,0,5,4,4,15
191024564,2,3,6,9,9,29
191024565,6,4,2,9,4,25
191024566,3,0,5,5,1,14
191024567,2,1,3,8,6,20
191024568,2,0,7,6,7,22
191024569,7,5,8,1,5,26
191024570,9,0,1,1,7,18
191024571,5,8,5,3,9,30
191024572,6,5,8,9,0,28
191024573,9,7,2,6,2,26
191024574,5,3,3,6,6,23
191024575,0,8,3,8,0,19
191024576,7,7,9,6,1,30
191024577,9,0,3,8,2,22
191024578,5,2,7,2,2,18
191024579,6,2,9,5,8,30
191024580,2,6,8,7,1,24
191024581,8,8,0,3,2,21
191024582,8,6,0,9,3,26
191024583,7,9,7,9,9,41
191024584,4,1,9,6,8,28
191024585,9,6,8,0,7,30
191024586,0,1,6,8,9,24
191024587,7,3,8,7,5,30
191024588,0,1,8,0,3,12
191024589,7,6,0,5,7,25
191024590,9,1,1,1,0,12
191024591,7,9,7,4,5,32
191024592,1,6,7,1,9,24
191024593,5,7,9,1,5,27
191024594,6,2,4,1,1,14
191024595,9,8,2,2,6,27
191024596,7,3,1,6,4,21
191024597,8,1,2,1,7,19
191024598,8,1,1,3,3,16
191024599,0,6,5,8,4,23
191024600,1,2,3,7,0,13
191024601,4,4,1,0,3,12
191024602,4,8,0,5,0,17
191024603,8,1,9,6,9,33
191024604,2,2,6,7,3,20
191024605,3,1,9,4,9,26
191024606,7,2,6,7,8,30
191024607,5,2,5,6,2,20
191024608,1,6,4,4,8,23
191024609,7,8,5,0,6,26
191024610,6,7,2,5,2,22
191024611,8,5,2,8,5,28
191024612,1,4,9,6,1,21
191024613,8,3,6,2,2,21
191024614,6,3,8,9,7,33
191024615,7,1,3,4,0,15
191024616,4,5,5,0,6,20
191024617,7,5,2,7,0,21
191024618,6,4,8,8,0,26
191024619,1,0,2,5,4,12
191024620,5,8,7,8,7,35
191024621,0,6,3,2,5,16
191024622,6,5,8,5,7,31
191024623,6,8,1,2,0,17
191024624,4,2,8,4,4,22
191024625,2,8,8,6,2,26
191024626,0,1,0,7,2,10
191024627,1,8,6,3,3,21
191024628,7,6,4,0,8,25
191024629,4,5,2,9,4,24
191024630,7,6,9,3,1,26
191024631,5,0,5,3,0,13
191024632,0,7,2,1,3,13
191024633,0,8,5,2,4,19
191024634,5,0,3,5,5,18
191024635,8,8,8,4,5,33
191024636,0,2,7,7,4,20
191024637,1,0,6,3,8,18
191024638,9,3,2,1,1,16
191024639,2,5,6,8,1,22
191024640,7,9,5,8,6,35
191024641,5,9,0,8,4,26
191024642,0,6,3,2,2,13
191024643,8,5,9,1,7,30
191024644,3,9,9,2,6,29
191024645,1,2,3,3,9,18
191024646,9,4,2,1,7,23
191024647,9,9,1,3,1,23
191024648,2,5,9,8,7,31
191024649,8,6,6,9,9,38
191024650,6,7,1,0,3,17
191024651,5,1,6,6,8,26
191024652,9,6,8,1,0,24
191024653,7,3,8,6,8,32
191024654,8,0,1,1,1,11
191024655,2,9,8,1,3,23
191024656,8,1,0,3,3,15
191024657,6,0,8,8,2,24
191024658,6,5,6,8,9,34
191024659,5,8,1,1,6,21
191024660,4,1,1,7,7,20
191024661,4,0,5,4,9,22
191024662,2,8,9,4,5,28
191024663,4,4,5,4,5,22
191024664,1,8,2,7,0,18
191024665,4,5,4,8,8,29
191024666,1,2,7,8,0,18
191024667,8,1,6,9,1,25
191024668,1,9,1,7,4,22
191024669,4,0,5,6,4,19
191024670,2,7,2,3,1,15
191024671,4,4,7,5,4,24
191024672,1,3,1,5,7,17
191024673,2,6,9,7,3,27
191024674,4,8,4,9,4,29
191024675,0,2,0,4,6,12
191024676,5,7,2,7,4,25
191024677,1,8,2,8,3,22
191024678,2,1,2,4,6,15
191024679,4,8,0,1,9,22
191024680,3,4,6,0,7,20
191024681,0,4,7,3,4,18
191024682,7,6,6,1,9,29
191024683,4,0,0,6,6,16
191024684,9,4,6,4,9,32
191024685,0,8,2,6,2,18
191024686,7,0,3,5,3,18
191024687,4,3,2,5,2,16
191024688,0,8,7,5,3,23
191024689,9,6,8,0,3,26
191024690,3,6,1,2,5,17
191024691,4,6,4,7,2,23
191024692,3,6,8,2,0,19
191024693,1,0,0,8,6,15
191024694,2,8,4,5,7,26
191024695,3,0,6,5,8,22
191024696,3,6,8,5,5,27
191024697,3,0,5,5,5,18
191024698,7,6,6,5,9,33
191024699,5,7,6,7,6,31
191024700,0,2,9,7,3,21
191024701,9,0,5,9,4,27
191024702,4,9,6,5,6,30
191024703,5,3,7,5,7,27
191024704,1,2,1,9,2,15
191024705,0,7,0,8,4,19
191024706,7,8,0,9,9,33
191024707,5,6,6,8,5,30
191024708,0,0,8,6,3,17
191024709,9,4,4,3,4,24
191024710,9,0,1,8,3,21
191024711,5,7,6,5,5,28
191024712,2,3,9,1,6,21
191024713,9,6,4,7,5,31
191024714,2,2,0,4,2,10
191024715,8,4,7,9,7,35
191024716,6,1,2,3,6,18
191024717,9,4,5,3,6,27
191024718,6,0,9,1,7,23
191024719,5,5,4,9,1,24
191024720,3,3,8,2,0,16
191024721,4,7,5,4,0,20
191024722,7,4,9,0,8,28
191024723,2,3,1,0,8,14
191024724,8,1,4,8,2,23
191024725,5,4,1,6,0,16
191024726,1,7,3,0,9,20
191024727,2,8,6,3,7,26
191024728,6,9,6,6,0,27
191024729,2,5,8,8,6,29
191024730,3,7,9,4,6,29
191024731,2,6,3,4,1,16
191024732,4,4,1,4,5,18
191024733,1,0,5,5,6,17
191024734,1,3,9,4,4,21
191024735,4,4,8,1,3,20
191024736,3,9,6,3,5,26
191024737,0,9,2,4,8,23
191024738,7,2,2,2,9,22
191024739,6,5,8,2,4,25
191024740,0,0,5,3,4,12
191024741,3,7,9,9,6,34
191024742,6,8,8,5,5,32
191024743,2,6,7,0,4,19
191024744,9,5,0,3,2,19
191024745,3,2,9,4,2,20
191024746,1,9,8,1,5,24
191024747,2,9,0,1,0,12
191024748,9,8,5,3,7,32
191024749,9,4,5,1,8,27
191024750,0,5,7,3,7,22
191024751,9,6,7,2,3,27
191024752,6,3,0,3,1,13
191024753,5,2,2,3,2,14
191024754,0,7,9,3,2,21
191024755,5,7,2,2,1,17
191024756,3,0,3,8,2,16
191024757,4,0,0,7,3,14
191024758,9,5,4,3,0,21
191024759,7,9,3,1,7,27
191024760,1,6,5,8,4,24
191024761,6,9,0,2,9,26
191024762,7,5,0,4,1,17
191024763,5,5,6,2,8,26
191024764,9,9,0,8,4,30
191024765,4,7,7,0,2,20
191024766,3,7,7,4,8,29
191024767,8,5,9,3,7,32
191024768,9,0,5,6,7,27
191024769,3,6,9,4,3,25
191024770,9,9,7,3,2,30
191024771,8,1,2,0,4,15
191024772,7,1,5,9,8,30
191024773,0,8,3,5,9,25
191024774,0,0,0,2,5,7
191024775,3,0,4,7,4,18
191024776,4,2,8,6,9,29
191024777,0,1,8,2,6,17
191024778,6,3,6,6,5,26
191024779,8,0,4,4,5,21
191024780,1,8,1,2,6,18
191024781,1,6,5,5,2,19
191024782,5,9,0,6,7,27
191024783,0,9,5,2,0,16
191024784,4,3,3,4,9,23
191024785,1,8,1,9,8,27
191024786,2,7,2,7,7,25
191024787,1,7,1,8,0,17
191024788,7,5,4,5,8,29
191024789,4,0,1,0,6,11
191024790,5,7,3,0,7,22
191024791,4,2,4,0,7,17
191024792,0,6,3,8,3,20
191024793,1,1,3,6,9,20
191024794,5,5,7,5,6,28
191024795,6,6,9,8,1,30
191024796,4,8,4,9,8,33
191024797,1,1,8,3,0,13
191024798,4,4,2,8,1,19
191024799,3,5,7,7,5,27
191024800,5,3,7,7,3,25
191024801,7,0,4,3,5,19
191024802,6,2,2,0,9,19
191024803,5,2,2,3,9,21
191024804,5,1,9,9,5,29
191024805,8,3,9,8,5,33
191024806,0,4,1,1,5,11
191024807,3,1,2,2,8,16
191024808,5,8,4,5,6,28
191024809,9,0,0,8,8,25
191024810,9,3,8,3,2,25
191024811,7,5,4,2,1,19
191024812,0,9,7,2,9,27
191024813,0,1,2,1,1,5
191024814,1,5,9,1,7,23
191024815,1,8,9,2,5,25
191024816,9,9,2,5,7,32
191024817,8,6,9,0,9,32
191024818,4,4,8,3,2,21
191024819,9,3,5,9,6,32
191024820,8,2,2,3,4,19
191024821,0,9,3,4,6,22
191024822,8,2,3,0,5,18
191024823,8,6,4,3,0,21
191024824,6,8,1,5,7,27
191024825,7,4,6,0,2,19
191024826,2,9,5,2,8,26
191024827,4,4,9,5,5,27
191024828,7,5,9,2,0,23
191024829,6,9,0,0,2,17
191024830,4,5,8,1,4,22
191024831,7,3,8,5,7,30
191024832,1,2,2,5,7,17
191024833,7,5,5,3,1,21
191024834,3,8,3,4,2,20
191024835,1,8,1,4,0,14
191024836,5,0,9,8,8,30
191024837,3,3,1,9,0,16
191024838,3,5,1,4,6,19
191024839,9,2,8,6,0,25
191024840,5,1,0,8,6,20
191024841,0,8,0,1,9,18
191024842,7,0,2,4,1,14
191024843,9,6,5,3,8,31
191024844,0,9,0,0,8,17
191024845,5,6,7,5,9,32
191024846,3,5,2,9,7,26
191024847,2,9,1,7,2,21
191024848,9,7,1,9,2,28
191024849,2,5,8,5,4,24
191024850,1,6,0,5,1,13
191024851,8,5,6,6,4,29
191024852,2,7,6,1,4,20
191024853,9,5,7,0,9,30
191024854,0,6,3,1,4,14
191024855,4,3,5,9,2,23
191024856,5,3,1,8,2,19
191024857,7,2,0,7,0,16
191024858,1,6,7,1,8,23
191024859,0,1,1,2,9,13
191024860,3,9,7,5,6,30
191024861,8,9,2,2,4,25
191024862,5,6,2,5,5,23
191024863,5,5,2,8,0,20
191024864,6,0,8,0,6,20
191024865,5,8,1,0,3,17
191024866,2,7,3,7,8,27
191024867,9,5,4,2,7,27
191024868,0,3,0,1,9,13
191024869,2,8,8,9,9,36
191024870,5,1,4,9,3,22
191024871,8,0,1,2,4,15
191024872,9,1,5,2,1,18
191024873,2,0,1,6,4,13
191024874,3,4,3,7,1,18
191024875,9,3,2,7,1,22
191024876,0,4,2,2,2,10
191024877,7,1,4,6,3,21
191024878,3,9,7,0,4,23
191024879,2,3,3,4,5,17
191024880,5,9,8,4,0,26
191024881,3,7,4,5,1,20
191024882,5,4,6,0,3,18
191024883,6,6,7,1,6,26
191024884,9,6,8,2,1,26
191024885,2,6,1,1,9,19
191024886,6,1,0,4,6,17
191024887,8,1,4,2,1,16
191024888,0,0,2,9,7,18
191024889,2,3,2,1,0,8
191024890,8,7,0,6,2,23
191024891,8,0,6,4,4,22
191024892,0,9,7,8,8,32
191024893,9,9,0,1,5,24
191024894,4,9,1,2,5,21
191024895,5,1,4,4,1,15
191024896,5,1,8,1,3,18
191024897,2,6,5,8,6,27
191024898,5,0,1,9,7,22
191024899,9,0,1,5,6,21
191024900,8,4,3,1,1,17
191024901,0,5,9,4,9,27
191024902,7,6,7,7,2,29
191024903,2,7,5,3,9,26
191024904,7,6,0,0,8,21
191024905,7,8,8,2,9,34
191024906,8,0,7,2,5,22
191024907,5,5,0,8,8,26
191024908,5,5,6,7,8,31
191024909,3,4,7,6,8,28
191024910,8,9,0,2,8,27
191024911,6,5,0,3,4,18
191024912,4,8,7,5,2,26
191024913,2,1,4,2,3,12
191024914,9,4,8,0,5,26
191024915,2,2,2,4,2,12
191024916,2,9,9,9,0,29
191024917,3,6,0,5,6,20
191024918,5,8,8,4,4,29
191024919,7,8,5,9,3,32
191024920,2,8,1,1,3,15
191024921,3,8,9,4,1,25
191024922,5,3,0,3,5,16
191024923,2,2,2,2,5,13
191024924,6,7,4,1,1,19
191024925,2,9,8,4,1,24
191024926,1,2,5,3,8,19
191024927,9,3,0,8,6,26
191024928,3,1,2,2,1,9
191024929,8,7,5,4,8,32
191024930,9,8,6,7,7,37
191024931,9,5,4,7,0,25
191024932,9,3,8,6,6,32
191024933,3,9,4,4,6,26
191024934,7,4,7,5,4,27
191024935,4,8,4,5,1,22
191024936,4,8,8,3,7,30
191024937,0,9,8,5,6,28
191024938,0,8,9,0,3,20
191024939,4,4,9,4,9,30
191024940,0,3,1,0,3,7
191024941,9,2,1,4,4,20
191024942,3,7,8,3,0,21
191024943,0,1,4,8,9,22
191024944,7,6,0,0,0,13
191024945,2,7,6,1,3,19
191024946,0,2,6,8,3,19
191024947,0,9,2,2,2,15
191024948,8,7,2,9,0,26
191024949,4,0,4,2,3,13
191024950,8,7,1,1,6,23
191024951,2,0,0,3,1,6
191024952,4,9,5,1,9,28
191024953,3,7,1,4,2,17
191024954,5,4,6,7,5,27
191024955,5,8,2,5,3,23
191024956,6,0,1,2,6,15
191024957,5,1,2,7,9,24
191024958,5,7,9,8,4,33
191024959,4,7,5,3,3,22
191024960,2,8,2,7,7,26
191024961,2,4,0,5,4,15
191024962,0,3,8,1,8,20
191024963,3,2,4,6,7,22
191024964,6,8,3,4,6,27
191024965,0,3,6,1,0,10
191024966,0,1,3,8,4,16
191024967,0,8,9,5,9,31
191024968,6,9,0,5,4,24
191024969,3,5,6,3,8,25
191024970,7,8,0,6,0,21
191024971,3,1,8,6,6,24
191024972,7,5,8,8,5,33
191024973,5,9,2,4,8,28
191024974,3,4,6,3,2,18
191024975,0,4,1,4,3,12
191024976,6,6,5,2,7,26
191024977,5,0,8,3,0,16
191024978,7,1,2,8,0,18
191024979,5,2,3,5,6,21
191024980,2,3,2,7,8,22
191024981,0,0,8,4,2,14
191024982,1,6,2,9,6,24
191024983,0,6,9,7,0,22
191024984,6,2,6,8,7,29
191024985,1,7,7,9,8,32
191024986,8,7,0,6,5,26
191024987,2,4,3,5,0,14
191024988,0,3,4,6,9,22
191024989,9,4,0,5,7,25
191024990,2,3,1,8,6,20
191024991,4,7,4,1,5,21
191024992,2,2,1,6,3,14
191024993,2,4,4,3,8,21
191024994,5,9,2,3,0,19
191024995,9,7,8,4,6,34
191024996,6,2,3,7,8,26
191024997,1,7,8,3,9,28
191024998,2,5,2,0,5,14
191024999,2,5,0,6,6,19
1910241000,7,0,6,0,6,19
1910241001,4,4,1,3,0,12
1910241002,8,8,5,8,2,31
1910241003,1,1,8,8,6,24
1910241004,8,2,7,9,0,26
1910241005,8,7,1,4,8,28
1910241006,5,3,2,1,1,12
1910241007,9,7,6,2,2,26
1910241008,7,6,3,8,0,24
1910241009,7,7,4,8,4,30
1910241010,1,6,6,2,4,19
1910241011,3,8,5,4,2,22
1910241012,7,9,4,4,9,33
1910241013,5,4,1,9,2,21
1910241014,5,2,1,9,3,20
1910241015,2,8,3,9,5,27
1910241016,8,7,3,1,5,24
1910241017,1,3,5,1,2,12
1910241018,9,1,6,9,2,27
1910241019,6,8,3,3,5,25
1910241020,1,9,9,5,9,33
1910241021,4,4,4,3,7,22
1910241022,5,4,1,4,9,23
1910241023,7,7,0,5,6,25
1910241024,1,5,5,0,0,11
1910241025,0,7,7,4,1,19
1910241026,2,3,0,7,7,19
1910241027,5,3,1,5,8,22
1910241028,1,3,1,2,6,13
1910241029,6,3,2,9,9,29
1910241030,4,0,1,9,2,16
1910241031,6,2,6,0,3,17
1910241032,6,0,7,4,1,18
1910241033,7,3,2,9,8,29
1910241034,8,9,2,4,2,25
1910241035,7,4,4,1,7,23
1910241036,4,8,0,4,5,21
1910241037,3,4,2,1,2,12
1910241038,3,0,4,7,5,19
1910241039,5,2,3,1,3,14
1910241040,0,0,4,9,5,18
1910241041,8,0,5,4,0,17
1910241042,9,4,4,4,1,22
1910241043,1,6,6,4,1,18
1910241044,6,3,8,9,0,26
1910241045,7,6,9,0,1,23
1910241046,0,1,0,0,6,7
1910241047,7,6,5,5,9,32
1910241048,6,5,7,9,7,34
1910241049,8,3,1,7,7,26
1910241050,6,2,1,9,7,25
1910241051,6,4,4,5,6,25
1910241052,8,7,5,0,2,22
1910241053,6,2,6,0,2,16
1910241054,7,1,7,9,8,32
1910241055,5,0,0,0,9,14
1910241056,2,9,9,6,8,34
1910241057,3,1,5,4,5,18
1910241058,8,2,0,2,5,17
1910241059,0,9,2,7,1,19
1910241060,7,3,9,8,4,31
1910241061,1,5,1,0,0,7
1910241062,5,6,8,9,3,31
1910241063,8,9,4,6,0,27
1910241064,0,2,7,5,7,21
1910241065,7,1,3,9,3,23
1910241066,6,8,0,7,3,24
1910241067,6,8,9,7,0,30
1910241068,6,3,7,2,9,27
1910241069,6,3,9,1,2,21
1910241070,5,0,4,5,0,14
1910241071,1,3,0,2,9,15
1910241072,6,5,7,8,3,29
1910241073,5,1,0,8,4,18
1910241074,3,1,9,6,2,21
1910241075,1,9,6,0,4,20
1910241076,4,6,9,1,9,29
1910241077,0,0,5,9,4,18
1910241078,8,2,5,7,2,24
1910241079,4,0,2,7,5,18
1910241080,4,8,4,4,3,23
1910241081,7,9,0,2,1,19
1910241082,2,7,1,5,0,15
1910241083,3,5,8,4,9,29
1910241084,8,1,4,6,6,25
1910241085,5,9,6,8,0,28
1910241086,5,1,3,7,5,21
1910241087,6,2,0,0,2,10
1910241088,4,3,4,6,5,22
1910241089,9,8,5,4,4,30
1910241090,6,0,9,4,2,21
1910241091,4,8,4,5,8,29
1910241092,5,4,1,6,6,22
1910241093,1,6,6,2,9,24
1910241094,7,4,2,5,6,24
1910241095,6,4,4,5,1,20
1910241096,8,2,9,2,5,26
1910241097,1,0,7,8,9,25
1910241098,8,2,5,3,8,26
1910241099,5,7,8,0,5,25
1910241100,0,1,5,8,5,19
1910241101,0,5,5,7,9,26
1910241102,2,1,4,0,1,8
1910241103,9,3,2,3,6,23
1910241104,8,1,4,2,4,19
1910241105,2,1,3,2,8,16
191025001,6,8,1,1,3,19
191025002,3,1,1,6,8,19
191025003,6,5,3,3,0,17
191025004,6,6,7,3,7,29
191025005,7,9,7,0,9,32
191025006,7,3,0,8,9,27
191025007,5,2,9,2,3,21
191025008,3,6,8,7,7,31
191025009,3,6,5,0,2,16
191025010,4,1,0,9,1,15
191025011,3,0,4,4,0,11
191025012,8,5,0,2,6,21
191025013,8,3,9,1,0,21
191025014,1,0,1,8,0,10
191025015,9,7,8,5,7,36
191025016,3,1,8,2,5,19
191025017,6,6,7,0,9,28
191025018,1,7,8,6,2,24
191025019,5,0,2,5,3,15
191025020,0,1,7,9,8,25
191025021,3,6,5,8,5,27
191025022,8,8,5,3,0,24
191025023,1,8,5,9,4,27
191025024,4,8,5,8,9,34
191025025,3,2,0,1,5,11
191025026,6,9,8,5,3,31
191025027,5,3,6,5,2,21
191025028,7,5,9,6,9,36
191025029,3,2,4,8,6,23
191025030,1,8,9,7,9,34
191025031,8,5,9,6,6,34
191025032,5,3,5,2,6,21
191025033,7,1,8,1,2,19
191025034,7,3,6,7,5,28
191025035,3,6,2,4,3,18
191025036,0,0,1,5,7,13
191025037,7,1,7,3,1,19
191025038,0,9,7,5,5,26
191025039,1,3,7,5,1,17
191025040,0,4,9,3,4,20
191025041,9,5,2,9,3,28
191025042,3,4,3,4,7,21
191025043,3,5,0,7,8,23
191025044,7,7,9,4,9,36
191025045,9,1,2,1,3,16
191025046,9,4,2,6,9,30
191025047,9,6,9,4,3,31
191025048,8,5,5,0,5,23
191025049,1,0,6,7,5,19
191025050,2,3,6,4,5,20
191025051,7,7,8,6,7,35
191025052,4,3,6,4,4,21
191025053,3,8,2,4,5,22
191025054,4,1,0,1,0,6
191025055,1,6,3,8,2,20
191025056,0,5,0,7,5,17
191025057,9,1,2,0,8,20
191025058,2,3,0,0,5,10
191025059,1,5,2,8,0,16
191025060,9,6,0,1,8,24
191025061,1,9,2,6,5,23
191025062,7,7,2,3,2,21
191025063,7,3,5,6,9,30
191025064,2,7,6,9,8,32
191025065,2,2,8,2,9,23
191025066,4,4,4,6,7,25
191025067,1,5,2,8,1,17
191025068,5,4,9,2,7,27
191025069,3,4,3,0,3,13
191025070,8,6,4,8,4,30
191025071,0,4,4,7,6,21
191025072,2,3,0,2,6,13
191025073,1,9,5,9,0,24
191025074,0,0,1,3,7,11
191025075,9,5,0,1,0,15
191025076,1,5,9,1,0,16
191025077,7,1,1,3,6,18
191025078,9,3,3,9,0,24
191025079,3,3,5,6,7,24
191025080,3,4,8,9,5,29
191025081,8,1,4,8,8,29
191025082,4,4,0,0,2,10
191025083,8,7,9,3,8,35
191025084,0,1,1,8,3,13
191025085,3,7,0,2,0,12
191025086,8,9,1,1,4,23
191025087,3,8,6,4,2,23
191025088,7,6,3,7,9,32
191025089,4,5,6,5,8,28
191025090,6,4,2,6,7,25
191025091,7,9,0,1,6,23
191025092,0,9,5,4,5,23
191025093,9,0,6,4,6,25
191025094,6,8,3,2,3,22
191025095,2,6,9,3,7,27
191025096,7,7,9,1,3,27
191025097,1,2,0,8,8,19
191025098,2,8,3,8,0,21
191025099,1,5,1,8,8,23
191025100,6,3,6,4,8,27
191025101,6,8,5,1,2,22
191025102,5,7,7,2,1,22
191025103,6,4,8,2,9,29
191025104,5,1,4,0,8,18
191025105,8,2,2,2,1,15
191025106,6,7,4,1,3,21
191025107,9,3,7,8,7,34
191025108,6,1,1,9,1,18
191025109,0,1,0,2,0,3
191025110,4,9,0,6,4,23
191025111,9,4,9,2,1,25
191025112,2,7,3,1,6,19
191025113,7,0,7,4,0,18
191025114,1,9,4,7,3,24
191025115,6,9,9,7,2,33
191025116,3,4,0,9,2,18
191025117,8,7,2,4,6,27
191025118,5,6,6,4,7,28
191025119,1,9,4,4,2,20
191025120,8,0,8,3,2,21
191025121,4,5,1,7,6,23
191025122,6,2,2,5,5,20
191025123,4,2,3,1,9,19
191025124,2,0,1,0,0,3
191025125,4,7,2,9,8,30
191025126,5,7,0,9,0,21
191025127,8,8,1,8,2,27
191025128,5,7,0,4,9,25
191025129,8,3,4,1,7,23
191025130,1,0,2,0,7,10
191025131,4,2,7,3,3,19
191025132,0,4,7,3,8,22
191025133,7,1,0,7,0,15
191025134,2,3,8,2,0,15
191025135,1,2,3,0,5,11
191025136,4,3,6,5,1,19
191025137,8,0,9,2,4,23
191025138,5,2,4,6,4,21
191025139,5,8,9,2,9,33
191025140,5,1,9,3,7,25
191025141,8,3,4,8,2,25
191025142,6,8,4,5,0,23
191025143,3,2,2,6,2,15
191025144,0,5,9,7,7,28
191025145,3,9,0,0,0,12
191025146,1,8,9,5,7,30
191025147,4,0,8,2,2,16
191025148,4,6,0,7,5,22
191025149,8,3,2,8,3,24
191025150,4,1,9,5,0,19
191025151,2,4,3,5,8,22
191025152,7,7,4,7,4,29
191025153,0,4,3,6,8,21
191025154,5,9,7,0,0,21
191025155,9,6,9,1,0,25
191025156,5,4,2,7,0,18
191025157,8,4,0,0,9,21
191025158,0,6,2,1,5,14
191025159,0,4,6,1,0,11
191025160,1,2,1,7,5,16
191025161,1,4,6,6,9,26
191025162,9,0,7,5,6,27
191025163,3,6,9,9,4,31
191025164,4,6,4,8,2,24
191025165,8,5,4,7,5,29
191025166,3,9,4,6,1,23
191025167,7,8,3,1,8,27
191025168,5,6,8,9,8,36
191025169,9,8,2,0,1,20
191025170,0,5,8,3,2,18
191025171,6,2,3,8,3,22
191025172,7,5,1,0,6,19
191025173,7,3,8,4,6,28
191025174,3,5,3,3,0,14
191025175,8,4,2,3,9,26
191025176,5,0,6,4,6,21
191025177,3,0,0,8,1,12
191025178,5,5,8,7,4,29
191025179,8,5,0,4,2,19
191025180,7,9,2,5,0,23
191025181,8,8,2,3,1,22
191025182,2,1,0,9,7,19
191025183,8,6,9,5,1,29
191025184,1,0,7,3,5,16
191025185,0,6,1,1,9,17
191025186,3,4,4,2,1,14
191025187,0,8,4,6,4,22
191025188,7,1,6,2,1,17
191025189,6,6,4,6,0,22
191025190,6,8,2,4,6,26
191025191,5,4,4,4,0,17
191025192,0,8,0,5,1,14
191025193,9,8,5,7,4,33
191025194,6,9,5,5,1,26
191025195,0,4,0,4,0,8
191025196,8,5,3,9,7,32
191025197,6,1,7,5,2,21
191025198,2,8,4,7,6,27
191025199,1,6,7,2,6,22
191025200,9,4,3,5,6,27
191025201,0,9,9,2,5,25
191025202,4,0,5,5,6,20
191025203,7,6,2,1,8,24
191025204,5,1,1,0,3,10
191025205,8,6,9,4,8,35
191025206,0,1,7,1,9,18
191025207,8,2,2,3,8,23
191025208,9,3,1,1,5,19
191025209,9,9,4,0,5,27
191025210,2,9,7,1,2,21
191025211,2,3,3,0,1,9
191025212,4,4,9,8,0,25
191025213,1,8,5,0,2,16
191025214,2,4,2,5,1,14
191025215,0,9,4,5,6,24
191025216,7,8,1,9,1,26
191025217,2,5,1,5,5,18
191025218,7,7,8,5,0,27
191025219,8,7,1,4,6,26
191025220,5,4,8,1,3,21
191025221,1,4,4,5,4,18
191025222,2,1,6,8,2,19
191025223,5,7,5,8,4,29
191025224,5,8,2,7,2,24
191025225,9,1,2,7,0,19
191025226,9,8,8,8,1,34
191025227,3,6,0,8,2,19
191025228,9,7,9,2,2,29
191025229,2,5,9,0,0,16
191025230,5,1,2,8,1,17
191025231,5,9,5,3,5,27
191025232,7,7,8,9,2,33
191025233,9,7,4,8,1,29
191025234,3,2,4,5,1,15
191025235,4,4,1,3,5,17
191025236,9,5,3,7,8,32
191025237,7,8,4,7,4,30
191025238,0,8,9,5,0,22
191025239,4,2,6,5,0,17
191025240,8,9,4,0,5,26
191025241,8,5,7,3,3,26
191025242,4,7,9,5,3,28
191025243,8,7,9,1,1,26
191025244,7,8,5,9,1,30
191025245,8,2,8,2,5,25
191025246,7,4,6,6,3,26
191025247,7,2,2,0,9,20
191025248,1,4,0,7,5,17
191025249,3,9,8,4,2,26
191025250,4,0,9,8,4,25
191025251,7,0,7,2,5,21
191025252,5,4,8,3,3,23
191025253,9,6,2,1,3,21
191025254,6,3,7,9,6,31
191025255,2,4,2,5,8,21
191025256,2,6,2,2,3,15
191025257,5,4,0,4,0,13
191025258,1,2,4,6,3,16
191025259,1,1,9,1,4,16
191025260,6,9,9,1,9,34
191025261,2,0,4,2,5,13
191025262,8,4,6,8,8,34
191025263,0,9,8,0,6,23
191025264,4,1,6,0,6,17
191025265,9,2,1,7,6,25
191025266,2,6,7,0,1,16
191025267,1,5,9,0,1,16
191025268,1,6,6,1,6,20
191025269,2,6,9,2,7,26
191025270,4,4,7,2,5,22
191025271,0,9,4,3,9,25
191025272,7,4,0,4,6,21
191025273,9,9,6,9,1,34
191025274,3,0,0,3,9,15
191025275,3,0,6,0,8,17
191025276,8,8,3,8,8,35
191025277,9,2,6,1,5,23
191025278,2,2,6,1,3,14
191025279,6,5,0,3,5,19
191025280,4,3,6,4,7,24
191025281,9,6,1,9,8,33
191025282,1,9,9,4,8,31
191025283,1,4,5,0,1,11
191025284,3,5,1,8,7,24
191025285,2,1,1,9,3,16
191025286,1,3,8,4,9,25
191025287,8,1,3,8,8,28
191025288,6,0,6,7,1,20
191025289,6,7,6,5,5,29
191025290,1,7,9,0,9,26
191025291,7,5,6,1,8,27
191025292,8,1,9,5,9,32
191025293,1,9,4,5,3,22
191025294,9,1,7,6,3,26
191025295,5,6,9,5,0,25
191025296,0,2,7,7,2,18
191025297,6,3,0,2,0,11
191025298,6,0,8,2,5,21
191025299,2,1,1,7,6,17
191025300,5,4,8,7,5,29
191025301,3,4,9,5,8,29
191025302,3,1,3,7,8,22
191025303,0,0,7,8,6,21
191025304,5,1,3,9,1,19
191025305,8,6,9,8,1,32
191025306,8,2,4,7,1,22
191025307,4,0,0,5,9,18
191025308,2,0,8,8,8,26
191025309,2,9,8,6,1,26
191025310,3,7,8,0,4,22
191025311,8,4,6,3,9,30
191025312,9,9,4,9,4,35
191025313,1,6,7,6,1,21
191025314,2,5,9,2,9,27
191025315,9,6,1,4,4,24
191025316,1,4,8,3,7,23
191025317,7,7,8,0,1,23
191025318,0,6,2,8,8,24
191025319,8,7,0,7,3,25
191025320,9,8,1,8,8,34
191025321,2,2,0,0,7,11
191025322,6,1,5,4,0,16
191025323,5,5,5,2,1,18
191025324,3,0,0,6,3,12
191025325,0,5,1,7,1,14
191025326,3,5,1,9,8,26
191025327,5,4,9,6,3,27
191025328,8,6,9,6,5,34
191025329,6,5,2,0,4,17
191025330,8,9,4,7,9,37
191025331,3,9,8,3,9,32
191025332,0,3,0,0,2,5
191025333,6,6,9,7,1,29
191025334,4,4,7,2,3,20
191025335,2,7,1,0,6,16
191025336,8,3,8,1,7,27
191025337,3,7,3,1,7,21
191025338,9,0,5,9,2,25
191025339,8,7,5,2,9,31
191025340,7,5,2,6,8,28
191025341,8,3,6,6,5,28
191025342,3,1,4,7,0,15
191025343,9,1,5,9,6,30
191025344,0,7,5,4,0,16
191025345,5,6,3,3,3,20
191025346,8,5,3,7,1,24
191025347,3,4,9,3,3,22
191025348,9,8,9,8,1,35
191025349,6,2,4,5,4,21
191025350,7,1,3,3,1,15
191025351,9,5,0,1,8,23
191025352,0,2,1,6,0,9
191025353,1,5,0,7,8,21
191025354,5,5,5,4,5,24
191025355,5,8,3,2,1,19
191025356,1,4,8,3,4,20
191025357,9,7,4,4,5,29
191025358,3,5,9,8,2,27
191025359,3,3,5,4,5,20
191025360,2,5,9,0,8,24
191025361,5,3,1,7,7,23
191025362,5,1,6,1,1,14
191025363,5,2,9,7,8,31
191025364,8,7,4,6,0,25
191025365,4,4,9,0,8,25
191025366,2,2,9,7,3,23
191025367,7,8,3,8,6,32
191025368,0,6,9,1,4,20
191025369,8,3,6,4,1,22
191025370,4,3,9,9,2,27
191025371,1,7,2,4,6,20
191025372,2,2,8,0,8,20
191025373,8,3,2,6,0,19
191025374,6,8,8,9,8,39
191025375,8,3,6,0,5,22
191025376,4,4,9,5,2,24
191025377,4,0,8,7,0,19
191025378,7,2,9,3,6,27
191025379,0,7,7,6,1,21
191025380,7,8,1,5,8,29
191025381,4,6,2,4,4,20
191025382,8,4,0,6,4,22
191025383,2,3,0,8,5,18
191025384,7,6,2,1,1,17
191025385,3,6,1,2,8,20
191025386,9,8,1,2,6,26
191025387,7,0,9,9,1,26
191025388,7,7,4,2,9,29
191025389,4,7,1,0,4,16
191025390,5,5,5,0,4,19
191025391,6,7,2,6,4,25
191025392,9,1,0,1,1,12
191025393,6,9,4,8,2,29
191025394,9,3,6,7,2,27
191025395,8,4,9,4,3,28
191025396,2,8,9,8,3,30
191025397,5,8,9,3,2,27
191025398,7,5,6,3,8,29
191025399,1,8,9,3,5,26
191025400,5,8,4,7,9,33
191025401,4,3,1,2,0,10
191025402,9,4,2,9,3,27
191025403,3,0,2,2,1,8
191025404,4,7,1,6,5,23
191025405,3,5,7,9,1,25
191025406,2,6,1,0,6,15
191025407,7,3,4,4,8,26
191025408,2,2,1,3,0,8
191025409,8,2,7,1,8,26
191025410,8,1,7,3,5,24
191025411,4,9,7,5,4,29
191025412,4,0,7,0,5,16
191025413,7,0,3,4,5,19
191025414,2,3,4,3,4,16
191025415,8,7,5,6,4,30
191025416,7,2,7,6,1,23
191025417,5,4,4,3,2,18
191025418,0,6,9,7,7,29
191025419,5,0,8,9,0,22
191025420,5,7,6,0,5,23
191025421,2,4,6,7,0,19
191025422,3,9,9,9,3,33
191025423,5,3,3,8,5,24
191025424,3,1,9,7,4,24
191025425,4,7,5,8,3,27
191025426,4,0,0,1,2,7
191025427,7,7,4,7,2,27
191025428,7,9,7,3,9,35
191025429,2,6,3,6,4,21
191025430,8,2,5,8,2,25
191025431,1,6,1,1,6,15
191025432,8,6,1,6,4,25
191025433,7,1,9,5,9,31
191025434,0,1,7,2,4,14
191025435,0,5,9,9,4,27
191025436,5,9,2,6,8,30
191025437,7,7,2,3,4,23
191025438,6,1,9,9,8,33
191025439,0,1,9,1,5,16
191025440,8,9,6,3,6,32
191025441,0,8,9,9,7,33
191025442,1,9,7,9,5,31
191025443,5,0,6,9,6,26
191025444,5,4,9,9,2,29
191025445,7,5,2,8,1,23
191025446,9,8,4,4,5,30
191025447,3,2,9,3,5,22
191025448,9,9,8,5,4,35
191025449,7,0,1,8,2,18
191025450,6,7,1,3,7,24
191025451,8,0,6,5,8,27
191025452,5,5,4,5,2,21
191025453,6,1,7,7,6,27
191025454,3,7,1,7,2,20
191025455,3,8,6,7,4,28
191025456,3,1,2,8,0,14
191025457,6,5,9,3,0,23
191025458,6,1,5,3,8,23
191025459,8,5,4,4,4,25
191025460,0,4,7,7,5,23
191025461,1,3,2,3,5,14
191025462,2,2,7,1,0,12
191025463,5,8,9,0,4,26
191025464,4,1,0,8,5,18
191025465,1,5,2,4,2,14
191025466,2,2,5,7,9,25
191025467,3,4,4,0,7,18
191025468,3,7,1,5,8,24
191025469,7,9,1,6,3,26
191025470,0,0,6,3,9,18
191025471,4,5,4,2,0,15
191025472,1,9,2,5,3,20
191025473,8,4,8,6,5,31
191025474,0,8,5,4,8,25
191025475,7,3,4,2,1,17
191025476,3,9,3,0,8,23
191025477,9,2,1,4,6,22
191025478,1,2,2,0,8,13
191025479,5,7,2,9,0,23
191025480,6,5,2,7,1,21
191025481,1,7,2,7,5,22
191025482,2,2,9,1,6,20
191025483,6,6,2,3,4,21
191025484,1,7,3,0,0,11
191025485,3,3,5,0,0,11
191025486,8,6,0,5,6,25
191025487,9,7,3,1,0,20
191025488,8,6,7,5,1,27
191025489,0,9,9,6,9,33
191025490,5,2,3,8,5,23
191025491,3,0,2,6,7,18
191025492,6,3,3,4,2,18
191025493,1,9,6,0,2,18
191025494,3,2,9,5,7,26
191025495,4,2,8,2,4,20
191025496,4,7,3,5,0,19
191025497,6,5,2,5,0,18
191025498,8,7,9,6,4,34
191025499,5,5,0,2,0,12
191025500,5,2,2,3,5,17
191025501,9,1,0,3,7,20
191025502,3,9,7,7,8,34
191025503,4,9,8,9,6,36
191025504,9,2,1,2,1,15
191025505,9,5,7,3,1,25
191025506,5,2,8,2,5,22
191025507,5,2,3,5,4,19
191025508,9,6,4,2,0,21
191025509,8,5,5,9,2,29
191025510,4,2,2,2,5,15
191025511,0,7,3,9,4,23
191025512,4,8,0,4,1,17
191025513,7,1,8,6,6,28
191025514,8,2,7,1,6,24
191025515,9,2,9,1,4,25
191025516,2,3,3,5,0,13
191025517,7,0,6,4,4,21
191025518,0,3,7,1,4,15
191025519,6,7,2,4,7,26
191025520,5,1,1,8,6,21
191025521,1,5,4,2,1,13
191025522,2,3,8,9,8,30
191025523,8,1,5,9,5,28
191025524,9,1,8,3,8,29
191025525,8,0,3,8,9,28
191025526,2,7,7,5,9,30
191025527,4,5,1,5,0,15
191025528,7,1,1,6,0,15
191025529,6,2,9,7,1,25
191025530,7,2,0,2,5,16
191025531,5,4,3,4,4,20
191025532,4,0,6,2,6,18
191025533,1,7,9,3,9,29
191025534,6,5,4,3,6,24
191025535,1,3,3,6,8,21
191025536,9,1,4,4,4,22
191025537,2,2,4,4,6,18
191025538,2,0,9,0,1,12
191025539,7,9,6,2,9,33
191025540,1,1,9,1,6,18
191025541,6,3,2,6,6,23
191025542,6,4,9,2,1,22
191025543,9,9,5,0,9,32
191025544,7,9,9,1,8,34
191025545,1,1,6,3,3,14
191025546,1,0,0,1,5,7
191025547,4,5,8,2,6,25
191025548,4,8,2,3,7,24
191025549,1,5,7,7,2,22
191025550,9,3,8,6,0,26
191025551,4,1,1,3,7,16
191025552,2,7,1,5,2,17
191025553,3,3,7,2,8,23
191025554,0,3,3,1,6,13
191025555,1,5,5,8,1,20
191025556,6,7,6,7,1,27
191025557,1,0,2,6,3,12
191025558,5,9,8,0,8,30
191025559,2,2,4,2,9,19
191025560,0,2,6,4,6,18
191025561,1,9,3,8,7,28
191025562,3,5,2,1,2,13
191025563,4,2,4,2,5,17
191025564,6,9,9,3,8,35
191025565,0,4,8,3,8,23
191025566,5,6,6,3,4,24
191025567,9,8,9,0,4,30
191025568,3,3,9,5,9,29
191025569,1,8,2,9,7,27
191025570,5,9,9,6,1,30
191025571,0,7,2,3,3,15
191025572,6,5,2,2,9,24
191025573,1,8,4,6,8,27
191025574,9,2,7,8,1,27
191025575,4,6,9,5,3,27
191025576,4,4,6,4,8,26
191025577,0,9,9,4,5,27
191025578,7,4,2,0,9,22
191025579,6,4,0,8,8,26
191025580,7,3,4,0,0,14
191025581,4,8,4,1,9,26
191025582,8,6,5,2,3,24
191025583,0,0,9,9,6,24
191025584,1,0,8,5,6,20
191025585,6,7,5,0,4,22
191025586,9,4,1,8,7,29
191025587,2,4,7,3,3,19
191025588,3,3,8,4,7,25
191025589,8,2,2,3,0,15
191025590,8,5,8,4,0,25
191025591,1,7,8,5,4,25
191025592,1,7,2,8,0,18
191025593,5,4,9,8,6,32
191025594,9,2,3,8,3,25
191025595,6,5,9,0,9,29
191025596,1,9,9,6,4,29
191025597,7,6,0,1,3,17
191025598,9,6,9,6,9,39
191025599,0,4,2,0,7,13
191025600,3,8,0,8,5,24
191025601,0,6,4,8,6,24
191025602,1,6,3,6,4,20
191025603,1,9,8,7,2,27
191025604,0,5,2,6,9,22
191025605,2,8,3,7,4,24
191025606,6,2,8,0,5,21
191025607,4,0,8,1,9,22
191025608,0,0,9,6,9,24
191025609,0,8,0,0,6,14
191025610,5,0,6,8,2,21
191025611,2,2,3,9,8,24
191025612,8,3,4,1,6,22
191025613,3,9,4,7,8,31
191025614,8,3,1,5,5,22
191025615,8,4,0,8,9,29
191025616,5,7,2,4,1,19
191025617,7,7,0,4,3,21
191025618,2,6,7,0,3,18
191025619,9,1,8,9,5,32
191025620,9,6,7,7,9,38
191025621,4,3,2,6,0,15
191025622,0,2,1,1,7,11
191025623,5,6,5,5,8,29
191025624,0,5,7,7,3,22
191025625,6,4,3,7,2,22
191025626,8,3,9,1,9,30
191025627,6,2,4,0,3,15
191025628,7,3,9,6,6,31
191025629,7,7,9,5,6,34
191025630,7,7,6,2,2,24
191025631,5,5,6,8,5,29
191025632,9,0,0,5,0,14
191025633,3,6,2,1,0,12
191025634,7,3,6,4,4,24
191025635,9,7,8,9,7,40
191025636,9,6,1,3,0,19
191025637,2,0,2,8,9,21
191025638,1,1,8,7,2,19
191025639,7,0,4,2,8,21
191025640,8,5,5,4,9,31
191025641,4,3,5,1,6,19
191025642,8,9,0,8,2,27
191025643,5,9,9,4,1,28
191025644,6,2,5,3,6,22
191025645,4,4,6,9,8,31
191025646,1,2,4,7,0,14
191025647,9,0,4,7,2,22
191025648,0,7,5,6,6,24
191025649,7,0,9,9,2,27
191025650,3,5,2,6,0,16
191025651,1,0,9,1,8,19
191025652,7,6,5,9,0,27
191025653,5,3,1,6,4,19
191025654,7,3,9,0,1,20
191025655,6,1,1,4,5,17
191025656,0,7,4,8,4,23
191025657,6,9,8,6,4,33
191025658,2,3,9,4,1,19
191025659,8,0,7,1,6,22
191025660,4,1,2,7,0,14
191025661,3,1,5,0,2,11
191025662,2,8,9,2,3,24
191025663,4,6,6,0,5,21
191025664,8,5,6,3,2,24
191025665,7,2,4,9,5,27
191025666,7,3,0,4,1,15
191025667,7,9,1,0,6,23
191025668,4,6,2,9,0,21
191025669,9,6,3,7,2,27
191025670,8,5,4,8,0,25
191025671,3,2,8,9,1,23
191025672,6,5,6,4,6,27
191025673,8,6,6,9,4,33
191025674,8,4,4,0,3,19
191025675,9,3,7,3,2,24
191025676,9,5,8,6,5,33
191025677,2,8,5,2,0,17
191025678,7,4,6,5,2,24
191025679,3,0,1,0,2,6
191025680,1,0,4,9,1,15
191025681,7,6,9,6,8,36
191025682,8,8,2,5,5,28
191025683,4,6,8,6,9,33
191025684,2,5,4,8,0,19
191025685,4,7,5,3,4,23
191025686,5,8,8,3,9,33
191025687,8,1,0,6,4,19
191025688,0,5,7,9,0,21
191025689,2,6,2,1,9,20
191025690,2,1,4,3,1,11
191025691,0,8,3,3,3,17
191025692,6,2,0,1,6,15
191025693,4,8,6,1,9,28
191025694,5,9,2,0,0,16
191025695,7,2,0,5,3,17
191025696,6,4,9,5,5,29
191025697,9,1,4,5,1,20
191025698,7,2,9,4,4,26
191025699,7,5,4,3,1,20
191025700,0,9,5,6,3,23
191025701,4,5,6,6,0,21
191025702,4,4,0,7,0,15
191025703,2,4,3,9,7,25
191025704,1,6,8,4,4,23
191025705,0,3,6,7,7,23
191025706,0,2,1,7,2,12
191025707,7,3,4,9,0,23
191025708,2,5,5,2,7,21
191025709,9,7,5,8,0,29
191025710,4,0,4,4,5,17
191025711,6,9,7,8,9,39
191025712,7,8,9,0,5,29
191025713,2,6,6,5,3,22
191025714,3,2,3,5,7,20
191025715,0,5,5,9,7,26
191025716,7,1,5,9,6,28
191025717,1,4,6,2,1,14
191025718,9,9,8,5,1,32
191025719,7,4,5,7,4,27
191025720,9,7,7,5,9,37
191025721,5,7,9,1,9,31
191025722,1,8,7,4,7,27
191025723,9,8,4,2,7,30
191025724,2,4,6,1,3,16
191025725,3,2,7,7,4,23
191025726,5,4,9,2,0,20
191025727,5,2,1,3,8,19
191025728,0,8,4,7,9,28
191025729,4,2,5,0,4,15
191025730,9,0,4,4,0,17
191025731,7,0,1,5,9,22
191025732,5,0,0,6,5,16
191025733,2,8,5,6,6,27
191025734,8,5,7,8,6,34
191025735,4,2,1,0,7,14
191025736,4,6,0,5,1,16
191025737,8,7,1,8,1,25
191025738,7,8,2,9,4,30
191025739,6,6,7,8,3,30
191025740,7,0,0,8,9,24
191025741,7,0,5,0,5,17
191025742,7,9,2,1,7,26
191025743,2,9,6,6,2,25
191025744,2,5,3,4,0,14
191025745,4,3,1,1,6,15
191025746,4,6,5,6,3,24
191025747,6,3,4,8,0,21
191025748,1,1,6,2,6,16
191025749,7,0,2,0,4,13
191025750,0,4,0,1,9,14
191025751,6,5,6,5,4,26
191025752,4,9,3,7,7,30
191025753,0,5,6,2,1,14
191025754,9,2,7,0,9,27
191025755,7,4,7,7,2,27
191025756,6,7,9,5,2,29
191025757,4,6,8,6,3,27
191025758,0,4,1,9,6,20
191025759,8,1,4,5,4,22
191025760,6,6,7,6,3,28
191025761,3,4,9,8,0,24
191025762,0,6,7,0,8,21
191025763,6,4,8,8,4,30
191025764,5,2,1,9,1,18
191025765,4,2,7,2,4,19
191025766,5,9,6,4,1,25
191025767,8,5,7,3,1,24
191025768,5,9,8,3,1,26
191025769,5,1,9,1,0,16
191025770,8,2,0,7,7,24
191025771,6,2,4,6,8,26
191025772,3,5,8,0,3,19
191025773,5,4,1,1,7,18
191025774,0,2,7,3,2,14
191025775,4,1,7,3,3,18
191025776,4,7,7,2,4,24
191025777,9,1,5,7,3,25
191025778,1,7,4,0,1,13
191025779,2,1,6,2,1,12
191025780,3,1,1,9,8,22
191025781,4,3,3,6,1,17
191025782,2,4,5,8,5,24
191025783,2,4,9,1,8,24
191025784,1,0,2,3,2,8
191025785,0,3,2,5,2,12
191025786,0,1,1,3,5,10
191025787,4,2,7,0,6,19
191025788,7,9,8,9,5,38
191025789,3,6,3,0,1,13
191025790,5,4,1,2,8,20
191025791,9,7,4,4,4,28
191025792,6,9,6,3,4,28
191025793,0,4,5,9,4,22
191025794,4,4,4,7,2,21
191025795,4,6,9,4,9,32
191025796,8,7,6,3,0,24
191025797,6,1,1,1,9,18
191025798,4,1,9,0,9,23
191025799,1,6,5,6,4,22
191025800,9,6,3,4,0,22
191025801,9,2,3,4,5,23
191025802,8,2,0,4,2,16
191025803,8,8,3,3,6,28
191025804,8,4,4,9,5,30
191025805,1,4,0,8,1,14
191025806,1,6,2,3,0,12
191025807,0,0,4,3,9,16
191025808,8,2,8,2,3,23
191025809,6,8,5,9,2,30
191025810,0,5,0,4,5,14
191025811,2,1,1,7,0,11
191025812,5,3,0,0,4,12
191025813,6,1,2,6,5,20
191025814,4,5,0,3,2,14
191025815,8,9,3,3,9,32
191025816,7,8,5,5,6,31
191025817,5,3,4,8,2,22
191025818,6,5,4,7,5,27
191025819,4,4,4,0,8,20
191025820,9,0,6,5,1,21
191025821,4,2,1,5,4,16
191025822,9,6,5,4,4,28
191025823,5,2,1,0,6,14
191025824,9,6,7,7,5,34
191025825,8,2,2,0,9,21
191025826,7,7,2,1,9,26
191025827,0,0,4,7,6,17
191025828,5,9,3,8,7,32
191025829,1,8,3,5,4,21
191025830,8,4,6,5,1,24
191025831,3,1,1,0,3,8
191025832,8,2,1,4,1,16
191025833,2,8,9,5,1,25
191025834,6,2,7,1,8,24
191025835,2,8,4,0,8,22
191025836,7,6,1,2,3,19
191025837,8,3,5,7,6,29
191025838,9,9,7,1,9,35
191025839,9,4,4,4,9,30
191025840,2,2,6,9,6,25
191025841,4,2,7,1,1,15
191025842,3,2,8,9,4,26
191025843,0,3,3,8,3,17
191025844,2,7,2,5,8,24
191025845,4,1,3,4,7,19
191025846,0,7,2,6,8,23
191025847,1,4,8,8,6,27
191025848,7,0,5,4,4,20
191025849,8,3,2,3,6,22
191025850,5,6,2,9,7,29
191025851,4,9,1,6,2,22
191025852,8,9,8,3,4,32
191025853,1,8,7,3,6,25
191025854,8,8,3,2,9,30
191025855,0,5,3,5,7,20
191025856,8,5,8,8,4,33
191025857,7,0,8,0,5,20
191025858,5,6,1,3,3,18
191025859,5,3,6,9,1,24
191025860,3,0,1,3,7,14
191025861,9,1,4,8,7,29
191025862,3,2,1,6,3,15
191025863,6,0,7,2,2,17
191025864,0,0,8,1,9,18
191025865,8,5,4,7,4,28
191025866,4,0,2,2,7,15
191025867,3,4,7,0,0,14
191025868,5,2,0,6,4,17
191025869,3,3,8,6,9,29
191025870,7,2,5,1,9,24
191025871,8,6,3,9,7,33
191025872,8,5,1,8,7,29
191025873,2,4,2,2,6,16
191025874,0,5,0,7,9,21
191025875,8,8,2,2,9,29
191025876,6,7,9,1,6,29
191025877,6,5,5,4,8,28
191025878,9,1,9,0,0,19
191025879,0,7,3,2,0,12
191025880,1,4,3,5,0,13
191025881,6,9,6,1,8,30
191025882,5,4,6,3,7,25
191025883,8,7,7,0,2,24
191025884,8,1,5,6,1,21
191025885,0,7,6,7,5,25
191025886,3,9,8,8,0,28
191025887,5,4,6,8,5,28
191025888,6,1,7,4,9,27
191025889,0,2,0,2,8,12
191025890,7,9,7,7,5,35
191025891,5,6,5,6,1,23
191025892,1,2,9,5,4,21
191025893,2,1,7,8,1,19
191025894,6,2,2,2,7,19
191025895,2,6,6,3,7,24
191025896,7,6,7,6,8,34
191025897,6,4,3,7,3,23
191025898,1,8,6,0,8,23
191025899,6,7,3,8,9,33
191025900,4,2,7,7,1,21
191025901,1,3,1,0,5,10
191025902,0,7,8,2,5,22
191025903,9,7,7,5,7,35
191025904,7,0,5,8,4,24
191025905,2,8,1,7,2,20
191025906,4,4,3,7,7,25
191025907,7,4,8,6,4,29
191025908,4,0,2,7,3,16
191025909,2,5,7,4,2,20
191025910,3,0,4,4,2,13
191025911,2,0,4,2,6,14
191025912,2,4,1,1,6,14
191025913,7,2,4,2,2,17
191025914,7,8,7,9,5,36
191025915,4,2,9,6,0,21
191025916,5,0,8,0,1,14
191025917,0,9,3,9,3,24
191025918,0,2,6,4,8,20
191025919,8,5,0,0,1,14
191025920,9,1,5,1,1,17
191025921,8,6,6,9,8,37
191025922,6,9,3,2,1,21
191025923,1,3,4,7,7,22
191025924,1,4,6,6,7,24
191025925,5,6,0,4,0,15
191025926,1,9,9,8,2,29
191025927,2,6,0,0,0,8
191025928,3,8,6,6,6,29
191025929,8,5,7,5,5,30
191025930,5,3,3,5,3,19
191025931,4,0,6,7,7,24
191025932,9,6,1,3,4,23
191025933,0,4,8,2,4,18
191025934,3,1,0,3,0,7
191025935,8,8,4,1,7,28
191025936,2,6,0,3,6,17
191025937,1,1,5,5,4,16
191025938,6,6,1,0,0,13
191025939,1,8,5,3,8,25
191025940,7,7,8,3,7,32
191025941,2,8,5,6,4,25
191025942,4,9,7,7,1,28
191025943,7,5,3,6,7,28
191025944,8,8,0,8,0,24
191025945,6,5,0,2,4,17
191025946,3,2,4,0,0,9
191025947,3,5,2,9,1,20
191025948,3,1,9,0,7,20
191025949,5,6,4,3,7,25
191025950,4,1,3,1,7,16
191025951,6,9,5,1,2,23
191025952,7,2,2,1,5,17
191025953,7,0,5,0,3,15
191025954,5,3,6,8,1,23
191025955,1,0,5,3,4,13
191025956,4,8,9,0,0,21
191025957,1,9,7,2,5,24
191025958,9,4,2,5,8,28
191025959,7,6,7,2,9,31
191025960,3,4,3,0,6,16
191025961,6,4,8,9,9,36
191025962,7,8,5,0,8,28
191025963,3,1,4,3,5,16
191025964,8,2,1,5,3,19
191025965,8,7,8,6,0,29
191025966,9,0,1,6,1,17
191025967,2,5,7,0,1,15
191025968,9,9,8,6,3,35
191025969,5,1,7,2,7,22
191025970,5,1,7,2,2,17
191025971,0,6,6,9,0,21
191025972,4,8,6,4,5,27
191025973,9,3,1,0,1,14
191025974,9,3,3,9,9,33
191025975,6,3,2,9,1,21
191025976,6,1,4,4,6,21
191025977,9,8,6,0,1,24
191025978,6,4,7,8,8,33
191025979,1,9,3,8,6,27
191025980,1,9,3,5,9,27
191025981,2,2,9,6,2,21
191025982,9,8,9,5,3,34
191025983,2,7,3,9,5,26
191025984,1,0,4,6,0,11
191025985,5,7,4,4,3,23
191025986,2,5,6,5,1,19
191025987,2,9,3,1,7,22
191025988,9,5,4,5,1,24
191025989,0,5,2,4,2,13
191025990,9,7,1,3,7,27
191025991,9,2,4,8,8,31
191025992,7,1,4,4,4,20
191025993,5,1,8,5,2,21
191025994,1,5,6,3,3,18
191025995,8,2,7,3,3,23
191025996,8,4,6,0,8,26
191025997,7,2,8,1,5,23
191025998,7,6,8,0,7,28
191025999,1,0,5,2,7,15
1910251000,5,1,7,6,3,22
1910251001,5,2,8,2,6,23
1910251002,8,2,1,7,9,27
1910251003,0,3,9,7,3,22
1910251004,2,1,3,0,0,6
1910251005,5,8,6,4,3,26
1910251006,8,7,9,4,5,33
1910251007,4,3,9,0,4,20
1910251008,2,7,0,0,0,9
1910251009,4,8,2,9,5,28
1910251010,1,4,4,1,3,13
1910251011,0,9,5,9,7,30
1910251012,3,1,0,4,3,11
1910251013,7,7,4,7,9,34
1910251014,2,6,4,9,9,30
1910251015,5,7,2,8,9,31
1910251016,0,3,7,2,8,20
1910251017,6,8,2,3,4,23
1910251018,7,1,1,4,0,13
1910251019,3,6,4,9,9,31
1910251020,0,2,8,6,7,23
1910251021,2,1,1,0,1,5
1910251022,9,2,0,8,2,21
1910251023,1,6,2,0,6,15
1910251024,5,1,1,9,0,16
1910251025,5,3,4,6,8,26
1910251026,1,0,5,5,7,18
1910251027,2,0,2,6,2,12
1910251028,7,9,7,3,5,31
1910251029,9,6,1,9,1,26
1910251030,3,6,1,4,7,21
1910251031,7,8,9,8,0,32
1910251032,0,3,3,7,8,21
1910251033,7,0,6,9,9,31
1910251034,1,1,4,3,1,10
1910251035,5,8,1,1,4,19
1910251036,2,0,6,5,8,21
1910251037,0,5,1,1,8,15
1910251038,3,7,7,6,5,28
1910251039,9,8,2,2,7,28
1910251040,2,7,6,0,9,24
1910251041,1,7,4,8,8,28
1910251042,0,8,9,9,1,27
1910251043,7,3,1,7,6,24
1910251044,6,4,7,4,4,25
1910251045,0,2,0,5,0,7
1910251046,1,5,8,5,1,20
1910251047,5,9,8,5,8,35
1910251048,7,9,1,6,0,23
1910251049,9,8,7,7,4,35
1910251050,5,3,9,5,7,29
1910251051,1,0,3,6,9,19
1910251052,7,0,3,0,2,12
1910251053,5,0,7,3,5,20
1910251054,8,0,0,2,3,13
1910251055,2,1,5,7,2,17
1910251056,5,3,4,0,9,21
1910251057,8,1,2,3,0,14
1910251058,2,2,0,1,9,14
1910251059,1,3,0,0,3,7
1910251060,0,2,4,3,3,12
1910251061,1,5,1,9,5,21
1910251062,2,3,0,5,8,18
1910251063,6,8,0,9,5,28
1910251064,4,7,1,4,4,20
1910251065,7,9,9,1,1,27
1910251066,5,3,0,0,0,8
1910251067,6,7,0,9,9,31
1910251068,2,2,4,8,0,16
1910251069,8,9,5,7,6,35
1910251070,1,9,7,1,3,21
1910251071,9,6,8,7,3,33
1910251072,3,1,1,9,1,15
1910251073,1,5,9,9,5,29
1910251074,4,7,0,2,6,19
1910251075,0,1,1,5,0,7
1910251076,0,2,5,5,0,12
1910251077,3,5,1,6,4,19
1910251078,5,4,0,8,5,22
1910251079,0,3,6,0,4,13
1910251080,8,7,5,7,6,33
1910251081,5,7,4,7,7,30
1910251082,9,0,7,5,4,25
1910251083,2,5,1,6,9,23
1910251084,9,1,0,0,5,15
1910251085,4,5,1,7,1,18
1910251086,7,3,7,8,0,25
1910251087,6,2,8,5,3,24
1910251088,4,6,7,8,5,30
1910251089,5,4,5,6,5,25
1910251090,2,1,9,1,9,22
1910251091,0,6,1,5,9,21
1910251092,6,6,4,7,0,23
1910251093,3,2,0,1,6,12
1910251094,6,3,9,4,2,24
1910251095,7,5,7,1,7,27
1910251096,2,6,7,2,0,17
1910251097,5,6,5,8,6,30
1910251098,6,2,6,4,3,21
1910251099,4,7,5,3,6,25
1910251100,5,3,4,2,0,14
1910251101,0,4,5,4,6,19
1910251102,2,4,0,6,4,16
1910251103,3,0,8,5,0,16
1910251104,1,7,3,6,6,23
1910251105,5,4,3,0,5,17
191026001,7,4,9,3,7,30
191026002,6,8,4,2,9,29
191026003,3,3,7,8,3,24
191026004,8,1,0,6,3,18
191026005,8,1,2,8,8,27
191026006,6,8,7,6,8,35
191026007,1,7,3,4,8,23
191026008,1,7,4,1,7,20
191026009,1,1,5,3,8,18
191026010,0,3,7,2,5,17
191026011,7,0,9,1,9,26
191026012,4,2,5,8,7,26
191026013,1,7,2,1,1,12
191026014,9,1,6,8,6,30
191026015,5,1,0,1,8,15
191026016,8,4,9,4,7,32
191026017,1,0,0,8,0,9
191026018,0,3,4,8,7,22
191026019,6,2,4,0,9,21
191026020,0,1,7,6,1,15
191026021,7,2,7,2,1,19
191026022,3,9,6,8,4,30
191026023,7,4,6,9,1,27
191026024,7,7,0,7,3,24
191026025,6,5,2,5,4,22
191026026,8,5,0,1,4,18
191026027,5,7,7,2,6,27
191026028,1,4,8,3,0,16
191026029,9,4,1,6,6,26
191026030,6,0,9,7,3,25
191026031,2,7,2,1,1,13
191026032,0,0,9,8,2,19
191026033,1,9,3,8,0,21
191026034,7,2,0,1,3,13
191026035,5,7,0,3,4,19
191026036,9,5,6,9,3,32
191026037,8,4,8,5,4,29
191026038,8,4,7,0,6,25
191026039,0,9,3,1,3,16
191026040,3,0,0,6,5,14
191026041,5,9,0,9,0,23
191026042,0,5,5,9,2,21
191026043,3,9,2,6,7,27
191026044,0,0,7,0,4,11
191026045,7,7,2,9,7,32
191026046,1,9,5,1,4,20
191026047,9,7,3,8,9,36
191026048,0,8,2,1,3,14
191026049,3,1,9,5,5,23
191026050,7,0,2,1,6,16
191026051,4,9,0,9,4,26
191026052,6,4,0,3,9,22
191026053,6,4,4,9,4,27
191026054,8,7,9,2,9,35
191026055,8,0,7,5,3,23
191026056,2,2,6,1,2,13
191026057,6,6,9,0,0,21
191026058,5,6,5,3,1,20
191026059,5,7,5,6,6,29
191026060,4,5,7,1,1,18
191026061,3,6,0,3,0,12
191026062,5,4,5,1,0,15
191026063,3,5,2,7,8,25
191026064,2,6,8,6,1,23
191026065,4,2,7,9,9,31
191026066,4,9,0,0,8,21
191026067,3,2,4,6,1,16
191026068,7,3,2,6,3,21
191026069,8,0,3,3,8,22
191026070,4,9,8,2,9,32
191026071,1,8,5,6,3,23
191026072,9,5,7,8,0,29
191026073,0,5,9,9,7,30
191026074,0,4,3,4,3,14
191026075,5,1,2,6,4,18
191026076,2,8,1,7,3,21
191026077,1,4,5,4,3,17
191026078,7,6,4,8,7,32
191026079,5,5,8,9,5,32
191026080,4,8,5,2,2,21
191026081,7,7,7,7,9,37
191026082,1,8,2,3,0,14
191026083,1,9,1,0,2,13
191026084,8,4,0,4,1,17
191026085,8,8,7,7,8,38
191026086,5,3,2,1,9,20
191026087,2,7,5,1,9,24
191026088,4,8,7,6,5,30
191026089,6,4,4,1,6,21
191026090,5,8,0,0,5,18
191026091,9,6,4,4,6,29
191026092,3,5,9,6,5,28
191026093,9,2,9,5,7,32
191026094,3,6,2,3,5,19
191026095,9,5,9,4,5,32
191026096,8,4,5,7,2,26
191026097,9,6,4,8,9,36
191026098,8,0,1,7,7,23
191026099,5,9,7,1,7,29
191026100,1,3,5,9,6,24
191026101,4,9,3,6,2,24
191026102,0,7,3,1,5,16
191026103,8,7,1,8,2,26
191026104,5,1,4,4,4,18
191026105,1,1,7,3,0,12
191026106,7,3,0,0,3,13
191026107,1,6,7,4,7,25
191026108,8,3,5,3,9,28
191026109,6,4,6,6,2,24
191026110,3,9,6,0,4,22
191026111,7,4,4,9,2,26
191026112,1,8,8,0,6,23
191026113,2,5,1,7,7,22
191026114,3,1,7,6,6,23
191026115,0,0,8,0,7,15
191026116,3,8,4,3,1,19
191026117,1,3,6,1,8,19
191026118,9,4,2,7,0,22
191026119,2,7,7,8,9,33
191026120,3,2,8,0,5,18
191026121,0,2,4,4,3,13
191026122,7,9,8,5,9,38
191026123,0,6,8,9,0,23
191026124,4,9,1,8,4,26
191026125,4,7,0,8,5,24
191026126,4,5,8,6,3,26
191026127,5,7,9,7,2,30
191026128,2,2,7,6,4,21
191026129,8,8,5,6,1,28
191026130,7,2,4,7,7,27
191026131,4,5,2,5,8,24
191026132,2,0,1,7,2,12
191026133,7,8,5,8,9,37
191026134,9,1,7,2,2,21
191026135,5,8,8,5,9,35
191026136,0,2,5,5,1,13
191026137,0,6,3,2,7,18
191026138,9,5,1,7,9,31
191026139,3,3,0,6,7,19
191026140,2,7,6,1,7,23
191026141,2,0,4,1,3,10
191026142,6,3,5,3,5,22
191026143,7,1,3,4,1,16
191026144,7,4,6,4,5,26
191026145,4,3,9,6,0,22
191026146,0,4,6,1,8,19
191026147,9,1,2,6,1,19
191026148,0,5,6,3,6,20
191026149,8,5,7,8,0,28
191026150,6,3,1,1,0,11
191026151,4,8,4,0,9,25
191026152,9,7,5,9,4,34
191026153,1,3,2,2,0,8
191026154,7,7,8,2,7,31
191026155,1,0,3,8,4,16
191026156,5,4,5,8,5,27
191026157,2,0,4,3,2,11
191026158,2,2,4,3,0,11
191026159,3,3,9,1,9,25
191026160,2,6,5,1,8,22
191026161,2,7,8,5,8,30
191026162,7,6,9,3,6,31
191026163,1,3,4,6,8,22
191026164,4,4,5,9,7,29
191026165,5,8,1,4,2,20
191026166,4,7,2,5,7,25
191026167,7,0,9,1,8,25
191026168,4,5,5,4,1,19
191026169,2,8,7,2,3,22
191026170,7,4,4,5,9,29
191026171,5,0,2,2,8,17
191026172,3,2,1,0,3,9
191026173,3,0,2,4,6,15
191026174,1,9,8,3,3,24
191026175,8,7,2,2,5,24
191026176,5,6,6,4,4,25
191026177,0,7,0,0,1,8
191026178,0,7,8,5,2,22
191026179,0,2,8,5,2,17
191026180,2,6,3,2,4,17
191026181,0,1,7,8,4,20
191026182,1,2,2,4,5,14
191026183,5,4,7,3,2,21
191026184,0,3,5,0,4,12
191026185,5,5,6,5,3,24
191026186,0,5,6,9,8,28
191026187,8,2,9,0,0,19
191026188,4,2,5,7,8,26
191026189,8,8,5,5,7,33
191026190,9,8,3,2,2,24
191026191,1,0,5,2,5,13
191026192,2,4,8,4,0,18
191026193,2,7,9,7,5,30
191026194,2,0,6,3,7,18
191026195,9,1,8,6,6,30
191026196,9,0,9,3,1,22
191026197,1,0,0,8,8,17
191026198,4,9,5,9,3,30
191026199,0,1,5,3,1,10
191026200,6,4,9,9,2,30
191026201,8,9,0,2,6,25
191026202,6,5,5,3,0,19
191026203,9,1,6,4,4,24
191026204,8,6,1,0,6,21
191026205,1,7,3,7,0,18
191026206,6,1,1,6,3,17
191026207,8,7,4,9,2,30
191026208,8,4,6,3,7,28
191026209,5,0,3,0,7,15
191026210,6,7,6,7,5,31
191026211,5,2,3,8,4,22
191026212,1,4,1,5,3,14
191026213,0,9,9,1,2,21
191026214,4,8,8,2,4,26
191026215,8,9,0,0,3,20
191026216,4,0,8,5,7,24
191026217,4,0,8,2,9,23
191026218,5,9,4,7,7,32
191026219,6,2,1,3,0,12
191026220,8,3,1,6,2,20
191026221,7,8,3,6,6,30
191026222,1,3,0,7,7,18
191026223,8,5,9,5,1,28
191026224,2,6,9,5,7,29
191026225,5,4,5,9,8,31
191026226,1,3,6,9,0,19
191026227,3,7,6,9,7,32
191026228,8,3,3,0,8,22
191026229,2,3,4,5,6,20
191026230,0,3,5,2,6,16
191026231,8,8,5,9,0,30
191026232,0,2,4,9,3,18
191026233,1,6,7,9,9,32
191026234,4,7,1,3,2,17
191026235,7,9,8,6,8,38
191026236,0,8,0,4,8,20
191026237,9,6,1,2,0,18
191026238,9,0,1,4,6,20
191026239,7,2,6,5,8,28
191026240,8,7,1,1,2,19
191026241,3,5,4,2,0,14
191026242,1,3,0,0,4,8
191026243,2,1,5,7,1,16
191026244,5,7,0,4,8,24
191026245,6,2,2,5,7,22
191026246,3,1,3,5,9,21
191026247,6,6,9,9,5,35
191026248,3,7,9,5,5,29
191026249,1,2,1,9,0,13
191026250,9,5,6,0,4,24
191026251,2,4,3,3,4,16
191026252,6,6,6,1,5,24
191026253,7,3,8,2,7,27
191026254,3,4,0,9,0,16
191026255,7,9,2,4,3,25
191026256,5,7,8,9,3,32
191026257,8,8,9,2,1,28
191026258,4,3,4,1,9,21
191026259,9,4,6,9,3,31
191026260,2,7,9,6,4,28
191026261,9,9,0,4,8,30
191026262,7,5,9,6,7,34
191026263,5,1,4,3,0,13
191026264,9,5,1,9,9,33
191026265,5,6,1,1,5,18
191026266,1,2,9,7,9,28
191026267,4,0,7,2,2,15
191026268,8,5,4,7,7,31
191026269,7,5,0,9,7,28
191026270,0,7,0,5,5,17
191026271,0,7,5,7,5,24
191026272,4,9,7,2,6,28
191026273,1,5,0,7,4,17
191026274,2,8,4,7,9,30
191026275,4,7,4,6,7,28
191026276,4,1,5,2,4,16
191026277,9,9,4,1,5,28
191026278,1,9,8,0,8,26
191026279,7,5,3,0,9,24
191026280,0,4,5,0,7,16
191026281,9,1,7,6,9,32
191026282,5,5,0,1,3,14
191026283,3,0,3,6,4,16
191026284,7,2,5,5,9,28
191026285,4,1,5,2,0,12
191026286,7,2,3,8,6,26
191026287,5,5,0,1,5,16
191026288,9,5,3,6,3,26
191026289,1,7,9,7,2,26
191026290,1,4,5,9,8,27
191026291,4,6,1,2,8,21
191026292,9,0,3,2,0,14
191026293,8,3,8,2,4,25
191026294,8,1,0,0,9,18
191026295,6,7,7,2,1,23
191026296,0,4,2,2,0,8
191026297,6,0,9,5,4,24
191026298,4,2,3,5,4,18
191026299,7,3,8,9,7,34
191026300,9,5,6,5,4,29
191026301,2,8,4,0,9,23
191026302,2,1,7,6,7,23
191026303,4,6,7,6,3,26
191026304,6,8,2,1,7,24
191026305,9,6,6,6,6,33
191026306,5,8,8,6,4,31
191026307,4,1,5,4,3,17
191026308,2,9,1,8,5,25
191026309,6,2,2,5,8,23
191026310,4,7,3,4,7,25
191026311,9,2,6,2,4,23
191026312,9,3,8,7,2,29
191026313,0,6,9,6,8,29
191026314,0,3,3,9,6,21
191026315,4,9,0,8,4,25
191026316,1,4,5,7,3,20
191026317,2,7,7,4,9,29
191026318,1,5,6,4,5,21
191026319,8,5,6,2,6,27
191026320,0,3,9,0,8,20
191026321,4,6,3,6,6,25
191026322,9,7,6,8,8,38
191026323,1,2,9,0,5,17
191026324,4,3,0,5,5,17
191026325,6,3,2,2,6,19
191026326,9,1,2,8,6,26
191026327,6,6,9,1,5,27
191026328,1,4,9,1,8,23
191026329,8,7,5,6,7,33
191026330,7,0,3,7,6,23
191026331,8,1,8,5,3,25
191026332,0,9,1,2,7,19
191026333,4,3,0,0,6,13
191026334,7,0,5,3,7,22
191026335,1,3,2,3,2,11
191026336,9,8,7,6,5,35
191026337,0,1,7,4,8,20
191026338,4,6,4,6,4,24
191026339,1,1,3,2,4,11
191026340,0,3,2,3,5,13
191026341,0,4,2,6,8,20
191026342,6,3,5,4,6,24
191026343,7,9,9,1,5,31
191026344,9,1,0,6,0,16
191026345,7,6,0,5,8,26
191026346,4,5,6,4,7,26
191026347,6,8,2,2,4,22
191026348,9,1,5,3,8,26
191026349,9,8,7,3,3,30
191026350,6,3,7,9,9,34
191026351,3,1,1,6,4,15
191026352,5,3,6,6,7,27
191026353,7,8,4,2,3,24
191026354,4,9,7,8,7,35
191026355,5,1,3,7,9,25
191026356,9,2,2,5,4,22
191026357,7,6,2,3,2,20
191026358,8,0,8,2,3,21
191026359,5,6,0,4,8,23
191026360,4,1,9,4,4,22
191026361,6,5,6,4,9,30
191026362,0,5,0,5,3,13
191026363,3,8,2,7,1,21
191026364,1,9,7,8,4,29
191026365,2,1,8,3,0,14
191026366,2,0,6,7,3,18
191026367,4,9,5,5,2,25
191026368,9,7,2,9,1,28
191026369,1,1,4,0,9,15
191026370,1,7,2,9,6,25
191026371,0,3,6,2,0,11
191026372,1,3,5,8,8,25
191026373,1,3,6,7,4,21
191026374,3,7,7,0,0,17
191026375,1,4,3,0,6,14
191026376,1,3,4,6,7,21
191026377,7,1,8,1,9,26
191026378,0,3,4,3,4,14
191026379,3,9,0,0,6,18
191026380,3,7,7,7,5,29
191026381,6,9,4,7,4,30
191026382,8,9,7,6,4,34
191026383,4,8,9,8,4,33
191026384,1,1,1,9,8,20
191026385,2,7,9,8,0,26
191026386,5,0,0,1,2,8
191026387,1,1,4,9,1,16
191026388,5,0,5,1,2,13
191026389,6,6,7,4,2,25
191026390,1,7,1,1,6,16
191026391,5,2,7,0,7,21
191026392,6,1,3,2,9,21
191026393,1,9,0,6,7,23
191026394,0,5,0,7,4,16
191026395,1,7,8,3,0,19
191026396,2,8,2,1,7,20
191026397,9,9,0,5,3,26
191026398,6,2,9,9,6,32
191026399,6,3,8,2,6,25
191026400,2,3,9,4,3,21
191026401,0,9,9,8,3,29
191026402,1,8,5,1,4,19
191026403,0,7,2,2,5,16
191026404,3,3,9,3,3,21
191026405,0,3,8,3,6,20
191026406,6,7,4,3,0,20
191026407,4,7,8,9,2,30
191026408,9,4,8,3,6,30
191026409,6,6,2,1,6,21
191026410,6,3,8,2,8,27
191026411,7,1,9,9,1,27
191026412,0,3,6,2,7,18
191026413,0,3,3,7,0,13
191026414,0,8,4,2,5,19
191026415,4,4,3,0,9,20
191026416,8,0,5,5,4,22
191026417,3,7,4,4,3,21
191026418,5,6,0,5,2,18
191026419,4,9,5,6,7,31
191026420,9,5,9,4,2,29
191026421,9,3,6,1,9,28
191026422,7,9,0,9,7,32
191026423,4,6,4,3,9,26
191026424,0,5,1,2,1,9
191026425,2,8,6,9,9,34
191026426,7,4,5,8,1,25
191026427,7,4,7,4,6,28
191026428,6,5,3,0,6,20
191026429,6,7,3,1,7,24
191026430,5,1,1,6,3,16
191026431,9,9,2,9,4,33
191026432,8,6,4,8,8,34
191026433,5,4,3,3,3,18
191026434,9,0,4,8,0,21
191026435,4,1,6,9,1,21
191026436,2,5,1,5,0,13
191026437,4,4,0,0,0,8
191026438,6,2,4,1,2,15
191026439,9,2,8,9,0,28
191026440,3,5,6,6,6,26
191026441,9,1,6,1,4,21
191026442,0,6,8,8,8,30
191026443,8,9,4,8,8,37
191026444,6,4,0,8,6,24
191026445,0,7,8,3,1,19
191026446,6,9,2,9,0,26
191026447,7,5,1,6,6,25
191026448,2,8,4,4,5,23
191026449,2,0,7,0,7,16
191026450,9,0,2,3,5,19
191026451,9,3,4,3,2,21
191026452,9,6,9,9,4,37
191026453,0,2,5,1,8,16
191026454,7,8,6,1,9,31
191026455,0,4,1,9,7,21
191026456,9,8,1,7,5,30
191026457,6,5,9,3,2,25
191026458,8,6,9,8,9,40
191026459,2,4,0,5,8,19
191026460,1,4,1,1,1,8
191026461,2,8,8,8,3,29
191026462,5,8,9,5,0,27
191026463,1,6,4,3,1,15
191026464,3,1,1,4,5,14
191026465,8,8,6,1,7,30
191026466,2,2,4,1,6,15
191026467,6,0,7,8,0,21
191026468,7,2,0,4,2,15
191026469,2,1,3,7,1,14
191026470,5,4,6,5,2,22
191026471,0,2,6,7,2,17
191026472,4,6,8,7,1,26
191026473,7,0,6,6,5,24
191026474,1,4,8,0,8,21
191026475,7,4,8,6,8,33
191026476,4,7,2,0,6,19
191026477,3,8,9,6,1,27
191026478,7,4,3,9,2,25
191026479,4,7,2,3,3,19
191026480,2,6,6,6,2,22
191026481,0,7,2,0,8,17
191026482,7,6,7,4,6,30
191026483,4,2,4,9,7,26
191026484,7,9,3,3,4,26
191026485,9,7,4,6,9,35
191026486,9,9,0,5,0,23
191026487,0,7,5,9,6,27
191026488,7,6,8,4,2,27
191026489,9,7,3,1,5,25
191026490,7,0,5,5,0,17
191026491,2,5,2,5,2,16
191026492,3,6,1,3,7,20
191026493,0,3,3,1,5,12
191026494,7,8,3,4,5,27
191026495,2,4,6,5,4,21
191026496,9,4,8,4,5,30
191026497,5,3,3,7,2,20
191026498,7,7,6,4,4,28
191026499,0,1,2,1,7,11
191026500,1,9,8,1,6,25
191026501,7,2,2,4,4,19
191026502,9,8,9,7,9,42
191026503,8,9,6,5,3,31
191026504,6,2,4,7,0,19
191026505,5,0,4,0,0,9
191026506,2,3,6,9,3,23
191026507,1,2,1,7,6,17
191026508,6,4,5,5,9,29
191026509,1,0,3,5,1,10
191026510,1,1,7,7,2,18
191026511,9,3,9,4,6,31
191026512,1,8,0,9,7,25
191026513,9,9,3,0,5,26
191026514,8,2,3,2,8,23
191026515,8,6,8,7,7,36
191026516,3,2,3,3,8,19
191026517,6,1,0,9,7,23
191026518,8,9,1,9,5,32
191026519,4,1,2,0,6,13
191026520,2,3,7,0,2,14
191026521,1,1,1,7,0,10
191026522,2,0,6,8,7,23
191026523,4,4,6,5,4,23
191026524,2,7,2,7,0,18
191026525,4,1,0,4,6,15
191026526,1,0,5,6,2,14
191026527,2,4,5,7,3,21
191026528,6,2,4,3,2,17
191026529,2,1,6,3,1,13
191026530,3,3,6,6,3,21
191026531,2,9,1,0,5,17
191026532,1,2,5,0,9,17
191026533,9,4,5,2,5,25
191026534,5,2,9,7,6,29
191026535,9,7,8,8,5,37
191026536,9,0,7,9,5,30
191026537,4,2,0,5,3,14
191026538,3,9,9,6,5,32
191026539,1,8,7,4,6,26
191026540,5,3,4,5,7,24
191026541,3,4,3,8,3,21
191026542,0,4,9,1,5,19
191026543,8,2,1,8,2,21
191026544,8,8,2,2,0,20
191026545,9,6,8,2,2,27
191026546,6,3,3,9,8,29
191026547,7,4,2,2,4,19
191026548,5,7,3,4,0,19
191026549,5,9,1,2,4,21
191026550,6,6,6,3,1,22
191026551,6,0,2,4,8,20
191026552,2,8,0,0,4,14
191026553,0,4,8,0,8,20
191026554,1,8,6,1,3,19
191026555,4,2,3,5,7,21
191026556,9,7,9,9,2,36
191026557,5,7,3,8,8,31
191026558,8,6,8,8,1,31
191026559,1,8,8,5,3,25
191026560,9,2,5,6,8,30
191026561,8,1,6,6,4,25
191026562,4,2,7,2,9,24
191026563,2,1,5,7,8,23
191026564,1,3,1,9,1,15
191026565,5,7,0,1,6,19
191026566,1,4,4,4,4,17
191026567,2,4,9,2,0,17
191026568,3,9,1,8,6,27
191026569,1,6,6,2,8,23
191026570,4,2,6,1,6,19
191026571,2,6,0,2,3,13
191026572,9,5,2,6,9,31
191026573,7,0,5,0,0,12
191026574,5,3,1,0,9,18
191026575,6,5,4,9,0,24
191026576,1,1,5,0,7,14
191026577,9,4,6,9,8,36
191026578,6,5,5,6,6,28
191026579,7,2,6,8,1,24
191026580,6,0,7,2,6,21
191026581,0,7,7,7,9,30
191026582,1,4,5,5,8,23
191026583,8,8,5,5,6,32
191026584,5,4,9,6,7,31
191026585,1,2,9,7,5,24
191026586,3,8,0,6,1,18
191026587,0,9,0,4,7,20
191026588,7,5,0,8,5,25
191026589,8,6,4,6,2,26
191026590,2,7,3,2,9,23
191026591,9,1,4,6,0,20
191026592,4,4,7,8,0,23
191026593,4,4,0,8,5,21
191026594,4,5,1,2,5,17
191026595,4,8,5,6,6,29
191026596,3,0,9,9,9,30
191026597,8,5,8,8,3,32
191026598,1,2,3,5,9,20
191026599,9,7,8,9,0,33
191026600,5,4,1,7,7,24
191026601,9,7,5,4,2,27
191026602,5,5,6,0,3,19
191026603,3,8,7,8,0,26
191026604,4,8,7,8,2,29
191026605,6,2,4,7,8,27
191026606,2,6,8,9,2,27
191026607,9,1,5,5,6,26
191026608,1,4,9,5,7,26
191026609,8,6,2,5,8,29
191026610,2,8,8,3,0,21
191026611,4,5,3,5,1,18
191026612,5,3,8,9,4,29
191026613,9,8,1,1,2,21
191026614,7,8,3,0,9,27
191026615,9,9,7,9,2,36
191026616,9,4,7,1,7,28
191026617,1,0,5,4,1,11
191026618,0,7,5,4,8,24
191026619,4,6,9,3,3,25
191026620,7,2,5,2,3,19
191026621,6,3,2,2,5,18
191026622,5,2,7,7,6,27
191026623,9,5,1,1,2,18
191026624,7,5,4,3,9,28
191026625,6,4,5,2,0,17
191026626,9,6,0,4,0,19
191026627,3,4,1,6,8,22
191026628,7,5,3,5,9,29
191026629,1,4,2,8,9,24
191026630,8,9,8,1,2,28
191026631,7,2,6,9,2,26
191026632,0,2,4,8,0,14
191026633,1,7,8,3,4,23
191026634,1,1,3,2,3,10
191026635,8,5,3,5,6,27
191026636,7,9,1,1,4,22
191026637,8,3,5,0,1,17
191026638,0,3,9,8,8,28
191026639,6,6,9,1,9,31
191026640,3,4,7,1,9,24
191026641,1,0,1,0,3,5
191026642,6,9,9,0,1,25
191026643,7,0,1,0,2,10
191026644,9,0,0,0,4,13
191026645,3,8,0,6,3,20
191026646,1,3,3,6,5,18
191026647,9,6,3,0,7,25
191026648,0,6,7,1,1,15
191026649,0,8,3,6,3,20
191026650,2,0,7,7,9,25
191026651,3,6,0,4,6,19
191026652,0,8,6,6,6,26
191026653,1,4,2,1,8,16
191026654,3,6,3,4,5,21
191026655,9,6,8,0,8,31
191026656,7,7,4,5,4,27
191026657,4,4,5,8,0,21
191026658,6,2,0,6,8,22
191026659,2,1,7,5,4,19
191026660,8,9,7,5,5,34
191026661,9,7,2,8,8,34
191026662,1,1,3,1,1,7
191026663,8,1,9,5,0,23
191026664,0,6,5,0,4,15
191026665,5,6,9,6,8,34
191026666,3,2,5,6,7,23
191026667,0,5,3,1,2,11
191026668,4,9,1,8,7,29
191026669,2,7,5,9,0,23
191026670,5,8,5,8,0,26
191026671,8,4,0,5,7,24
191026672,5,4,0,3,5,17
191026673,5,8,2,7,4,26
191026674,9,4,5,2,9,29
191026675,0,1,1,1,1,4
191026676,9,6,2,1,5,23
191026677,2,9,7,1,4,23
191026678,7,0,8,8,7,30
191026679,5,4,0,1,3,13
191026680,8,5,6,7,2,28
191026681,0,8,5,0,0,13
191026682,4,5,7,1,5,22
191026683,1,5,1,0,7,14
191026684,1,6,1,9,4,21
191026685,3,5,3,5,3,19
191026686,5,4,0,1,4,14
191026687,5,5,9,4,8,31
191026688,5,9,5,4,6,29
191026689,8,0,1,6,3,18
191026690,2,5,5,4,4,20
191026691,8,2,9,1,7,27
191026692,6,4,0,4,8,22
191026693,2,8,3,3,1,17
191026694,1,4,9,8,3,25
191026695,0,1,2,5,5,13
191026696,2,4,8,0,2,16
191026697,2,8,5,6,8,29
191026698,3,4,9,6,5,27
191026699,6,6,0,8,1,21
191026700,4,3,4,3,1,15
191026701,3,4,6,2,0,15
191026702,3,9,2,3,8,25
191026703,8,0,4,3,9,24
191026704,2,4,9,5,5,25
191026705,9,2,6,6,3,26
191026706,8,8,0,3,4,23
191026707,4,8,7,2,9,30
191026708,2,8,7,7,1,25
191026709,9,7,5,3,6,30
191026710,4,0,8,7,6,25
191026711,4,1,6,8,8,27
191026712,6,7,9,9,8,39
191026713,4,6,4,2,2,18
191026714,1,5,9,4,8,27
191026715,3,7,3,7,3,23
191026716,3,5,1,3,4,16
191026717,1,0,0,2,9,12
191026718,4,0,8,0,1,13
191026719,2,8,5,1,1,17
191026720,1,1,9,6,6,23
191026721,5,7,1,8,2,23
191026722,9,1,9,4,4,27
191026723,3,4,3,1,8,19
191026724,4,8,2,5,3,22
191026725,8,5,9,3,1,26
191026726,8,1,8,7,9,33
191026727,5,0,0,0,6,11
191026728,1,3,4,0,9,17
191026729,1,7,3,1,7,19
191026730,6,3,2,8,2,21
191026731,4,7,5,3,2,21
191026732,4,3,2,5,3,17
191026733,2,9,3,4,7,25
191026734,2,3,1,4,1,11
191026735,4,5,5,3,4,21
191026736,7,9,9,6,0,31
191026737,7,3,9,5,4,28
191026738,1,6,2,0,7,16
191026739,6,3,2,7,6,24
191026740,5,8,9,4,8,34
191026741,4,6,7,7,7,31
191026742,1,6,0,1,6,14
191026743,0,2,9,3,2,16
191026744,2,5,3,2,8,20
191026745,8,9,8,6,7,38
191026746,2,5,7,3,5,22
191026747,2,3,4,1,3,13
191026748,6,8,4,6,2,26
191026749,0,7,1,5,9,22
191026750,4,6,7,9,5,31
191026751,8,7,9,5,5,34
191026752,9,5,0,3,6,23
191026753,1,2,3,4,7,17
191026754,8,2,0,1,7,18
191026755,2,6,0,7,3,18
191026756,8,6,9,8,8,39
191026757,5,5,0,1,4,15
191026758,6,4,5,4,6,25
191026759,2,3,3,7,2,17
191026760,0,4,1,2,1,8
191026761,1,9,7,4,3,24
191026762,0,2,1,8,8,19
191026763,2,0,3,3,1,9
191026764,4,6,1,7,1,19
191026765,3,8,7,9,0,27
191026766,1,3,3,9,9,25
191026767,9,8,2,8,0,27
191026768,7,4,9,9,0,29
191026769,8,5,4,6,0,23
191026770,0,9,1,3,8,21
191026771,0,4,0,9,6,19
191026772,4,5,7,5,9,30
191026773,9,8,1,9,9,36
191026774,5,4,5,3,4,21
191026775,3,7,3,3,9,25
191026776,2,5,2,7,7,23
191026777,5,5,6,4,8,28
191026778,6,8,9,9,2,34
191026779,9,7,1,7,6,30
191026780,7,5,4,7,9,32
191026781,5,6,1,0,7,19
191026782,5,5,5,7,5,27
191026783,4,4,5,4,9,26
191026784,1,4,5,8,8,26
191026785,6,3,6,1,2,18
191026786,5,4,7,0,2,18
191026787,6,9,2,3,0,20
191026788,0,4,0,1,1,6
191026789,2,9,2,9,1,23
191026790,3,6,2,0,2,13
191026791,4,3,3,7,5,22
191026792,6,9,3,2,7,27
191026793,5,7,4,0,1,17
191026794,5,1,1,4,1,12
191026795,5,3,5,6,6,25
191026796,0,9,2,6,6,23
191026797,8,9,0,6,4,27
191026798,7,6,8,4,1,26
191026799,6,1,9,2,5,23
191026800,4,1,2,7,8,22
191026801,7,4,5,0,4,20
191026802,3,3,5,8,9,28
191026803,6,1,2,5,1,15
191026804,0,9,2,9,7,27
191026805,9,5,5,0,6,25
191026806,7,8,6,1,0,22
191026807,7,5,3,7,5,27
191026808,2,6,6,8,3,25
191026809,3,7,0,2,1,13
191026810,3,2,5,0,6,16
191026811,5,9,5,1,8,28
191026812,1,4,0,0,6,11
191026813,8,9,4,8,1,30
191026814,7,7,1,3,5,23
191026815,9,2,5,7,2,25
191026816,6,7,9,8,6,36
191026817,0,0,1,0,9,10
191026818,2,3,8,4,7,24
191026819,6,3,7,9,7,32
191026820,8,3,4,8,9,32
191026821,8,2,1,8,8,27
191026822,1,1,8,3,9,22
191026823,5,0,3,5,7,20
191026824,4,8,8,7,2,29
191026825,8,7,3,6,9,33
191026826,6,0,4,4,9,23
191026827,3,9,6,2,4,24
191026828,8,1,9,9,1,28
191026829,2,1,9,7,4,23
191026830,5,4,9,1,2,21
191026831,4,7,2,6,7,26
191026832,3,1,1,5,3,13
191026833,5,2,9,4,0,20
191026834,7,6,2,3,0,18
191026835,2,2,7,6,5,22
191026836,2,9,3,8,8,30
191026837,0,4,8,9,5,26
191026838,7,9,4,9,3,32
191026839,1,6,6,6,1,20
191026840,3,6,8,2,0,19
191026841,2,7,2,8,3,22
191026842,2,3,1,4,7,17
191026843,3,2,5,4,1,15
191026844,4,3,6,5,9,27
191026845,9,0,4,0,0,13
191026846,9,4,5,0,2,20
191026847,0,9,6,0,4,19
191026848,5,0,6,6,1,18
191026849,1,4,6,0,2,13
191026850,5,6,3,4,6,24
191026851,7,7,9,7,1,31
191026852,1,6,7,5,3,22
191026853,9,9,8,5,7,38
191026854,4,6,1,5,1,17
191026855,4,6,2,0,0,12
191026856,2,0,7,2,0,11
191026857,8,1,5,2,6,22
191026858,8,4,9,8,4,33
191026859,8,4,2,1,6,21
191026860,0,3,2,9,7,21
191026861,9,6,4,4,5,28
191026862,2,2,1,9,2,16
191026863,0,3,0,8,8,19
191026864,9,0,1,7,9,26
191026865,1,3,8,0,4,16
191026866,5,5,5,9,8,32
191026867,2,4,0,0,6,12
191026868,0,5,5,0,6,16
191026869,3,0,6,7,6,22
191026870,6,2,8,8,9,33
191026871,1,5,3,0,9,18
191026872,9,4,8,2,3,26
191026873,1,3,8,1,8,21
191026874,6,6,2,4,2,20
191026875,6,1,9,7,5,28
191026876,2,7,3,3,1,16
191026877,5,5,9,9,2,30
191026878,8,2,1,0,5,16
191026879,0,6,9,9,7,31
191026880,3,8,2,1,1,15
191026881,1,4,3,0,9,17
191026882,5,2,6,7,7,27
191026883,0,7,3,1,8,19
191026884,6,6,8,7,4,31
191026885,8,3,4,5,3,23
191026886,8,2,8,8,3,29
191026887,7,2,9,7,7,32
191026888,2,5,7,3,8,25
191026889,5,4,7,9,5,30
191026890,3,1,1,7,7,19
191026891,5,6,2,4,5,22
191026892,6,3,1,7,8,25
191026893,8,9,7,0,9,33
191026894,9,3,5,1,4,22
191026895,5,6,4,2,1,18
191026896,8,2,4,5,0,19
191026897,0,6,7,0,9,22
191026898,5,4,5,5,2,21
191026899,2,5,1,0,6,14
191026900,6,5,2,9,6,28
191026901,5,0,2,4,2,13
191026902,4,0,9,7,7,27
191026903,9,8,7,6,2,32
191026904,1,1,8,8,4,22
191026905,5,0,9,2,4,20
191026906,0,1,4,5,2,12
191026907,3,3,0,2,5,13
191026908,2,1,1,2,0,6
191026909,7,9,0,6,3,25
191026910,8,4,8,3,4,27
191026911,7,8,3,8,9,35
191026912,0,5,1,5,9,20
191026913,2,4,7,5,6,24
191026914,8,1,2,6,9,26
191026915,0,7,7,4,4,22
191026916,6,1,9,7,4,27
191026917,2,3,3,4,0,12
191026918,8,0,0,3,7,18
191026919,4,6,1,4,3,18
191026920,0,2,7,8,2,19
191026921,7,2,7,0,9,25
191026922,2,6,1,0,9,18
191026923,6,1,5,1,3,16
191026924,4,3,1,8,4,20
191026925,4,3,6,1,4,18
191026926,4,5,7,3,5,24
191026927,4,6,5,7,0,22
191026928,1,2,3,5,0,11
191026929,8,7,3,8,4,30
191026930,1,1,8,8,9,27
191026931,5,0,5,5,9,24
191026932,7,9,4,4,2,26
191026933,5,4,4,7,6,26
191026934,5,6,8,8,4,31
191026935,6,8,7,9,6,36
191026936,5,3,5,5,6,24
191026937,6,5,8,8,2,29
191026938,5,0,0,6,8,19
191026939,1,7,9,3,5,25
191026940,0,3,5,8,8,24
191026941,5,3,4,4,0,16
191026942,4,6,9,2,1,22
191026943,3,7,2,6,2,20
191026944,3,1,2,0,3,9
191026945,9,1,4,7,3,24
191026946,3,3,7,9,9,31
191026947,6,1,0,9,3,19
191026948,0,5,2,9,5,21
191026949,7,0,3,0,9,19
191026950,9,2,4,2,0,17
191026951,5,0,1,8,1,15
191026952,0,8,3,1,5,17
191026953,5,2,9,1,9,26
191026954,4,6,6,5,0,21
191026955,5,0,7,3,7,22
191026956,4,8,3,7,2,24
191026957,1,7,4,8,0,20
191026958,8,6,1,8,1,24
191026959,6,0,7,0,4,17
191026960,3,7,1,2,9,22
191026961,3,1,9,1,6,20
191026962,3,5,5,3,4,20
191026963,7,4,5,8,8,32
191026964,5,6,9,5,4,29
191026965,8,0,6,5,4,23
191026966,1,6,9,1,6,23
191026967,1,4,9,3,7,24
191026968,0,6,3,1,9,19
191026969,1,7,0,0,9,17
191026970,5,9,1,7,7,29
191026971,6,7,4,6,7,30
191026972,5,5,7,0,4,21
191026973,1,8,2,9,5,25
191026974,7,9,1,4,8,29
191026975,7,5,5,8,3,28
191026976,9,5,6,0,9,29
191026977,0,2,9,1,3,15
191026978,3,9,5,0,1,18
191026979,4,4,3,3,8,22
191026980,9,1,2,5,1,18
191026981,0,3,9,4,3,19
191026982,0,2,1,9,2,14
191026983,1,5,3,1,8,18
191026984,7,2,4,9,3,25
191026985,5,1,0,3,0,9
191026986,6,8,3,9,8,34
191026987,8,2,3,0,5,18
191026988,4,9,7,2,2,24
191026989,3,1,3,4,9,20
191026990,7,2,2,0,5,16
191026991,5,0,9,7,0,21
191026992,0,6,7,1,4,18
191026993,0,8,8,6,8,30
191026994,6,9,8,6,5,34
191026995,7,8,8,2,1,26
191026996,5,7,0,8,5,25
191026997,6,7,1,5,9,28
191026998,5,9,7,5,2,28
191026999,3,5,7,8,1,24
1910261000,3,5,9,9,6,32
1910261001,6,6,6,2,3,23
1910261002,9,2,3,2,5,21
1910261003,7,2,9,8,1,27
1910261004,5,3,2,1,4,15
1910261005,7,3,9,1,2,22
1910261006,8,3,1,5,7,24
1910261007,3,8,6,4,7,28
1910261008,6,0,9,6,9,30
1910261009,2,8,9,5,6,30
1910261010,6,4,2,2,6,20
1910261011,5,0,1,5,0,11
1910261012,5,8,8,3,5,29
1910261013,0,1,5,0,0,6
1910261014,5,5,4,4,2,20
1910261015,0,0,8,3,4,15
1910261016,2,6,7,1,5,21
1910261017,5,0,0,7,5,17
1910261018,6,4,3,0,0,13
1910261019,9,8,8,7,1,33
1910261020,2,3,8,1,6,20
1910261021,1,0,3,3,2,9
1910261022,1,8,0,1,5,15
1910261023,6,2,8,7,1,24
1910261024,6,1,4,9,6,26
1910261025,0,3,9,7,1,20
1910261026,3,9,0,8,9,29
1910261027,4,0,3,7,9,23
1910261028,8,8,4,4,7,31
1910261029,0,3,8,7,5,23
1910261030,4,9,8,6,2,29
1910261031,8,1,6,8,6,29
1910261032,1,3,4,8,2,18
1910261033,5,3,1,0,3,12
1910261034,9,2,1,4,4,20
1910261035,4,6,3,3,9,25
1910261036,8,2,5,8,6,29
1910261037,3,5,9,1,7,25
1910261038,2,4,5,0,0,11
1910261039,3,5,4,0,9,21
1910261040,6,5,3,1,5,20
1910261041,0,8,9,8,4,29
1910261042,1,5,5,0,1,12
1910261043,9,3,2,1,5,20
1910261044,3,5,5,1,8,22
1910261045,8,3,3,9,3,26
1910261046,9,0,3,2,7,21
1910261047,8,9,0,8,5,30
1910261048,3,0,5,9,9,26
1910261049,3,5,2,1,6,17
1910261050,4,0,8,1,1,14
1910261051,0,9,8,9,5,31
1910261052,7,4,4,4,2,21
1910261053,4,5,8,4,2,23
1910261054,7,6,6,1,6,26
1910261055,5,4,6,8,7,30
1910261056,6,2,7,5,1,21
1910261057,8,1,3,0,4,16
1910261058,7,1,5,2,0,15
1910261059,4,5,4,9,3,25
1910261060,0,8,4,3,2,17
1910261061,7,4,3,0,4,18
1910261062,7,2,0,4,8,21
1910261063,7,6,2,8,5,28
1910261064,1,6,8,8,5,28
1910261065,8,3,3,2,5,21
1910261066,3,1,0,8,6,18
1910261067,7,4,5,1,6,23
1910261068,7,4,7,9,5,32
1910261069,9,5,8,2,4,28
1910261070,8,5,0,6,8,27
1910261071,5,5,9,7,1,27
1910261072,3,3,0,7,0,13
1910261073,8,5,3,0,7,23
1910261074,9,5,4,6,5,29
1910261075,0,3,3,9,8,23
1910261076,1,6,9,2,6,24
1910261077,8,1,8,7,2,26
1910261078,3,0,8,8,0,19
1910261079,2,7,7,9,7,32
1910261080,5,8,8,7,4,32
1910261081,5,7,6,9,0,27
1910261082,7,5,7,2,7,28
1910261083,9,3,8,3,5,28
1910261084,3,4,6,5,0,18
1910261085,1,2,2,0,2,7
1910261086,9,7,7,8,2,33
1910261087,3,2,2,2,9,18
1910261088,3,7,4,3,5,22
1910261089,5,4,9,2,6,26
1910261090,6,9,1,0,4,20
1910261091,7,6,1,9,7,30
1910261092,7,6,8,7,9,37
1910261093,0,7,2,4,5,18
1910261094,8,5,2,5,9,29
1910261095,3,9,3,0,2,17
1910261096,9,0,2,4,1,16
1910261097,7,9,7,9,4,36
1910261098,9,7,2,9,0,27
1910261099,5,5,1,4,8,23
1910261100,4,4,7,5,7,27
1910261101,8,0,7,6,1,22
1910261102,1,8,2,7,8,26
1910261103,1,7,8,5,5,26
1910261104,0,4,3,3,9,19
1910261105,1,6,7,4,0,18
191027001,8,0,9,2,7,26
191027002,0,0,2,8,1,11
191027003,2,9,3,6,4,24
191027004,8,4,2,6,6,26
191027005,4,0,2,1,2,9
191027006,1,4,9,0,6,20
191027007,8,7,5,8,8,36
191027008,5,1,7,4,3,20
191027009,6,6,5,5,9,31
191027010,8,3,8,0,6,25
191027011,5,2,4,5,3,19
191027012,9,5,5,0,1,20
191027013,4,9,5,9,2,29
191027014,0,4,1,2,6,13
191027015,2,0,3,3,7,15
191027016,0,0,3,8,8,19
191027017,3,2,0,9,8,22
191027018,9,8,2,8,9,36
191027019,2,2,2,8,2,16
191027020,0,6,3,8,8,25
191027021,0,2,2,4,1,9
191027022,0,4,9,2,6,21
191027023,5,4,0,9,3,21
191027024,6,8,8,2,7,31
191027025,0,7,6,0,0,13
191027026,7,4,9,5,8,33
191027027,8,2,1,5,8,24
191027028,9,3,7,2,0,21
191027029,9,6,7,6,8,36
191027030,5,8,6,7,9,35
191027031,8,2,7,0,9,26
191027032,4,2,4,7,4,21
191027033,7,5,6,8,3,29
191027034,3,8,5,2,3,21
191027035,4,9,1,2,4,20
191027036,0,5,5,2,5,17
191027037,0,9,4,6,1,20
191027038,9,9,9,8,6,41
191027039,5,3,5,9,8,30
191027040,0,2,5,2,9,18
191027041,2,1,6,5,6,20
191027042,2,6,9,6,1,24
191027043,0,8,7,3,7,25
191027044,2,3,0,3,1,9
191027045,3,9,9,9,2,32
191027046,1,0,2,5,9,17
191027047,0,5,4,4,2,15
191027048,5,8,6,0,6,25
191027049,3,0,9,8,7,27
191027050,1,8,2,9,4,24
191027051,4,8,0,9,8,29
191027052,0,4,6,3,6,19
191027053,2,6,1,5,8,22
191027054,5,6,9,2,7,29
191027055,0,8,5,5,8,26
191027056,2,3,0,2,4,11
191027057,9,6,0,8,5,28
191027058,2,8,2,1,6,19
191027059,5,4,8,9,5,31
191027060,5,5,0,1,0,11
191027061,4,4,2,0,2,12
191027062,5,3,8,2,1,19
191027063,0,7,4,2,0,13
191027064,5,4,5,6,3,23
191027065,5,0,9,2,8,24
191027066,6,3,3,7,6,25
191027067,9,3,5,4,5,26
191027068,7,5,6,3,3,24
191027069,9,3,4,8,0,24
191027070,5,2,1,4,7,19
191027071,0,1,5,6,3,15
191027072,4,5,5,9,1,24
191027073,4,7,9,6,4,30
191027074,0,5,4,3,5,17
191027075,9,9,6,1,6,31
191027076,8,5,8,9,0,30
191027077,6,8,7,8,5,34
191027078,0,1,7,9,0,17
191027079,8,0,3,2,0,13
191027080,8,8,3,3,9,31
191027081,0,1,8,2,2,13
191027082,5,1,7,1,7,21
191027083,7,8,1,3,8,27
191027084,9,8,3,4,0,24
191027085,5,9,7,1,5,27
191027086,1,1,3,8,5,18
191027087,9,3,0,0,5,17
191027088,2,9,4,6,1,22
191027089,0,4,2,3,7,16
191027090,6,8,1,6,6,27
191027091,8,1,7,2,2,20
191027092,0,2,3,2,2,9
191027093,2,6,8,5,6,27
191027094,2,9,3,5,9,28
191027095,1,0,6,4,0,11
191027096,1,8,3,4,4,20
191027097,8,1,6,1,6,22
191027098,5,0,9,5,7,26
191027099,2,6,3,5,0,16
191027100,4,1,2,5,4,16
191027101,5,8,6,5,0,24
191027102,4,6,6,4,5,25
191027103,1,9,0,2,8,20
191027104,0,8,6,3,2,19
191027105,7,2,9,9,1,28
191027106,4,7,4,9,1,25
191027107,0,6,8,0,1,15
191027108,2,7,4,9,2,24
191027109,2,4,2,9,5,22
191027110,2,4,8,0,4,18
191027111,3,6,1,7,0,17
191027112,7,9,0,0,5,21
191027113,4,5,0,5,0,14
191027114,1,9,2,6,9,27
191027115,5,5,5,7,1,23
191027116,7,5,5,4,1,22
191027117,5,8,7,7,7,34
191027118,7,4,5,3,6,25
191027119,1,8,4,4,5,22
191027120,3,2,9,5,2,21
191027121,2,5,8,9,7,31
191027122,5,6,3,1,3,18
191027123,0,5,8,0,0,13
191027124,1,5,8,2,1,17
191027125,7,2,4,1,6,20
191027126,9,4,0,4,8,25
191027127,9,9,9,8,1,36
191027128,0,2,5,4,4,15
191027129,8,4,8,1,5,26
191027130,9,1,1,8,9,28
191027131,7,2,5,3,1,18
191027132,0,3,5,5,6,19
191027133,5,5,0,0,3,13
191027134,4,3,0,0,4,11
191027135,8,1,5,6,5,25
191027136,2,9,3,3,4,21
191027137,9,0,2,8,6,25
191027138,9,9,5,5,9,37
191027139,1,2,4,5,5,17
191027140,2,1,7,2,3,15
191027141,0,4,9,9,2,24
191027142,3,7,9,8,3,30
191027143,2,7,0,3,8,20
191027144,8,5,1,5,0,19
191027145,3,8,5,1,4,21
191027146,7,5,0,7,0,19
191027147,2,1,5,2,8,18
191027148,2,8,3,3,9,25
191027149,3,9,3,3,5,23
191027150,7,6,6,1,2,22
191027151,2,7,1,1,2,13
191027152,5,3,1,2,0,11
191027153,7,1,1,9,9,27
191027154,5,8,5,6,0,24
191027155,7,4,8,3,0,22
191027156,5,9,5,4,7,30
191027157,1,6,6,1,1,15
191027158,0,9,2,3,3,17
191027159,4,8,2,0,6,20
191027160,6,7,9,6,8,36
191027161,6,3,0,1,2,12
191027162,2,1,9,3,9,24
191027163,5,9,2,5,9,30
191027164,4,4,7,7,8,30
191027165,2,3,6,8,1,20
191027166,1,8,4,7,4,24
191027167,1,1,0,4,9,15
191027168,0,6,5,4,6,21
191027169,8,0,9,8,5,30
191027170,3,4,7,4,0,18
191027171,8,5,7,8,3,31
191027172,3,8,4,1,0,16
191027173,8,3,4,0,0,15
191027174,8,9,9,6,8,40
191027175,1,1,1,8,8,19
191027176,8,5,3,3,0,19
191027177,5,9,2,4,3,23
191027178,9,1,8,6,0,24
191027179,1,6,8,5,1,21
191027180,2,9,8,5,1,25
191027181,8,7,9,1,0,25
191027182,1,7,8,9,0,25
191027183,5,8,9,6,1,29
191027184,7,7,9,5,0,28
191027185,7,3,2,0,9,21
191027186,9,6,1,4,3,23
191027187,4,2,7,0,8,21
191027188,4,7,5,4,2,22
191027189,1,4,1,4,9,19
191027190,5,3,0,1,8,17
191027191,8,3,9,4,2,26
191027192,5,0,3,1,9,18
191027193,4,4,9,3,6,26
191027194,1,7,2,4,3,17
191027195,2,4,5,6,1,18
191027196,1,2,1,3,9,16
191027197,7,6,4,6,6,29
191027198,4,7,7,1,8,27
191027199,2,2,4,4,1,13
191027200,3,1,9,0,8,21
191027201,2,7,6,6,0,21
191027202,5,7,7,8,3,30
191027203,0,7,7,2,3,19
191027204,1,9,9,5,9,33
191027205,6,2,0,0,6,14
191027206,4,7,3,2,0,16
191027207,6,8,9,3,4,30
191027208,5,3,1,4,5,18
191027209,0,8,6,2,5,21
191027210,3,5,4,5,0,17
191027211,6,1,2,2,0,11
191027212,2,1,7,7,4,21
191027213,5,2,0,5,2,14
191027214,3,2,3,4,6,18
191027215,3,8,8,6,2,27
191027216,7,7,2,1,8,25
191027217,2,1,5,5,1,14
191027218,9,0,9,7,3,28
191027219,6,7,6,5,8,32
191027220,6,2,3,2,5,18
191027221,4,4,4,5,8,25
191027222,4,2,1,9,4,20
191027223,6,6,3,1,3,19
191027224,2,3,5,3,5,18
191027225,4,0,7,2,0,13
191027226,7,1,1,8,2,19
191027227,4,3,6,2,0,15
191027228,6,1,3,0,8,18
191027229,0,6,7,1,9,23
191027230,1,4,8,6,4,23
191027231,8,5,6,7,4,30
191027232,5,7,3,8,1,24
191027233,5,7,5,1,0,18
191027234,0,9,8,7,0,24
191027235,7,6,1,5,8,27
191027236,8,1,4,2,3,18
191027237,4,2,3,3,3,15
191027238,5,0,8,3,0,16
191027239,8,9,9,4,0,30
191027240,4,0,9,2,7,22
191027241,8,6,1,5,1,21
191027242,7,7,3,9,1,27
191027243,5,6,4,9,1,25
191027244,9,7,6,5,2,29
191027245,8,4,0,8,7,27
191027246,2,8,2,7,4,23
191027247,0,6,4,8,4,22
191027248,9,2,7,0,6,24
191027249,2,6,5,6,1,20
191027250,9,1,1,2,8,21
191027251,5,9,3,9,7,33
191027252,8,4,7,2,1,22
191027253,7,0,3,6,6,22
191027254,9,9,1,2,9,30
191027255,9,7,0,2,2,20
191027256,4,9,9,1,3,26
191027257,0,2,5,6,4,17
191027258,0,2,3,7,0,12
191027259,4,9,7,3,6,29
191027260,6,2,9,6,2,25
191027261,6,0,2,6,1,15
191027262,0,2,4,3,1,10
191027263,6,4,1,2,9,22
191027264,5,4,5,7,5,26
191027265,1,4,0,3,7,15
191027266,8,7,1,9,2,27
191027267,4,9,3,9,7,32
191027268,3,6,7,4,9,29
191027269,3,7,8,7,8,33
191027270,9,1,4,2,2,18
191027271,2,7,1,6,6,22
191027272,2,3,9,6,2,22
191027273,2,0,5,4,4,15
191027274,8,7,6,3,5,29
191027275,3,4,9,0,3,19
191027276,3,9,8,2,3,25
191027277,3,5,2,4,7,21
191027278,6,3,9,8,4,30
191027279,7,7,1,5,5,25
191027280,8,3,8,3,6,28
191027281,7,6,2,5,2,22
191027282,1,6,8,1,2,18
191027283,9,8,1,3,2,23
191027284,9,9,8,9,8,43
191027285,2,0,7,9,1,19
191027286,7,5,8,6,7,33
191027287,7,6,5,4,4,26
191027288,0,5,0,6,6,17
191027289,1,8,3,6,9,27
191027290,1,3,5,7,0,16
191027291,1,6,1,8,9,25
191027292,0,3,6,7,0,16
191027293,8,3,9,9,7,36
191027294,5,7,5,7,5,29
191027295,2,4,4,0,4,14
191027296,8,7,9,3,2,29
191027297,1,0,3,1,8,13
191027298,6,6,2,5,7,26
191027299,5,2,7,5,5,24
191027300,8,0,9,3,4,24
191027301,9,3,6,3,2,23
191027302,2,8,4,2,4,20
191027303,7,5,2,6,3,23
191027304,3,6,6,7,0,22
191027305,0,5,4,6,4,19
191027306,6,4,8,4,2,24
191027307,9,5,2,6,2,24
191027308,8,2,0,8,3,21
191027309,1,4,9,7,2,23
191027310,0,9,3,7,3,22
191027311,0,3,2,3,8,16
191027312,7,4,0,5,0,16
191027313,2,3,0,7,5,17
191027314,0,0,8,2,9,19
191027315,3,8,2,1,4,18
191027316,7,1,5,6,4,23
191027317,2,7,6,2,9,26
191027318,2,8,5,7,4,26
191027319,8,5,5,9,9,36
191027320,6,7,6,3,8,30
191027321,0,5,9,4,7,25
191027322,6,1,9,4,7,27
191027323,5,9,8,0,7,29
191027324,1,9,4,1,0,15
191027325,2,8,2,3,8,23
191027326,2,7,1,6,4,20
191027327,0,5,3,8,2,18
191027328,1,1,3,1,8,14
191027329,5,0,1,6,3,15
191027330,9,2,4,2,1,18
191027331,6,1,1,7,6,21
191027332,0,2,8,7,7,24
191027333,5,6,9,5,8,33
191027334,4,2,2,1,1,10
191027335,4,7,8,5,3,27
191027336,9,2,2,5,9,27
191027337,0,6,1,8,9,24
191027338,9,4,8,2,1,24
191027339,6,0,3,1,3,13
191027340,9,9,5,4,3,30
191027341,7,5,5,6,8,31
191027342,8,3,5,8,9,33
191027343,6,0,6,7,0,19
191027344,8,2,7,0,6,23
191027345,4,8,3,0,0,15
191027346,7,7,4,0,8,26
191027347,4,2,4,9,6,25
191027348,8,8,0,6,3,25
191027349,5,3,7,9,3,27
191027350,2,3,8,1,8,22
191027351,6,5,3,9,4,27
191027352,7,0,3,4,4,18
191027353,1,2,1,9,2,15
191027354,4,5,2,1,6,18
191027355,2,7,0,9,8,26
191027356,2,7,8,3,6,26
191027357,3,5,0,8,9,25
191027358,7,2,0,4,7,20
191027359,0,1,0,2,0,3
191027360,3,2,4,9,4,22
191027361,6,4,4,0,9,23
191027362,7,0,2,3,2,14
191027363,7,3,7,3,9,29
191027364,7,5,3,0,5,20
191027365,6,7,9,9,4,35
191027366,0,8,8,2,7,25
191027367,0,4,0,9,7,20
191027368,9,2,0,9,7,27
191027369,1,4,2,0,3,10
191027370,1,7,2,9,2,21
191027371,0,2,9,1,5,17
191027372,6,3,4,4,8,25
191027373,6,3,6,4,3,22
191027374,3,8,5,9,3,28
191027375,0,0,6,3,1,10
191027376,2,0,3,0,8,13
191027377,7,1,9,4,5,26
191027378,6,5,6,5,0,22
191027379,6,5,1,0,3,15
191027380,4,3,9,2,6,24
191027381,7,9,5,1,2,24
191027382,2,6,4,0,1,13
191027383,8,4,1,6,9,28
191027384,1,6,9,3,6,25
191027385,4,5,7,1,9,26
191027386,5,3,0,5,2,15
191027387,5,8,5,6,4,28
191027388,7,7,6,0,8,28
191027389,2,5,0,7,5,19
191027390,2,7,6,6,8,29
191027391,8,5,8,2,4,27
191027392,6,0,9,9,6,30
191027393,0,6,3,6,4,19
191027394,9,4,0,7,7,27
191027395,0,8,4,1,8,21
191027396,1,9,1,4,9,24
191027397,5,3,4,3,4,19
191027398,6,3,3,4,6,22
191027399,7,5,7,4,8,31
191027400,3,2,1,2,2,10
191027401,4,8,4,4,1,21
191027402,0,7,4,2,6,19
191027403,8,4,6,8,8,34
191027404,6,5,4,8,0,23
191027405,9,2,1,3,6,21
191027406,5,3,7,1,7,23
191027407,0,9,7,9,8,33
191027408,7,4,8,7,2,28
191027409,7,7,7,9,4,34
191027410,0,7,6,3,2,18
191027411,3,6,9,6,4,28
191027412,0,9,5,9,0,23
191027413,5,7,7,2,4,25
191027414,4,5,9,3,9,30
191027415,8,1,6,3,6,24
191027416,4,9,2,3,1,19
191027417,0,5,8,9,2,24
191027418,8,8,2,7,6,31
191027419,9,3,7,9,3,31
191027420,0,4,7,2,6,19
191027421,5,6,3,1,7,22
191027422,1,8,7,1,6,23
191027423,9,6,1,5,0,21
191027424,9,8,5,8,9,39
191027425,5,6,9,4,0,24
191027426,6,9,8,9,7,39
191027427,8,6,7,3,1,25
191027428,8,7,6,2,8,31
191027429,5,9,7,6,0,27
191027430,7,8,5,5,4,29
191027431,1,1,0,5,3,10
191027432,9,2,6,1,1,19
191027433,7,1,9,7,5,29
191027434,3,7,1,0,3,14
191027435,5,5,9,8,5,32
191027436,8,8,7,5,8,36
191027437,0,3,7,6,5,21
191027438,9,9,9,6,6,39
191027439,5,6,4,7,6,28
191027440,9,6,1,9,0,25
191027441,8,1,8,0,7,24
191027442,7,8,1,8,7,31
191027443,6,7,6,2,4,25
191027444,6,3,0,8,6,23
191027445,7,1,1,1,5,15
191027446,9,1,0,1,3,14
191027447,4,7,7,2,7,27
191027448,0,6,3,7,9,25
191027449,0,7,5,7,4,23
191027450,7,2,8,6,1,24
191027451,4,0,0,4,8,16
191027452,6,5,5,6,0,22
191027453,0,7,1,8,8,24
191027454,0,8,7,8,5,28
191027455,3,5,4,6,8,26
191027456,1,4,7,0,0,12
191027457,4,3,1,6,3,17
191027458,1,1,8,1,2,13
191027459,2,7,8,0,0,17
191027460,3,7,2,6,9,27
191027461,4,5,1,0,0,10
191027462,0,5,8,1,2,16
191027463,8,1,6,2,4,21
191027464,6,9,5,0,9,29
191027465,8,6,2,0,0,16
191027466,5,3,1,8,9,26
191027467,2,4,8,5,0,19
191027468,6,0,1,9,7,23
191027469,4,3,0,5,4,16
191027470,4,4,3,8,6,25
191027471,2,7,2,9,2,22
191027472,0,7,9,4,6,26
191027473,6,7,4,3,8,28
191027474,8,8,5,1,2,24
191027475,9,8,8,9,8,42
191027476,8,4,7,6,0,25
191027477,3,7,4,4,2,20
191027478,1,3,4,0,1,9
191027479,9,4,7,3,4,27
191027480,3,1,2,4,4,14
191027481,0,1,1,8,7,17
191027482,9,9,4,3,1,26
191027483,7,1,9,5,1,23
191027484,1,5,0,1,8,15
191027485,6,9,6,3,2,26
191027486,9,0,8,5,5,27
191027487,7,0,7,4,2,20
191027488,3,7,0,7,1,18
191027489,3,6,0,3,8,20
191027490,2,3,2,0,6,13
191027491,0,1,0,7,6,14
191027492,6,7,7,4,7,31
191027493,4,6,5,0,1,16
191027494,7,7,0,3,7,24
191027495,5,6,1,8,7,27
191027496,3,2,2,1,1,9
191027497,1,8,2,8,9,28
191027498,9,6,3,2,0,20
191027499,3,7,3,0,2,15
191027500,3,3,4,6,8,24
191027501,4,3,0,9,4,20
191027502,1,7,1,9,3,21
191027503,2,5,6,1,7,21
191027504,2,0,8,3,0,13
191027505,7,9,4,6,8,34
191027506,4,9,1,7,0,21
191027507,8,8,5,8,9,38
191027508,9,5,7,3,1,25
191027509,2,9,3,3,5,22
191027510,8,7,8,5,7,35
191027511,0,0,0,9,7,16
191027512,2,4,3,8,3,20
191027513,5,5,9,3,4,26
191027514,9,5,4,9,7,34
191027515,3,1,3,5,8,20
191027516,3,3,5,6,1,18
191027517,4,4,7,6,4,25
191027518,1,0,6,4,8,19
191027519,0,7,9,8,1,25
191027520,6,9,4,0,6,25
191027521,4,4,2,0,1,11
191027522,9,5,2,9,8,33
191027523,4,2,7,8,8,29
191027524,7,2,3,3,5,20
191027525,9,0,1,4,9,23
191027526,4,7,8,4,5,28
191027527,3,1,6,1,8,19
191027528,5,0,5,0,0,10
191027529,7,6,5,6,9,33
191027530,7,6,4,1,0,18
191027531,9,1,6,4,8,28
191027532,4,2,6,5,2,19
191027533,5,8,8,8,9,38
191027534,6,6,0,3,3,18
191027535,4,7,9,9,1,30
191027536,9,5,0,2,7,23
191027537,3,7,8,8,1,27
191027538,8,7,6,6,8,35
191027539,0,6,4,6,0,16
191027540,5,2,1,8,4,20
191027541,2,4,7,7,8,28
191027542,9,6,8,2,9,34
191027543,2,9,1,0,3,15
191027544,7,1,9,5,2,24
191027545,5,3,3,7,9,27
191027546,5,9,9,0,1,24
191027547,3,0,5,5,1,14
191027548,8,4,8,3,8,31
191027549,1,5,1,3,4,14
191027550,0,1,9,4,2,16
191027551,1,8,3,0,0,12
191027552,9,5,7,0,2,23
191027553,8,7,5,9,4,33
191027554,5,9,8,9,7,38
191027555,6,4,2,2,0,14
191027556,2,5,0,8,3,18
191027557,7,4,2,0,0,13
191027558,6,7,9,4,0,26
191027559,3,9,5,3,2,22
191027560,6,7,1,0,5,19
191027561,2,0,6,0,2,10
191027562,6,4,0,1,1,12
191027563,1,7,6,8,3,25
191027564,1,0,6,4,9,20
191027565,9,0,7,7,8,31
191027566,9,8,0,0,9,26
191027567,7,4,1,8,3,23
191027568,4,7,8,7,5,31
191027569,8,7,4,5,6,30
191027570,1,2,2,2,3,10
191027571,6,5,5,4,7,27
191027572,4,1,4,7,1,17
191027573,2,7,3,8,0,20
191027574,6,3,0,7,6,22
191027575,2,8,1,8,9,28
191027576,5,1,0,5,6,17
191027577,0,6,3,2,2,13
191027578,4,5,6,4,5,24
191027579,7,2,0,6,6,21
191027580,7,5,3,8,9,32
191027581,5,3,7,5,2,22
191027582,6,8,7,7,0,28
191027583,8,5,1,0,7,21
191027584,5,4,3,1,9,22
191027585,2,3,3,0,6,14
191027586,2,5,8,5,2,22
191027587,6,0,4,4,0,14
191027588,9,0,9,6,7,31
191027589,9,0,3,3,8,23
191027590,8,4,0,4,7,23
191027591,9,5,9,3,5,31
191027592,6,4,9,7,0,26
191027593,6,3,0,9,1,19
191027594,7,7,0,5,1,20
191027595,1,5,7,7,1,21
191027596,7,3,6,3,5,24
191027597,1,9,5,4,7,26
191027598,9,9,3,4,3,28
191027599,9,2,9,1,3,24
191027600,8,1,1,7,6,23
191027601,9,4,0,7,8,28
191027602,0,0,3,6,0,9
191027603,5,1,6,6,0,18
191027604,3,5,4,8,3,23
191027605,6,6,0,9,5,26
191027606,6,7,0,8,7,28
191027607,5,1,1,4,7,18
191027608,3,7,7,9,4,30
191027609,8,8,7,4,8,35
191027610,9,0,3,4,8,24
191027611,1,6,8,0,0,15
191027612,1,7,8,8,1,25
191027613,7,4,4,1,1,17
191027614,0,8,7,0,3,18
191027615,4,1,0,1,5,11
191027616,6,7,5,8,0,26
191027617,4,3,8,6,4,25
191027618,1,1,5,4,6,17
191027619,3,2,1,0,8,14
191027620,6,4,7,6,8,31
191027621,8,0,3,7,0,18
191027622,6,4,7,4,8,29
191027623,0,7,8,7,6,28
191027624,0,5,5,0,4,14
191027625,6,1,0,4,2,13
191027626,4,3,6,9,0,22
191027627,5,9,8,8,5,35
191027628,8,7,2,3,8,28
191027629,3,4,4,0,8,19
191027630,3,1,4,6,9,23
191027631,9,1,9,4,7,30
191027632,6,5,4,3,2,20
191027633,2,5,6,8,7,28
191027634,7,9,0,5,6,27
191027635,9,5,0,2,0,16
191027636,5,8,0,9,8,30
191027637,4,2,7,2,1,16
191027638,4,7,1,9,2,23
191027639,2,2,0,9,6,19
191027640,7,0,7,3,8,25
191027641,9,2,4,5,9,29
191027642,7,6,7,0,1,21
191027643,5,4,8,7,4,28
191027644,2,7,4,9,7,29
191027645,9,0,7,9,7,32
191027646,0,4,7,5,0,16
191027647,6,7,3,6,1,23
191027648,8,5,7,8,1,29
191027649,2,4,4,8,8,26
191027650,1,5,5,4,7,22
191027651,8,2,5,5,6,26
191027652,5,2,9,7,7,30
191027653,8,2,3,0,1,14
191027654,3,4,0,5,0,12
191027655,1,3,5,5,1,15
191027656,7,5,0,5,7,24
191027657,0,6,0,4,4,14
191027658,6,4,3,9,7,29
191027659,1,2,7,7,5,22
191027660,1,3,7,3,6,20
191027661,7,4,0,7,1,19
191027662,9,7,9,8,3,36
191027663,6,5,8,6,0,25
191027664,0,9,4,9,3,25
191027665,1,0,4,5,2,12
191027666,1,5,2,5,3,16
191027667,4,4,8,3,8,27
191027668,5,4,7,3,0,19
191027669,6,5,0,8,8,27
191027670,4,7,1,2,1,15
191027671,7,0,8,5,5,25
191027672,0,3,8,0,2,13
191027673,4,3,6,8,9,30
191027674,5,3,6,9,8,31
191027675,3,3,0,9,2,17
191027676,9,7,2,3,6,27
191027677,5,3,6,1,9,24
191027678,9,3,7,8,6,33
191027679,6,7,3,7,7,30
191027680,6,3,8,2,3,22
191027681,0,7,3,9,8,27
191027682,6,4,3,4,1,18
191027683,5,6,0,7,1,19
191027684,5,2,1,1,2,11
191027685,2,9,9,7,0,27
191027686,1,1,5,0,8,15
191027687,9,7,0,5,1,22
191027688,9,7,3,9,0,28
191027689,9,7,6,4,3,29
191027690,6,2,6,9,8,31
191027691,4,0,1,1,0,6
191027692,8,3,9,9,9,38
191027693,7,7,5,1,8,28
191027694,5,9,2,0,3,19
191027695,3,8,2,4,4,21
191027696,2,1,1,2,3,9
191027697,0,9,5,3,2,19
191027698,4,2,2,1,3,12
191027699,0,5,4,1,7,17
191027700,1,4,0,7,9,21
191027701,3,9,1,4,3,20
191027702,4,4,6,8,8,30
191027703,5,3,7,6,6,27
191027704,5,5,1,2,9,22
191027705,3,6,2,1,9,21
191027706,5,1,8,3,5,22
191027707,4,2,4,1,9,20
191027708,1,3,9,4,5,22
191027709,4,1,5,1,9,20
191027710,8,8,9,2,5,32
191027711,8,7,9,8,0,32
191027712,0,9,8,3,2,22
191027713,9,2,3,4,0,18
191027714,2,5,0,5,8,20
191027715,1,0,8,4,1,14
191027716,3,8,1,1,7,20
191027717,5,5,6,6,9,31
191027718,4,4,2,7,3,20
191027719,2,4,8,4,7,25
191027720,4,4,5,5,5,23
191027721,7,9,7,4,8,35
191027722,8,8,2,0,6,24
191027723,3,5,6,8,0,22
191027724,9,8,4,5,5,31
191027725,1,7,5,0,2,15
191027726,3,0,0,3,1,7
191027727,9,0,2,2,9,22
191027728,6,4,9,5,5,29
191027729,9,0,7,6,8,30
191027730,4,3,9,5,2,23
191027731,2,3,1,0,5,11
191027732,3,3,4,9,8,27
191027733,4,7,5,5,3,24
191027734,5,0,8,8,0,21
191027735,6,7,5,0,0,18
191027736,2,9,5,7,3,26
191027737,5,1,9,9,3,27
191027738,8,4,8,7,2,29
191027739,0,7,4,1,6,18
191027740,1,3,4,6,6,20
191027741,6,7,6,6,7,32
191027742,3,4,5,3,0,15
191027743,2,3,3,2,5,15
191027744,5,0,2,1,8,16
191027745,6,8,5,2,6,27
191027746,6,1,1,7,8,23
191027747,9,4,9,7,5,34
191027748,1,7,9,3,0,20
191027749,2,2,2,4,5,15
191027750,2,6,5,8,7,28
191027751,8,2,2,2,5,19
191027752,1,0,1,5,8,15
191027753,9,8,1,3,0,21
191027754,6,9,9,4,9,37
191027755,3,4,2,7,9,25
191027756,2,5,4,2,3,16
191027757,1,0,5,4,5,15
191027758,0,0,0,4,1,5
191027759,1,5,7,3,5,21
191027760,0,6,6,5,9,26
191027761,0,0,7,0,7,14
191027762,6,6,5,7,3,27
191027763,9,8,9,8,1,35
191027764,9,8,0,7,3,27
191027765,4,4,9,7,3,27
191027766,9,4,0,0,6,19
191027767,2,9,6,0,7,24
191027768,6,5,8,6,2,27
191027769,4,5,5,2,4,20
191027770,2,6,1,2,4,15
191027771,8,5,3,9,0,25
191027772,7,5,9,7,1,29
191027773,1,2,8,8,7,26
191027774,5,5,1,1,8,20
191027775,7,7,6,5,0,25
191027776,8,2,0,6,4,20
191027777,3,5,3,7,3,21
191027778,9,5,1,7,5,27
191027779,9,3,9,6,0,27
191027780,3,1,9,2,8,23
191027781,1,4,1,8,7,21
191027782,3,2,1,8,7,21
191027783,0,2,8,2,9,21
191027784,0,2,0,2,0,4
191027785,3,9,7,5,5,29
191027786,2,6,9,6,6,29
191027787,7,3,2,3,7,22
191027788,7,7,7,8,6,35
191027789,0,2,7,6,3,18
191027790,7,4,3,6,7,27
191027791,1,1,7,7,9,25
191027792,1,6,1,7,5,20
191027793,5,0,1,7,1,14
191027794,0,0,9,1,6,16
191027795,0,6,4,3,5,18
191027796,8,8,6,1,4,27
191027797,1,6,0,2,5,14
191027798,5,9,3,2,2,21
191027799,7,8,3,8,6,32
191027800,4,5,2,7,4,22
191027801,8,2,2,0,7,19
191027802,9,1,2,4,3,19
191027803,6,8,4,5,3,26
191027804,2,1,4,9,3,19
191027805,3,5,9,4,4,25
191027806,7,4,5,6,8,30
191027807,1,9,4,7,2,23
191027808,2,8,1,4,4,19
191027809,9,2,3,0,2,16
191027810,1,2,6,9,6,24
191027811,4,4,6,2,6,22
191027812,1,7,6,6,6,26
191027813,6,9,4,8,7,34
191027814,9,1,6,9,2,27
191027815,0,0,0,8,1,9
191027816,6,9,1,5,2,23
191027817,0,3,1,1,4,9
191027818,2,6,0,0,1,9
191027819,3,2,5,5,4,19
191027820,2,5,3,5,5,20
191027821,7,4,1,6,4,22
191027822,6,9,3,8,9,35
191027823,0,0,3,2,0,5
191027824,3,5,7,6,5,26
191027825,9,1,4,5,1,20
191027826,3,4,3,2,0,12
191027827,8,5,8,7,8,36
191027828,8,0,6,0,1,15
191027829,6,0,0,0,6,12
191027830,6,4,1,9,3,23
191027831,0,1,0,3,6,10
191027832,6,5,0,9,9,29
191027833,7,4,1,9,4,25
191027834,9,8,2,0,8,27
191027835,7,4,3,1,3,18
191027836,7,5,1,9,6,28
191027837,8,0,0,0,8,16
191027838,8,4,4,9,9,34
191027839,3,6,7,0,0,16
191027840,4,7,3,0,6,20
191027841,3,3,3,9,8,26
191027842,8,0,1,3,5,17
191027843,7,3,9,0,4,23
191027844,9,3,5,8,4,29
191027845,6,0,7,4,1,18
191027846,1,3,0,9,2,15
191027847,4,5,5,3,7,24
191027848,8,9,2,4,9,32
191027849,5,0,0,7,2,14
191027850,6,7,5,9,8,35
191027851,0,4,2,3,2,11
191027852,8,2,0,3,7,20
191027853,4,5,7,5,5,26
191027854,6,3,9,3,9,30
191027855,1,7,0,5,1,14
191027856,5,2,6,8,9,30
191027857,8,1,7,2,7,25
191027858,9,0,4,9,7,29
191027859,1,6,0,3,1,11
191027860,9,6,7,1,5,28
191027861,6,6,2,6,8,28
191027862,3,8,0,4,7,22
191027863,7,1,5,6,9,28
191027864,0,5,3,6,3,17
191027865,5,0,2,6,7,20
191027866,9,0,0,9,9,27
191027867,1,5,9,2,1,18
191027868,3,5,0,8,2,18
191027869,5,3,0,7,7,22
191027870,3,1,8,0,6,18
191027871,6,5,3,9,9,32
191027872,2,9,6,1,1,19
191027873,3,7,5,7,1,23
191027874,4,3,6,1,0,14
191027875,7,5,7,8,8,35
191027876,4,0,7,7,3,21
191027877,8,4,6,9,1,28
191027878,1,9,3,3,8,24
191027879,3,7,0,5,2,17
191027880,2,4,1,8,7,22
191027881,1,4,5,3,2,15
191027882,1,3,8,3,9,24
191027883,5,8,5,7,8,33
191027884,1,3,4,2,6,16
191027885,3,2,9,3,4,21
191027886,2,2,6,3,8,21
191027887,0,6,3,2,3,14
191027888,0,4,2,1,2,9
191027889,2,8,1,5,7,23
191027890,2,5,9,8,7,31
191027891,3,2,0,9,0,14
191027892,1,7,8,9,7,32
191027893,0,8,7,2,1,18
191027894,8,7,8,2,2,27
191027895,2,8,9,7,8,34
191027896,2,1,5,5,7,20
191027897,9,5,1,6,1,22
191027898,6,6,0,1,4,17
191027899,3,4,8,8,0,23
191027900,9,3,3,4,0,19
191027901,7,2,0,6,9,24
191027902,8,2,2,3,8,23
191027903,4,2,0,0,4,10
191027904,6,4,1,2,8,21
191027905,7,2,7,5,4,25
191027906,7,1,7,7,0,22
191027907,4,5,5,7,2,23
191027908,5,1,4,7,7,24
191027909,1,5,9,1,0,16
191027910,5,4,0,6,6,21
191027911,4,4,0,7,5,20
191027912,7,4,3,7,3,24
191027913,8,4,1,1,3,17
191027914,9,7,9,2,3,30
191027915,4,8,5,2,1,20
191027916,1,2,4,5,6,18
191027917,9,8,8,9,4,38
191027918,5,1,3,7,0,16
191027919,4,5,2,4,8,23
191027920,7,1,3,8,5,24
191027921,0,1,4,8,5,18
191027922,9,8,2,2,3,24
191027923,3,9,6,6,1,25
191027924,9,5,4,2,2,22
191027925,8,9,2,0,4,23
191027926,9,4,4,5,8,30
191027927,2,2,1,4,2,11
191027928,5,4,4,7,5,25
191027929,7,5,8,1,4,25
191027930,0,9,8,4,6,27
191027931,2,4,1,5,3,15
191027932,8,7,1,5,7,28
191027933,5,0,1,5,8,19
191027934,7,2,1,2,7,19
191027935,8,5,7,2,5,27
191027936,3,8,5,0,7,23
191027937,4,9,3,6,1,23
191027938,0,5,9,3,9,26
191027939,3,2,2,9,3,19
191027940,4,6,2,0,1,13
191027941,1,5,7,8,1,22
191027942,9,0,2,9,9,29
191027943,9,3,9,1,4,26
191027944,6,1,3,5,3,18
191027945,3,5,7,0,7,22
191027946,7,6,0,9,8,30
191027947,1,4,5,0,6,16
191027948,3,5,2,0,3,13
191027949,9,7,4,3,0,23
191027950,4,9,2,2,9,26
191027951,5,0,2,6,4,17
191027952,6,3,6,7,9,31
191027953,0,1,0,9,5,15
191027954,0,8,1,0,9,18
191027955,4,9,8,5,0,26
191027956,1,6,0,9,6,22
191027957,2,3,6,2,4,17
191027958,5,2,9,2,2,20
191027959,4,3,0,9,7,23
191027960,5,6,7,1,4,23
191027961,1,7,2,4,0,14
191027962,6,0,0,9,6,21
191027963,1,2,6,8,7,24
191027964,2,0,5,9,7,23
191027965,5,6,7,7,0,25
191027966,9,0,9,8,1,27
191027967,6,9,9,3,4,31
191027968,9,0,2,6,4,21
191027969,5,8,3,7,5,28
191027970,1,0,9,8,2,20
191027971,1,3,5,0,6,15
191027972,8,0,9,6,1,24
191027973,4,5,0,9,6,24
191027974,1,8,1,3,5,18
191027975,8,5,3,2,6,24
191027976,6,6,8,6,1,27
191027977,0,5,8,2,5,20
191027978,3,8,7,1,4,23
191027979,3,7,6,1,4,21
191027980,4,1,0,7,1,13
191027981,7,3,7,0,4,21
191027982,5,1,7,9,3,25
191027983,9,5,4,3,0,21
191027984,5,9,9,1,7,31
191027985,9,9,5,7,3,33
191027986,0,1,3,8,0,12
191027987,9,3,6,3,4,25
191027988,9,8,2,4,9,32
191027989,8,1,9,2,9,29
191027990,0,8,6,0,7,21
191027991,1,9,8,3,6,27
191027992,0,1,3,6,3,13
191027993,7,7,8,3,5,30
191027994,1,1,4,1,8,15
191027995,0,7,3,5,6,21
191027996,6,9,0,1,0,16
191027997,8,1,6,8,8,31
191027998,1,1,5,3,3,13
191027999,6,3,2,1,5,17
1910271000,1,2,3,1,4,11
1910271001,8,1,4,9,2,24
1910271002,3,3,9,6,2,23
1910271003,8,5,7,3,9,32
1910271004,2,8,6,0,9,25
1910271005,5,4,8,5,9,31
1910271006,9,1,9,6,9,34
1910271007,3,3,8,3,5,22
1910271008,7,5,4,1,1,18
1910271009,3,4,3,6,8,24
1910271010,6,9,7,9,6,37
1910271011,5,7,3,9,9,33
1910271012,3,3,6,3,2,17
1910271013,1,9,9,0,1,20
1910271014,0,0,3,9,8,20
1910271015,0,4,4,3,9,20
1910271016,7,4,2,6,1,20
1910271017,7,3,4,2,0,16
1910271018,6,0,4,7,1,18
1910271019,0,1,9,0,6,16
1910271020,7,7,4,9,0,27
1910271021,9,6,4,5,5,29
1910271022,1,5,6,9,2,23
1910271023,8,6,8,1,5,28
1910271024,8,5,7,8,8,36
1910271025,3,1,9,8,9,30
1910271026,5,0,1,2,0,8
1910271027,6,4,0,5,2,17
1910271028,5,5,7,3,5,25
1910271029,7,3,2,0,7,19
1910271030,9,2,5,3,4,23
1910271031,8,3,5,7,2,25
1910271032,9,3,5,3,8,28
1910271033,7,8,1,6,9,31
1910271034,5,2,8,9,6,30
1910271035,8,5,7,2,3,25
1910271036,5,5,9,3,2,24
1910271037,3,7,8,5,1,24
1910271038,2,4,8,7,1,22
1910271039,9,4,6,8,7,34
1910271040,7,0,1,3,8,19
1910271041,4,7,8,4,2,25
1910271042,0,8,8,3,7,26
1910271043,0,9,8,5,9,31
1910271044,6,1,0,8,3,18
1910271045,3,5,4,4,1,17
1910271046,5,4,5,4,5,23
1910271047,9,8,5,0,4,26
1910271048,8,2,2,9,5,26
1910271049,5,5,8,9,7,34
1910271050,4,1,2,9,4,20
1910271051,5,5,4,3,2,19
1910271052,9,9,3,3,2,26
1910271053,5,0,5,9,3,22
1910271054,3,6,8,8,0,25
1910271055,1,4,6,7,0,18
1910271056,1,9,5,1,3,19
1910271057,6,2,8,9,3,28
1910271058,8,0,9,0,8,25
1910271059,8,0,2,2,6,18
1910271060,9,8,9,3,7,36
1910271061,3,7,9,5,1,25
1910271062,7,4,6,2,3,22
1910271063,8,1,5,2,7,23
1910271064,1,6,6,1,0,14
1910271065,7,9,2,0,2,20
1910271066,5,9,5,8,0,27
1910271067,5,4,9,3,6,27
1910271068,2,5,6,7,8,28
1910271069,3,3,7,7,4,24
1910271070,3,5,6,0,4,18
1910271071,7,5,8,1,8,29
1910271072,2,5,4,5,5,21
1910271073,8,2,3,2,6,21
1910271074,8,4,4,7,8,31
1910271075,1,1,7,5,6,20
1910271076,0,6,1,8,2,17
1910271077,9,3,6,7,5,30
1910271078,4,1,2,3,7,17
1910271079,2,7,8,4,0,21
1910271080,2,9,0,2,1,14
1910271081,5,1,2,6,8,22
1910271082,2,7,8,5,9,31
1910271083,3,7,0,6,5,21
1910271084,9,9,4,3,7,32
1910271085,1,1,0,4,2,8
1910271086,8,9,8,1,4,30
1910271087,3,2,3,9,8,25
1910271088,9,1,4,2,1,17
1910271089,8,3,8,6,9,34
1910271090,0,2,5,0,4,11
1910271091,9,3,4,0,1,17
1910271092,6,1,9,4,6,26
1910271093,9,7,6,2,9,33
1910271094,8,8,8,9,6,39
1910271095,7,1,5,5,5,23
1910271096,6,6,8,9,1,30
1910271097,6,4,2,1,0,13
1910271098,8,0,3,8,8,27
1910271099,0,1,1,3,6,11
1910271100,0,4,6,7,5,22
1910271101,3,1,9,2,4,19
1910271102,3,5,7,0,5,20
1910271103,2,4,6,1,0,13
1910271104,9,8,6,8,0,31
1910271105,1,5,6,4,2,18
191028001,2,7,7,0,4,20
191028002,5,4,9,8,2,28
191028003,9,5,4,9,4,31
191028004,7,1,4,3,5,20
191028005,2,3,7,5,1,18
191028006,1,9,1,5,5,21
191028007,3,0,4,5,4,16
191028008,2,7,9,4,6,28
191028009,1,4,5,6,3,19
191028010,3,4,6,3,6,22
191028011,7,7,5,8,1,28
191028012,2,1,3,1,7,14
191028013,6,3,2,9,3,23
191028014,9,3,5,8,0,25
191028015,1,9,0,3,0,13
191028016,7,9,1,3,0,20
191028017,6,8,3,7,6,30
191028018,5,1,6,1,0,13
191028019,0,1,7,3,0,11
191028020,2,8,6,1,5,22
191028021,0,1,3,4,1,9
191028022,1,3,3,2,0,9
191028023,8,6,9,2,9,34
191028024,0,0,8,0,5,13
191028025,2,2,1,9,7,21
191028026,5,9,9,4,7,34
191028027,2,4,5,3,9,23
191028028,1,2,0,2,4,9
191028029,9,8,6,1,4,28
191028030,5,3,8,1,1,18
191028031,4,9,2,4,3,22
191028032,3,9,9,6,9,36
191028033,3,6,6,6,1,22
191028034,0,5,2,1,3,11
191028035,7,9,2,8,6,32
191028036,3,4,2,0,2,11
191028037,6,4,7,6,1,24
191028038,6,7,4,8,1,26
191028039,5,7,6,4,9,31
191028040,5,2,9,6,5,27
191028041,8,6,5,6,6,31
191028042,8,4,8,1,9,30
191028043,3,7,8,6,5,29
191028044,9,9,3,2,1,24
191028045,0,3,4,6,1,14
191028046,7,2,1,1,1,12
191028047,8,4,4,2,4,22
191028048,1,8,2,6,1,18
191028049,7,7,5,4,6,29
191028050,8,8,7,6,1,30
191028051,0,5,2,1,2,10
191028052,8,1,6,6,8,29
191028053,2,8,4,4,4,22
191028054,3,3,7,9,5,27
191028055,5,9,4,5,1,24
191028056,9,0,6,5,0,20
191028057,9,9,9,5,4,36
191028058,7,4,5,7,1,24
191028059,5,1,9,0,0,15
191028060,9,7,3,0,0,19
191028061,8,8,9,9,2,36
191028062,1,1,8,5,6,21
191028063,4,4,9,3,2,22
191028064,8,5,6,4,0,23
191028065,2,1,9,9,7,28
191028066,6,1,2,8,6,23
191028067,5,1,8,6,5,25
191028068,9,6,9,4,1,29
191028069,7,0,5,3,4,19
191028070,5,5,4,0,8,22
191028071,4,8,9,0,3,24
191028072,2,4,7,3,6,22
191028073,9,6,0,7,9,31
191028074,0,3,2,2,8,15
191028075,3,7,8,2,8,28
191028076,0,4,2,3,3,12
191028077,2,3,1,5,0,11
191028078,1,9,3,2,7,22
191028079,2,4,9,0,4,19
191028080,5,3,2,1,8,19
191028081,1,1,0,3,3,8
191028082,0,8,5,3,1,17
191028083,5,7,8,7,5,32
191028084,5,0,2,9,3,19
191028085,4,0,8,5,0,17
191028086,2,4,6,2,1,15
191028087,0,2,7,4,8,21
191028088,2,5,3,7,9,26
191028089,8,4,0,0,2,14
191028090,3,7,6,0,1,17
191028091,9,6,5,7,1,28
191028092,0,8,3,2,5,18
191028093,7,5,1,8,9,30
191028094,7,3,6,7,8,31
191028095,4,6,4,7,2,23
191028096,0,0,5,6,1,12
191028097,3,5,1,8,1,18
191028098,1,4,1,0,8,14
191028099,4,8,5,6,8,31
191028100,5,6,6,2,2,21
191028101,4,6,4,5,2,21
191028102,0,2,6,5,7,20
191028103,9,1,9,0,4,23
191028104,8,2,2,0,2,14
191028105,1,8,4,4,0,17
191028106,1,5,4,1,5,16
191028107,1,4,0,4,9,18
191028108,6,4,0,9,8,27
191028109,5,2,8,7,4,26
191028110,6,7,5,8,7,33
191028111,3,6,3,3,0,15
191028112,2,3,2,2,7,16
191028113,6,4,1,0,4,15
191028114,0,7,5,1,7,20
191028115,2,5,9,4,9,29
191028116,8,1,5,2,8,24
191028117,8,5,0,5,8,26
191028118,9,7,3,4,4,27
191028119,8,7,9,2,0,26
191028120,2,8,4,8,6,28
191028121,6,6,5,4,8,29
191028122,6,3,3,8,7,27
191028123,7,9,8,8,6,38
191028124,3,3,3,9,0,18
191028125,9,1,5,8,7,30
191028126,4,2,4,0,3,13
191028127,5,3,3,8,9,28
191028128,8,5,5,3,2,23
191028129,1,2,6,5,4,18
191028130,5,8,9,6,0,28
191028131,9,9,4,5,2,29
191028132,9,0,0,3,6,18
191028133,5,3,6,6,6,26
191028134,5,6,8,1,1,21
191028135,1,9,3,3,3,19
191028136,5,5,0,8,0,18
191028137,5,0,9,1,2,17
191028138,3,4,6,4,0,17
191028139,8,4,0,4,2,18
191028140,7,0,3,9,8,27
191028141,2,3,2,5,9,21
191028142,9,2,8,5,6,30
191028143,4,3,4,1,0,12
191028144,5,4,5,4,2,20
191028145,7,1,7,7,4,26
191028146,2,2,8,1,5,18
191028147,9,4,4,4,2,23
191028148,5,2,7,6,7,27
191028149,9,0,3,8,2,22
191028150,1,7,8,3,8,27
191028151,9,3,2,3,2,19
191028152,4,5,5,0,3,17
191028153,9,5,9,1,4,28
191028154,0,6,6,8,1,21
191028155,1,5,4,5,6,21
191028156,1,3,9,8,0,21
191028157,8,1,3,3,6,21
191028158,1,1,3,5,9,19
191028159,9,1,3,9,0,22
191028160,1,7,1,3,0,12
191028161,1,6,4,9,1,21
191028162,2,0,3,5,8,18
191028163,4,8,0,5,0,17
191028164,7,5,6,9,6,33
191028165,0,5,4,5,3,17
191028166,1,1,3,7,3,15
191028167,2,4,4,0,6,16
191028168,5,8,7,0,8,28
191028169,3,7,8,3,3,24
191028170,5,4,9,4,8,30
191028171,7,2,4,0,5,18
191028172,2,0,0,4,5,11
191028173,5,6,9,7,1,28
191028174,5,8,9,3,2,27
191028175,2,1,8,5,1,17
191028176,7,3,9,2,9,30
191028177,6,8,6,6,5,31
191028178,0,2,4,9,9,24
191028179,4,6,5,4,8,27
191028180,2,7,6,3,2,20
191028181,1,7,1,0,9,18
191028182,1,5,5,0,2,13
191028183,8,0,0,4,6,18
191028184,4,1,0,9,8,22
191028185,0,1,2,8,1,12
191028186,6,4,2,6,5,23
191028187,6,9,4,7,2,28
191028188,8,4,9,4,4,29
191028189,5,4,2,2,2,15
191028190,0,3,9,2,4,18
191028191,5,0,3,3,0,11
191028192,1,9,6,1,6,23
191028193,4,6,0,8,3,21
191028194,7,8,1,7,2,25
191028195,2,0,4,3,8,17
191028196,5,5,9,4,3,26
191028197,3,9,1,2,0,15
191028198,6,3,8,1,5,23
191028199,2,1,4,1,0,8
191028200,5,9,1,8,9,32
191028201,4,5,6,9,6,30
191028202,4,6,8,4,2,24
191028203,4,9,6,1,6,26
191028204,9,8,2,5,7,31
191028205,3,0,2,9,3,17
191028206,1,6,8,1,9,25
191028207,3,5,9,3,1,21
191028208,3,0,3,3,1,10
191028209,1,4,8,2,0,15
191028210,3,4,4,7,6,24
191028211,8,9,4,7,4,32
191028212,0,6,9,4,1,20
191028213,3,1,9,6,4,23
191028214,6,5,1,7,0,19
191028215,3,5,8,8,8,32
191028216,4,4,0,5,8,21
191028217,1,9,0,1,1,12
191028218,8,3,4,1,8,24
191028219,1,1,2,3,8,15
191028220,9,8,8,5,3,33
191028221,8,3,2,4,3,20
191028222,0,7,0,0,9,16
191028223,9,4,4,2,7,26
191028224,1,2,6,2,4,15
191028225,4,5,4,0,9,22
191028226,6,2,5,2,7,22
191028227,1,8,8,9,9,35
191028228,3,2,2,6,2,15
191028229,5,2,8,4,7,26
191028230,5,3,6,9,5,28
191028231,8,0,1,8,7,24
191028232,1,8,1,0,7,17
191028233,0,1,4,1,7,13
191028234,2,8,0,6,0,16
191028235,0,6,7,2,7,22
191028236,8,4,8,2,8,30
191028237,7,0,7,0,2,16
191028238,7,0,4,1,0,12
191028239,0,4,3,0,2,9
191028240,1,2,8,0,9,20
191028241,2,6,3,6,1,18
191028242,9,7,0,3,9,28
191028243,6,3,0,9,7,25
191028244,8,4,0,3,9,24
191028245,7,1,6,5,6,25
191028246,8,8,2,8,4,30
191028247,8,3,4,7,6,28
191028248,1,4,2,5,9,21
191028249,3,4,9,2,5,23
191028250,5,1,2,5,0,13
191028251,7,5,7,6,1,26
191028252,1,5,4,7,5,22
191028253,9,8,0,6,3,26
191028254,2,4,7,8,2,23
191028255,2,1,3,5,1,12
191028256,2,4,6,9,4,25
191028257,3,3,0,0,8,14
191028258,1,2,1,5,2,11
191028259,9,4,4,7,0,24
191028260,5,9,7,0,0,21
191028261,5,5,6,0,1,17
191028262,3,4,4,7,9,27
191028263,8,4,9,3,5,29
191028264,9,9,3,8,1,30
191028265,0,5,2,6,6,19
191028266,7,7,7,7,0,28
191028267,4,6,6,2,8,26
191028268,8,1,3,5,4,21
191028269,1,9,2,6,2,20
191028270,7,9,8,1,0,25
191028271,0,9,2,6,5,22
191028272,0,8,2,1,8,19
191028273,2,9,6,2,7,26
191028274,0,1,2,0,8,11
191028275,9,9,2,8,1,29
191028276,7,2,0,5,4,18
191028277,5,4,9,0,9,27
191028278,4,2,9,8,6,29
191028279,8,2,9,7,8,34
191028280,0,9,7,2,3,21
191028281,1,4,6,4,2,17
191028282,9,0,9,7,1,26
191028283,5,2,7,1,9,24
191028284,8,1,1,5,9,24
191028285,0,9,2,7,8,26
191028286,4,4,9,1,9,27
191028287,5,5,6,0,7,23
191028288,2,3,7,0,9,21
191028289,9,0,6,1,5,21
191028290,6,9,4,5,4,28
191028291,4,6,8,6,5,29
191028292,8,8,7,8,9,40
191028293,8,7,1,1,7,24
191028294,3,5,8,9,6,31
191028295,0,3,4,2,0,9
191028296,8,8,8,1,2,27
191028297,3,8,7,5,1,24
191028298,9,1,3,7,3,23
191028299,4,7,6,1,1,19
191028300,5,5,3,3,3,19
191028301,2,9,7,1,0,19
191028302,9,3,9,7,2,30
191028303,6,9,5,2,5,27
191028304,2,0,7,3,8,20
191028305,4,8,0,4,2,18
191028306,3,5,4,1,8,21
191028307,7,5,9,5,4,30
191028308,1,4,5,0,1,11
191028309,0,8,1,9,1,19
191028310,1,2,6,1,4,14
191028311,3,0,0,3,5,11
191028312,3,5,4,5,9,26
191028313,0,0,3,9,1,13
191028314,2,2,3,9,4,20
191028315,7,7,0,7,8,29
191028316,3,7,9,6,6,31
191028317,6,9,1,1,1,18
191028318,8,2,8,9,9,36
191028319,9,2,9,5,3,28
191028320,2,2,1,0,5,10
191028321,6,8,4,4,0,22
191028322,6,5,1,3,1,16
191028323,7,1,5,7,0,20
191028324,4,4,4,0,5,17
191028325,9,4,6,3,6,28
191028326,3,1,7,4,5,20
191028327,1,5,7,9,5,27
191028328,1,0,3,9,0,13
191028329,5,8,7,4,5,29
191028330,8,6,9,9,8,40
191028331,7,6,9,2,3,27
191028332,8,0,1,2,2,13
191028333,5,9,0,0,6,20
191028334,8,5,4,6,3,26
191028335,4,6,7,5,6,28
191028336,7,7,0,5,0,19
191028337,2,0,8,3,5,18
191028338,9,4,7,6,0,26
191028339,2,6,6,8,9,31
191028340,3,1,7,8,5,24
191028341,8,4,8,4,9,33
191028342,4,5,7,5,3,24
191028343,3,1,2,8,6,20
191028344,0,2,8,9,6,25
191028345,8,9,4,8,3,32
191028346,6,9,5,8,3,31
191028347,8,3,1,9,2,23
191028348,2,2,7,7,5,23
191028349,6,6,2,0,7,21
191028350,4,0,9,6,3,22
191028351,9,1,4,9,0,23
191028352,4,8,7,5,4,28
191028353,1,8,5,8,5,27
191028354,0,6,2,4,4,16
191028355,9,7,9,6,6,37
191028356,5,2,2,7,9,25
191028357,4,5,4,7,0,20
191028358,4,0,0,8,7,19
191028359,2,1,1,4,6,14
191028360,1,8,1,5,7,22
191028361,3,3,1,8,7,22
191028362,2,4,2,1,1,10
191028363,3,4,2,4,5,18
191028364,2,2,3,1,1,9
191028365,7,9,8,1,6,31
191028366,7,6,7,5,8,33
191028367,3,9,0,2,7,21
191028368,1,2,4,3,9,19
191028369,4,3,6,8,1,22
191028370,9,0,7,7,3,26
191028371,2,7,0,7,5,21
191028372,9,6,6,6,7,34
191028373,4,4,7,9,9,33
191028374,8,6,0,6,6,26
191028375,4,3,3,8,3,21
191028376,0,2,9,2,8,21
191028377,5,0,1,8,2,16
191028378,9,9,7,2,4,31
191028379,2,7,5,4,6,24
191028380,8,5,2,3,9,27
191028381,7,3,9,6,3,28
191028382,4,4,4,7,2,21
191028383,8,2,2,8,3,23
191028384,0,1,9,1,6,17
191028385,3,3,1,6,9,22
191028386,5,1,6,3,0,15
191028387,2,4,4,4,2,16
191028388,2,1,2,9,4,18
191028389,1,0,9,5,8,23
191028390,7,1,4,9,1,22
191028391,2,1,6,5,5,19
191028392,0,7,5,2,3,17
191028393,3,9,3,7,0,22
191028394,3,5,7,4,8,27
191028395,9,2,4,3,3,21
191028396,5,6,8,4,7,30
191028397,1,5,4,8,1,19
191028398,7,0,2,8,2,19
191028399,7,3,1,7,7,25
191028400,4,8,8,7,5,32
191028401,4,5,3,5,9,26
191028402,0,4,3,6,4,17
191028403,0,9,5,7,0,21
191028404,1,5,0,2,0,8
191028405,5,0,6,9,2,22
191028406,1,7,4,8,8,28
191028407,3,8,7,3,2,23
191028408,8,5,6,1,5,25
191028409,1,8,2,0,8,19
191028410,9,0,8,6,4,27
191028411,8,9,6,6,3,32
191028412,6,5,2,3,7,23
191028413,2,0,0,0,4,6
191028414,3,0,1,6,5,15
191028415,3,4,7,8,4,26
191028416,4,0,0,3,5,12
191028417,7,1,4,2,6,20
191028418,8,5,3,2,4,22
191028419,8,6,8,7,3,32
191028420,0,2,6,8,4,20
191028421,7,4,5,2,2,20
191028422,0,6,0,9,3,18
191028423,8,0,9,7,7,31
191028424,1,8,8,2,6,25
191028425,8,0,8,9,2,27
191028426,3,9,7,9,3,31
191028427,1,7,0,9,2,19
191028428,0,9,2,8,9,28
191028429,4,7,7,3,8,29
191028430,7,0,1,3,9,20
191028431,3,3,8,3,9,26
191028432,4,0,4,9,0,17
191028433,7,1,0,7,4,19
191028434,1,6,8,9,0,24
191028435,0,4,4,9,6,23
191028436,6,2,0,9,7,24
191028437,4,1,1,5,7,18
191028438,7,3,3,1,9,23
191028439,4,0,2,9,5,20
191028440,7,9,6,6,7,35
191028441,5,5,6,9,0,25
191028442,2,6,3,2,8,21
191028443,0,1,1,7,6,15
191028444,7,9,7,2,0,25
191028445,5,3,5,7,4,24
191028446,3,2,3,6,1,15
191028447,9,3,4,2,6,24
191028448,8,5,5,8,5,31
191028449,0,0,2,2,2,6
191028450,4,2,7,2,0,15
191028451,2,8,0,4,5,19
191028452,8,9,7,0,5,29
191028453,0,3,9,2,7,21
191028454,0,8,0,7,7,22
191028455,3,1,7,6,6,23
191028456,9,1,3,7,8,28
191028457,7,4,9,7,8,35
191028458,6,0,9,1,7,23
191028459,5,4,3,1,3,16
191028460,5,6,2,5,0,18
191028461,8,1,5,0,4,18
191028462,1,0,5,0,5,11
191028463,3,7,7,5,6,28
191028464,4,1,2,5,7,19
191028465,8,7,6,6,6,33
191028466,9,3,2,8,9,31
191028467,2,8,3,9,6,28
191028468,9,4,7,5,0,25
191028469,7,4,3,0,1,15
191028470,1,5,8,1,7,22
191028471,4,6,2,4,1,17
191028472,1,6,5,3,9,24
191028473,7,6,6,4,0,23
191028474,5,1,1,0,3,10
191028475,9,4,6,1,9,29
191028476,0,9,0,7,1,17
191028477,2,2,9,9,3,25
191028478,4,0,6,9,8,27
191028479,4,8,0,1,2,15
191028480,2,0,7,4,8,21
191028481,9,9,3,5,1,27
191028482,8,2,0,1,0,11
191028483,4,8,0,3,6,21
191028484,2,1,1,8,7,19
191028485,3,3,3,4,1,14
191028486,1,2,0,7,0,10
191028487,3,3,9,1,3,19
191028488,3,1,4,5,5,18
191028489,3,6,4,9,7,29
191028490,5,4,5,7,7,28
191028491,6,7,4,5,5,27
191028492,2,3,7,3,0,15
191028493,1,0,6,3,6,16
191028494,3,3,9,9,4,28
191028495,7,1,9,1,2,20
191028496,0,4,4,7,5,20
191028497,2,9,0,4,0,15
191028498,9,4,1,2,3,19
191028499,7,1,0,3,0,11
191028500,2,6,4,4,7,23
191028501,3,4,9,8,3,27
191028502,4,5,3,7,1,20
191028503,7,9,1,7,9,33
191028504,6,5,6,4,9,30
191028505,3,4,4,6,0,17
191028506,2,2,4,9,0,17
191028507,2,9,2,4,7,24
191028508,5,0,4,1,9,19
191028509,4,7,6,2,8,27
191028510,7,6,2,9,2,26
191028511,1,0,4,4,1,10
191028512,1,7,1,1,9,19
191028513,5,2,1,3,2,13
191028514,4,6,1,5,9,25
191028515,9,8,7,0,9,33
191028516,8,7,0,7,3,25
191028517,0,4,1,3,1,9
191028518,9,7,6,7,5,34
191028519,4,8,3,0,5,20
191028520,8,9,0,2,4,23
191028521,4,0,4,9,2,19
191028522,1,7,0,4,4,16
191028523,8,0,9,0,9,26
191028524,8,1,8,6,5,28
191028525,4,6,9,6,4,29
191028526,0,9,8,4,1,22
191028527,6,9,0,1,1,17
191028528,0,5,2,0,7,14
191028529,6,5,8,9,0,28
191028530,7,9,9,1,8,34
191028531,1,1,4,5,0,11
191028532,5,0,1,8,6,20
191028533,4,9,2,7,5,27
191028534,2,4,8,5,2,21
191028535,4,2,9,3,6,24
191028536,1,0,2,9,0,12
191028537,3,2,8,9,3,25
191028538,4,3,8,5,0,20
191028539,2,7,8,7,6,30
191028540,7,7,5,4,2,25
191028541,2,9,6,1,8,26
191028542,6,8,7,6,1,28
191028543,4,7,9,0,6,26
191028544,5,8,6,3,4,26
191028545,1,0,1,3,6,11
191028546,1,8,4,2,0,15
191028547,2,0,7,2,2,13
191028548,5,2,8,3,9,27
191028549,5,4,9,1,0,19
191028550,5,1,3,8,1,18
191028551,0,9,3,4,4,20
191028552,3,4,9,0,8,24
191028553,0,3,0,6,8,17
191028554,4,3,0,2,0,9
191028555,4,8,6,6,9,33
191028556,3,3,5,8,4,23
191028557,0,2,1,8,5,16
191028558,0,9,9,7,0,25
191028559,5,4,4,6,0,19
191028560,5,1,6,7,7,26
191028561,7,8,8,3,7,33
191028562,7,9,0,7,7,30
191028563,9,5,5,7,5,31
191028564,5,9,0,8,8,30
191028565,0,5,4,5,6,20
191028566,5,3,6,6,4,24
191028567,3,2,7,9,2,23
191028568,7,4,0,1,3,15
191028569,2,6,9,6,4,27
191028570,4,4,0,8,0,16
191028571,0,9,1,1,5,16
191028572,3,4,7,6,7,27
191028573,0,6,9,9,0,24
191028574,3,0,7,6,3,19
191028575,5,2,0,1,0,8
191028576,5,9,0,9,7,30
191028577,0,9,4,4,3,20
191028578,3,8,2,8,8,29
191028579,6,7,7,9,7,36
191028580,1,0,1,3,9,14
191028581,1,2,7,0,3,13
191028582,5,7,4,9,8,33
191028583,7,8,5,4,0,24
191028584,1,6,7,1,1,16
191028585,6,9,2,3,2,22
191028586,6,1,3,7,3,20
191028587,9,8,4,2,3,26
191028588,7,3,2,3,2,17
191028589,9,6,8,2,6,31
191028590,6,5,9,8,6,34
191028591,5,4,8,5,1,23
191028592,4,3,5,1,9,22
191028593,4,2,0,4,2,12
191028594,5,7,5,9,1,27
191028595,7,9,8,4,4,32
191028596,8,0,3,6,0,17
191028597,2,0,3,6,3,14
191028598,0,7,2,8,5,22
191028599,0,3,0,7,0,10
191028600,8,6,3,9,3,29
191028601,4,4,6,5,2,21
191028602,6,8,4,7,7,32
191028603,5,6,8,2,0,21
191028604,9,0,6,2,5,22
191028605,2,8,0,7,4,21
191028606,5,8,0,8,0,21
191028607,4,9,0,8,3,24
191028608,1,5,1,7,8,22
191028609,3,8,1,3,8,23
191028610,4,9,0,3,2,18
191028611,8,9,7,1,3,28
191028612,0,7,4,3,6,20
191028613,9,5,5,8,0,27
191028614,3,6,7,6,4,26
191028615,3,5,7,3,1,19
191028616,4,3,0,7,5,19
191028617,6,5,8,2,3,24
191028618,4,1,0,3,8,16
191028619,9,0,4,0,3,16
191028620,0,8,2,1,2,13
191028621,2,5,7,5,9,28
191028622,2,5,7,2,5,21
191028623,6,0,0,1,4,11
191028624,8,8,9,7,3,35
191028625,1,8,1,7,3,20
191028626,4,9,6,3,3,25
191028627,5,9,6,6,9,35
191028628,3,9,8,5,6,31
191028629,6,9,8,9,9,41
191028630,5,4,1,1,5,16
191028631,8,0,4,3,4,19
191028632,9,9,8,7,2,35
191028633,4,3,0,3,0,10
191028634,0,4,6,4,0,14
191028635,6,0,8,9,1,24
191028636,7,0,3,4,3,17
191028637,1,0,0,6,0,7
191028638,5,7,2,5,9,28
191028639,2,8,6,5,0,21
191028640,6,2,4,5,2,19
191028641,1,0,0,9,9,19
191028642,9,2,1,3,5,20
191028643,8,9,9,4,9,39
191028644,4,7,5,3,5,24
191028645,7,4,9,6,1,27
191028646,8,6,3,8,9,34
191028647,6,6,3,5,8,28
191028648,6,4,7,0,4,21
191028649,5,0,7,9,7,28
191028650,1,0,1,4,2,8
191028651,1,6,2,3,0,12
191028652,0,1,9,1,0,11
191028653,9,6,6,8,4,33
191028654,4,7,4,9,9,33
191028655,0,6,2,8,0,16
191028656,9,9,0,8,3,29
191028657,9,9,8,0,6,32
191028658,8,6,7,3,7,31
191028659,4,5,5,7,9,30
191028660,6,4,1,4,7,22
191028661,4,8,8,8,2,30
191028662,1,2,0,1,3,7
191028663,8,6,6,8,7,35
191028664,3,1,0,0,9,13
191028665,3,3,9,1,4,20
191028666,3,2,2,4,6,17
191028667,7,3,6,6,9,31
191028668,1,3,4,3,5,16
191028669,0,9,9,6,6,30
191028670,4,4,7,6,6,27
191028671,2,3,1,9,9,24
191028672,0,5,1,6,7,19
191028673,6,9,2,7,8,32
191028674,8,9,4,6,8,35
191028675,5,0,2,5,4,16
191028676,2,1,5,2,3,13
191028677,8,4,2,9,6,29
191028678,3,2,2,4,0,11
191028679,9,0,7,8,7,31
191028680,5,1,1,0,1,8
191028681,2,6,6,2,9,25
191028682,1,0,7,2,9,19
191028683,2,2,8,4,7,23
191028684,8,0,4,2,7,21
191028685,6,4,5,0,7,22
191028686,6,7,7,3,3,26
191028687,6,0,1,8,3,18
191028688,0,0,3,6,2,11
191028689,4,4,1,8,9,26
191028690,0,5,1,6,1,13
191028691,1,5,1,3,5,15
191028692,7,5,5,3,7,27
191028693,9,6,0,0,8,23
191028694,1,6,4,7,1,19
191028695,3,8,6,0,8,25
191028696,7,5,3,1,3,19
191028697,1,1,7,4,0,13
191028698,8,7,7,6,9,37
191028699,1,7,6,2,6,22
191028700,3,1,7,1,7,19
191028701,4,4,3,9,3,23
191028702,4,1,0,4,5,14
191028703,9,7,7,1,1,25
191028704,0,6,5,5,4,20
191028705,4,3,0,2,7,16
191028706,1,4,4,2,3,14
191028707,5,2,0,3,1,11
191028708,0,8,2,5,0,15
191028709,0,9,9,1,6,25
191028710,2,7,4,0,7,20
191028711,6,8,0,4,6,24
191028712,8,9,7,5,5,34
191028713,3,6,2,4,7,22
191028714,6,0,6,5,8,25
191028715,5,8,2,2,5,22
191028716,1,2,7,1,9,20
191028717,5,8,6,3,6,28
191028718,4,4,2,9,3,22
191028719,1,8,0,6,6,21
191028720,0,6,3,5,2,16
191028721,2,5,4,4,1,16
191028722,0,2,7,5,4,18
191028723,3,1,1,8,4,17
191028724,0,9,5,7,5,26
191028725,9,0,4,1,9,23
191028726,9,8,6,6,8,37
191028727,5,9,0,4,3,21
191028728,2,5,4,7,6,24
191028729,7,9,6,9,9,40
191028730,5,2,7,1,4,19
191028731,2,5,5,3,4,19
191028732,7,1,2,9,1,20
191028733,6,8,3,1,6,24
191028734,8,8,3,7,6,32
191028735,0,8,2,2,8,20
191028736,7,1,7,0,6,21
191028737,4,2,8,5,4,23
191028738,8,7,3,3,9,30
191028739,3,6,3,8,5,25
191028740,3,4,4,5,5,21
191028741,9,8,6,7,2,32
191028742,5,1,2,9,0,17
191028743,0,8,0,8,8,24
191028744,7,8,3,3,9,30
191028745,7,7,7,9,2,32
191028746,8,2,9,8,9,36
191028747,4,7,0,5,4,20
191028748,1,9,5,9,7,31
191028749,1,0,8,0,9,18
191028750,9,9,7,7,0,32
191028751,6,9,3,0,9,27
191028752,9,5,9,9,8,40
191028753,8,0,3,5,5,21
191028754,4,0,3,1,4,12
191028755,1,0,5,3,3,12
191028756,3,0,6,7,3,19
191028757,9,5,5,7,3,29
191028758,9,9,6,5,3,32
191028759,6,5,6,7,1,25
191028760,0,2,6,3,2,13
191028761,7,2,5,4,6,24
191028762,9,6,8,2,8,33
191028763,7,8,7,8,3,33
191028764,8,8,0,5,8,29
191028765,9,2,1,2,3,17
191028766,7,4,1,0,1,13
191028767,6,7,2,5,6,26
191028768,3,9,5,3,7,27
191028769,0,0,9,0,7,16
191028770,0,4,1,3,6,14
191028771,8,1,3,3,4,19
191028772,1,4,8,4,5,22
191028773,1,1,2,6,7,17
191028774,3,8,9,2,3,25
191028775,3,6,1,8,8,26
191028776,1,7,0,2,6,16
191028777,1,9,7,6,9,32
191028778,8,1,3,2,7,21
191028779,2,2,2,4,8,18
191028780,9,6,0,2,0,17
191028781,8,0,7,3,3,21
191028782,1,2,4,6,7,20
191028783,2,5,9,4,0,20
191028784,2,0,8,2,6,18
191028785,1,1,2,7,3,14
191028786,8,1,7,3,3,22
191028787,3,2,9,2,0,16
191028788,2,5,6,9,2,24
191028789,8,4,9,9,2,32
191028790,0,3,3,4,3,13
191028791,2,4,7,7,9,29
191028792,6,6,5,1,2,20
191028793,1,4,1,1,7,14
191028794,1,4,0,3,3,11
191028795,4,4,1,9,2,20
191028796,8,3,8,3,9,31
191028797,6,4,4,9,7,30
191028798,1,2,6,2,1,12
191028799,6,2,8,8,7,31
191028800,0,9,3,6,4,22
191028801,2,0,0,6,5,13
191028802,5,1,3,4,3,16
191028803,8,7,3,0,5,23
191028804,1,8,7,7,5,28
191028805,7,3,8,1,3,22
191028806,6,7,8,6,5,32
191028807,7,0,5,1,1,14
191028808,0,4,1,2,1,8
191028809,9,6,1,6,1,23
191028810,5,3,4,4,3,19
191028811,0,9,1,5,4,19
191028812,8,3,8,9,6,34
191028813,0,4,8,1,5,18
191028814,5,1,6,9,3,24
191028815,6,6,2,3,1,18
191028816,2,1,1,4,3,11
191028817,6,2,0,5,4,17
191028818,4,8,4,8,8,32
191028819,6,5,2,3,0,16
191028820,1,6,0,7,1,15
191028821,1,2,2,7,5,17
191028822,8,0,3,7,4,22
191028823,8,0,8,1,4,21
191028824,4,7,9,4,1,25
191028825,9,8,9,8,2,36
191028826,9,0,2,9,5,25
191028827,3,8,7,2,6,26
191028828,4,1,1,6,4,16
191028829,7,6,3,9,1,26
191028830,1,0,8,7,4,20
191028831,3,1,3,5,5,17
191028832,8,1,8,3,2,22
191028833,8,5,2,1,1,17
191028834,3,5,6,3,7,24
191028835,1,2,5,5,9,22
191028836,9,2,5,0,5,21
191028837,2,1,7,1,4,15
191028838,6,8,5,0,2,21
191028839,0,3,9,6,5,23
191028840,3,8,4,5,5,25
191028841,2,0,3,5,7,17
191028842,6,3,6,9,5,29
191028843,1,8,9,2,7,27
191028844,7,9,9,3,3,31
191028845,8,6,3,4,9,30
191028846,9,5,5,2,6,27
191028847,8,2,9,2,8,29
191028848,6,5,5,9,6,31
191028849,2,5,2,1,2,12
191028850,3,6,7,7,4,27
191028851,8,6,8,2,9,33
191028852,0,9,6,2,4,21
191028853,2,6,3,9,0,20
191028854,2,3,2,8,3,18
191028855,1,6,6,7,0,20
191028856,2,4,2,4,9,21
191028857,2,4,9,9,4,28
191028858,8,8,4,2,8,30
191028859,6,4,6,7,0,23
191028860,1,0,7,9,7,24
191028861,8,6,1,5,7,27
191028862,9,3,7,4,5,28
191028863,3,4,7,7,1,22
191028864,4,6,8,1,8,27
191028865,2,1,3,4,0,10
191028866,7,6,5,0,7,25
191028867,4,8,7,9,2,30
191028868,5,6,8,1,4,24
191028869,9,9,2,1,3,24
191028870,0,9,1,1,9,20
191028871,0,3,5,7,5,20
191028872,8,9,3,0,7,27
191028873,2,8,2,4,7,23
191028874,6,1,2,0,2,11
191028875,6,2,1,2,7,18
191028876,4,8,9,3,2,26
191028877,3,7,4,9,5,28
191028878,3,3,0,4,0,10
191028879,2,7,0,5,0,14
191028880,4,4,1,1,1,11
191028881,5,4,6,6,3,24
191028882,3,8,2,7,9,29
191028883,1,5,2,6,4,18
191028884,7,3,3,3,4,20
191028885,5,0,7,5,6,23
191028886,2,1,2,2,8,15
191028887,2,2,1,1,4,10
191028888,9,7,8,0,3,27
191028889,4,8,1,2,5,20
191028890,8,8,8,8,1,33
191028891,5,3,5,6,5,24
191028892,7,2,4,5,1,19
191028893,8,7,5,9,8,37
191028894,1,2,6,2,6,17
191028895,7,5,8,5,1,26
191028896,4,8,6,6,7,31
191028897,6,1,5,9,3,24
191028898,7,7,0,7,7,28
191028899,2,5,6,3,8,24
191028900,5,9,6,2,9,31
191028901,1,6,2,0,9,18
191028902,1,4,6,8,4,23
191028903,9,9,9,7,1,35
191028904,9,9,0,2,6,26
191028905,7,2,8,6,3,26
191028906,3,5,8,4,7,27
191028907,6,1,7,0,0,14
191028908,1,1,0,1,9,12
191028909,1,2,0,7,6,16
191028910,0,3,2,6,9,20
191028911,4,7,4,9,6,30
191028912,3,7,9,7,2,28
191028913,7,0,2,2,8,19
191028914,8,1,8,7,6,30
191028915,3,3,4,0,1,11
191028916,1,3,9,1,1,15
191028917,6,6,4,0,0,16
191028918,4,1,8,5,1,19
191028919,3,9,3,4,7,26
191028920,1,1,4,2,9,17
191028921,9,2,3,1,3,18
191028922,0,8,5,2,7,22
191028923,7,9,8,7,9,40
191028924,8,8,9,3,8,36
191028925,6,6,4,7,2,25
191028926,4,5,9,9,6,33
191028927,8,7,0,7,5,27
191028928,4,3,3,4,7,21
191028929,5,2,7,2,8,24
191028930,0,4,4,0,6,14
191028931,2,2,6,8,2,20
191028932,5,4,6,6,4,25
191028933,9,0,1,4,1,15
191028934,0,3,0,8,6,17
191028935,5,0,2,2,8,17
191028936,8,8,5,9,8,38
191028937,3,8,9,9,6,35
191028938,3,1,8,9,5,26
191028939,9,4,7,0,8,28
191028940,4,2,4,6,5,21
191028941,8,2,4,7,2,23
191028942,7,0,0,2,3,12
191028943,0,5,8,4,8,25
191028944,6,5,7,2,6,26
191028945,3,9,2,9,0,23
191028946,0,0,8,7,0,15
191028947,6,9,4,6,1,26
191028948,1,7,5,1,5,19
191028949,8,2,8,5,6,29
191028950,7,9,0,4,7,27
191028951,9,4,9,7,4,33
191028952,9,2,9,6,2,28
191028953,3,4,9,3,4,23
191028954,6,1,2,2,2,13
191028955,4,5,3,7,9,28
191028956,9,2,5,9,5,30
191028957,6,3,0,5,4,18
191028958,7,0,9,5,1,22
191028959,9,6,8,6,1,30
191028960,2,6,1,8,6,23
191028961,7,6,5,6,5,29
191028962,1,9,7,2,2,21
191028963,6,0,5,3,8,22
191028964,9,4,9,1,4,27
191028965,9,2,0,4,7,22
191028966,0,2,0,9,3,14
191028967,8,6,9,3,7,33
191028968,1,3,9,9,9,31
191028969,5,6,5,5,0,21
191028970,1,2,0,0,8,11
191028971,5,0,5,5,6,21
191028972,7,8,9,5,2,31
191028973,0,1,2,7,4,14
191028974,0,8,5,1,7,21
191028975,9,5,2,1,2,19
191028976,8,8,3,4,4,27
191028977,2,5,4,1,8,20
191028978,1,9,7,9,7,33
191028979,9,5,7,9,4,34
191028980,9,5,7,1,3,25
191028981,3,8,7,6,4,28
191028982,5,1,0,7,2,15
191028983,6,1,7,0,1,15
191028984,0,7,0,4,2,13
191028985,5,6,2,2,7,22
191028986,4,9,9,1,9,32
191028987,7,4,1,7,7,26
191028988,2,9,2,1,8,22
191028989,2,5,8,6,1,22
191028990,5,6,6,9,7,33
191028991,7,7,4,0,1,19
191028992,6,1,5,3,5,20
191028993,9,1,2,5,9,26
191028994,0,9,2,9,3,23
191028995,8,9,5,5,1,28
191028996,9,9,9,2,4,33
191028997,8,2,0,5,1,16
191028998,8,9,1,9,5,32
191028999,8,1,1,2,5,17
1910281000,6,2,0,6,5,19
1910281001,9,3,2,4,3,21
1910281002,7,6,1,0,0,14
1910281003,6,7,0,3,8,24
1910281004,0,5,1,9,1,16
1910281005,4,2,7,9,2,24
1910281006,3,7,7,6,4,27
1910281007,5,1,3,5,0,14
1910281008,3,8,1,7,5,24
1910281009,4,8,2,6,4,24
1910281010,7,5,5,2,8,27
1910281011,7,4,5,2,5,23
1910281012,3,9,4,9,7,32
1910281013,5,7,3,9,7,31
1910281014,6,7,9,5,8,35
1910281015,7,6,5,0,3,21
1910281016,3,1,5,7,6,22
1910281017,3,2,5,2,0,12
1910281018,5,8,1,6,7,27
1910281019,8,8,8,6,2,32
1910281020,6,2,3,3,0,14
1910281021,2,0,4,6,7,19
1910281022,6,0,7,3,5,21
1910281023,8,9,5,3,1,26
1910281024,7,5,6,1,5,24
1910281025,7,2,6,3,7,25
1910281026,1,3,5,8,5,22
1910281027,8,1,9,8,1,27
1910281028,1,0,7,7,7,22
1910281029,6,7,9,8,4,34
1910281030,9,1,4,8,1,23
1910281031,3,0,3,4,4,14
1910281032,6,1,0,7,2,16
1910281033,4,4,7,7,1,23
1910281034,7,1,7,7,8,30
1910281035,0,7,0,4,0,11
1910281036,4,6,8,4,4,26
1910281037,8,0,2,7,6,23
1910281038,5,4,1,7,6,23
1910281039,1,1,2,5,2,11
1910281040,4,6,9,3,0,22
1910281041,4,0,7,4,6,21
1910281042,4,3,2,6,6,21
1910281043,6,4,4,2,3,19
1910281044,2,5,3,7,8,25
1910281045,8,9,5,3,7,32
1910281046,0,7,2,6,4,19
1910281047,6,4,6,9,8,33
1910281048,0,7,0,5,6,18
1910281049,1,3,9,6,9,28
1910281050,6,4,6,9,3,28
1910281051,3,1,6,6,0,16
1910281052,2,4,1,9,4,20
1910281053,3,2,2,1,0,8
1910281054,6,1,6,0,0,13
1910281055,0,4,2,6,8,20
1910281056,2,7,8,4,1,22
1910281057,0,8,8,4,1,21
1910281058,6,3,1,9,2,21
1910281059,7,5,2,2,3,19
1910281060,1,4,5,9,9,28
1910281061,4,6,4,8,2,24
1910281062,2,3,1,9,8,23
1910281063,1,8,7,6,9,31
1910281064,3,5,1,1,2,12
1910281065,6,8,7,7,7,35
1910281066,5,5,0,2,9,21
1910281067,5,7,1,3,1,17
1910281068,1,4,1,2,7,15
1910281069,6,3,9,8,8,34
1910281070,0,3,5,9,3,20
1910281071,1,6,1,2,9,19
1910281072,5,1,8,7,2,23
1910281073,2,6,7,6,1,22
1910281074,3,4,7,5,1,20
1910281075,0,6,0,2,3,11
1910281076,6,3,3,6,0,18
1910281077,3,5,1,5,3,17
1910281078,4,2,1,4,9,20
1910281079,2,3,6,4,2,17
1910281080,7,1,9,2,8,27
1910281081,3,2,6,8,0,19
1910281082,2,0,2,3,7,14
1910281083,5,5,2,8,1,21
1910281084,2,2,0,6,9,19
1910281085,4,5,5,4,5,23
1910281086,3,0,6,5,6,20
1910281087,0,0,7,5,4,16
1910281088,5,3,8,5,3,24
1910281089,8,7,1,0,9,25
1910281090,4,9,3,5,8,29
1910281091,7,9,0,5,4,25
1910281092,5,5,5,8,7,30
1910281093,5,5,2,5,9,26
1910281094,5,7,2,8,5,27
1910281095,4,6,7,1,2,20
1910281096,5,3,7,9,6,30
1910281097,6,3,6,6,2,23
1910281098,2,3,1,5,5,16
1910281099,5,0,4,9,5,23
1910281100,4,8,6,7,1,26
1910281101,3,6,6,2,6,23
1910281102,4,5,5,0,5,19
1910281103,2,2,4,6,1,15
1910281104,6,8,1,9,1,25
1910281105,7,7,0,3,4,21
191029001,1,5,2,2,1,11
191029002,0,7,8,9,8,32
191029003,6,3,1,7,2,19
191029004,8,5,1,8,8,30
191029005,7,3,1,7,2,20
191029006,8,3,7,5,5,28
191029007,0,9,9,2,6,26
191029008,5,4,4,3,0,16
191029009,4,6,5,0,9,24
191029010,9,5,2,3,6,25
191029011,0,2,8,6,8,24
191029012,3,9,0,2,8,22
191029013,2,3,5,7,4,21
191029014,0,5,4,6,8,23
191029015,7,1,1,4,4,17
191029016,6,6,9,8,9,38
191029017,0,6,1,6,2,15
191029018,3,5,4,5,7,24
191029019,4,0,6,4,1,15
191029020,8,2,9,2,6,27
191029021,3,1,0,6,3,13
191029022,4,9,5,0,2,20
191029023,6,3,6,1,6,22
191029024,3,1,5,3,4,16
191029025,2,8,9,0,8,27
191029026,4,1,3,5,8,21
191029027,3,4,7,9,2,25
191029028,9,6,9,8,7,39
191029029,7,4,1,1,5,18
191029030,5,8,5,2,2,22
191029031,5,4,9,2,2,22
191029032,2,5,9,2,0,18
191029033,2,1,6,5,0,14
191029034,4,4,9,7,7,31
191029035,1,1,6,7,5,20
191029036,4,3,4,8,0,19
191029037,7,6,3,2,6,24
191029038,9,4,3,3,0,19
191029039,0,4,4,1,1,10
191029040,9,6,4,6,3,28
191029041,3,0,4,2,9,18
191029042,6,4,9,4,7,30
191029043,5,4,3,7,6,25
191029044,0,6,6,7,5,24
191029045,8,4,1,9,8,30
191029046,0,7,5,3,5,20
191029047,6,7,3,3,6,25
191029048,7,2,8,3,5,25
191029049,0,7,4,8,8,27
191029050,3,0,9,4,0,16
191029051,8,7,3,7,6,31
191029052,1,6,2,3,6,18
191029053,0,0,5,5,0,10
191029054,3,3,7,0,4,17
191029055,4,1,5,9,6,25
191029056,4,4,0,4,7,19
191029057,5,7,5,1,2,20
191029058,3,7,9,9,5,33
191029059,5,1,3,8,9,26
191029060,9,6,3,6,8,32
191029061,1,0,4,6,5,16
191029062,2,2,7,8,3,22
191029063,7,7,6,6,5,31
191029064,2,9,3,3,3,20
191029065,7,5,2,4,6,24
191029066,7,5,9,5,6,32
191029067,4,2,8,7,6,27
191029068,9,5,1,4,3,22
191029069,6,5,7,1,4,23
191029070,3,7,9,9,8,36
191029071,7,8,9,5,3,32
191029072,5,2,6,9,3,25
191029073,1,8,7,5,9,30
191029074,0,6,9,7,9,31
191029075,6,0,4,3,5,18
191029076,6,1,9,5,2,23
191029077,4,7,1,6,7,25
191029078,8,7,8,5,9,37
191029079,8,4,4,7,6,29
191029080,4,1,8,5,7,25
191029081,3,3,5,2,3,16
191029082,4,9,4,0,7,24
191029083,9,8,2,2,1,22
191029084,3,7,4,7,2,23
191029085,3,7,3,2,6,21
191029086,9,2,8,1,8,28
191029087,0,0,1,2,1,4
191029088,5,0,5,2,9,21
191029089,4,5,0,3,5,17
191029090,1,9,1,2,7,20
191029091,1,4,1,2,8,16
191029092,9,4,3,8,7,31
191029093,1,5,2,9,3,20
191029094,7,8,8,8,1,32
191029095,1,2,1,0,1,5
191029096,4,8,5,7,9,33
191029097,1,8,6,2,5,22
191029098,5,4,7,7,3,26
191029099,1,0,1,8,0,10
191029100,7,6,5,8,6,32
191029101,1,0,7,7,4,19
191029102,1,4,7,7,1,20
191029103,8,1,0,9,2,20
191029104,2,7,0,6,3,18
191029105,5,2,5,1,3,16
191029106,2,1,2,6,1,12
191029107,4,9,1,1,3,18
191029108,8,0,6,7,0,21
191029109,0,3,8,7,0,18
191029110,7,2,9,3,7,28
191029111,0,8,1,1,5,15
191029112,9,5,9,8,0,31
191029113,1,6,3,5,1,16
191029114,0,8,9,5,0,22
191029115,4,3,0,3,7,17
191029116,1,5,6,3,6,21
191029117,5,8,3,8,5,29
191029118,6,1,2,3,0,12
191029119,8,8,3,6,9,34
191029120,1,2,0,8,8,19
191029121,1,6,9,0,9,25
191029122,1,0,8,0,3,12
191029123,9,6,4,7,0,26
191029124,5,2,2,7,4,20
191029125,0,1,2,9,8,20
191029126,4,1,6,2,3,16
191029127,2,4,1,4,2,13
191029128,3,4,5,6,1,19
191029129,3,5,6,0,2,16
191029130,5,7,4,7,6,29
191029131,1,7,0,9,6,23
191029132,3,3,9,8,6,29
191029133,3,6,2,7,0,18
191029134,2,9,4,5,5,25
191029135,4,2,5,8,9,28
191029136,9,4,8,9,4,34
191029137,2,1,8,3,4,18
191029138,4,3,9,8,8,32
191029139,1,0,4,9,5,19
191029140,0,5,6,3,5,19
191029141,2,1,4,3,0,10
191029142,5,0,1,3,6,15
191029143,1,7,0,6,6,20
191029144,1,2,7,8,8,26
191029145,7,7,3,3,9,29
191029146,0,9,1,3,2,15
191029147,6,7,4,5,4,26
191029148,5,7,1,2,9,24
191029149,9,7,1,3,4,24
191029150,9,4,2,8,9,32
191029151,7,3,1,3,5,19
191029152,2,7,7,1,9,26
191029153,0,4,5,2,3,14
191029154,0,4,5,5,7,21
191029155,2,1,3,0,6,12
191029156,8,1,2,1,3,15
191029157,0,8,2,7,4,21
191029158,4,8,4,9,9,34
191029159,1,2,5,0,9,17
191029160,3,9,5,1,9,27
191029161,5,5,8,8,5,31
191029162,3,5,3,3,6,20
191029163,6,7,7,5,9,34
191029164,8,0,2,2,0,12
191029165,3,0,4,2,1,10
191029166,9,8,8,8,0,33
191029167,6,6,2,3,3,20
191029168,1,4,7,8,3,23
191029169,0,2,0,0,3,5
191029170,6,5,4,3,9,27
191029171,9,1,1,3,1,15
191029172,2,1,2,4,2,11
191029173,4,4,2,8,3,21
191029174,5,1,1,7,0,14
191029175,3,2,7,9,0,21
191029176,6,7,6,2,6,27
191029177,0,7,7,1,0,15
191029178,6,9,6,5,5,31
191029179,9,7,0,4,0,20
191029180,8,6,3,2,1,20
191029181,4,1,6,6,3,20
191029182,5,6,9,7,9,36
191029183,4,3,1,7,4,19
191029184,2,9,1,0,9,21
191029185,1,0,9,2,7,19
191029186,7,3,1,1,7,19
191029187,5,5,2,2,2,16
191029188,9,4,1,9,4,27
191029189,9,8,1,5,8,31
191029190,6,8,8,3,3,28
191029191,2,9,7,0,9,27
191029192,3,6,3,9,7,28
191029193,0,9,0,5,4,18
191029194,2,2,0,4,2,10
191029195,5,8,7,2,5,27
191029196,9,4,3,6,9,31
191029197,9,1,5,3,4,22
191029198,1,9,1,4,5,20
191029199,6,7,4,4,7,28
191029200,9,2,4,2,8,25
191029201,9,4,4,4,4,25
191029202,0,7,3,8,0,18
191029203,0,8,7,6,3,24
191029204,5,6,0,4,2,17
191029205,0,7,4,9,8,28
191029206,8,1,8,1,3,21
191029207,4,0,1,7,3,15
191029208,6,9,7,8,3,33
191029209,0,8,8,1,3,20
191029210,2,1,3,9,4,19
191029211,9,1,1,0,3,14
191029212,9,0,8,6,9,32
191029213,2,8,1,1,0,12
191029214,4,0,7,8,6,25
191029215,6,4,6,1,2,19
191029216,3,8,6,9,1,27
191029217,3,0,6,4,9,22
191029218,7,0,7,2,0,16
191029219,3,3,0,8,8,22
191029220,5,3,9,4,1,22
191029221,7,0,1,3,1,12
191029222,9,8,5,9,0,31
191029223,6,0,8,2,4,20
191029224,7,2,6,9,0,24
191029225,9,5,7,1,2,24
191029226,5,4,9,4,6,28
191029227,8,3,1,7,2,21
191029228,6,8,2,6,0,22
191029229,8,7,6,8,0,29
191029230,4,3,0,6,7,20
191029231,0,0,4,8,4,16
191029232,6,6,2,7,6,27
191029233,1,6,3,8,9,27
191029234,5,4,5,1,3,18
191029235,9,9,8,8,9,43
191029236,5,7,6,2,8,28
191029237,5,0,2,5,9,21
191029238,6,2,4,6,1,19
191029239,3,7,6,8,9,33
191029240,3,5,1,0,3,12
191029241,4,0,8,9,5,26
191029242,8,1,9,6,4,28
191029243,7,1,2,2,8,20
191029244,6,1,8,6,7,28
191029245,8,0,7,2,6,23
191029246,5,7,1,7,0,20
191029247,3,1,4,4,3,15
191029248,7,9,0,8,4,28
191029249,0,7,2,7,8,24
191029250,0,0,4,8,0,12
191029251,6,3,5,6,0,20
191029252,2,1,6,0,6,15
191029253,9,1,6,9,8,33
191029254,6,0,8,0,2,16
191029255,7,2,2,1,2,14
191029256,7,7,4,3,6,27
191029257,7,3,3,5,5,23
191029258,0,9,7,3,0,19
191029259,0,5,0,2,6,13
191029260,9,0,2,4,2,17
191029261,2,2,5,8,3,20
191029262,7,1,4,7,3,22
191029263,1,0,4,4,7,16
191029264,8,9,6,4,3,30
191029265,4,0,3,2,4,13
191029266,7,0,1,5,4,17
191029267,7,3,3,3,1,17
191029268,9,0,2,0,4,15
191029269,6,2,2,9,4,23
191029270,8,6,2,9,7,32
191029271,4,4,0,1,5,14
191029272,9,0,6,7,2,24
191029273,0,4,8,0,3,15
191029274,6,8,1,8,1,24
191029275,2,0,8,7,2,19
191029276,6,4,5,3,2,20
191029277,6,7,8,2,1,24
191029278,6,5,5,3,3,22
191029279,9,3,8,2,4,26
191029280,3,3,8,0,2,16
191029281,8,0,6,1,0,15
191029282,7,1,3,0,1,12
191029283,7,7,1,7,9,31
191029284,5,3,6,8,1,23
191029285,0,1,4,4,0,9
191029286,1,8,1,3,8,21
191029287,2,9,5,3,3,22
191029288,8,1,7,9,4,29
191029289,6,0,3,8,9,26
191029290,7,3,2,1,3,16
191029291,9,6,4,3,0,22
191029292,8,4,7,4,4,27
191029293,7,5,9,7,6,34
191029294,3,7,6,7,7,30
191029295,0,1,4,8,3,16
191029296,2,5,9,3,3,22
191029297,7,4,0,4,4,19
191029298,3,7,5,9,6,30
191029299,8,4,7,8,3,30
191029300,0,2,3,1,8,14
191029301,4,9,0,4,4,21
191029302,6,2,1,3,4,16
191029303,5,4,2,6,1,18
191029304,4,5,1,3,9,22
191029305,4,8,6,6,0,24
191029306,2,9,7,5,8,31
191029307,0,2,3,5,0,10
191029308,3,9,2,7,9,30
191029309,3,4,2,5,1,15
191029310,4,9,3,4,3,23
191029311,4,1,9,9,1,24
191029312,2,8,8,0,9,27
191029313,4,2,9,2,7,24
191029314,3,7,7,4,1,22
191029315,8,4,1,9,0,22
191029316,5,5,0,1,8,19
191029317,2,4,8,2,7,23
191029318,5,6,8,4,1,24
191029319,2,2,5,4,0,13
191029320,8,3,8,6,1,26
191029321,9,2,9,1,1,22
191029322,7,6,9,4,8,34
191029323,8,8,7,8,6,37
191029324,1,6,2,2,3,14
191029325,8,9,3,3,6,29
191029326,5,3,7,9,8,32
191029327,8,9,9,3,0,29
191029328,8,0,1,4,6,19
191029329,4,2,0,2,6,14
191029330,9,0,5,3,0,17
191029331,2,9,1,7,9,28
191029332,8,8,2,5,1,24
191029333,2,7,7,9,9,34
191029334,7,1,0,4,4,16
191029335,8,1,2,1,1,13
191029336,9,8,7,8,3,35
191029337,9,5,5,9,3,31
191029338,8,0,9,4,5,26
191029339,2,5,2,3,7,19
191029340,4,8,0,9,4,25
191029341,1,6,4,8,8,27
191029342,3,4,9,4,2,22
191029343,7,0,1,2,6,16
191029344,7,2,0,3,3,15
191029345,1,1,5,9,9,25
191029346,5,4,5,9,2,25
191029347,7,2,0,9,0,18
191029348,9,2,3,6,4,24
191029349,0,3,2,7,4,16
191029350,8,2,8,3,0,21
191029351,0,7,3,0,0,10
191029352,2,4,2,8,4,20
191029353,1,4,0,4,2,11
191029354,6,3,7,9,0,25
191029355,6,7,9,1,2,25
191029356,9,2,1,9,6,27
191029357,9,5,8,2,6,30
191029358,8,8,2,7,8,33
191029359,4,6,8,5,2,25
191029360,9,2,2,5,0,18
191029361,0,1,0,7,4,12
191029362,8,3,0,5,3,19
191029363,8,0,3,8,9,28
191029364,5,9,7,4,3,28
191029365,9,3,2,7,9,30
191029366,9,4,5,9,1,28
191029367,8,6,3,7,2,26
191029368,0,2,0,5,3,10
191029369,4,0,6,5,7,22
191029370,0,7,5,3,2,17
191029371,6,8,8,1,2,25
191029372,9,4,1,0,5,19
191029373,2,2,7,4,1,16
191029374,1,5,7,5,5,23
191029375,8,3,4,0,9,24
191029376,3,2,7,3,1,16
191029377,2,9,7,6,9,33
191029378,8,3,4,1,4,20
191029379,5,9,4,7,5,30
191029380,7,0,1,6,8,22
191029381,1,8,1,7,0,17
191029382,0,4,0,2,8,14
191029383,1,8,3,8,7,27
191029384,5,6,6,1,1,19
191029385,2,9,6,3,6,26
191029386,1,0,0,0,2,3
191029387,0,3,7,2,7,19
191029388,8,1,7,6,5,27
191029389,3,4,2,5,0,14
191029390,2,2,6,3,6,19
191029391,6,5,3,6,0,20
191029392,8,3,3,0,8,22
191029393,6,0,9,8,0,23
191029394,0,4,5,3,1,13
191029395,4,1,8,9,1,23
191029396,2,7,1,0,6,16
191029397,8,5,4,4,6,27
191029398,6,7,5,9,0,27
191029399,2,4,2,4,5,17
191029400,3,6,8,4,2,23
191029401,0,4,5,1,6,16
191029402,6,2,2,8,1,19
191029403,4,2,3,9,2,20
191029404,3,7,9,3,9,31
191029405,3,0,7,1,0,11
191029406,2,3,1,9,6,21
191029407,7,5,8,1,6,27
191029408,8,1,7,6,7,29
191029409,0,5,9,8,9,31
191029410,3,0,1,9,0,13
191029411,5,2,9,8,5,29
191029412,7,4,4,0,5,20
191029413,3,9,6,0,0,18
191029414,4,7,6,9,8,34
191029415,1,9,6,7,1,24
191029416,1,4,1,9,6,21
191029417,1,1,6,4,0,12
191029418,3,7,5,0,6,21
191029419,3,9,9,8,2,31
191029420,2,6,2,2,7,19
191029421,6,0,8,6,3,23
191029422,2,1,3,0,4,10
191029423,7,2,3,1,2,15
191029424,0,7,1,3,7,18
191029425,9,9,5,3,3,29
191029426,6,1,4,0,0,11
191029427,9,1,9,9,8,36
191029428,5,3,8,5,8,29
191029429,6,1,4,5,2,18
191029430,4,3,4,0,0,11
191029431,3,3,0,2,3,11
191029432,4,5,3,2,6,20
191029433,0,2,4,5,5,16
191029434,9,8,1,0,4,22
191029435,8,0,2,5,9,24
191029436,1,5,4,6,1,17
191029437,4,7,3,8,2,24
191029438,1,9,3,8,0,21
191029439,2,7,0,9,7,25
191029440,3,7,4,5,5,24
191029441,0,3,7,0,5,15
191029442,8,3,3,8,3,25
191029443,0,2,8,2,5,17
191029444,9,4,4,3,7,27
191029445,3,1,2,2,2,10
191029446,4,4,2,3,9,22
191029447,7,9,4,0,9,29
191029448,1,1,7,4,9,22
191029449,5,1,4,6,2,18
191029450,5,2,5,3,9,24
191029451,0,3,2,3,4,12
191029452,2,9,6,5,0,22
191029453,8,0,0,9,6,23
191029454,4,6,7,9,9,35
191029455,3,0,3,0,5,11
191029456,3,8,6,1,6,24
191029457,4,5,3,3,0,15
191029458,3,5,3,2,5,18
191029459,7,1,2,4,6,20
191029460,1,8,7,1,8,25
191029461,6,3,8,4,8,29
191029462,1,1,2,6,0,10
191029463,4,1,8,9,8,30
191029464,6,3,5,0,2,16
191029465,9,4,1,8,1,23
191029466,7,1,8,4,3,23
191029467,5,0,1,2,7,15
191029468,0,1,8,8,0,17
191029469,9,3,2,6,8,28
191029470,9,8,7,4,5,33
191029471,3,7,2,7,3,22
191029472,9,7,3,2,9,30
191029473,3,6,0,2,4,15
191029474,6,8,7,2,8,31
191029475,9,5,3,1,7,25
191029476,2,2,8,2,4,18
191029477,3,9,3,0,3,18
191029478,7,1,3,6,3,20
191029479,2,3,2,7,7,21
191029480,7,2,8,3,4,24
191029481,9,2,7,3,3,24
191029482,7,1,3,1,3,15
191029483,0,9,8,0,2,19
191029484,6,4,2,7,5,24
191029485,8,4,0,2,3,17
191029486,6,5,7,4,6,28
191029487,6,8,9,2,9,34
191029488,7,0,3,6,5,21
191029489,1,2,4,9,8,24
191029490,8,6,3,8,3,28
191029491,4,4,6,4,2,20
191029492,9,9,2,2,2,24
191029493,5,8,1,0,5,19
191029494,6,0,2,9,9,26
191029495,6,9,0,5,3,23
191029496,4,6,5,8,3,26
191029497,9,5,2,0,5,21
191029498,1,6,0,2,6,15
191029499,5,3,3,0,9,20
191029500,8,2,7,5,0,22
191029501,5,0,7,7,0,19
191029502,3,9,0,8,3,23
191029503,4,4,2,2,1,13
191029504,4,0,8,9,0,21
191029505,6,8,9,3,8,34
191029506,4,5,2,4,3,18
191029507,0,3,7,1,3,14
191029508,8,2,7,0,2,19
191029509,2,8,0,9,2,21
191029510,6,8,5,5,2,26
191029511,8,9,1,9,9,36
191029512,9,9,6,7,7,38
191029513,0,1,0,6,4,11
191029514,6,5,6,6,5,28
191029515,4,6,5,8,6,29
191029516,1,2,8,1,0,12
191029517,1,1,8,5,2,17
191029518,1,8,1,1,6,17
191029519,1,7,4,8,3,23
191029520,3,1,8,6,8,26
191029521,3,1,9,1,5,19
191029522,6,7,4,7,7,31
191029523,1,0,0,1,0,2
191029524,5,0,6,2,4,17
191029525,2,1,0,6,5,14
191029526,6,9,3,0,2,20
191029527,0,8,9,3,7,27
191029528,2,5,3,7,1,18
191029529,7,5,1,5,6,24
191029530,9,7,7,1,2,26
191029531,5,1,0,2,8,16
191029532,6,1,2,6,0,15
191029533,5,5,3,0,2,15
191029534,4,6,1,0,1,12
191029535,0,7,7,6,0,20
191029536,3,3,4,7,5,22
191029537,0,9,5,2,2,18
191029538,2,6,7,0,5,20
191029539,8,3,9,7,8,35
191029540,4,0,2,7,9,22
191029541,7,6,3,6,3,25
191029542,5,0,0,5,7,17
191029543,5,7,9,9,2,32
191029544,4,5,5,6,7,27
191029545,4,3,3,0,2,12
191029546,6,6,9,0,5,26
191029547,0,8,8,0,4,20
191029548,2,0,0,5,2,9
191029549,3,3,9,2,1,18
191029550,9,6,0,1,1,17
191029551,4,4,3,7,8,26
191029552,3,3,8,0,4,18
191029553,4,3,4,2,4,17
191029554,5,6,9,2,6,28
191029555,0,2,4,5,4,15
191029556,6,0,2,2,5,15
191029557,0,9,6,9,8,32
191029558,6,1,5,6,1,19
191029559,6,9,6,5,1,27
191029560,5,8,0,9,5,27
191029561,5,6,6,3,2,22
191029562,3,1,1,5,8,18
191029563,7,7,6,9,5,34
191029564,2,1,1,7,3,14
191029565,6,1,9,2,0,18
191029566,8,8,7,3,0,26
191029567,1,0,0,4,6,11
191029568,2,2,3,3,8,18
191029569,0,7,8,0,3,18
191029570,2,1,8,8,9,28
191029571,7,6,5,7,7,32
191029572,5,4,2,5,8,24
191029573,5,8,4,1,2,20
191029574,8,8,2,6,1,25
191029575,6,7,1,0,8,22
191029576,5,2,0,9,4,20
191029577,3,9,2,9,5,28
191029578,6,6,5,7,0,24
191029579,7,7,1,1,2,18
191029580,7,3,6,8,2,26
191029581,1,9,4,8,5,27
191029582,2,9,3,7,7,28
191029583,7,5,6,6,5,29
191029584,7,2,3,3,1,16
191029585,6,9,1,2,0,18
191029586,4,7,2,0,1,14
191029587,2,9,4,4,9,28
191029588,0,9,3,5,3,20
191029589,1,2,8,1,6,18
191029590,5,0,3,4,5,17
191029591,5,3,2,8,6,24
191029592,2,2,8,9,8,29
191029593,2,5,0,7,6,20
191029594,3,1,6,0,4,14
191029595,9,0,4,1,2,16
191029596,4,4,2,3,4,17
191029597,6,7,2,2,1,18
191029598,2,1,8,9,7,27
191029599,7,8,5,9,7,36
191029600,7,0,3,3,3,16
191029601,2,2,5,4,7,20
191029602,9,7,5,2,3,26
191029603,4,9,1,8,9,31
191029604,3,1,6,2,3,15
191029605,6,3,6,1,7,23
191029606,2,2,4,1,9,18
191029607,7,1,1,9,3,21
191029608,3,4,8,4,1,20
191029609,7,7,0,8,8,30
191029610,6,7,6,1,7,27
191029611,0,5,2,6,2,15
191029612,0,7,9,5,8,29
191029613,9,8,6,9,8,40
191029614,9,0,0,2,4,15
191029615,9,0,3,6,4,22
191029616,3,7,0,2,6,18
191029617,0,4,3,7,4,18
191029618,0,5,3,1,3,12
191029619,7,8,6,1,6,28
191029620,3,6,2,9,8,28
191029621,3,7,3,6,4,23
191029622,3,6,3,7,9,28
191029623,7,3,5,6,6,27
191029624,6,3,7,3,1,20
191029625,3,7,3,5,0,18
191029626,3,3,4,5,0,15
191029627,4,1,5,2,1,13
191029628,2,0,2,3,4,11
191029629,4,1,8,1,9,23
191029630,0,3,0,1,5,9
191029631,0,0,5,3,5,13
191029632,2,0,2,7,6,17
191029633,2,0,5,0,9,16
191029634,2,8,6,8,6,30
191029635,0,9,7,4,6,26
191029636,5,5,4,4,2,20
191029637,2,6,4,3,6,21
191029638,3,8,9,5,1,26
191029639,3,9,5,8,1,26
191029640,8,9,0,5,1,23
191029641,1,8,6,2,0,17
191029642,2,6,8,6,4,26
191029643,6,7,8,1,3,25
191029644,0,2,7,2,2,13
191029645,0,9,1,4,5,19
191029646,1,8,2,2,5,18
191029647,6,0,0,3,0,9
191029648,5,5,7,4,9,30
191029649,8,2,7,7,7,31
191029650,3,6,1,1,4,15
191029651,0,1,0,7,5,13
191029652,9,2,2,1,6,20
191029653,0,6,6,2,2,16
191029654,0,1,1,8,0,10
191029655,0,8,2,3,4,17
191029656,0,0,4,0,4,8
191029657,2,2,3,8,7,22
191029658,8,2,8,8,3,29
191029659,0,6,1,3,3,13
191029660,6,7,2,6,6,27
191029661,8,4,9,9,4,34
191029662,8,9,5,6,0,28
191029663,4,6,2,1,2,15
191029664,0,8,7,5,6,26
191029665,8,6,2,0,0,16
191029666,5,1,5,0,2,13
191029667,4,9,4,4,7,28
191029668,4,1,8,2,2,17
191029669,7,3,7,7,9,33
191029670,3,0,6,1,0,10
191029671,2,0,1,4,8,15
191029672,8,8,8,5,4,33
191029673,5,1,1,8,4,19
191029674,0,0,1,9,1,11
191029675,3,4,4,5,9,25
191029676,7,2,3,9,3,24
191029677,6,4,8,0,0,18
191029678,6,8,9,1,9,33
191029679,2,8,0,7,9,26
191029680,6,1,7,4,0,18
191029681,0,9,2,3,8,22
191029682,9,5,2,1,4,21
191029683,7,5,9,6,2,29
191029684,9,9,0,9,8,35
191029685,9,9,6,3,9,36
191029686,7,0,8,6,3,24
191029687,5,4,2,4,8,23
191029688,6,7,6,5,1,25
191029689,5,7,5,8,9,34
191029690,2,1,5,6,1,15
191029691,1,3,5,5,9,23
191029692,3,0,9,9,4,25
191029693,3,9,0,0,1,13
191029694,8,8,5,5,1,27
191029695,8,0,3,0,6,17
191029696,1,3,5,0,2,11
191029697,2,9,0,6,6,23
191029698,7,5,3,2,1,18
191029699,4,9,0,2,7,22
191029700,4,6,1,9,1,21
191029701,0,6,8,1,1,16
191029702,2,5,3,9,5,24
191029703,3,2,9,6,2,22
191029704,1,0,2,6,2,11
191029705,3,8,7,8,5,31
191029706,0,3,1,9,0,13
191029707,9,8,0,0,6,23
191029708,2,0,0,7,2,11
191029709,2,5,6,5,8,26
191029710,9,8,6,4,8,35
191029711,8,0,5,4,1,18
191029712,4,0,5,7,9,25
191029713,9,2,2,7,2,22
191029714,4,7,0,3,6,20
191029715,8,9,0,4,7,28
191029716,4,2,5,4,6,21
191029717,5,1,8,1,7,22
191029718,0,3,7,4,8,22
191029719,4,6,5,7,5,27
191029720,2,8,8,5,9,32
191029721,3,7,3,9,6,28
191029722,4,9,1,7,5,26
191029723,0,7,5,9,7,28
191029724,3,8,6,0,1,18
191029725,3,8,3,8,6,28
191029726,0,7,1,9,5,22
191029727,9,6,2,3,1,21
191029728,7,2,5,4,1,19
191029729,6,3,7,9,1,26
191029730,2,6,8,9,7,32
191029731,0,8,7,1,0,16
191029732,3,0,0,9,6,18
191029733,0,4,5,5,2,16
191029734,3,4,4,1,1,13
191029735,3,6,6,1,2,18
191029736,8,6,5,5,7,31
191029737,9,6,6,3,4,28
191029738,2,7,5,5,1,20
191029739,5,7,4,6,1,23
191029740,3,6,1,7,7,24
191029741,1,6,4,2,3,16
191029742,6,5,7,3,8,29
191029743,5,8,3,4,7,27
191029744,7,2,1,5,8,23
191029745,2,3,9,3,1,18
191029746,1,0,4,2,2,9
191029747,5,7,0,4,8,24
191029748,1,9,1,7,5,23
191029749,3,6,0,9,5,23
191029750,5,0,4,6,5,20
191029751,9,5,1,4,8,27
191029752,9,9,3,9,0,30
191029753,9,7,8,1,5,30
191029754,9,5,3,7,4,28
191029755,8,0,1,6,6,21
191029756,3,2,2,0,5,12
191029757,3,7,1,7,0,18
191029758,5,9,9,0,0,23
191029759,5,8,0,1,7,21
191029760,9,7,9,9,8,42
191029761,3,3,1,8,6,21
191029762,0,5,2,7,7,21
191029763,0,6,6,4,0,16
191029764,7,2,8,3,6,26
191029765,9,9,9,3,4,34
191029766,5,3,3,9,4,24
191029767,3,5,1,9,0,18
191029768,3,6,0,4,3,16
191029769,3,4,5,4,7,23
191029770,3,3,1,1,9,17
191029771,0,5,2,7,0,14
191029772,1,5,7,8,9,30
191029773,1,6,4,3,3,17
191029774,1,9,8,1,1,20
191029775,6,7,3,1,7,24
191029776,0,0,6,4,3,13
191029777,7,5,4,8,6,30
191029778,4,9,0,3,9,25
191029779,6,7,3,1,0,17
191029780,3,9,4,4,7,27
191029781,1,4,7,0,2,14
191029782,7,5,7,2,7,28
191029783,2,7,0,3,7,19
191029784,6,4,6,5,5,26
191029785,8,8,9,5,6,36
191029786,8,5,1,1,6,21
191029787,9,6,3,7,2,27
191029788,6,6,1,5,1,19
191029789,2,6,7,9,6,30
191029790,0,1,4,7,7,19
191029791,7,7,6,9,4,33
191029792,8,4,6,6,2,26
191029793,8,5,2,9,5,29
191029794,0,6,6,4,2,18
191029795,1,7,6,3,0,17
191029796,1,2,1,9,2,15
191029797,9,4,8,3,0,24
191029798,6,9,5,3,0,23
191029799,1,1,3,1,0,6
191029800,4,4,0,6,3,17
191029801,3,3,9,0,5,20
191029802,9,8,7,8,9,41
191029803,1,8,2,7,0,18
191029804,5,1,8,0,8,22
191029805,6,5,1,2,8,22
191029806,6,2,2,1,4,15
191029807,3,8,6,4,4,25
191029808,6,4,4,4,2,20
191029809,1,8,5,8,2,24
191029810,8,1,1,8,8,26
191029811,0,5,0,0,0,5
191029812,4,6,0,7,7,24
191029813,7,9,1,8,9,34
191029814,1,6,7,3,9,26
191029815,8,3,3,9,0,23
191029816,4,7,3,5,3,22
191029817,8,2,9,9,0,28
191029818,5,5,1,1,0,12
191029819,4,9,9,5,2,29
191029820,6,9,4,7,0,26
191029821,4,7,1,9,4,25
191029822,2,5,3,2,6,18
191029823,6,2,7,0,6,21
191029824,4,0,5,4,9,22
191029825,3,3,0,0,1,7
191029826,5,9,3,2,7,26
191029827,2,6,0,9,8,25
191029828,4,6,2,6,4,22
191029829,3,4,6,3,5,21
191029830,9,4,0,8,6,27
191029831,6,3,8,5,4,26
191029832,3,3,3,3,0,12
191029833,5,8,0,7,6,26
191029834,5,6,6,7,3,27
191029835,6,2,2,0,2,12
191029836,5,9,0,2,5,21
191029837,2,9,1,0,7,19
191029838,5,7,8,5,8,33
191029839,8,5,0,2,4,19
191029840,0,5,6,5,1,17
191029841,9,7,8,0,2,26
191029842,4,5,4,1,7,21
191029843,9,2,6,6,4,27
191029844,5,2,8,2,6,23
191029845,2,4,0,7,2,15
191029846,8,6,8,1,3,26
191029847,4,5,3,9,1,22
191029848,0,8,6,7,2,23
191029849,5,4,1,0,2,12
191029850,7,0,7,0,3,17
191029851,8,3,5,0,2,18
191029852,6,3,9,1,4,23
191029853,0,6,4,3,5,18
191029854,8,1,6,0,7,22
191029855,8,7,1,6,8,30
191029856,5,7,5,4,4,25
191029857,5,5,5,8,4,27
191029858,9,5,7,0,1,22
191029859,0,7,4,2,0,13
191029860,5,9,7,8,5,34
191029861,6,9,9,5,5,34
191029862,0,6,6,8,4,24
191029863,4,1,9,4,4,22
191029864,1,6,0,6,7,20
191029865,2,7,0,2,7,18
191029866,2,2,2,2,6,14
191029867,3,0,9,2,4,18
191029868,4,7,3,1,2,17
191029869,5,3,1,4,2,15
191029870,0,0,2,0,8,10
191029871,3,3,9,2,9,26
191029872,5,0,6,8,6,25
191029873,6,0,7,7,2,22
191029874,2,2,8,9,5,26
191029875,8,7,8,2,3,28
191029876,6,1,2,6,9,24
191029877,9,4,3,8,9,33
191029878,4,1,8,6,9,28
191029879,2,0,2,7,5,16
191029880,8,4,2,6,7,27
191029881,8,6,1,9,9,33
191029882,3,7,4,2,3,19
191029883,6,3,9,5,1,24
191029884,5,4,0,5,9,23
191029885,0,7,1,4,3,15
191029886,8,0,6,0,5,19
191029887,4,1,2,8,8,23
191029888,8,4,7,3,6,28
191029889,7,2,1,4,4,18
191029890,0,6,3,4,1,14
191029891,2,4,6,7,7,26
191029892,0,0,0,6,7,13
191029893,7,7,5,9,1,29
191029894,6,0,7,5,2,20
191029895,6,7,5,9,1,28
191029896,2,1,8,3,3,17
191029897,0,6,8,6,1,21
191029898,7,4,7,0,9,27
191029899,1,3,8,6,6,24
191029900,6,4,9,8,2,29
191029901,3,1,0,5,3,12
191029902,5,6,2,8,8,29
191029903,4,0,5,5,8,22
191029904,2,8,0,5,6,21
191029905,4,8,0,5,1,18
191029906,7,4,2,3,5,21
191029907,8,7,8,5,4,32
191029908,6,3,6,3,9,27
191029909,2,1,6,8,5,22
191029910,4,9,6,2,7,28
191029911,1,4,4,1,8,18
191029912,1,9,1,1,9,21
191029913,1,6,3,4,4,18
191029914,2,0,4,9,7,22
191029915,0,1,3,0,2,6
191029916,0,6,1,9,1,17
191029917,7,4,4,5,7,27
191029918,9,0,4,0,4,17
191029919,3,1,4,7,1,16
191029920,0,4,2,5,9,20
191029921,0,7,6,5,5,23
191029922,2,2,5,5,1,15
191029923,4,3,0,8,7,22
191029924,9,5,3,8,3,28
191029925,4,2,6,8,7,27
191029926,3,7,0,8,4,22
191029927,7,6,3,0,6,22
191029928,3,8,3,3,9,26
191029929,5,0,9,6,7,27
191029930,1,4,5,2,0,12
191029931,0,0,7,2,1,10
191029932,0,6,2,3,7,18
191029933,9,0,3,4,7,23
191029934,5,4,9,6,9,33
191029935,7,7,7,3,6,30
191029936,9,0,9,4,3,25
191029937,6,1,4,0,7,18
191029938,3,8,5,6,6,28
191029939,8,3,9,1,4,25
191029940,5,2,9,7,1,24
191029941,0,3,2,4,7,16
191029942,1,5,1,1,1,9
191029943,8,4,4,2,2,20
191029944,8,1,6,9,9,33
191029945,8,0,0,6,0,14
191029946,3,2,8,4,0,17
191029947,0,4,5,2,2,13
191029948,1,9,8,7,1,26
191029949,6,8,9,6,5,34
191029950,4,9,8,8,9,38
191029951,7,6,3,8,4,28
191029952,7,8,5,6,2,28
191029953,6,4,2,0,7,19
191029954,6,7,0,3,7,23
191029955,0,6,9,3,6,24
191029956,3,5,3,8,8,27
191029957,8,0,4,3,3,18
191029958,6,9,7,4,1,27
191029959,8,8,4,4,3,27
191029960,5,0,2,5,2,14
191029961,5,4,1,0,5,15
191029962,1,5,9,5,3,23
191029963,5,3,0,8,3,19
191029964,5,4,1,0,1,11
191029965,0,4,8,1,9,22
191029966,0,2,9,9,6,26
191029967,9,4,3,7,0,23
191029968,0,0,7,9,9,25
191029969,6,1,6,6,6,25
191029970,9,2,6,2,1,20
191029971,6,2,0,0,8,16
191029972,1,3,1,2,2,9
191029973,8,2,3,3,4,20
191029974,1,7,3,2,6,19
191029975,1,5,6,9,4,25
191029976,4,0,1,7,8,20
191029977,6,4,0,1,9,20
191029978,9,3,3,6,0,21
191029979,6,8,7,9,2,32
191029980,6,8,9,9,1,33
191029981,5,5,5,1,6,22
191029982,1,6,8,9,7,31
191029983,2,7,0,8,7,24
191029984,7,3,1,1,6,18
191029985,7,8,4,9,8,36
191029986,3,3,6,4,6,22
191029987,3,8,7,9,1,28
191029988,5,0,3,1,1,10
191029989,2,8,7,7,3,27
191029990,7,0,1,0,5,13
191029991,4,2,0,0,6,12
191029992,3,0,1,0,0,4
191029993,6,5,9,4,5,29
191029994,9,4,1,7,9,30
191029995,2,2,7,0,0,11
191029996,5,9,3,0,5,22
191029997,9,9,0,3,7,28
191029998,7,8,0,3,8,26
191029999,9,0,6,8,2,25
1910291000,1,3,0,3,2,9
1910291001,1,2,6,8,4,21
1910291002,0,1,7,9,2,19
1910291003,8,7,5,7,8,35
1910291004,7,9,8,4,8,36
1910291005,1,1,6,0,6,14
1910291006,6,6,7,3,2,24
1910291007,4,6,8,2,5,25
1910291008,6,3,0,4,0,13
1910291009,5,1,7,8,7,28
1910291010,0,4,1,0,0,5
1910291011,3,6,4,9,3,25
1910291012,9,5,6,8,4,32
1910291013,3,4,0,0,8,15
1910291014,7,3,6,9,7,32
1910291015,1,7,3,3,0,14
1910291016,5,3,3,8,1,20
1910291017,8,4,7,0,1,20
1910291018,2,7,0,0,5,14
1910291019,6,0,2,5,7,20
1910291020,5,5,6,2,6,24
1910291021,9,0,1,0,2,12
1910291022,3,3,6,7,9,28
1910291023,4,5,0,8,5,22
1910291024,9,7,2,2,8,28
1910291025,3,3,3,7,8,24
1910291026,1,9,9,1,4,24
1910291027,4,1,7,3,5,20
1910291028,6,3,8,1,6,24
1910291029,0,8,0,0,5,13
1910291030,4,6,0,7,9,26
1910291031,0,7,1,0,5,13
1910291032,8,4,3,6,2,23
1910291033,5,1,5,6,2,19
1910291034,5,1,9,1,6,22
1910291035,4,7,3,6,6,26
1910291036,3,7,3,7,1,21
1910291037,3,4,0,8,2,17
1910291038,6,3,1,7,4,21
1910291039,9,7,7,6,3,32
1910291040,2,1,3,0,0,6
1910291041,3,8,4,1,0,16
1910291042,8,9,9,3,4,33
1910291043,2,8,1,9,3,23
1910291044,7,7,9,8,4,35
1910291045,1,0,0,7,7,15
1910291046,8,6,9,6,8,37
1910291047,9,7,0,6,4,26
1910291048,0,1,4,1,9,15
1910291049,7,2,1,2,0,12
1910291050,0,9,2,9,6,26
1910291051,5,4,2,6,0,17
1910291052,5,4,2,8,5,24
1910291053,7,6,1,3,8,25
1910291054,9,6,6,1,8,30
1910291055,0,4,9,6,1,20
1910291056,0,5,7,7,5,24
1910291057,7,7,9,1,2,26
1910291058,2,5,2,3,6,18
1910291059,7,2,5,2,6,22
1910291060,8,2,4,7,8,29
1910291061,2,9,0,4,6,21
1910291062,5,5,7,0,0,17
1910291063,0,9,2,4,5,20
1910291064,2,8,5,3,8,26
1910291065,6,8,7,0,9,30
1910291066,8,1,1,4,8,22
1910291067,2,0,4,5,4,15
1910291068,1,1,5,4,7,18
1910291069,9,3,3,6,4,25
1910291070,3,8,6,6,7,30
1910291071,5,8,9,8,9,39
1910291072,4,1,8,0,2,15
1910291073,2,3,8,4,0,17
1910291074,8,5,5,3,3,24
1910291075,1,8,9,6,3,27
1910291076,6,1,8,9,7,31
1910291077,7,1,8,6,0,22
1910291078,4,1,6,8,4,23
1910291079,5,9,0,4,5,23
1910291080,0,2,0,7,0,9
1910291081,6,9,3,8,4,30
1910291082,8,8,3,9,8,36
1910291083,8,3,0,7,7,25
1910291084,1,0,3,8,1,13
1910291085,2,9,5,4,6,26
1910291086,7,5,0,6,8,26
1910291087,4,0,1,6,0,11
1910291088,1,1,9,9,9,29
1910291089,8,6,2,7,4,27
1910291090,6,0,1,1,3,11
1910291091,8,5,8,1,9,31
1910291092,7,9,2,4,0,22
1910291093,3,8,5,7,0,23
1910291094,9,0,3,2,3,17
1910291095,0,0,2,8,3,13
1910291096,3,0,6,1,8,18
1910291097,7,2,6,6,5,26
1910291098,6,1,6,3,1,17
1910291099,6,4,9,3,8,30
1910291100,4,6,0,9,4,23
1910291101,5,0,9,1,4,19
1910291102,8,8,0,9,4,29
1910291103,4,5,1,3,2,15
1910291104,7,6,2,3,6,24
1910291105,7,1,8,0,7,23
191030001,7,8,6,2,9,32
191030002,7,6,1,7,7,28
191030003,5,9,2,5,8,29
191030004,2,7,4,4,3,20
191030005,5,0,7,6,5,23
191030006,3,1,8,1,7,20
191030007,3,2,2,3,8,18
191030008,4,2,3,9,6,24
191030009,1,7,0,8,9,25
191030010,7,5,0,2,6,20
191030011,0,8,3,1,3,15
191030012,6,7,7,5,6,31
191030013,0,5,8,1,6,20
191030014,8,9,0,4,9,30
191030015,6,9,7,6,9,37
191030016,8,0,3,2,7,20
191030017,8,4,5,6,2,25
191030018,6,9,5,3,5,28
191030019,3,0,0,2,9,14
191030020,9,8,6,2,1,26
191030021,6,7,6,7,5,31
191030022,7,3,4,6,3,23
191030023,8,8,1,4,6,27
191030024,2,5,2,0,2,11
191030025,1,6,7,9,1,24
191030026,8,6,8,0,6,28
191030027,5,7,4,5,6,27
191030028,8,8,2,5,8,31
191030029,2,2,3,0,2,9
191030030,0,5,3,2,1,11
191030031,4,7,7,5,6,29
191030032,7,2,8,6,1,24
191030033,9,9,7,7,6,38
191030034,7,3,5,2,8,25
191030035,2,9,7,3,3,24
191030036,1,6,4,1,5,17
191030037,2,1,5,2,3,13
191030038,1,6,8,7,6,28
191030039,8,7,2,7,1,25
191030040,0,7,1,3,8,19
191030041,8,3,3,0,7,21
191030042,6,4,4,9,2,25
191030043,6,6,2,2,8,24
191030044,0,7,5,5,6,23
191030045,3,0,4,1,3,11
191030046,7,8,8,7,2,32
191030047,8,7,8,5,0,28
191030048,3,8,4,9,4,28
191030049,6,4,6,5,2,23
191030050,5,9,0,3,3,20
191030051,9,0,6,6,4,25
191030052,1,1,5,8,6,21
191030053,5,3,4,8,2,22
191030054,3,2,3,5,5,18
191030055,5,2,6,8,1,22
191030056,6,7,2,6,9,30
191030057,8,8,8,7,1,32
191030058,7,3,2,1,5,18
191030059,7,9,7,9,9,41
191030060,5,4,1,1,8,19
191030061,4,4,2,8,0,18
191030062,7,7,9,8,9,40
191030063,9,8,7,9,9,42
191030064,0,2,4,1,8,15
191030065,8,6,9,0,2,25
191030066,1,7,0,1,8,17
191030067,1,6,0,5,5,17
191030068,5,3,3,4,9,24
191030069,4,4,8,2,9,27
191030070,6,7,0,4,3,20
191030071,6,4,7,5,6,28
191030072,6,4,1,4,8,23
191030073,0,4,0,6,0,10
191030074,9,9,1,0,4,23
191030075,8,1,4,1,8,22
191030076,3,4,8,3,9,27
191030077,7,9,8,8,0,32
191030078,7,6,7,0,9,29
191030079,2,4,7,4,0,17
191030080,9,0,6,8,5,28
191030081,7,6,6,7,0,26
191030082,6,8,4,2,3,23
191030083,3,2,6,7,8,26
191030084,8,6,7,8,9,38
191030085,8,7,7,5,1,28
191030086,6,6,0,9,3,24
191030087,2,7,4,5,5,23
191030088,4,6,8,7,7,32
191030089,4,3,2,0,6,15
191030090,8,0,2,7,2,19
191030091,6,5,3,5,4,23
191030092,0,1,7,8,0,16
191030093,1,1,1,9,8,20
191030094,3,8,5,2,5,23
191030095,8,9,2,2,4,25
191030096,1,3,9,6,1,20
191030097,0,4,6,6,4,20
191030098,6,1,9,4,5,25
191030099,7,0,9,1,1,18
191030100,5,6,5,2,1,19
191030101,8,8,8,9,8,41
191030102,0,3,3,8,0,14
191030103,7,7,4,9,9,36
191030104,7,9,3,3,8,30
191030105,1,0,9,0,4,14
191030106,8,4,8,2,8,30
191030107,5,6,8,0,5,24
191030108,5,7,7,6,7,32
191030109,8,9,9,3,3,32
191030110,6,6,7,0,7,26
191030111,6,0,0,1,5,12
191030112,7,2,8,9,3,29
191030113,6,9,3,6,1,25
191030114,7,3,3,0,8,21
191030115,5,1,2,6,3,17
191030116,4,6,0,9,3,22
191030117,7,6,2,4,2,21
191030118,7,5,4,2,3,21
191030119,7,3,4,8,8,30
191030120,9,8,1,3,6,27
191030121,0,9,2,9,7,27
191030122,8,7,7,3,3,28
191030123,8,7,1,0,3,19
191030124,1,9,6,8,4,28
191030125,6,2,3,1,0,12
191030126,8,6,7,9,3,33
191030127,5,6,1,4,6,22
191030128,5,2,5,5,1,18
191030129,5,7,4,3,3,22
191030130,1,1,9,6,0,17
191030131,5,8,8,1,5,27
191030132,7,8,9,5,7,36
191030133,1,6,0,6,8,21
191030134,0,4,1,6,8,19
191030135,6,2,2,9,2,21
191030136,2,3,1,8,8,22
191030137,3,2,9,5,2,21
191030138,3,0,2,8,7,20
191030139,5,7,7,8,9,36
191030140,6,8,2,8,8,32
191030141,6,9,4,6,0,25
191030142,6,6,6,6,0,24
191030143,7,6,6,0,0,19
191030144,4,6,1,5,6,22
191030145,3,7,9,4,8,31
191030146,8,2,6,1,3,20
191030147,4,6,2,3,6,21
191030148,9,7,7,2,1,26
191030149,9,5,3,0,8,25
191030150,6,8,8,7,1,30
191030151,5,9,9,0,3,26
191030152,5,8,7,9,5,34
191030153,1,4,1,6,4,16
191030154,8,3,4,0,4,19
191030155,2,4,9,1,0,16
191030156,2,9,7,3,7,28
191030157,5,3,0,3,0,11
191030158,4,5,7,0,2,18
191030159,1,3,2,7,1,14
191030160,6,9,9,4,6,34
191030161,3,3,3,2,9,20
191030162,5,2,6,9,0,22
191030163,6,9,0,5,2,22
191030164,2,2,2,6,2,14
191030165,8,4,3,6,7,28
191030166,1,7,1,7,5,21
191030167,9,3,8,4,6,30
191030168,9,3,3,4,7,26
191030169,9,2,4,4,4,23
191030170,8,6,2,8,4,28
191030171,3,5,5,0,0,13
191030172,4,5,6,9,6,30
191030173,4,7,4,7,0,22
191030174,9,3,6,4,5,27
191030175,6,1,5,1,1,14
191030176,0,5,0,7,3,15
191030177,4,7,5,6,9,31
191030178,7,1,0,2,2,12
191030179,2,0,1,8,6,17
191030180,5,5,1,6,6,23
191030181,9,5,6,0,8,28
191030182,8,7,8,9,2,34
191030183,9,8,1,6,0,24
191030184,3,4,9,5,0,21
191030185,5,9,0,1,4,19
191030186,4,0,4,7,9,24
191030187,8,8,1,3,4,24
191030188,3,0,6,0,5,14
191030189,4,1,8,6,6,25
191030190,3,9,1,9,3,25
191030191,5,3,9,9,5,31
191030192,1,1,4,1,6,13
191030193,2,2,6,5,8,23
191030194,5,7,3,2,9,26
191030195,1,9,2,3,8,23
191030196,1,3,7,3,4,18
191030197,4,0,3,5,6,18
191030198,9,3,1,7,7,27
191030199,1,0,6,8,2,17
191030200,1,2,8,8,2,21
191030201,4,7,1,0,6,18
191030202,6,4,3,7,5,25
191030203,2,5,1,1,5,14
191030204,1,3,9,4,6,23
191030205,8,7,6,6,7,34
191030206,9,5,2,5,6,27
191030207,2,8,4,6,3,23
191030208,4,0,6,5,0,15
191030209,0,9,5,3,7,24
191030210,9,5,9,1,3,27
191030211,7,0,3,0,8,18
191030212,7,0,8,6,1,22
191030213,4,5,2,6,3,20
191030214,1,0,3,6,3,13
191030215,9,0,8,4,7,28
191030216,1,3,7,3,5,19
191030217,3,3,2,0,2,10
191030218,1,9,5,7,3,25
191030219,1,5,3,3,5,17
191030220,0,1,9,1,4,15
191030221,6,8,6,5,0,25
191030222,6,5,8,1,0,20
191030223,5,1,4,8,6,24
191030224,0,6,2,5,0,13
191030225,9,2,2,7,9,29
191030226,8,0,4,1,6,19
191030227,0,6,9,3,2,20
191030228,6,9,1,3,7,26
191030229,1,7,9,8,3,28
191030230,5,2,7,0,3,17
191030231,0,8,5,3,7,23
191030232,8,9,8,9,8,42
191030233,8,9,7,3,7,34
191030234,1,0,6,2,2,11
191030235,9,1,2,4,4,20
191030236,6,6,5,1,3,21
191030237,6,3,0,0,1,10
191030238,0,0,8,9,5,22
191030239,9,4,3,0,0,16
191030240,4,1,3,7,6,21
191030241,5,2,4,3,1,15
191030242,4,5,6,5,5,25
191030243,5,0,1,3,1,10
191030244,2,5,5,3,0,15
191030245,4,4,7,6,8,29
191030246,4,4,9,5,1,23
191030247,3,8,4,8,6,29
191030248,8,7,9,9,1,34
191030249,7,5,3,3,4,22
191030250,7,5,9,1,1,23
191030251,6,0,3,6,1,16
191030252,0,3,7,4,6,20
191030253,4,1,3,7,5,20
191030254,0,9,3,3,3,18
191030255,4,2,6,1,8,21
191030256,6,1,3,3,8,21
191030257,1,2,4,2,7,16
191030258,7,6,8,3,5,29
191030259,8,1,0,9,4,22
191030260,3,4,7,1,0,15
191030261,9,6,5,5,5,30
191030262,1,6,1,4,8,20
191030263,6,1,1,0,9,17
191030264,5,5,9,4,2,25
191030265,3,3,4,8,9,27
191030266,5,6,9,6,4,30
191030267,2,4,1,2,2,11
191030268,5,8,6,8,6,33
191030269,6,5,6,8,9,34
191030270,6,3,5,6,2,22
191030271,1,6,9,9,6,31
191030272,4,9,8,7,6,34
191030273,3,2,7,5,4,21
191030274,4,2,4,2,7,19
191030275,5,5,5,3,9,27
191030276,1,3,8,8,0,20
191030277,6,0,4,0,7,17
191030278,7,5,5,5,6,28
191030279,0,6,8,9,7,30
191030280,4,6,3,9,7,29
191030281,2,0,1,6,8,17
191030282,7,3,7,4,1,22
191030283,3,6,1,5,5,20
191030284,3,4,6,4,3,20
191030285,6,2,8,0,6,22
191030286,2,2,9,3,8,24
191030287,2,2,5,8,1,18
191030288,3,0,9,0,9,21
191030289,0,0,3,1,5,9
191030290,1,7,7,3,4,22
191030291,8,3,8,2,9,30
191030292,2,2,9,9,1,23
191030293,6,6,2,4,5,23
191030294,8,3,2,5,2,20
191030295,7,8,6,6,5,32
191030296,6,1,8,1,0,16
191030297,3,2,2,7,0,14
191030298,6,3,8,1,4,22
191030299,3,5,7,5,4,24
191030300,4,1,3,6,2,16
191030301,4,4,4,5,6,23
191030302,0,0,2,9,2,13
191030303,8,1,8,2,8,27
191030304,4,9,6,5,4,28
191030305,9,4,3,5,5,26
191030306,8,6,1,3,7,25
191030307,7,9,7,5,6,34
191030308,0,3,7,3,0,13
191030309,8,6,5,0,2,21
191030310,9,0,3,3,6,21
191030311,2,3,9,5,1,20
191030312,1,2,9,4,5,21
191030313,5,6,4,8,0,23
191030314,3,2,4,4,6,19
191030315,2,9,8,6,6,31
191030316,6,3,9,9,0,27
191030317,0,0,3,5,5,13
191030318,7,1,6,1,2,17
191030319,5,3,3,3,2,16
191030320,2,2,7,6,1,18
191030321,2,9,4,3,7,25
191030322,7,6,7,6,4,30
191030323,2,7,0,3,3,15
191030324,0,4,3,7,0,14
191030325,1,5,6,1,0,13
191030326,4,8,0,6,7,25
191030327,1,5,7,6,1,20
191030328,6,9,8,6,2,31
191030329,7,7,6,1,0,21
191030330,9,6,2,6,8,31
191030331,3,1,9,5,7,25
191030332,4,3,5,5,5,22
191030333,2,6,4,4,0,16
191030334,8,5,2,2,0,17
191030335,8,1,9,6,9,33
191030336,1,6,2,3,7,19
191030337,9,9,8,0,9,35
191030338,9,5,4,1,4,23
191030339,9,1,4,9,3,26
191030340,0,9,3,8,0,20
191030341,0,4,4,8,3,19
191030342,7,5,1,9,5,27
191030343,0,3,7,2,5,17
191030344,8,7,5,5,4,29
191030345,8,5,1,7,7,28
191030346,6,4,7,1,1,19
191030347,7,0,6,2,8,23
191030348,6,8,3,8,3,28
191030349,9,1,0,1,7,18
191030350,3,2,6,6,6,23
191030351,0,1,6,1,2,10
191030352,1,8,2,4,3,18
191030353,5,2,9,3,0,19
191030354,4,4,4,6,5,23
191030355,5,3,7,5,8,28
191030356,9,0,0,0,6,15
191030357,1,6,0,6,0,13
191030358,1,8,7,3,8,27
191030359,3,4,3,9,9,28
191030360,9,5,8,6,0,28
191030361,5,6,7,8,8,34
191030362,6,9,6,4,0,25
191030363,3,8,3,6,2,22
191030364,1,1,4,9,7,22
191030365,0,3,1,8,0,12
191030366,2,2,8,2,5,19
191030367,5,6,9,2,5,27
191030368,3,5,2,0,9,19
191030369,0,8,2,5,6,21
191030370,7,4,8,5,0,24
191030371,3,2,2,6,9,22
191030372,3,2,1,6,9,21
191030373,1,8,8,4,1,22
191030374,8,2,6,0,7,23
191030375,5,8,8,2,4,27
191030376,2,1,1,1,6,11
191030377,8,4,7,9,0,28
191030378,0,0,4,2,3,9
191030379,1,6,4,4,8,23
191030380,4,3,7,8,9,31
191030381,0,5,3,2,6,16
191030382,9,5,1,8,2,25
191030383,4,0,4,7,2,17
191030384,6,4,5,4,0,19
191030385,6,3,2,8,1,20
191030386,6,7,6,6,2,27
191030387,4,9,5,6,2,26
191030388,9,1,0,3,3,16
191030389,7,2,1,2,6,18
191030390,3,5,2,9,3,22
191030391,0,5,7,6,3,21
191030392,0,1,7,3,9,20
191030393,0,8,2,0,5,15
191030394,7,2,2,1,8,20
191030395,3,5,7,2,3,20
191030396,2,2,4,3,8,19
191030397,6,5,0,5,7,23
191030398,3,7,2,6,6,24
191030399,4,1,1,5,5,16
191030400,3,9,4,8,6,30
191030401,3,7,3,2,4,19
191030402,5,8,3,3,2,21
191030403,1,2,7,7,9,26
191030404,3,3,5,6,7,24
191030405,4,7,0,1,1,13
191030406,9,8,1,7,3,28
191030407,0,7,6,0,2,15
191030408,4,5,0,9,7,25
191030409,5,9,6,2,0,22
191030410,0,4,0,7,8,19
191030411,5,7,7,0,7,26
191030412,6,6,5,1,1,19
191030413,4,6,4,1,1,16
191030414,3,8,4,8,3,26
191030415,7,9,4,0,0,20
191030416,7,7,4,0,3,21
191030417,7,6,1,9,4,27
191030418,0,5,6,9,8,28
191030419,4,5,7,6,5,27
191030420,5,4,7,0,0,16
191030421,7,6,4,0,1,18
191030422,9,8,9,8,6,40
191030423,9,9,0,4,2,24
191030424,8,5,4,9,7,33
191030425,2,6,5,1,5,19
191030426,3,4,2,0,0,9
191030427,9,6,7,5,7,34
191030428,8,5,0,0,4,17
191030429,5,0,9,2,1,17
191030430,1,8,1,7,1,18
191030431,8,9,4,9,8,38
191030432,8,8,1,4,7,28
191030433,8,2,1,8,0,19
191030434,0,4,8,6,4,22
191030435,5,9,6,9,9,38
191030436,1,1,4,8,4,18
191030437,1,5,0,8,6,20
191030438,1,0,7,6,4,18
191030439,9,9,7,3,5,33
191030440,3,3,5,1,9,21
191030441,5,7,8,3,4,27
191030442,4,9,6,2,0,21
191030443,1,0,7,8,1,17
191030444,2,3,6,5,4,20
191030445,9,9,3,7,9,37
191030446,7,4,5,7,9,32
191030447,2,8,5,0,3,18
191030448,5,5,2,0,1,13
191030449,9,3,2,0,3,17
191030450,1,9,8,0,7,25
191030451,9,0,7,1,7,24
191030452,1,0,4,8,1,14
191030453,2,3,4,6,4,19
191030454,4,1,9,6,5,25
191030455,1,4,3,6,5,19
191030456,4,4,0,2,8,18
191030457,6,4,5,3,7,25
191030458,2,2,8,0,3,15
191030459,1,8,9,5,3,26
191030460,5,4,9,1,7,26
191030461,9,6,0,7,4,26
191030462,0,6,1,7,6,20
191030463,1,2,4,0,1,8
191030464,7,8,4,8,0,27
191030465,7,4,4,2,6,23
191030466,2,2,3,7,2,16
191030467,4,7,2,5,6,24
191030468,6,6,6,9,7,34
191030469,3,3,3,0,2,11
191030470,7,5,2,3,3,20
191030471,9,9,4,7,9,38
191030472,1,2,7,4,4,18
191030473,8,0,3,4,1,16
191030474,0,2,0,1,2,5
191030475,6,0,4,2,0,12
191030476,0,5,6,5,3,19
191030477,5,2,3,4,1,15
191030478,2,5,0,1,5,13
191030479,6,6,4,8,1,25
191030480,4,9,9,0,6,28
191030481,3,1,0,0,0,4
191030482,1,9,2,6,4,22
191030483,6,3,1,7,7,24
191030484,1,7,6,4,6,24
191030485,7,9,3,3,4,26
191030486,1,6,7,6,5,25
191030487,1,9,6,9,9,34
191030488,6,5,7,4,1,23
191030489,5,4,9,1,9,28
191030490,8,7,4,5,4,28
191030491,8,7,9,0,5,29
191030492,1,4,6,2,9,22
191030493,2,8,5,5,5,25
191030494,4,9,0,7,6,26
191030495,1,4,0,1,0,6
191030496,0,5,9,8,8,30
191030497,8,0,0,9,8,25
191030498,6,1,9,9,4,29
191030499,0,4,8,9,9,30
191030500,5,0,7,9,0,21
191030501,6,8,8,0,8,30
191030502,9,7,3,9,1,29
191030503,9,8,3,5,8,33
191030504,9,4,6,3,9,31
191030505,5,6,8,6,2,27
191030506,8,7,7,3,4,29
191030507,5,0,7,3,2,17
191030508,9,1,1,4,6,21
191030509,8,7,5,2,7,29
191030510,1,9,3,7,9,29
191030511,5,2,4,8,5,24
191030512,2,2,9,3,5,21
191030513,4,9,5,2,8,28
191030514,0,1,2,7,7,17
191030515,6,5,4,7,0,22
191030516,9,2,0,5,8,24
191030517,4,4,1,3,2,14
191030518,6,0,4,9,6,25
191030519,4,8,0,2,5,19
191030520,8,4,6,2,6,26
191030521,4,9,6,0,2,21
191030522,7,3,6,3,6,25
191030523,5,9,5,3,0,22
191030524,2,6,1,7,5,21
191030525,3,7,7,1,5,23
191030526,3,6,0,0,1,10
191030527,1,1,6,1,8,17
191030528,4,7,9,2,6,28
191030529,6,2,3,5,9,25
191030530,2,8,5,2,4,21
191030531,3,3,3,7,2,18
191030532,4,8,7,6,6,31
191030533,9,6,2,3,9,29
191030534,9,1,4,0,3,17
191030535,3,4,3,7,3,20
191030536,4,1,0,7,4,16
191030537,3,9,9,7,3,31
191030538,5,1,1,4,9,20
191030539,2,1,9,3,2,17
191030540,9,7,4,3,6,29
191030541,7,2,7,2,0,18
191030542,5,5,4,8,9,31
191030543,4,4,0,0,1,9
191030544,1,7,8,6,3,25
191030545,0,7,1,0,6,14
191030546,5,5,2,2,9,23
191030547,6,7,0,5,3,21
191030548,6,3,0,4,4,17
191030549,8,0,4,6,7,25
191030550,0,2,4,1,5,12
191030551,9,3,1,9,9,31
191030552,8,6,6,5,5,30
191030553,2,3,1,3,2,11
191030554,0,5,5,7,3,20
191030555,5,1,7,2,6,21
191030556,2,2,8,2,3,17
191030557,2,9,4,1,5,21
191030558,2,9,4,2,9,26
191030559,5,7,0,4,1,17
191030560,4,9,0,3,1,17
191030561,0,4,2,8,8,22
191030562,6,7,3,7,3,26
191030563,3,6,5,6,3,23
191030564,8,1,9,6,3,27
191030565,3,6,4,2,7,22
191030566,0,2,1,9,3,15
191030567,4,3,9,2,0,18
191030568,8,3,7,2,0,20
191030569,7,6,5,1,4,23
191030570,6,0,0,8,1,15
191030571,9,5,0,2,1,17
191030572,0,0,3,8,1,12
191030573,0,6,0,2,7,15
191030574,3,9,9,3,4,28
191030575,7,8,6,9,6,36
191030576,2,1,2,9,5,19
191030577,7,7,5,0,8,27
191030578,9,3,8,1,2,23
191030579,0,7,7,7,4,25
191030580,9,6,9,4,4,32
191030581,4,3,2,7,5,21
191030582,8,5,7,1,1,22
191030583,4,7,3,0,9,23
191030584,8,1,0,3,6,18
191030585,2,8,5,0,4,19
191030586,0,3,4,8,7,22
191030587,1,7,4,5,0,17
191030588,3,4,1,8,3,19
191030589,1,2,1,3,4,11
191030590,9,6,6,1,2,24
191030591,9,4,3,9,9,34
191030592,2,2,5,4,9,22
191030593,9,0,9,3,4,25
191030594,6,4,7,7,0,24
191030595,9,3,1,5,8,26
191030596,1,5,6,8,1,21
191030597,8,0,6,5,0,19
191030598,4,1,8,4,6,23
191030599,6,3,9,1,9,28
191030600,9,5,3,4,5,26
191030601,9,8,2,1,4,24
191030602,4,0,0,6,3,13
191030603,9,8,2,5,2,26
191030604,9,4,7,7,6,33
191030605,6,0,9,2,1,18
191030606,5,6,5,7,6,29
191030607,8,3,6,0,3,20
191030608,7,1,2,2,2,14
191030609,7,5,0,0,4,16
191030610,2,3,6,0,9,20
191030611,1,8,7,8,7,31
191030612,5,6,2,5,3,21
191030613,5,3,5,5,9,27
191030614,4,5,8,5,3,25
191030615,1,6,0,5,7,19
191030616,7,0,3,9,8,27
191030617,2,9,8,6,7,32
191030618,9,8,7,9,0,33
191030619,8,8,2,3,5,26
191030620,7,1,3,0,6,17
191030621,4,7,7,7,1,26
191030622,9,1,8,0,6,24
191030623,8,6,6,2,6,28
191030624,3,9,1,0,4,17
191030625,7,2,2,9,4,24
191030626,3,9,6,0,9,27
191030627,5,0,8,3,5,21
191030628,9,5,1,3,4,22
191030629,6,7,3,6,0,22
191030630,5,9,6,8,2,30
191030631,8,7,2,7,7,31
191030632,8,9,6,0,9,32
191030633,6,4,2,1,5,18
191030634,8,6,6,9,2,31
191030635,0,1,2,4,4,11
191030636,5,2,0,8,2,17
191030637,3,1,3,5,6,18
191030638,6,1,9,0,8,24
191030639,7,4,3,0,4,18
191030640,4,7,4,8,3,26
191030641,0,6,0,6,1,13
191030642,3,3,5,7,3,21
191030643,0,4,4,8,5,21
191030644,7,4,1,1,6,19
191030645,7,8,2,0,7,24
191030646,4,4,5,9,5,27
191030647,9,0,5,7,7,28
191030648,4,8,4,0,9,25
191030649,1,2,7,5,2,17
191030650,9,2,2,7,7,27
191030651,6,5,7,3,1,22
191030652,3,4,6,6,0,19
191030653,7,9,7,7,8,38
191030654,2,6,2,6,7,23
191030655,6,1,5,2,4,18
191030656,6,0,4,9,5,24
191030657,5,2,8,3,8,26
191030658,1,4,9,2,0,16
191030659,5,1,1,8,2,17
191030660,3,5,5,2,4,19
191030661,0,3,6,8,3,20
191030662,2,5,7,8,4,26
191030663,9,8,8,3,9,37
191030664,3,6,3,1,9,22
191030665,7,6,6,2,9,30
191030666,9,9,6,6,5,35
191030667,9,0,7,0,6,22
191030668,1,1,6,6,4,18
191030669,0,3,7,2,9,21
191030670,1,5,2,2,7,17
191030671,4,1,6,8,0,19
191030672,9,3,2,5,5,24
191030673,3,8,9,2,5,27
191030674,2,0,8,2,3,15
191030675,4,9,6,4,9,32
191030676,8,4,0,7,9,28
191030677,4,8,4,7,7,30
191030678,9,6,1,8,9,33
191030679,2,1,7,8,4,22
191030680,4,1,1,2,0,8
191030681,9,5,3,4,7,28
191030682,1,2,9,6,5,23
191030683,2,4,5,7,1,19
191030684,5,0,1,9,4,19
191030685,7,3,4,2,5,21
191030686,5,0,6,0,9,20
191030687,6,7,7,3,4,27
191030688,6,9,8,1,1,25
191030689,0,1,0,9,1,11
191030690,9,8,1,1,9,28
191030691,6,9,3,7,8,33
191030692,4,5,9,0,1,19
191030693,0,7,4,1,1,13
191030694,0,7,5,6,4,22
191030695,4,2,1,8,6,21
191030696,2,4,8,5,3,22
191030697,5,7,8,6,3,29
191030698,5,6,3,7,5,26
191030699,2,1,0,2,8,13
191030700,8,6,0,4,2,20
191030701,6,4,1,3,0,14
191030702,7,8,4,3,0,22
191030703,2,6,4,1,2,15
191030704,2,9,1,1,3,16
191030705,3,3,7,5,8,26
191030706,1,0,1,1,0,3
191030707,0,1,6,5,9,21
191030708,1,6,7,2,4,20
191030709,3,3,1,9,4,20
191030710,8,1,4,4,0,17
191030711,9,2,0,4,6,21
191030712,3,6,2,4,5,20
191030713,1,6,3,6,5,21
191030714,6,3,5,5,0,19
191030715,4,8,4,6,3,25
191030716,9,3,3,6,2,23
191030717,8,7,0,3,4,22
191030718,9,9,1,1,9,29
191030719,5,8,6,6,6,31
191030720,0,9,1,6,1,17
191030721,6,3,0,6,5,20
191030722,9,8,3,2,8,30
191030723,3,8,1,3,1,16
191030724,2,9,8,3,6,28
191030725,2,4,7,5,6,24
191030726,6,2,8,9,0,25
191030727,4,4,3,9,2,22
191030728,9,5,7,9,6,36
191030729,6,8,5,6,6,31
191030730,2,6,4,8,7,27
191030731,6,1,3,2,1,13
191030732,2,2,4,0,4,12
191030733,4,8,6,9,2,29
191030734,2,1,7,1,9,20
191030735,2,1,1,3,3,10
191030736,2,2,6,5,0,15
191030737,9,3,9,4,7,32
191030738,3,0,2,4,7,16
191030739,2,6,4,4,6,22
191030740,0,5,9,3,7,24
191030741,7,8,4,3,7,29
191030742,4,9,8,0,1,22
191030743,6,1,1,5,5,18
191030744,7,1,5,3,2,18
191030745,1,4,6,0,4,15
191030746,5,3,1,3,0,12
191030747,6,8,6,0,9,29
191030748,8,1,8,5,6,28
191030749,8,3,6,4,8,29
191030750,5,6,0,8,6,25
191030751,4,7,3,7,6,27
191030752,4,3,4,3,8,22
191030753,8,2,8,7,3,28
191030754,2,9,6,8,1,26
191030755,7,3,4,2,7,23
191030756,3,6,0,6,2,17
191030757,1,1,0,4,3,9
191030758,7,3,7,7,3,27
191030759,1,4,7,0,6,18
191030760,5,8,4,7,0,24
191030761,4,1,1,2,8,16
191030762,9,2,7,1,8,27
191030763,5,5,9,3,8,30
191030764,4,5,9,6,5,29
191030765,0,2,6,5,7,20
191030766,6,8,9,7,6,36
191030767,7,5,1,4,1,18
191030768,0,6,9,1,8,24
191030769,5,9,9,4,2,29
191030770,5,7,4,3,6,25
191030771,3,3,2,2,5,15
191030772,4,4,3,2,3,16
191030773,2,5,5,4,7,23
191030774,8,7,4,7,8,34
191030775,4,3,3,7,4,21
191030776,8,3,9,1,9,30
191030777,7,6,0,0,9,22
191030778,6,3,1,6,4,20
191030779,1,3,6,2,3,15
191030780,1,1,8,0,1,11
191030781,1,8,4,8,3,24
191030782,1,1,0,4,8,14
191030783,0,7,7,6,8,28
191030784,5,7,6,1,9,28
191030785,0,7,7,9,1,24
191030786,9,8,2,2,9,30
191030787,2,5,1,3,2,13
191030788,2,7,9,2,3,23
191030789,3,1,4,4,0,12
191030790,1,7,1,8,0,17
191030791,9,3,0,3,9,24
191030792,4,3,5,0,0,12
191030793,8,9,7,6,9,39
191030794,2,4,6,2,1,15
191030795,0,8,3,5,3,19
191030796,4,8,3,7,2,24
191030797,4,6,2,9,5,26
191030798,1,0,9,4,1,15
191030799,8,3,7,0,6,24
191030800,9,8,9,0,6,32
191030801,5,4,1,2,4,16
191030802,9,1,4,8,2,24
191030803,3,4,7,3,5,22
191030804,8,0,0,7,4,19
191030805,0,1,0,0,0,1
191030806,0,8,8,4,7,27
191030807,0,9,2,7,2,20
191030808,5,2,8,8,4,27
191030809,9,3,6,7,3,28
191030810,0,1,9,8,2,20
191030811,0,5,4,3,9,21
191030812,0,9,0,7,2,18
191030813,4,5,5,4,1,19
191030814,7,0,6,8,0,21
191030815,4,0,5,2,0,11
191030816,9,3,0,9,9,30
191030817,6,9,0,8,0,23
191030818,9,2,2,8,1,22
191030819,3,5,2,0,2,12
191030820,4,8,3,1,2,18
191030821,4,7,9,9,4,33
191030822,7,8,5,1,5,26
191030823,2,8,6,6,2,24
191030824,7,6,9,7,0,29
191030825,7,5,3,2,4,21
191030826,4,3,5,5,0,17
191030827,9,5,7,6,7,34
191030828,4,4,1,0,0,9
191030829,8,4,3,9,2,26
191030830,0,2,1,6,1,10
191030831,5,6,0,8,7,26
191030832,2,7,4,9,5,27
191030833,4,7,7,0,3,21
191030834,2,0,6,4,1,13
191030835,1,3,7,4,6,21
191030836,4,9,9,8,1,31
191030837,9,1,0,9,9,28
191030838,6,5,5,5,6,27
191030839,5,5,9,3,3,25
191030840,1,5,4,3,9,22
191030841,8,7,0,1,4,20
191030842,7,5,9,3,1,25
191030843,3,5,3,8,3,22
191030844,8,8,9,5,3,33
191030845,7,8,7,0,3,25
191030846,2,5,5,4,6,22
191030847,3,4,6,6,1,20
191030848,5,0,8,6,2,21
191030849,2,0,5,3,5,15
191030850,6,1,0,4,1,12
191030851,8,8,9,9,3,37
191030852,1,2,4,6,3,16
191030853,6,9,2,1,7,25
191030854,9,4,8,7,3,31
191030855,7,2,0,7,6,22
191030856,9,6,3,1,2,21
191030857,9,3,4,2,0,18
191030858,5,8,8,2,3,26
191030859,0,5,3,0,7,15
191030860,4,6,1,4,6,21
191030861,0,5,0,4,4,13
191030862,4,0,8,0,7,19
191030863,9,3,5,0,0,17
191030864,8,5,4,4,8,29
191030865,7,7,8,0,1,23
191030866,7,3,6,0,3,19
191030867,8,6,6,8,2,30
191030868,5,3,6,0,0,14
191030869,5,9,6,6,9,35
191030870,2,6,2,0,8,18
191030871,6,4,1,9,7,27
191030872,7,0,7,1,9,24
191030873,1,1,3,6,0,11
191030874,0,0,7,2,5,14
191030875,7,4,4,5,9,29
191030876,0,5,5,5,0,15
191030877,3,5,4,8,4,24
191030878,6,1,4,0,8,19
191030879,9,1,6,8,0,24
191030880,2,6,1,0,2,11
191030881,6,7,5,4,3,25
191030882,2,0,8,1,7,18
191030883,5,2,5,4,9,25
191030884,8,9,2,5,7,31
191030885,5,5,8,0,1,19
191030886,3,5,0,6,3,17
191030887,8,4,9,3,2,26
191030888,6,4,6,0,5,21
191030889,5,0,0,3,0,8
191030890,5,6,8,5,1,25
191030891,4,2,3,5,6,20
191030892,0,4,7,3,7,21
191030893,2,2,8,6,1,19
191030894,6,0,6,7,5,24
191030895,9,0,9,4,1,23
191030896,0,9,2,0,6,17
191030897,9,0,1,7,5,22
191030898,7,2,8,2,5,24
191030899,1,7,0,1,2,11
191030900,7,3,5,6,5,26
191030901,2,9,4,0,0,15
191030902,1,5,7,0,9,22
191030903,7,7,0,7,8,29
191030904,0,7,9,3,1,20
191030905,8,0,1,6,9,24
191030906,8,5,6,2,0,21
191030907,3,2,7,5,3,20
191030908,0,8,3,3,8,22
191030909,9,3,4,7,1,24
191030910,6,3,4,3,6,22
191030911,3,8,2,2,6,21
191030912,5,4,9,9,1,28
191030913,7,8,5,4,9,33
191030914,4,2,7,0,2,15
191030915,0,2,8,1,5,16
191030916,5,7,2,7,6,27
191030917,7,4,4,6,6,27
191030918,3,2,8,2,2,17
191030919,7,1,7,4,6,25
191030920,9,2,8,4,6,29
191030921,5,0,0,8,3,16
191030922,5,7,3,4,4,23
191030923,1,1,0,0,4,6
191030924,4,1,3,1,2,11
191030925,5,6,4,6,0,21
191030926,2,1,4,7,4,18
191030927,8,3,4,9,0,24
191030928,1,5,6,2,8,22
191030929,2,3,2,3,6,16
191030930,4,2,1,1,9,17
191030931,1,5,4,5,5,20
191030932,2,9,2,8,1,22
191030933,4,1,1,3,8,17
191030934,3,7,6,5,4,25
191030935,8,4,9,8,3,32
191030936,9,1,7,1,9,27
191030937,9,6,2,3,0,20
191030938,4,8,1,3,9,25
191030939,6,1,8,5,4,24
191030940,6,9,3,9,3,30
191030941,5,8,7,8,5,33
191030942,2,8,4,1,8,23
191030943,4,2,4,9,3,22
191030944,5,2,5,2,1,15
191030945,4,0,6,8,8,26
191030946,6,6,2,3,2,19
191030947,2,7,0,4,0,13
191030948,2,7,7,9,5,30
191030949,3,4,7,2,0,16
191030950,8,6,7,9,6,36
191030951,7,3,0,1,2,13
191030952,7,5,9,2,7,30
191030953,2,9,6,6,9,32
191030954,6,3,8,9,1,27
191030955,8,3,2,0,2,15
191030956,1,8,8,9,5,31
191030957,8,4,5,4,4,25
191030958,5,8,9,0,7,29
191030959,6,1,3,6,8,24
191030960,7,1,7,0,1,16
191030961,6,1,7,6,9,29
191030962,2,9,7,8,2,28
191030963,3,3,1,8,5,20
191030964,5,8,6,7,1,27
191030965,3,0,1,0,0,4
191030966,8,8,2,8,9,35
191030967,4,4,0,2,5,15
191030968,9,3,2,7,2,23
191030969,5,2,6,6,4,23
191030970,9,3,2,6,4,24
191030971,7,3,6,6,1,23
191030972,9,3,9,3,8,32
191030973,5,6,3,1,6,21
191030974,5,0,7,7,8,27
191030975,7,9,6,0,3,25
191030976,6,7,5,7,0,25
191030977,4,5,9,5,5,28
191030978,9,2,9,1,9,30
191030979,9,9,0,3,3,24
191030980,7,5,6,4,0,22
191030981,8,9,2,4,7,30
191030982,4,4,2,6,4,20
191030983,0,2,4,4,0,10
191030984,0,8,5,4,6,23
191030985,2,0,8,7,6,23
191030986,3,7,8,6,7,31
191030987,5,8,2,0,9,24
191030988,7,3,2,7,3,22
191030989,1,6,0,2,4,13
191030990,1,6,8,9,4,28
191030991,5,5,4,7,4,25
191030992,2,0,0,5,0,7
191030993,0,9,7,9,1,26
191030994,8,5,8,5,6,32
191030995,6,7,9,4,7,33
191030996,1,8,0,1,6,16
191030997,5,5,6,2,9,27
191030998,5,3,1,3,8,20
191030999,3,5,8,6,9,31
1910301000,5,3,8,7,8,31
1910301001,2,9,3,6,0,20
1910301002,8,4,2,6,8,28
1910301003,1,8,1,0,8,18
1910301004,6,5,5,1,4,21
1910301005,7,6,5,1,9,28
1910301006,7,8,4,4,9,32
1910301007,8,8,5,9,0,30
1910301008,2,0,9,6,4,21
1910301009,1,0,1,0,5,7
1910301010,3,6,7,5,4,25
1910301011,5,9,9,7,4,34
1910301012,4,5,5,5,8,27
1910301013,5,1,2,1,0,9
1910301014,8,5,1,2,3,19
1910301015,2,8,8,7,3,28
1910301016,1,7,1,3,1,13
1910301017,8,8,3,4,5,28
1910301018,3,0,4,2,4,13
1910301019,0,6,0,2,9,17
1910301020,7,2,7,4,6,26
1910301021,4,5,0,9,9,27
1910301022,1,2,6,3,7,19
1910301023,9,4,7,5,0,25
1910301024,7,3,3,2,1,16
1910301025,9,7,3,7,6,32
1910301026,3,3,9,3,6,24
1910301027,0,2,0,4,3,9
1910301028,1,7,5,3,1,17
1910301029,5,8,4,1,3,21
1910301030,8,2,7,3,9,29
1910301031,4,5,5,6,6,26
1910301032,4,1,7,0,2,14
1910301033,9,9,0,6,3,27
1910301034,5,2,9,9,8,33
1910301035,9,4,7,8,2,30
1910301036,3,7,1,0,6,17
1910301037,0,8,7,0,2,17
1910301038,9,9,1,0,8,27
1910301039,0,7,7,6,3,23
1910301040,0,7,7,1,6,21
1910301041,0,9,3,2,6,20
1910301042,7,9,7,6,4,33
1910301043,7,7,6,4,4,28
1910301044,6,0,0,5,2,13
1910301045,9,0,0,1,6,16
1910301046,6,1,2,4,9,22
1910301047,0,3,7,6,6,22
1910301048,5,9,1,8,2,25
1910301049,4,9,1,6,7,27
1910301050,9,7,2,4,2,24
1910301051,8,6,3,3,9,29
1910301052,6,6,8,4,8,32
1910301053,7,7,6,1,2,23
1910301054,8,4,4,5,6,27
1910301055,6,6,0,6,1,19
1910301056,9,3,2,9,4,27
1910301057,6,4,5,8,3,26
1910301058,5,5,9,9,3,31
1910301059,0,0,3,3,5,11
1910301060,6,9,4,0,2,21
1910301061,3,3,3,5,2,16
1910301062,5,0,0,8,4,17
1910301063,5,0,6,2,2,15
1910301064,8,8,3,8,3,30
1910301065,9,9,2,3,8,31
1910301066,3,9,1,5,0,18
1910301067,2,8,0,3,1,14
1910301068,2,0,2,6,3,13
1910301069,7,8,1,3,0,19
1910301070,9,4,4,6,7,30
1910301071,1,2,9,4,2,18
1910301072,8,8,7,5,1,29
1910301073,1,0,1,5,1,8
1910301074,9,0,3,7,6,25
1910301075,2,5,4,2,0,13
1910301076,5,8,8,8,2,31
1910301077,4,9,6,0,0,19
1910301078,1,9,3,3,6,22
1910301079,6,7,9,4,0,26
1910301080,4,4,0,3,5,16
1910301081,4,4,1,6,4,19
1910301082,7,4,5,0,0,16
1910301083,2,1,3,6,7,19
1910301084,0,6,7,0,3,16
1910301085,0,0,7,0,8,15
1910301086,9,9,9,1,4,32
1910301087,9,3,5,0,8,25
1910301088,2,3,0,0,9,14
1910301089,3,4,2,6,1,16
1910301090,1,1,7,0,9,18
1910301091,9,6,6,7,5,33
1910301092,6,8,3,1,2,20
1910301093,2,6,4,6,9,27
1910301094,9,1,8,8,1,27
1910301095,0,0,9,0,6,15
1910301096,3,3,7,4,8,25
1910301097,1,0,2,0,1,4
1910301098,8,1,1,6,9,25
1910301099,3,4,6,5,8,26
1910301100,8,5,5,5,8,31
1910301101,9,6,1,1,9,26
1910301102,4,6,1,8,6,25
1910301103,7,5,2,4,5,23
1910301104,0,7,2,6,0,15
1910301105,7,1,7,6,4,25
191031001,8,8,3,3,5,27
191031002,6,3,5,6,1,21
191031003,7,0,4,4,0,15
191031004,5,3,4,2,8,22
191031005,4,8,0,6,4,22
191031006,2,9,8,1,9,29
191031007,0,2,6,2,4,14
191031008,5,6,5,7,0,23
191031009,5,2,1,2,1,11
191031010,7,9,1,5,5,27
191031011,6,8,8,3,9,34
191031012,0,4,7,8,3,22
191031013,7,4,2,1,5,19
191031014,3,5,6,9,5,28
191031015,4,1,2,7,1,15
191031016,1,2,8,4,4,19
191031017,3,4,5,7,0,19
191031018,5,6,5,6,2,24
191031019,2,9,7,4,3,25
191031020,9,0,0,2,3,14
191031021,4,8,8,9,9,38
191031022,1,1,4,1,0,7
191031023,7,3,2,1,1,14
191031024,0,4,2,0,0,6
191031025,5,5,9,6,2,27
191031026,0,2,9,5,8,24
191031027,0,7,5,0,2,14
191031028,8,0,0,9,2,19
191031029,5,8,9,9,8,39
191031030,7,6,3,9,8,33
191031031,6,3,3,4,1,17
191031032,7,1,5,9,6,28
191031033,4,2,3,5,7,21
191031034,6,3,4,2,6,21
191031035,5,3,0,0,6,14
191031036,5,2,3,3,2,15
191031037,6,5,8,9,9,37
191031038,3,2,9,8,9,31
191031039,9,1,9,4,0,23
191031040,6,5,0,3,4,18
191031041,5,8,6,5,5,29
191031042,4,1,8,7,9,29
191031043,3,4,8,2,5,22
191031044,4,9,3,1,2,19
191031045,3,7,5,4,2,21
191031046,1,6,0,5,8,20
191031047,1,4,7,9,6,27
191031048,8,4,2,5,3,22
191031049,0,2,7,7,3,19
191031050,5,2,8,0,8,23
191031051,9,7,8,6,1,31
191031052,4,0,6,7,6,23
191031053,6,5,7,6,6,30
191031054,2,9,7,5,6,29
191031055,7,1,9,0,5,22
191031056,1,0,0,6,9,16
191031057,3,0,4,9,6,22
191031058,1,7,7,1,0,16
191031059,5,7,2,0,5,19
191031060,9,1,0,1,1,12
191031061,5,1,1,1,6,14
191031062,7,3,8,7,1,26
191031063,9,1,0,7,9,26
191031064,4,9,3,3,3,22
191031065,0,0,9,9,9,27
191031066,6,0,5,7,5,23
191031067,7,2,8,6,4,27
191031068,0,8,2,3,2,15
191031069,2,3,7,9,6,27
191031070,9,9,8,4,6,36
191031071,2,9,7,0,0,18
191031072,4,5,6,8,4,27
191031073,2,3,4,5,5,19
191031074,3,0,3,2,3,11
191031075,2,5,1,1,8,17
191031076,0,1,6,3,7,17
191031077,6,3,5,7,5,26
191031078,7,6,7,7,2,29
191031079,3,5,7,4,3,22
191031080,9,3,4,4,5,25
191031081,4,6,8,9,7,34
191031082,6,6,0,0,3,15
191031083,7,4,3,3,0,17
191031084,4,3,0,5,8,20
191031085,3,5,5,6,0,19
191031086,7,0,6,1,9,23
191031087,7,0,1,4,7,19
191031088,7,8,3,5,2,25
191031089,7,6,6,1,7,27
191031090,9,6,9,0,3,27
191031091,4,5,9,4,7,29
191031092,9,0,1,7,8,25
191031093,7,5,7,1,8,28
191031094,6,2,8,3,9,28
191031095,9,5,8,5,9,36
191031096,9,1,0,5,1,16
191031097,9,4,7,7,0,27
191031098,0,0,9,1,5,15
191031099,2,3,6,0,4,15
191031100,4,2,1,1,4,12
191031101,2,4,0,6,1,13
191031102,7,6,6,5,9,33
191031103,1,0,0,4,5,10
191031104,2,7,9,7,8,33
191031105,2,6,5,0,4,17
191031106,4,9,5,1,4,23
191031107,9,2,4,1,5,21
191031108,9,8,1,8,7,33
191031109,9,5,3,7,8,32
191031110,8,8,8,7,5,36
191031111,6,7,0,3,6,22
191031112,9,3,8,7,6,33
191031113,5,9,9,0,8,31
191031114,0,5,9,2,6,22
191031115,0,0,0,3,3,6
191031116,7,6,9,4,9,35
191031117,7,8,0,7,6,28
191031118,5,5,6,2,6,24
191031119,0,6,9,9,9,33
191031120,8,9,8,1,5,31
191031121,7,5,1,8,0,21
191031122,6,6,7,5,8,32
191031123,5,1,8,8,8,30
191031124,7,7,0,6,2,22
191031125,3,6,9,6,8,32
191031126,4,7,5,4,9,29
191031127,2,3,2,8,5,20
191031128,6,9,3,6,7,31
191031129,6,1,6,1,4,18
191031130,4,8,8,3,4,27
191031131,0,0,0,0,6,6
191031132,3,0,9,1,0,13
191031133,6,6,3,3,1,19
191031134,4,4,9,3,7,27
191031135,4,3,2,2,9,20
191031136,3,4,7,4,3,21
191031137,0,5,9,9,6,29
191031138,6,7,1,2,2,18
191031139,5,1,8,0,5,19
191031140,6,7,4,4,5,26
191031141,4,6,9,3,1,23
191031142,1,8,4,1,3,17
191031143,7,6,3,4,6,26
191031144,2,2,7,7,2,20
191031145,7,0,2,1,8,18
191031146,3,5,2,1,2,13
191031147,5,1,2,0,2,10
191031148,5,9,3,5,7,29
191031149,1,6,7,8,0,22
191031150,9,6,7,5,9,36
191031151,9,9,8,6,1,33
191031152,9,9,7,3,1,29
191031153,2,7,8,8,8,33
191031154,3,3,3,7,0,16
191031155,6,1,1,4,3,15
191031156,8,1,9,9,1,28
191031157,2,6,9,0,9,26
191031158,9,8,7,6,0,30
191031159,1,7,4,2,3,17
191031160,4,6,1,5,7,23
191031161,3,8,0,9,4,24
191031162,5,7,9,1,3,25
191031163,4,1,2,7,3,17
191031164,9,7,4,3,5,28
191031165,4,0,1,9,4,18
191031166,1,7,0,5,5,18
191031167,4,7,7,6,6,30
191031168,5,9,7,7,0,28
191031169,7,4,9,4,6,30
191031170,8,2,9,0,2,21
191031171,0,1,0,5,2,8
191031172,7,3,6,8,4,28
191031173,0,1,0,3,5,9
191031174,3,9,1,2,2,17
191031175,3,8,6,8,2,27
191031176,6,3,5,4,9,27
191031177,0,8,3,8,0,19
191031178,1,2,5,1,8,17
191031179,3,5,4,6,0,18
191031180,7,6,7,7,7,34
191031181,6,8,5,4,6,29
191031182,2,5,1,4,1,13
191031183,5,2,4,6,1,18
191031184,1,4,8,5,2,20
191031185,2,6,0,5,5,18
191031186,4,1,0,1,2,8
191031187,5,4,2,4,2,17
191031188,7,5,0,1,4,17
191031189,5,2,1,4,8,20
191031190,8,5,7,2,0,22
191031191,4,4,6,8,8,30
191031192,1,7,2,6,8,24
191031193,1,4,0,0,9,14
191031194,5,7,5,2,8,27
191031195,1,5,5,7,8,26
191031196,1,8,7,0,6,22
191031197,9,1,7,3,6,26
191031198,0,6,3,8,6,23
191031199,6,3,2,4,8,23
191031200,8,9,2,4,0,23
191031201,3,8,9,3,5,28
191031202,3,1,2,8,0,14
191031203,2,8,3,9,8,30
191031204,9,8,5,2,6,30
191031205,4,8,1,5,4,22
191031206,5,3,1,9,1,19
191031207,3,9,0,0,9,21
191031208,1,1,4,2,3,11
191031209,1,5,1,1,3,11
191031210,9,1,0,6,0,16
191031211,3,8,6,5,3,25
191031212,0,2,5,1,6,14
191031213,5,8,9,0,6,28
191031214,4,9,6,5,7,31
191031215,3,8,4,3,3,21
191031216,2,9,7,0,3,21
191031217,9,1,3,9,6,28
191031218,2,6,0,1,1,10
191031219,9,4,6,1,5,25
191031220,8,1,4,5,8,26
191031221,9,2,0,0,6,17
191031222,8,4,0,2,6,20
191031223,7,5,7,8,0,27
191031224,6,3,8,1,5,23
191031225,2,5,2,2,8,19
191031226,1,4,7,6,6,24
191031227,7,9,4,7,0,27
191031228,2,6,5,5,7,25
191031229,4,6,3,4,6,23
191031230,0,0,9,5,7,21
191031231,4,6,1,0,5,16
191031232,8,7,6,1,7,29
191031233,7,0,2,3,4,16
191031234,5,2,5,6,8,26
191031235,2,5,7,8,2,24
191031236,9,0,0,7,3,19
191031237,2,3,7,6,6,24
191031238,8,3,3,6,5,25
191031239,5,4,2,1,9,21
191031240,3,8,5,9,7,32
191031241,6,1,0,0,9,16
191031242,3,0,2,9,3,17
191031243,3,6,0,8,2,19
191031244,8,5,6,4,1,24
191031245,0,5,8,1,1,15
191031246,9,7,7,2,2,27
191031247,3,5,6,8,5,27
191031248,5,5,5,6,6,27
191031249,2,7,8,5,0,22
191031250,9,6,1,1,1,18
191031251,5,5,1,6,5,22
191031252,4,7,7,1,6,25
191031253,0,9,4,1,5,19
191031254,5,5,3,0,0,13
191031255,6,8,0,9,3,26
191031256,9,7,6,7,6,35
191031257,6,9,6,3,1,25
191031258,6,0,0,1,2,9
191031259,1,3,9,1,7,21
191031260,5,2,9,9,7,32
191031261,7,2,7,8,8,32
191031262,4,3,1,1,2,11
191031263,3,6,7,4,7,27
191031264,7,5,6,5,2,25
191031265,3,1,1,8,2,15
191031266,8,3,7,4,8,30
191031267,0,2,9,9,5,25
191031268,7,7,2,4,4,24
191031269,6,3,6,4,0,19
191031270,9,9,9,6,7,40
191031271,2,0,3,6,0,11
191031272,7,7,5,0,3,22
191031273,4,3,5,1,8,21
191031274,0,4,7,8,7,26
191031275,5,2,7,5,1,20
191031276,1,4,3,2,3,13
191031277,9,2,9,4,1,25
191031278,5,7,8,0,2,22
191031279,7,3,1,9,8,28
191031280,9,7,8,6,8,38
191031281,8,3,5,3,3,22
191031282,1,2,8,7,1,19
191031283,2,7,8,5,9,31
191031284,7,7,1,5,3,23
191031285,0,5,9,3,2,19
191031286,5,0,2,0,2,9
191031287,3,8,7,8,7,33
191031288,5,7,5,5,7,29
191031289,8,3,2,7,7,27
191031290,2,2,0,7,1,12
191031291,9,2,7,6,4,28
191031292,0,0,3,4,4,11
191031293,2,2,1,5,9,19
191031294,3,6,7,1,1,18
191031295,8,7,7,0,2,24
191031296,7,0,0,7,9,23
191031297,4,3,5,1,9,22
191031298,3,9,0,8,6,26
191031299,7,1,4,2,7,21
191031300,4,0,3,5,3,15
191031301,2,4,9,7,8,30
191031302,7,5,5,6,6,29
191031303,2,0,1,6,2,11
191031304,0,9,7,2,1,19
191031305,6,9,0,3,5,23
191031306,1,1,4,6,2,14
191031307,7,1,3,1,6,18
191031308,0,9,8,5,5,27
191031309,6,7,9,9,6,37
191031310,9,3,5,5,0,22
191031311,4,5,1,1,1,12
191031312,7,7,8,9,9,40
191031313,0,3,3,6,7,19
191031314,1,4,8,4,2,19
191031315,2,4,0,9,9,24
191031316,1,4,1,7,6,19
191031317,8,0,5,3,7,23
191031318,1,0,8,9,7,25
191031319,4,4,6,2,0,16
191031320,8,0,3,5,3,19
191031321,4,8,4,5,7,28
191031322,7,5,9,1,7,29
191031323,1,5,7,4,0,17
191031324,7,8,5,3,0,23
191031325,1,2,4,1,2,10
191031326,2,7,7,3,9,28
191031327,5,1,9,2,5,22
191031328,7,0,8,9,9,33
191031329,2,7,1,2,8,20
191031330,6,4,8,8,3,29
191031331,7,9,2,2,7,27
191031332,2,6,2,3,6,19
191031333,3,3,6,6,7,25
191031334,7,0,9,3,0,19
191031335,3,0,6,2,8,19
191031336,0,5,2,7,8,22
191031337,8,9,8,7,3,35
191031338,2,4,1,2,5,14
191031339,0,9,4,7,8,28
191031340,6,6,7,2,4,25
191031341,6,5,3,8,1,23
191031342,3,1,6,4,5,19
191031343,8,1,2,3,2,16
191031344,7,5,1,5,9,27
191031345,9,2,5,2,1,19
191031346,5,1,1,9,7,23
191031347,9,4,7,8,3,31
191031348,9,7,3,3,6,28
191031349,2,1,9,9,1,22
191031350,6,6,1,1,2,16
191031351,9,8,0,9,9,35
191031352,3,3,4,2,0,12
191031353,2,6,6,4,3,21
191031354,0,9,0,1,8,18
191031355,2,9,5,2,7,25
191031356,0,8,5,2,0,15
191031357,7,6,1,5,0,19
191031358,8,1,8,3,5,25
191031359,0,0,0,7,2,9
191031360,2,5,4,9,5,25
191031361,1,4,2,0,0,7
191031362,4,5,1,3,0,13
191031363,2,1,9,8,3,23
191031364,5,8,8,5,6,32
191031365,7,8,2,8,5,30
191031366,2,1,5,5,4,17
191031367,9,4,2,6,1,22
191031368,8,8,6,6,9,37
191031369,8,2,0,0,6,16
191031370,4,3,8,2,9,26
191031371,4,1,6,6,8,25
191031372,1,8,4,3,1,17
191031373,9,2,7,8,5,31
191031374,2,5,0,0,5,12
191031375,7,2,0,1,4,14
191031376,9,1,5,8,2,25
191031377,6,9,3,4,8,30
191031378,4,8,5,2,3,22
191031379,2,7,3,6,2,20
191031380,0,8,1,7,1,17
191031381,5,0,9,9,3,26
191031382,0,0,9,8,5,22
191031383,8,0,8,8,9,33
191031384,2,1,2,3,9,17
191031385,4,2,1,7,7,21
191031386,3,2,8,6,9,28
191031387,5,4,5,8,6,28
191031388,5,7,9,8,4,33
191031389,1,0,8,8,0,17
191031390,6,0,6,4,4,20
191031391,1,7,1,2,5,16
191031392,8,1,4,7,6,26
191031393,5,5,7,0,3,20
191031394,2,0,9,0,9,20
191031395,9,5,1,1,5,21
191031396,5,5,1,2,2,15
191031397,8,7,6,4,6,31
191031398,3,8,1,5,1,18
191031399,1,2,0,9,6,18
191031400,0,2,2,2,4,10
191031401,6,7,2,7,0,22
191031402,7,0,1,3,4,15
191031403,4,0,4,1,8,17
191031404,9,1,3,2,6,21
191031405,8,0,4,3,6,21
191031406,0,1,6,4,9,20
191031407,5,1,0,3,5,14
191031408,1,0,9,2,8,20
191031409,5,8,4,5,8,30
191031410,9,0,3,4,8,24
191031411,0,0,4,0,0,4
191031412,3,5,6,4,8,26
191031413,6,9,7,2,2,26
191031414,0,9,1,0,0,10
191031415,1,0,0,2,3,6
191031416,0,2,2,5,7,16
191031417,7,2,4,8,9,30
191031418,4,5,6,0,9,24
191031419,8,7,7,8,7,37
191031420,9,3,9,3,1,25
191031421,0,0,9,0,4,13
191031422,3,4,1,3,3,14
191031423,4,1,7,1,0,13
191031424,5,3,3,5,0,16
191031425,2,1,0,1,3,7
191031426,1,5,9,2,6,23
191031427,1,6,5,2,8,22
191031428,1,6,2,9,7,25
191031429,3,8,9,1,3,24
191031430,0,3,8,8,0,19
191031431,8,0,5,7,2,22
191031432,4,2,7,3,1,17
191031433,8,4,1,8,7,28
191031434,8,2,4,0,4,18
191031435,3,9,4,6,1,23
191031436,5,2,8,1,2,18
191031437,8,1,0,2,2,13
191031438,4,7,3,9,8,31
191031439,5,2,0,7,2,16
191031440,4,1,0,8,2,15
191031441,0,1,5,5,8,19
191031442,5,8,3,6,1,23
191031443,9,5,7,3,9,33
191031444,0,9,7,7,3,26
191031445,7,7,8,9,3,34
191031446,2,6,2,7,8,25
191031447,3,1,0,4,7,15
191031448,0,9,7,8,9,33
191031449,2,0,5,2,3,12
191031450,2,1,5,2,0,10
191031451,2,4,5,7,8,26
191031452,1,3,4,2,6,16
191031453,7,3,4,9,6,29
191031454,8,3,5,4,9,29
191031455,0,4,5,0,7,16
191031456,9,3,6,9,4,31
191031457,0,6,9,2,8,25
191031458,9,9,1,3,0,22
191031459,4,4,0,0,0,8
191031460,4,9,7,4,1,25
191031461,9,9,3,3,0,24
191031462,8,2,9,6,9,34
191031463,3,5,5,0,9,22
191031464,9,3,9,8,2,31
191031465,6,6,9,8,3,32
191031466,5,2,7,8,1,23
191031467,2,3,5,3,3,16
191031468,2,3,9,9,3,26
191031469,1,7,3,2,9,22
191031470,9,6,4,5,9,33
191031471,0,9,0,5,9,23
191031472,1,1,4,7,7,20
191031473,6,6,0,1,5,18
191031474,5,1,0,9,8,23
191031475,5,7,0,3,9,24
191031476,2,4,9,3,8,26
191031477,7,6,3,0,0,16
191031478,4,1,8,0,5,18
191031479,3,4,1,2,4,14
191031480,3,2,9,1,4,19
191031481,5,1,7,6,0,19
191031482,6,8,3,2,2,21
191031483,9,7,6,4,7,33
191031484,3,6,2,0,4,15
191031485,8,0,1,0,6,15
191031486,7,8,2,8,2,27
191031487,9,0,4,2,3,18
191031488,0,0,1,6,8,15
191031489,0,9,2,7,3,21
191031490,4,4,3,6,6,23
191031491,7,2,9,3,0,21
191031492,2,3,6,8,1,20
191031493,7,3,6,3,0,19
191031494,9,7,6,2,0,24
191031495,0,0,9,3,2,14
191031496,9,8,0,6,2,25
191031497,7,3,8,2,8,28
191031498,2,2,9,6,4,23
191031499,2,2,9,9,4,26
191031500,3,1,8,3,6,21
191031501,3,2,1,4,8,18
191031502,4,5,1,2,3,15
191031503,7,3,7,9,5,31
191031504,6,6,6,2,6,26
191031505,2,6,0,3,9,20
191031506,2,7,5,3,4,21
191031507,4,5,7,9,3,28
191031508,7,4,7,7,6,31
191031509,2,8,5,1,2,18
191031510,7,0,8,1,0,16
191031511,3,3,3,2,3,14
191031512,4,8,8,4,6,30
191031513,8,0,7,2,4,21
191031514,9,9,0,2,8,28
191031515,9,0,5,4,2,20
191031516,7,4,0,5,0,16
191031517,2,5,9,4,7,27
191031518,3,8,9,5,4,29
191031519,8,6,9,2,0,25
191031520,0,3,2,5,2,12
191031521,7,0,7,9,6,29
191031522,4,3,1,4,5,17
191031523,5,7,3,8,6,29
191031524,4,8,1,6,1,20
191031525,8,9,1,5,0,23
191031526,8,1,9,8,3,29
191031527,7,9,5,7,9,37
191031528,0,8,5,4,1,18
191031529,3,7,0,2,0,12
191031530,7,1,6,1,8,23
191031531,4,9,1,7,7,28
191031532,6,2,4,3,9,24
191031533,1,5,9,0,8,23
191031534,9,2,1,9,0,21
191031535,9,9,1,2,3,24
191031536,0,9,5,1,0,15
191031537,4,0,5,1,2,12
191031538,7,8,4,9,1,29
191031539,2,2,8,2,8,22
191031540,7,8,0,3,9,27
191031541,0,4,3,8,4,19
191031542,0,8,0,3,1,12
191031543,3,3,9,8,5,28
191031544,9,4,7,1,8,29
191031545,3,1,6,8,9,27
191031546,8,3,4,4,9,28
191031547,0,3,2,6,1,12
191031548,2,4,2,0,5,13
191031549,4,7,3,9,1,24
191031550,0,4,4,1,8,17
191031551,0,3,6,2,3,14
191031552,7,6,3,6,0,22
191031553,6,0,0,4,8,18
191031554,4,5,0,8,5,22
191031555,3,6,2,6,7,24
191031556,8,8,2,4,3,25
191031557,8,8,7,0,9,32
191031558,8,1,7,1,2,19
191031559,4,0,6,5,6,21
191031560,8,8,0,4,4,24
191031561,4,7,3,2,3,19
191031562,3,8,5,0,6,22
191031563,7,2,2,2,5,18
191031564,8,8,4,2,6,28
191031565,9,8,7,3,2,29
191031566,5,4,5,1,9,24
191031567,9,5,3,0,2,19
191031568,7,9,2,1,4,23
191031569,6,4,0,0,2,12
191031570,0,3,1,4,5,13
191031571,5,3,4,4,0,16
191031572,5,2,4,9,0,20
191031573,5,5,8,1,6,25
191031574,5,3,6,6,2,22
191031575,1,2,2,5,5,15
191031576,4,0,2,8,5,19
191031577,9,3,7,6,8,33
191031578,1,0,3,7,4,15
191031579,8,0,1,6,7,22
191031580,5,3,1,8,3,20
191031581,2,0,6,4,2,14
191031582,0,7,1,5,9,22
191031583,7,3,0,1,1,12
191031584,0,7,9,5,1,22
191031585,3,3,0,9,8,23
191031586,1,2,9,7,3,22
191031587,5,0,6,5,1,17
191031588,4,5,0,1,2,12
191031589,7,0,1,9,7,24
191031590,5,2,4,6,3,20
191031591,6,5,8,6,7,32
191031592,8,7,8,5,6,34
191031593,9,3,9,2,9,32
191031594,5,8,1,6,0,20
191031595,6,2,2,4,2,16
191031596,2,2,3,5,2,14
191031597,9,2,1,6,1,19
191031598,4,2,8,6,5,25
191031599,8,0,6,0,3,17
191031600,5,9,9,2,5,30
191031601,9,0,3,8,1,21
191031602,1,7,5,3,9,25
191031603,5,0,2,0,7,14
191031604,5,8,1,8,0,22
191031605,2,6,9,5,8,30
191031606,6,4,8,1,1,20
191031607,2,6,3,5,6,22
191031608,5,4,7,1,2,19
191031609,0,8,3,4,6,21
191031610,4,0,2,6,2,14
191031611,3,5,8,2,7,25
191031612,6,6,1,8,6,27
191031613,4,3,4,9,5,25
191031614,8,3,2,6,4,23
191031615,3,0,6,8,7,24
191031616,9,3,1,9,8,30
191031617,4,6,2,1,1,14
191031618,8,5,4,0,1,18
191031619,0,8,9,7,5,29
191031620,4,4,1,8,5,22
191031621,4,5,4,7,4,24
191031622,8,5,3,7,4,27
191031623,3,4,0,5,0,12
191031624,8,7,1,1,9,26
191031625,2,4,9,5,7,27
191031626,2,3,8,6,0,19
191031627,3,4,2,8,6,23
191031628,0,2,6,1,3,12
191031629,6,1,9,8,6,30
191031630,7,8,8,9,8,40
191031631,4,3,1,6,3,17
191031632,7,5,2,4,2,20
191031633,4,3,0,5,1,13
191031634,5,5,5,2,7,24
191031635,1,7,2,7,8,25
191031636,3,4,2,8,5,22
191031637,3,4,3,4,3,17
191031638,8,5,1,5,7,26
191031639,8,3,9,4,4,28
191031640,0,8,8,8,1,25
191031641,9,0,3,3,7,22
191031642,0,6,1,3,1,11
191031643,4,2,1,7,6,20
191031644,2,6,8,4,3,23
191031645,9,5,3,3,7,27
191031646,0,1,5,3,7,16
191031647,1,7,3,9,5,25
191031648,9,7,9,8,1,34
191031649,0,5,1,0,2,8
191031650,0,5,0,3,8,16
191031651,9,3,2,1,6,21
191031652,5,5,6,5,6,27
191031653,0,4,3,0,9,16
191031654,8,7,8,3,7,33
191031655,3,2,7,7,1,20
191031656,5,1,2,3,0,11
191031657,9,3,3,1,9,25
191031658,7,2,4,8,0,21
191031659,2,6,0,6,7,21
191031660,7,2,3,2,4,18
191031661,1,0,1,5,9,16
191031662,1,2,4,3,7,17
191031663,0,5,6,0,0,11
191031664,9,8,1,6,9,33
191031665,9,8,6,7,3,33
191031666,1,4,9,3,5,22
191031667,6,0,5,5,5,21
191031668,8,2,9,1,9,29
191031669,3,0,2,0,3,8
191031670,2,0,6,1,2,11
191031671,7,1,0,3,6,17
191031672,9,5,6,0,7,27
191031673,5,8,8,5,4,30
191031674,9,7,6,6,3,31
191031675,9,8,1,3,1,22
191031676,2,7,5,9,4,27
191031677,2,6,3,6,0,17
191031678,8,5,1,3,4,21
191031679,9,5,2,3,4,23
191031680,9,1,9,0,7,26
191031681,2,9,9,7,4,31
191031682,5,1,1,8,6,21
191031683,2,9,6,5,2,24
191031684,6,1,3,3,3,16
191031685,9,3,0,8,4,24
191031686,4,6,7,3,4,24
191031687,6,4,1,5,5,21
191031688,7,0,9,9,6,31
191031689,3,5,6,5,7,26
191031690,3,6,0,0,0,9
191031691,7,5,0,5,9,26
191031692,9,5,6,3,0,23
191031693,5,8,3,9,4,29
191031694,8,4,5,5,0,22
191031695,3,7,7,6,1,24
191031696,0,9,3,5,6,23
191031697,3,1,1,8,0,13
191031698,8,4,2,6,2,22
191031699,6,5,1,2,1,15
191031700,6,3,6,0,1,16
191031701,0,3,6,3,8,20
191031702,4,4,9,8,0,25
191031703,1,6,2,0,3,12
191031704,5,8,6,8,7,34
191031705,4,1,1,3,6,15
191031706,0,0,3,0,1,4
191031707,5,0,0,7,7,19
191031708,2,4,9,3,9,27
191031709,0,2,6,9,4,21
191031710,4,5,9,6,1,25
191031711,4,3,8,9,3,27
191031712,4,7,1,9,2,23
191031713,7,5,5,2,5,24
191031714,3,4,8,8,4,27
191031715,8,0,7,4,3,22
191031716,0,0,1,6,6,13
191031717,3,8,2,1,1,15
191031718,7,6,3,4,9,29
191031719,3,4,7,7,0,21
191031720,0,6,8,8,7,29
191031721,6,8,4,1,8,27
191031722,6,0,2,7,3,18
191031723,9,4,7,3,5,28
191031724,7,6,2,7,0,22
191031725,1,9,5,7,9,31
191031726,8,7,7,4,7,33
191031727,5,7,4,5,8,29
191031728,0,6,2,0,2,10
191031729,0,0,0,9,9,18
191031730,3,3,0,0,8,14
191031731,7,9,5,7,2,30
191031732,7,1,0,3,4,15
191031733,9,6,0,8,4,27
191031734,5,5,5,1,4,20
191031735,7,7,7,1,1,23
191031736,3,4,0,6,2,15
191031737,3,9,4,9,1,26
191031738,3,7,5,7,9,31
191031739,0,3,6,1,1,11
191031740,4,0,3,3,5,15
191031741,6,5,3,4,2,20
191031742,5,9,0,0,4,18
191031743,2,7,0,3,6,18
191031744,6,4,5,5,2,22
191031745,9,2,7,7,5,30
191031746,4,2,9,0,7,22
191031747,0,5,2,9,8,24
191031748,6,0,3,7,6,22
191031749,9,9,6,4,9,37
191031750,5,1,6,5,5,22
191031751,2,7,1,6,3,19
191031752,9,1,5,1,0,16
191031753,7,3,3,5,1,19
191031754,1,3,9,5,1,19
191031755,5,4,4,9,6,28
191031756,9,6,7,1,6,29
191031757,7,2,2,1,1,13
191031758,1,5,6,0,5,17
191031759,3,0,0,5,5,13
191031760,2,6,5,1,8,22
191031761,3,3,2,5,4,17
191031762,1,8,1,6,6,22
191031763,5,4,8,8,0,25
191031764,8,8,2,1,2,21
191031765,6,6,2,2,5,21
191031766,6,8,3,4,7,28
191031767,4,8,8,1,7,28
191031768,5,8,0,5,6,24
191031769,5,3,4,0,8,20
191031770,8,6,0,7,9,30
191031771,1,1,6,7,0,15
191031772,4,0,9,1,0,14
191031773,0,9,7,3,8,27
191031774,2,9,1,1,6,19
191031775,4,8,6,8,9,35
191031776,1,2,0,7,0,10
191031777,6,3,8,8,3,28
191031778,8,0,5,3,6,22
191031779,3,5,4,6,2,20
191031780,2,0,3,7,5,17
191031781,0,1,1,4,6,12
191031782,6,7,1,7,0,21
191031783,7,8,1,2,8,26
191031784,0,9,1,4,8,22
191031785,3,1,4,5,4,17
191031786,4,2,0,2,6,14
191031787,6,0,3,9,7,25
191031788,8,5,7,6,5,31
191031789,4,3,3,9,3,22
191031790,4,7,7,1,0,19
191031791,5,7,3,8,3,26
191031792,3,6,2,3,7,21
191031793,1,7,8,5,6,27
191031794,2,6,3,4,6,21
191031795,6,8,2,7,0,23
191031796,4,9,6,7,6,32
191031797,2,9,2,7,6,26
191031798,5,2,5,7,8,27
191031799,0,2,9,1,2,14
191031800,4,0,9,6,3,22
191031801,8,0,7,8,2,25
191031802,9,3,8,4,1,25
191031803,8,0,6,8,3,25
191031804,8,6,5,9,6,34
191031805,6,5,8,6,9,34
191031806,7,3,7,2,6,25
191031807,7,1,7,1,0,16
191031808,7,9,2,0,2,20
191031809,0,3,8,2,5,18
191031810,9,2,8,3,7,29
191031811,5,4,8,9,3,29
191031812,0,1,5,6,0,12
191031813,1,9,1,1,4,16
191031814,6,6,8,1,2,23
191031815,6,7,2,1,4,20
191031816,6,5,9,8,9,37
191031817,0,9,1,5,2,17
191031818,9,0,1,4,8,22
191031819,1,7,9,0,0,17
191031820,8,7,8,4,9,36
191031821,3,6,5,6,5,25
191031822,9,6,9,2,8,34
191031823,5,8,1,9,1,24
191031824,4,6,6,3,3,22
191031825,1,3,9,4,7,24
191031826,6,3,7,0,3,19
191031827,8,2,2,8,9,29
191031828,9,2,2,7,1,21
191031829,9,8,7,0,1,25
191031830,2,7,6,8,0,23
191031831,8,3,1,3,2,17
191031832,2,6,4,6,5,23
191031833,4,3,3,3,1,14
191031834,7,6,1,3,8,25
191031835,2,5,0,6,6,19
191031836,1,9,1,0,0,11
191031837,1,2,3,8,8,22
191031838,1,2,7,2,9,21
191031839,3,0,9,2,0,14
191031840,5,5,4,3,9,26
191031841,8,1,6,3,9,27
191031842,8,0,0,8,7,23
191031843,0,9,4,0,8,21
191031844,8,4,7,1,3,23
191031845,0,6,9,4,6,25
191031846,1,4,2,9,5,21
191031847,5,8,2,3,2,20
191031848,2,6,9,1,9,27
191031849,5,0,2,7,9,23
191031850,7,5,8,5,2,27
191031851,8,5,7,1,3,24
191031852,6,3,8,8,5,30
191031853,3,4,6,0,1,14
191031854,8,0,6,0,0,14
191031855,7,3,3,3,3,19
191031856,6,8,9,7,1,31
191031857,4,4,5,5,3,21
191031858,6,4,7,5,4,26
191031859,2,1,8,5,8,24
191031860,0,4,3,5,4,16
191031861,6,5,3,0,6,20
191031862,0,4,8,9,7,28
191031863,9,6,8,2,8,33
191031864,1,6,7,5,8,27
191031865,9,8,5,1,2,25
191031866,5,9,8,4,7,33
191031867,1,3,3,9,5,21
191031868,7,4,5,8,2,26
191031869,2,6,8,0,8,24
191031870,9,2,0,4,5,20
191031871,2,1,7,5,2,17
191031872,8,2,1,6,6,23
191031873,3,4,5,8,9,29
191031874,9,3,7,5,2,26
191031875,6,6,1,1,4,18
191031876,0,1,0,0,5,6
191031877,2,0,5,4,0,11
191031878,3,0,4,1,6,14
191031879,7,6,1,6,1,21
191031880,6,9,3,0,8,26
191031881,0,6,3,8,5,22
191031882,9,7,6,6,8,36
191031883,1,6,1,9,3,20
191031884,9,8,9,5,7,38
191031885,4,2,0,7,0,13
191031886,1,9,2,5,5,22
191031887,1,5,0,9,5,20
191031888,7,6,4,4,4,25
191031889,7,1,8,7,6,29
191031890,6,9,5,8,9,37
191031891,2,3,4,4,1,14
191031892,0,2,3,5,3,13
191031893,7,0,6,0,4,17
191031894,5,7,7,9,0,28
191031895,1,5,9,1,4,20
191031896,8,1,4,6,7,26
191031897,6,1,6,6,1,20
191031898,5,7,7,4,8,31
191031899,0,4,8,7,5,24
191031900,4,4,7,6,5,26
191031901,0,4,4,1,5,14
191031902,3,5,9,6,1,24
191031903,9,2,1,3,7,22
191031904,2,6,8,4,5,25
191031905,5,8,6,5,9,33
191031906,6,2,9,6,5,28
191031907,2,2,7,8,4,23
191031908,8,6,5,0,0,19
191031909,1,1,4,8,2,16
191031910,3,6,2,7,4,22
191031911,7,3,8,6,8,32
191031912,9,0,2,0,7,18
191031913,2,6,4,8,8,28
191031914,1,2,0,3,1,7
191031915,8,7,8,0,5,28
191031916,6,2,3,6,8,25
191031917,8,0,8,2,6,24
191031918,9,8,5,5,5,32
191031919,8,7,3,4,1,23
191031920,0,9,9,6,4,28
191031921,8,2,6,6,6,28
191031922,5,0,3,7,8,23
191031923,5,7,4,8,8,32
191031924,2,9,1,9,8,29
191031925,1,6,5,9,7,28
191031926,1,4,9,8,9,31
191031927,9,1,3,7,0,20
191031928,0,9,0,0,1,10
191031929,5,6,7,7,7,32
191031930,1,4,1,0,3,9
191031931,8,6,5,3,1,23
191031932,0,3,5,9,5,22
191031933,4,3,0,1,2,10
191031934,6,0,1,6,3,16
191031935,0,0,2,4,3,9
191031936,4,5,9,6,8,32
191031937,8,6,4,2,2,22
191031938,5,5,3,5,8,26
191031939,8,4,4,4,6,26
191031940,5,4,6,0,5,20
191031941,3,2,5,6,8,24
191031942,4,0,5,5,8,22
191031943,3,2,2,8,7,22
191031944,7,1,7,0,9,24
191031945,2,0,2,3,9,16
191031946,5,9,9,8,7,38
191031947,3,4,4,7,8,26
191031948,0,3,3,7,6,19
191031949,4,1,3,0,7,15
191031950,0,6,6,8,6,26
191031951,1,1,8,1,9,20
191031952,9,4,1,7,5,26
191031953,5,8,0,4,8,25
191031954,0,4,9,2,9,24
191031955,8,9,6,3,1,27
191031956,0,1,0,2,6,9
191031957,3,7,1,6,7,24
191031958,3,8,7,4,8,30
191031959,5,5,0,3,3,16
191031960,2,1,1,7,0,11
191031961,4,6,1,3,6,20
191031962,3,5,9,9,7,33
191031963,9,2,8,7,7,33
191031964,6,8,7,4,8,33
191031965,8,1,8,2,9,28
191031966,0,4,3,8,6,21
191031967,0,9,7,0,7,23
191031968,3,2,2,7,9,23
191031969,3,7,6,9,4,29
191031970,9,6,4,5,4,28
191031971,6,3,4,4,2,19
191031972,5,8,6,3,3,25
191031973,7,7,0,3,3,20
191031974,7,8,7,1,8,31
191031975,8,9,8,1,3,29
191031976,9,2,8,6,6,31
191031977,5,5,5,9,1,25
191031978,3,7,1,5,8,24
191031979,2,8,4,7,6,27
191031980,3,8,5,5,3,24
191031981,0,5,8,8,3,24
191031982,1,0,9,5,6,21
191031983,9,0,3,2,9,23
191031984,0,5,2,6,3,16
191031985,7,6,1,1,1,16
191031986,1,4,4,8,1,18
191031987,0,9,0,7,8,24
191031988,6,8,8,5,0,27
191031989,3,9,2,6,9,29
191031990,1,0,2,3,3,9
191031991,5,4,5,2,3,19
191031992,5,6,6,1,2,20
191031993,2,1,7,0,5,15
191031994,4,0,4,7,0,15
191031995,9,1,4,0,7,21
191031996,5,7,4,7,6,29
191031997,8,5,1,0,9,23
191031998,2,2,8,9,4,25
191031999,4,8,7,9,9,37
1910311000,4,3,2,5,2,16
1910311001,3,7,4,5,0,19
1910311002,1,8,9,5,5,28
1910311003,4,6,0,1,6,17
1910311004,5,7,4,0,4,20
1910311005,7,7,5,9,8,36
1910311006,1,5,5,6,7,24
1910311007,2,0,5,9,1,17
1910311008,2,5,7,4,9,27
1910311009,3,5,6,1,7,22
1910311010,2,1,2,8,3,16
1910311011,9,2,3,2,8,24
1910311012,3,8,9,0,2,22
1910311013,6,2,4,8,8,28
1910311014,2,5,6,4,6,23
1910311015,3,3,7,8,5,26
1910311016,1,2,6,6,6,21
1910311017,2,3,0,3,1,9
1910311018,9,0,7,9,4,29
1910311019,5,8,8,1,9,31
1910311020,5,0,0,1,4,10
1910311021,0,2,7,0,8,17
1910311022,4,5,5,3,7,24
1910311023,3,8,7,5,2,25
1910311024,3,2,7,2,7,21
1910311025,7,6,4,6,0,23
1910311026,9,5,8,4,6,32
1910311027,7,8,5,7,3,30
1910311028,6,5,7,0,5,23
1910311029,9,0,8,5,5,27
1910311030,2,0,2,5,3,12
1910311031,4,5,5,2,0,16
1910311032,0,0,2,3,9,14
1910311033,8,1,7,6,0,22
1910311034,6,3,6,6,8,29
1910311035,5,5,9,0,1,20
1910311036,4,8,1,4,7,24
1910311037,7,7,6,4,2,26
1910311038,3,4,7,3,9,26
1910311039,5,5,2,7,4,23
1910311040,0,5,7,6,9,27
1910311041,1,8,4,4,2,19
1910311042,6,4,8,0,3,21
1910311043,5,6,9,6,5,31
1910311044,7,2,4,2,4,19
1910311045,3,4,4,2,5,18
1910311046,5,5,3,9,9,31
1910311047,1,9,2,2,9,23
1910311048,8,0,4,5,3,20
1910311049,0,9,1,8,8,26
1910311050,2,6,0,7,0,15
1910311051,6,3,6,0,0,15
1910311052,5,5,8,3,9,30
1910311053,3,4,8,0,0,15
1910311054,1,1,2,5,6,15
1910311055,4,6,2,3,2,17
1910311056,4,2,6,0,3,15
1910311057,2,7,1,2,2,14
1910311058,4,1,1,6,7,19
1910311059,3,9,8,7,2,29
1910311060,2,1,9,3,8,23
1910311061,9,3,0,6,2,20
1910311062,4,2,8,2,8,24
1910311063,3,9,1,8,3,24
1910311064,5,2,0,4,4,15
1910311065,3,5,6,0,9,23
1910311066,8,9,2,1,2,22
1910311067,4,7,7,0,4,22
1910311068,6,1,9,4,4,24
1910311069,4,8,2,9,0,23
1910311070,4,0,9,7,1,21
1910311071,6,0,3,2,4,15
1910311072,5,1,5,1,6,18
1910311073,8,6,9,7,8,38
1910311074,2,0,6,6,2,16
1910311075,7,2,0,7,5,21
1910311076,9,8,2,9,5,33
1910311077,3,9,9,3,9,33
1910311078,0,4,6,5,7,22
1910311079,8,8,1,0,8,25
1910311080,4,7,7,1,1,20
1910311081,3,5,2,6,3,19
1910311082,8,3,7,5,5,28
1910311083,4,0,3,3,8,18
1910311084,0,4,4,6,1,15
1910311085,2,8,4,4,8,26
1910311086,1,3,6,0,0,10
1910311087,6,7,4,5,0,22
1910311088,8,9,8,2,8,35
1910311089,3,4,8,2,8,25
1910311090,2,0,1,9,2,14
1910311091,3,3,4,9,1,20
1910311092,9,5,8,7,9,38
1910311093,7,2,4,7,5,25
1910311094,5,0,1,8,0,14
1910311095,5,8,2,8,1,24
1910311096,9,9,7,7,3,35
1910311097,3,4,4,5,6,22
1910311098,5,8,7,3,2,25
1910311099,0,5,5,4,2,16
1910311100,1,8,3,7,4,23
1910311101,5,2,0,6,0,13
1910311102,4,2,3,5,5,19
1910311103,1,7,0,1,4,13
1910311104,5,3,0,4,8,20
1910311105,4,1,0,9,4,18
191101001,9,3,2,9,8,31
191101002,0,8,7,1,3,19
191101003,8,9,0,9,3,29
191101004,0,9,5,5,6,25
191101005,8,1,8,4,8,29
191101006,4,8,2,6,2,22
191101007,6,2,7,2,9,26
191101008,8,1,4,0,7,20
191101009,9,0,8,4,6,27
191101010,0,4,2,3,7,16
191101011,8,4,0,6,4,22
191101012,3,3,5,9,5,25
191101013,4,7,9,8,5,33
191101014,8,5,4,4,5,26
191101015,1,6,4,3,1,15
191101016,0,1,5,1,7,14
191101017,1,9,8,1,4,23
191101018,7,0,1,8,1,17
191101019,0,9,6,0,1,16
191101020,5,0,8,8,3,24
191101021,1,9,2,7,3,22
191101022,6,2,6,9,9,32
191101023,7,1,0,2,4,14
191101024,7,0,4,2,6,19
191101025,0,6,5,1,9,21
191101026,1,0,7,9,5,22
191101027,4,9,8,1,9,31
191101028,2,2,2,6,7,19
191101029,0,5,1,1,2,9
191101030,2,0,3,9,2,16
191101031,6,3,1,2,6,18
191101032,3,8,0,9,5,25
191101033,0,8,7,2,2,19
191101034,6,1,4,9,4,24
191101035,8,7,6,8,5,34
191101036,5,4,7,3,6,25
191101037,8,4,2,3,9,26
191101038,1,3,0,7,4,15
191101039,9,9,8,2,9,37
191101040,2,4,8,1,0,15
191101041,4,1,4,2,9,20
191101042,5,0,5,1,1,12
191101043,4,2,2,3,5,16
191101044,6,6,9,5,9,35
191101045,6,6,5,1,5,23
191101046,1,7,7,6,3,24
191101047,3,0,1,9,4,17
191101048,5,8,6,9,3,31
191101049,3,0,0,4,0,7
191101050,1,3,4,0,0,8
191101051,9,9,1,0,1,20
191101052,9,2,0,1,1,13
191101053,4,8,3,4,1,20
191101054,3,4,3,3,2,15
191101055,7,6,4,7,3,27
191101056,9,9,4,3,8,33
191101057,6,8,5,4,8,31
191101058,3,8,7,3,6,27
191101059,0,2,7,6,4,19
191101060,9,8,4,7,2,30
191101061,8,3,8,8,6,33
191101062,2,7,0,1,8,18
191101063,3,9,2,3,5,22
191101064,1,1,4,0,6,12
191101065,0,7,9,2,5,23
191101066,6,9,8,3,0,26
191101067,5,8,5,2,3,23
191101068,4,8,3,2,3,20
191101069,6,0,6,1,6,19
191101070,9,0,5,3,5,22
191101071,9,0,7,2,6,24
191101072,4,5,7,5,6,27
191101073,7,9,5,2,2,25
191101074,5,9,0,4,3,21
191101075,5,8,1,1,6,21
191101076,0,3,8,1,0,12
191101077,4,2,3,3,6,18
191101078,7,0,9,1,6,23
191101079,4,6,0,8,3,21
191101080,0,8,0,4,5,17
191101081,5,9,9,6,5,34
191101082,1,9,2,1,2,15
191101083,7,0,7,4,5,23
191101084,4,7,3,6,0,20
191101085,7,9,5,7,5,33
191101086,3,0,1,1,3,8
191101087,3,4,1,1,1,10
191101088,3,0,5,9,0,17
191101089,0,9,3,9,2,23
191101090,5,0,4,3,1,13
191101091,4,0,5,9,8,26
191101092,9,7,6,9,8,39
191101093,8,9,9,1,9,36
191101094,1,1,2,4,8,16
191101095,8,8,9,5,5,35
191101096,3,7,8,4,7,29
191101097,4,3,1,7,3,18
191101098,0,3,8,3,2,16
191101099,4,7,0,7,2,20
191101100,8,2,5,3,2,20
191101101,0,9,0,1,4,14
191101102,6,9,5,1,7,28
191101103,4,1,3,0,3,11
191101104,2,6,9,6,8,31
191101105,7,8,9,7,5,36
191101106,1,4,3,9,5,22
191101107,2,0,0,4,0,6
191101108,5,8,4,9,1,27
191101109,4,8,1,7,6,26
191101110,2,0,1,2,3,8
191101111,1,5,5,4,3,18
191101112,4,8,0,6,8,26
191101113,2,0,6,5,5,18
191101114,4,4,3,7,7,25
191101115,1,9,4,5,4,23
191101116,2,1,6,0,7,16
191101117,2,7,2,9,6,26
191101118,1,1,1,5,0,8
191101119,2,9,5,0,0,16
191101120,7,4,0,9,2,22
191101121,5,5,1,3,9,23
191101122,9,0,6,1,9,25
191101123,0,9,2,4,2,17
191101124,2,1,0,3,6,12
191101125,2,1,2,0,8,13
191101126,0,2,2,8,6,18
191101127,7,5,9,8,5,34
191101128,2,9,1,9,6,27
191101129,7,7,2,7,8,31
191101130,5,0,0,2,9,16
191101131,9,8,4,0,4,25
191101132,5,2,7,4,2,20
191101133,0,2,7,4,2,15
191101134,8,7,2,2,5,24
191101135,3,6,7,1,6,23
191101136,3,7,9,8,6,33
191101137,0,7,4,9,9,29
191101138,7,6,6,8,8,35
191101139,3,4,2,3,3,15
191101140,9,0,3,1,5,18
191101141,6,6,6,8,1,27
191101142,9,6,1,0,5,21
191101143,8,8,5,1,6,28
191101144,6,0,9,4,6,25
191101145,6,2,2,7,3,20
191101146,0,9,0,0,3,12
191101147,1,5,1,8,8,23
191101148,3,3,0,2,0,8
191101149,0,8,5,6,9,28
191101150,9,4,0,8,2,23
191101151,9,6,8,1,4,28
191101152,9,9,6,8,4,36
191101153,6,4,3,5,3,21
191101154,0,6,0,4,0,10
191101155,9,0,9,9,7,34
191101156,5,2,8,6,1,22
191101157,2,7,4,2,3,18
191101158,9,1,3,1,9,23
191101159,1,2,3,7,1,14
191101160,4,8,3,0,0,15
191101161,2,1,2,9,3,17
191101162,1,3,0,8,0,12
191101163,3,4,3,9,2,21
191101164,1,9,6,5,4,25
191101165,7,3,9,8,5,32
191101166,2,8,1,1,0,12
191101167,5,8,1,8,1,23
191101168,7,3,0,0,8,18
191101169,8,7,2,9,0,26
191101170,8,0,2,6,2,18
191101171,9,4,9,7,3,32
191101172,1,3,1,1,2,8
191101173,7,2,8,9,6,32
191101174,5,3,6,3,8,25
191101175,7,9,5,5,9,35
191101176,2,0,2,3,1,8
191101177,8,9,0,4,4,25
191101178,5,4,3,3,4,19
191101179,0,5,2,8,8,23
191101180,2,6,6,4,6,24
191101181,5,2,9,1,2,19
191101182,0,1,7,4,0,12
191101183,5,1,1,7,7,21
191101184,5,9,0,0,3,17
191101185,4,8,9,2,6,29
191101186,9,1,4,7,6,27
191101187,5,5,3,0,7,20
191101188,7,6,1,7,2,23
191101189,8,7,7,4,1,27
191101190,3,0,4,1,0,8
191101191,7,5,2,7,7,28
191101192,9,8,0,9,3,29
191101193,4,1,9,7,6,27
191101194,2,0,1,7,1,11
191101195,4,7,5,9,9,34
191101196,6,2,1,7,8,24
191101197,0,6,9,2,0,17
191101198,3,5,6,5,0,19
191101199,5,1,4,7,7,24
191101200,3,0,5,8,3,19
191101201,2,0,1,4,3,10
191101202,3,9,9,8,1,30
191101203,5,1,0,0,1,7
191101204,7,8,0,4,7,26
191101205,8,4,1,9,3,25
191101206,2,3,7,3,5,20
191101207,6,7,2,0,9,24
191101208,0,2,9,4,9,24
191101209,5,2,1,8,1,17
191101210,5,1,3,7,2,18
191101211,7,1,2,0,9,19
191101212,2,2,3,6,2,15
191101213,9,0,6,8,8,31
191101214,9,0,6,1,5,21
191101215,9,2,6,9,0,26
191101216,6,3,5,4,4,22
191101217,6,9,0,2,1,18
191101218,1,3,1,3,8,16
191101219,6,7,5,8,2,28
191101220,2,9,7,7,7,32
191101221,9,4,3,1,6,23
191101222,9,6,9,6,5,35
191101223,6,8,2,8,1,25
191101224,4,8,9,5,8,34
191101225,3,6,7,5,6,27
191101226,3,2,3,6,1,15
191101227,2,0,9,6,6,23
191101228,4,0,4,0,9,17
191101229,6,2,6,5,7,26
191101230,0,4,7,3,8,22
191101231,0,4,0,3,5,12
191101232,2,1,0,9,6,18
191101233,6,5,6,3,4,24
191101234,6,3,3,2,7,21
191101235,3,1,9,1,4,18
191101236,6,1,4,6,8,25
191101237,8,6,4,8,2,28
191101238,5,0,5,9,9,28
191101239,1,7,5,2,6,21
191101240,3,1,8,9,2,23
191101241,7,8,0,4,1,20
191101242,2,9,3,2,1,17
191101243,9,5,3,1,5,23
191101244,3,5,9,4,9,30
191101245,5,5,4,2,3,19
191101246,4,1,7,9,8,29
191101247,2,8,4,1,1,16
191101248,0,2,7,2,3,14
191101249,7,3,1,1,1,13
191101250,7,2,6,2,4,21
191101251,4,4,6,0,7,21
191101252,5,8,7,8,4,32
191101253,8,0,3,1,0,12
191101254,7,4,4,2,7,24
191101255,6,9,9,4,3,31
191101256,5,6,7,5,0,23
191101257,1,0,8,7,8,24
191101258,0,1,8,5,4,18
191101259,2,6,1,2,9,20
191101260,6,0,7,2,2,17
191101261,2,4,8,4,6,24
191101262,2,0,9,6,2,19
191101263,6,7,7,7,4,31
191101264,0,0,5,9,5,19
191101265,9,7,7,5,0,28
191101266,6,5,3,5,0,19
191101267,5,1,5,0,0,11
191101268,9,4,8,4,4,29
191101269,5,9,4,1,0,19
191101270,3,1,6,7,3,20
191101271,4,9,8,4,8,33
191101272,5,4,4,9,5,27
191101273,4,3,9,3,1,20
191101274,4,6,0,4,1,15
191101275,2,8,7,8,9,34
191101276,9,3,7,6,9,34
191101277,4,3,2,5,6,20
191101278,0,6,6,6,7,25
191101279,9,0,9,7,8,33
191101280,2,7,2,3,3,17
191101281,3,9,3,9,8,32
191101282,1,8,9,4,8,30
191101283,3,3,9,0,8,23
191101284,3,8,1,9,2,23
191101285,3,0,4,7,7,21
191101286,7,0,7,2,0,16
191101287,0,5,1,8,3,17
191101288,0,7,6,3,8,24
191101289,8,5,9,6,1,29
191101290,0,6,1,0,7,14
191101291,8,3,4,5,3,23
191101292,9,6,8,8,9,40
191101293,0,1,4,3,8,16
191101294,2,4,4,9,4,23
191101295,1,7,0,6,2,16
191101296,5,6,7,9,6,33
191101297,9,2,5,0,8,24
191101298,4,1,7,3,0,15
191101299,3,9,7,9,3,31
191101300,2,8,6,1,7,24
191101301,6,7,7,4,8,32
191101302,5,0,9,7,2,23
191101303,1,7,4,7,4,23
191101304,2,5,7,3,1,18
191101305,9,3,5,9,9,35
191101306,1,0,0,1,6,8
191101307,9,6,5,5,1,26
191101308,9,9,1,5,5,29
191101309,1,9,6,7,3,26
191101310,5,6,0,7,5,23
191101311,7,6,1,1,4,19
191101312,8,1,1,3,7,20
191101313,5,6,7,2,1,21
191101314,2,3,5,0,0,10
191101315,1,8,8,2,0,19
191101316,4,3,3,9,9,28
191101317,0,1,4,1,9,15
191101318,8,3,8,0,5,24
191101319,4,4,7,8,0,23
191101320,1,9,4,0,8,22
191101321,7,9,7,5,9,37
191101322,4,6,9,7,1,27
191101323,9,1,0,8,3,21
191101324,7,9,1,9,9,35
191101325,2,5,7,7,1,22
191101326,6,3,8,4,0,21
191101327,5,7,2,7,5,26
191101328,2,7,3,0,6,18
191101329,9,8,6,4,8,35
191101330,6,8,2,6,2,24
191101331,7,6,8,9,9,39
191101332,7,3,7,7,6,30
191101333,6,0,6,7,3,22
191101334,4,8,9,5,4,30
191101335,2,8,3,7,1,21
191101336,3,9,1,9,3,25
191101337,2,5,3,2,2,14
191101338,7,9,7,0,8,31
191101339,9,6,3,1,0,19
191101340,3,5,1,0,5,14
191101341,3,1,9,1,6,20
191101342,6,5,7,4,7,29
191101343,2,8,2,0,6,18
191101344,9,6,6,4,9,34
191101345,4,3,5,3,2,17
191101346,0,5,7,7,9,28
191101347,0,3,1,4,3,11
191101348,4,2,7,2,0,15
191101349,6,8,5,4,4,27
191101350,6,1,1,1,5,14
191101351,7,8,7,3,4,29
191101352,5,7,7,0,8,27
191101353,0,6,3,9,8,26
191101354,5,0,2,5,9,21
191101355,0,9,2,2,7,20
191101356,5,3,4,5,7,24
191101357,5,8,4,4,1,22
191101358,1,7,7,2,1,18
191101359,2,1,7,4,4,18
191101360,1,2,8,8,0,19
191101361,8,4,7,5,2,26
191101362,4,3,0,7,5,19
191101363,2,9,1,1,1,14
191101364,0,2,4,7,5,18
191101365,0,5,5,4,7,21
191101366,9,3,9,4,1,26
191101367,2,2,6,0,1,11
191101368,3,5,6,4,4,22
191101369,6,3,1,0,4,14
191101370,5,8,0,8,8,29
191101371,4,5,6,6,7,28
191101372,2,9,4,6,7,28
191101373,1,6,0,0,5,12
191101374,1,7,5,0,3,16
191101375,3,4,7,3,3,20
191101376,3,1,5,3,0,12
191101377,9,8,3,3,0,23
191101378,5,5,2,1,0,13
191101379,3,0,9,3,6,21
191101380,7,8,9,7,3,34
191101381,5,1,3,2,1,12
191101382,3,2,6,9,5,25
191101383,6,2,4,4,3,19
191101384,4,3,1,4,2,14
191101385,5,3,6,0,6,20
191101386,9,6,3,5,5,28
191101387,2,0,0,0,6,8
191101388,2,6,3,4,0,15
191101389,0,3,1,5,7,16
191101390,0,6,4,7,2,19
191101391,1,4,7,0,1,13
191101392,3,2,2,6,4,17
191101393,8,1,4,4,1,18
191101394,9,3,9,3,0,24
191101395,3,3,6,5,6,23
191101396,1,1,2,6,8,18
191101397,3,3,9,7,3,25
191101398,8,1,3,5,1,18
191101399,9,9,4,5,0,27
191101400,0,3,8,7,9,27
191101401,3,5,9,7,6,30
191101402,2,6,5,8,0,21
191101403,5,1,4,8,8,26
191101404,3,6,0,5,8,22
191101405,6,9,1,8,6,30
191101406,0,5,6,8,5,24
191101407,2,0,7,4,3,16
191101408,5,4,0,4,0,13
191101409,2,8,1,6,0,17
191101410,3,5,3,6,1,18
191101411,9,1,2,6,4,22
191101412,1,4,8,7,5,25
191101413,8,0,2,3,7,20
191101414,3,5,8,5,8,29
191101415,8,3,5,2,9,27
191101416,4,4,5,2,8,23
191101417,3,5,4,5,5,22
191101418,6,6,3,3,5,23
191101419,6,6,1,2,6,21
191101420,3,2,1,5,9,20
191101421,8,6,2,9,0,25
191101422,8,0,7,3,7,25
191101423,2,7,3,6,8,26
191101424,7,1,5,7,7,27
191101425,3,5,3,0,7,18
191101426,4,5,4,9,7,29
191101427,4,1,9,1,2,17
191101428,9,8,8,5,8,38
191101429,5,3,0,9,8,25
191101430,9,7,6,4,1,27
191101431,7,6,3,0,1,17
191101432,8,1,3,6,1,19
191101433,5,1,9,2,7,24
191101434,0,8,8,5,7,28
191101435,9,6,4,1,8,28
191101436,0,9,2,9,5,25
191101437,8,0,1,4,3,16
191101438,9,1,0,4,9,23
191101439,9,4,0,2,5,20
191101440,4,6,2,4,1,17
191101441,6,0,2,4,8,20
191101442,1,8,1,3,1,14
191101443,4,0,5,2,5,16
191101444,3,5,2,6,2,18
191101445,1,3,7,8,0,19
191101446,3,6,7,2,2,20
191101447,4,9,8,0,6,27
191101448,3,7,9,4,2,25
191101449,6,4,9,6,5,30
191101450,3,2,9,3,2,19
191101451,8,5,5,5,0,23
191101452,8,9,1,4,1,23
191101453,0,1,2,4,2,9
191101454,0,4,5,1,5,15
191101455,0,6,8,6,2,22
191101456,6,5,4,6,6,27
191101457,3,5,7,6,5,26
191101458,2,1,7,0,9,19
191101459,0,8,0,9,0,17
191101460,0,0,8,4,1,13
191101461,4,9,9,1,2,25
191101462,8,1,6,9,4,28
191101463,7,4,4,6,0,21
191101464,7,1,8,7,5,28
191101465,0,2,0,6,2,10
191101466,8,9,4,7,7,35
191101467,8,7,9,0,1,25
191101468,3,7,2,6,0,18
191101469,9,9,5,2,0,25
191101470,9,2,9,7,7,34
191101471,1,6,2,9,5,23
191101472,0,1,1,3,2,7
191101473,6,7,7,6,5,31
191101474,0,4,9,7,7,27
191101475,2,7,6,4,4,23
191101476,8,6,7,9,3,33
191101477,6,7,7,3,6,29
191101478,6,9,5,9,2,31
191101479,5,8,7,7,5,32
191101480,1,0,5,1,5,12
191101481,9,6,0,5,5,25
191101482,6,0,7,9,1,23
191101483,8,2,2,8,8,28
191101484,7,2,1,5,9,24
191101485,0,4,5,5,7,21
191101486,1,9,6,0,1,17
191101487,0,0,2,5,2,9
191101488,8,2,6,8,3,27
191101489,5,3,2,7,9,26
191101490,1,5,6,0,9,21
191101491,9,5,2,4,4,24
191101492,2,0,5,4,2,13
191101493,6,8,1,6,4,25
191101494,1,7,3,5,6,22
191101495,3,0,2,2,1,8
191101496,9,2,4,5,2,22
191101497,1,7,2,4,5,19
191101498,3,1,2,7,1,14
191101499,3,9,6,7,4,29
191101500,0,5,6,8,7,26
191101501,7,5,6,1,4,23
191101502,4,9,1,0,3,17
191101503,4,4,9,5,5,27
191101504,9,6,7,5,0,27
191101505,4,6,9,2,2,23
191101506,8,7,4,2,9,30
191101507,4,6,2,5,8,25
191101508,8,1,9,9,4,31
191101509,5,9,7,8,9,38
191101510,6,1,2,7,6,22
191101511,0,2,2,7,2,13
191101512,3,6,2,4,7,22
191101513,5,9,8,9,6,37
191101514,0,3,8,5,6,22
191101515,3,9,4,0,1,17
191101516,1,5,5,7,1,19
191101517,6,4,7,9,3,29
191101518,2,9,3,5,4,23
191101519,8,6,1,0,7,22
191101520,3,2,1,2,8,16
191101521,1,9,4,3,8,25
191101522,6,9,2,3,2,22
191101523,1,4,4,6,1,16
191101524,7,1,0,8,2,18
191101525,8,3,4,7,7,29
191101526,1,6,3,1,3,14
191101527,1,1,5,2,4,13
191101528,9,1,2,5,1,18
191101529,8,6,4,4,8,30
191101530,7,9,2,0,8,26
191101531,7,2,0,6,8,23
191101532,7,6,0,5,8,26
191101533,3,6,3,2,0,14
191101534,2,8,5,9,7,31
191101535,5,2,5,7,6,25
191101536,3,5,6,1,6,21
191101537,3,9,3,7,9,31
191101538,5,6,8,4,9,32
191101539,9,8,8,5,0,30
191101540,8,0,3,3,2,16
191101541,3,8,5,6,3,25
191101542,9,2,2,1,8,22
191101543,8,9,7,0,9,33
191101544,7,5,1,0,4,17
191101545,6,7,1,2,7,23
191101546,3,1,2,5,6,17
191101547,5,0,6,3,1,15
191101548,9,4,2,2,9,26
191101549,3,0,5,7,8,23
191101550,2,8,6,3,1,20
191101551,4,4,6,3,8,25
191101552,7,9,8,1,6,31
191101553,0,7,3,8,1,19
191101554,6,7,5,0,6,24
191101555,8,1,4,2,5,20
191101556,2,9,9,0,5,25
191101557,6,3,1,9,6,25
191101558,8,8,7,3,7,33
191101559,3,1,9,0,9,22
191101560,7,4,0,6,1,18
191101561,9,6,5,7,3,30
191101562,1,0,5,1,1,8
191101563,4,7,5,2,1,19
191101564,3,1,2,4,3,13
191101565,7,0,3,4,4,18
191101566,8,9,2,8,6,33
191101567,3,5,5,5,5,23
191101568,4,6,9,8,4,31
191101569,7,8,9,8,0,32
191101570,8,4,3,9,8,32
191101571,7,0,4,4,5,20
191101572,9,5,5,9,0,28
191101573,8,5,7,1,4,25
191101574,1,5,1,8,3,18
191101575,7,5,7,6,9,34
191101576,1,9,1,6,9,26
191101577,7,8,9,1,5,30
191101578,3,5,9,6,4,27
191101579,8,4,9,9,8,38
191101580,1,5,8,2,7,23
191101581,3,2,8,3,3,19
191101582,9,1,3,4,2,19
191101583,9,7,8,6,2,32
191101584,1,9,8,9,3,30
191101585,9,1,3,0,2,15
191101586,2,6,9,0,2,19
191101587,7,0,5,7,5,24
191101588,9,2,4,8,1,24
191101589,2,3,3,1,1,10
191101590,3,4,6,6,9,28
191101591,5,8,4,5,3,25
191101592,9,1,9,0,5,24
191101593,0,7,0,8,2,17
191101594,1,4,4,5,1,15
191101595,5,5,0,5,1,16
191101596,1,0,0,8,8,17
191101597,8,0,5,2,5,20
191101598,5,8,2,9,0,24
191101599,7,0,3,3,0,13
191101600,8,5,6,2,5,26
191101601,9,9,5,5,3,31
191101602,7,8,6,1,0,22
191101603,8,8,1,6,7,30
191101604,3,7,1,6,3,20
191101605,5,4,7,5,3,24
191101606,0,6,0,6,4,16
191101607,2,9,5,0,2,18
191101608,9,8,2,1,9,29
191101609,3,8,6,5,8,30
191101610,4,8,9,5,0,26
191101611,4,7,1,8,0,20
191101612,7,2,9,2,4,24
191101613,2,7,5,7,1,22
191101614,0,2,1,6,0,9
191101615,1,2,0,4,8,15
191101616,5,6,1,0,4,16
191101617,2,5,7,3,2,19
191101618,9,9,0,9,9,36
191101619,6,1,8,1,0,16
191101620,8,6,1,1,5,21
191101621,1,9,9,9,1,29
191101622,4,3,5,0,2,14
191101623,6,8,3,3,7,27
191101624,2,8,8,0,1,19
191101625,1,2,3,2,6,14
191101626,9,7,6,7,7,36
191101627,2,6,0,0,8,16
191101628,1,6,2,2,5,16
191101629,4,6,7,6,9,32
191101630,2,0,4,3,1,10
191101631,3,7,8,8,6,32
191101632,1,2,0,3,4,10
191101633,5,0,4,1,1,11
191101634,7,4,1,9,7,28
191101635,5,0,6,9,9,29
191101636,3,1,1,0,0,5
191101637,7,9,0,8,6,30
191101638,1,5,8,2,0,16
191101639,3,5,1,6,7,22
191101640,8,7,7,2,8,32
191101641,0,3,9,3,2,17
191101642,3,0,3,8,3,17
191101643,7,2,4,1,0,14
191101644,7,1,1,8,0,17
191101645,9,5,6,4,4,28
191101646,5,3,2,5,6,21
191101647,1,4,1,9,9,24
191101648,6,2,9,8,3,28
191101649,2,4,7,9,3,25
191101650,5,6,3,1,3,18
191101651,1,4,2,1,9,17
191101652,7,6,8,5,5,31
191101653,2,6,1,0,6,15
191101654,4,3,7,3,2,19
191101655,7,4,5,2,2,20
191101656,5,5,4,9,6,29
191101657,0,0,8,4,3,15
191101658,8,3,4,5,9,29
191101659,6,3,2,4,3,18
191101660,9,6,3,0,0,18
191101661,6,6,0,1,3,16
191101662,4,4,5,5,9,27
191101663,2,3,9,3,4,21
191101664,4,2,7,4,2,19
191101665,0,1,1,6,1,9
191101666,0,6,9,3,2,20
191101667,9,6,7,8,5,35
191101668,1,2,8,2,9,22
191101669,0,2,7,0,1,10
191101670,4,7,2,6,5,24
191101671,0,5,5,0,2,12
191101672,3,3,9,5,4,24
191101673,8,4,1,0,5,18
191101674,8,2,4,6,1,21
191101675,0,8,2,6,9,25
191101676,1,8,6,4,1,20
191101677,4,2,7,2,6,21
191101678,5,5,4,7,2,23
191101679,5,5,9,9,0,28
191101680,3,1,5,8,3,20
191101681,9,3,6,0,6,24
191101682,8,4,0,0,2,14
191101683,6,0,5,2,3,16
191101684,1,3,6,0,2,12
191101685,6,1,1,8,9,25
191101686,2,5,2,8,0,17
191101687,1,7,9,5,0,22
191101688,3,8,8,8,1,28
191101689,5,4,5,6,7,27
191101690,2,8,3,2,0,15
191101691,3,7,8,9,4,31
191101692,7,3,9,2,2,23
191101693,4,0,9,8,5,26
191101694,9,9,0,3,6,27
191101695,9,2,6,8,5,30
191101696,0,8,1,2,8,19
191101697,2,0,8,5,5,20
191101698,2,1,6,8,9,26
191101699,5,7,6,8,2,28
191101700,0,9,4,8,0,21
191101701,5,5,1,3,3,17
191101702,2,3,0,0,2,7
191101703,3,1,9,9,5,27
191101704,9,2,6,1,3,21
191101705,4,3,4,1,0,12
191101706,4,5,8,1,4,22
191101707,6,3,0,4,7,20
191101708,8,6,3,6,4,27
191101709,8,1,2,1,1,13
191101710,5,0,2,7,6,20
191101711,0,5,9,7,6,27
191101712,1,1,1,9,7,19
191101713,8,4,1,6,0,19
191101714,4,7,2,1,9,23
191101715,0,0,0,8,1,9
191101716,0,0,2,6,0,8
191101717,1,9,0,3,6,19
191101718,8,7,2,2,4,23
191101719,2,1,0,5,7,15
191101720,1,1,6,4,8,20
191101721,2,0,7,0,7,16
191101722,5,0,4,0,4,13
191101723,7,3,4,2,2,18
191101724,5,9,0,9,5,28
191101725,9,3,6,9,2,29
191101726,3,7,0,1,5,16
191101727,1,7,9,6,5,28
191101728,0,4,3,9,0,16
191101729,3,6,9,3,1,22
191101730,0,5,2,8,1,16
191101731,1,5,3,4,9,22
191101732,1,3,7,8,3,22
191101733,9,9,6,1,9,34
191101734,0,8,4,6,0,18
191101735,3,6,9,4,6,28
191101736,2,4,2,2,8,18
191101737,2,6,5,0,6,19
191101738,0,6,9,0,7,22
191101739,2,9,2,0,3,16
191101740,6,6,1,8,1,22
191101741,4,8,2,7,6,27
191101742,3,9,0,1,8,21
191101743,3,3,9,9,0,24
191101744,5,8,0,2,8,23
191101745,9,9,0,1,2,21
191101746,1,4,8,8,1,22
191101747,0,5,0,9,6,20
191101748,5,7,0,7,5,24
191101749,3,8,3,9,2,25
191101750,4,0,9,9,5,27
191101751,3,8,0,2,8,21
191101752,8,6,1,7,4,26
191101753,9,6,1,6,7,29
191101754,9,0,4,5,4,22
191101755,1,3,0,5,7,16
191101756,9,9,6,5,5,34
191101757,6,9,7,9,0,31
191101758,3,1,6,0,2,12
191101759,7,2,1,2,4,16
191101760,8,9,0,4,5,26
191101761,4,8,5,3,0,20
191101762,2,4,5,5,9,25
191101763,6,3,2,8,9,28
191101764,8,4,7,4,6,29
191101765,1,5,6,7,4,23
191101766,3,0,7,4,3,17
191101767,1,1,1,1,4,8
191101768,9,8,0,1,4,22
191101769,4,0,3,2,9,18
191101770,7,5,4,9,1,26
191101771,9,9,7,5,2,32
191101772,7,7,0,9,4,27
191101773,0,3,3,6,4,16
191101774,8,0,8,9,2,27
191101775,7,2,1,1,0,11
191101776,3,5,8,9,0,25
191101777,8,8,3,6,8,33
191101778,9,5,4,8,9,35
191101779,2,5,2,2,4,15
191101780,9,9,2,0,1,21
191101781,1,2,5,7,7,22
191101782,9,9,2,9,3,32
191101783,0,5,4,9,7,25
191101784,1,4,6,4,0,15
191101785,0,6,6,4,5,21
191101786,6,0,5,3,1,15
191101787,9,5,0,9,6,29
191101788,5,2,1,1,4,13
191101789,9,6,2,2,1,20
191101790,7,8,5,7,4,31
191101791,7,3,0,7,2,19
191101792,7,1,9,6,0,23
191101793,8,4,2,9,2,25
191101794,0,7,3,1,9,20
191101795,3,3,9,5,5,25
191101796,1,5,0,3,8,17
191101797,1,4,6,3,0,14
191101798,0,4,6,3,6,19
191101799,7,8,4,6,2,27
191101800,9,4,2,8,5,28
191101801,0,1,6,6,9,22
191101802,4,9,3,4,1,21
191101803,0,8,0,8,2,18
191101804,3,5,6,7,3,24
191101805,2,3,7,1,1,14
191101806,9,4,9,7,9,38
191101807,5,2,6,8,9,30
191101808,7,9,5,2,4,27
191101809,7,5,1,6,8,27
191101810,1,1,9,7,6,24
191101811,8,0,6,9,4,27
191101812,9,8,6,8,0,31
191101813,9,3,7,1,2,22
191101814,1,3,7,1,8,20
191101815,9,9,6,3,6,33
191101816,2,1,1,8,6,18
191101817,5,1,2,6,6,20
191101818,0,8,0,9,5,22
191101819,1,2,7,3,2,15
191101820,1,8,0,0,6,15
191101821,6,2,1,9,0,18
191101822,8,3,8,7,4,30
191101823,2,5,9,4,1,21
191101824,1,9,1,1,3,15
191101825,3,7,3,1,1,15
191101826,0,0,6,9,9,24
191101827,6,8,3,0,1,18
191101828,3,9,4,8,2,26
191101829,9,4,2,1,3,19
191101830,4,8,9,4,7,32
191101831,5,6,0,6,7,24
191101832,3,8,0,3,6,20
191101833,6,9,1,2,7,25
191101834,6,5,4,2,1,18
191101835,4,1,2,6,8,21
191101836,6,9,6,1,3,25
191101837,0,4,1,4,7,16
191101838,1,1,2,7,9,20
191101839,8,6,4,8,6,32
191101840,0,7,4,1,0,12
191101841,8,4,0,3,6,21
191101842,2,3,1,9,1,16
191101843,3,7,7,9,2,28
191101844,8,2,6,5,6,27
191101845,8,9,6,5,9,37
191101846,8,9,3,1,3,24
191101847,6,3,2,3,2,16
191101848,9,3,7,1,7,27
191101849,0,2,5,7,2,16
191101850,5,8,1,3,2,19
191101851,7,8,6,8,7,36
191101852,7,0,1,8,0,16
191101853,0,7,6,8,3,24
191101854,3,4,0,3,2,12
191101855,2,1,2,7,9,21
191101856,4,7,6,7,3,27
191101857,6,8,2,7,5,28
191101858,7,6,3,1,2,19
191101859,0,3,4,3,4,14
191101860,2,0,8,6,6,22
191101861,2,1,9,2,1,15
191101862,9,7,0,4,1,21
191101863,9,3,4,3,4,23
191101864,2,1,2,3,3,11
191101865,4,9,5,0,0,18
191101866,8,0,5,7,5,25
191101867,3,4,9,1,1,18
191101868,8,8,8,7,1,32
191101869,5,2,0,2,2,11
191101870,1,3,9,8,4,25
191101871,2,9,3,5,6,25
191101872,9,3,8,9,4,33
191101873,9,0,8,0,8,25
191101874,6,5,2,3,1,17
191101875,8,4,6,0,2,20
191101876,6,0,1,9,4,20
191101877,6,9,9,3,9,36
191101878,3,1,5,2,2,13
191101879,3,9,1,2,4,19
191101880,3,9,3,6,4,25
191101881,3,1,0,9,9,22
191101882,2,3,2,6,5,18
191101883,2,9,9,2,5,27
191101884,2,9,2,8,7,28
191101885,7,7,6,6,0,26
191101886,2,2,6,3,1,14
191101887,6,5,0,3,1,15
191101888,4,4,7,6,8,29
191101889,3,2,7,7,7,26
191101890,4,5,8,9,8,34
191101891,4,6,6,3,9,28
191101892,7,5,5,9,5,31
191101893,3,4,9,8,5,29
191101894,0,8,2,5,7,22
191101895,6,6,3,9,6,30
191101896,9,5,4,0,1,19
191101897,8,1,5,1,7,22
191101898,4,6,0,5,8,23
191101899,8,8,6,8,4,34
191101900,4,6,2,8,3,23
191101901,9,0,8,0,0,17
191101902,2,1,3,6,1,13
191101903,7,5,7,3,1,23
191101904,7,7,9,2,5,30
191101905,5,2,9,4,0,20
191101906,1,6,3,8,5,23
191101907,6,9,3,8,9,35
191101908,0,0,6,4,8,18
191101909,9,7,0,9,3,28
191101910,0,6,7,1,8,22
191101911,7,3,6,8,7,31
191101912,2,2,7,4,7,22
191101913,7,8,5,6,0,26
191101914,3,9,9,0,7,28
191101915,3,6,1,2,9,21
191101916,9,1,0,5,0,15
191101917,3,9,2,5,8,27
191101918,7,6,1,0,4,18
191101919,8,7,8,4,3,30
191101920,2,4,3,1,0,10
191101921,5,1,1,2,7,16
191101922,9,8,3,8,5,33
191101923,2,6,0,7,6,21
191101924,0,8,4,0,2,14
191101925,7,7,3,4,9,30
191101926,1,7,1,5,9,23
191101927,4,4,2,0,9,19
191101928,4,2,2,5,2,15
191101929,4,3,7,6,0,20
191101930,2,6,0,3,0,11
191101931,1,2,2,2,9,16
191101932,9,5,4,4,5,27
191101933,2,6,5,2,4,19
191101934,9,5,8,8,8,38
191101935,2,3,8,4,5,22
191101936,3,6,8,1,9,27
191101937,9,5,1,6,5,26
191101938,0,1,1,2,8,12
191101939,7,8,8,8,9,40
191101940,2,3,1,4,9,19
191101941,6,6,1,8,5,26
191101942,1,1,5,9,2,18
191101943,6,3,6,8,1,24
191101944,3,1,7,9,0,20
191101945,7,4,0,3,5,19
191101946,2,1,7,6,5,21
191101947,2,8,9,0,6,25
191101948,7,8,6,0,7,28
191101949,5,7,7,0,1,20
191101950,0,6,5,0,0,11
191101951,8,7,7,5,5,32
191101952,9,2,7,2,3,23
191101953,1,5,9,4,4,23
191101954,0,9,6,7,5,27
191101955,8,2,7,8,7,32
191101956,8,2,3,7,4,24
191101957,5,1,0,5,7,18
191101958,1,3,3,2,6,15
191101959,5,9,1,8,8,31
191101960,1,1,0,4,6,12
191101961,9,5,1,1,6,22
191101962,6,2,3,4,2,17
191101963,7,2,3,9,0,21
191101964,6,2,4,6,1,19
191101965,2,5,3,0,0,10
191101966,4,1,3,2,2,12
191101967,7,3,3,5,8,26
191101968,4,5,8,7,1,25
191101969,3,1,2,0,7,13
191101970,3,9,3,2,7,24
191101971,6,6,2,4,4,22
191101972,6,2,8,3,2,21
191101973,5,0,9,0,5,19
191101974,2,9,3,7,4,25
191101975,1,0,6,7,1,15
191101976,4,3,6,2,2,17
191101977,4,0,3,6,6,19
191101978,8,7,3,7,5,30
191101979,3,8,3,9,5,28
191101980,1,0,1,3,3,8
191101981,4,9,2,5,1,21
191101982,8,5,6,7,3,29
191101983,8,1,8,1,3,21
191101984,7,7,1,7,7,29
191101985,7,4,4,8,8,31
191101986,8,9,9,5,1,32
191101987,7,3,2,0,5,17
191101988,3,8,4,0,0,15
191101989,8,9,1,8,9,35
191101990,8,9,5,0,0,22
191101991,7,7,6,1,8,29
191101992,3,9,2,6,4,24
191101993,2,2,8,4,5,21
191101994,9,9,2,7,6,33
191101995,1,1,2,2,5,11
191101996,8,0,3,7,2,20
191101997,0,4,1,8,3,16
191101998,2,2,4,6,5,19
191101999,7,2,2,6,6,23
1911011000,6,0,6,6,2,20
1911011001,8,2,2,7,9,28
1911011002,0,1,5,5,1,12
1911011003,3,0,9,0,0,12
1911011004,8,0,3,6,5,22
1911011005,9,7,2,7,1,26
1911011006,5,6,4,7,5,27
1911011007,6,1,9,3,0,19
1911011008,3,5,1,9,2,20
1911011009,0,6,4,1,5,16
1911011010,5,8,3,8,5,29
1911011011,3,8,8,1,1,21
1911011012,6,6,8,8,6,34
1911011013,1,4,8,0,0,13
1911011014,8,0,8,6,3,25
1911011015,8,6,4,6,8,32
1911011016,5,4,8,0,6,23
1911011017,7,2,6,1,1,17
1911011018,2,8,7,9,0,26
1911011019,3,3,1,6,5,18
1911011020,4,8,0,8,1,21
1911011021,8,5,0,4,6,23
1911011022,3,4,6,4,3,20
1911011023,4,7,4,4,5,24
1911011024,3,7,5,0,8,23
1911011025,0,9,6,8,8,31
1911011026,3,4,2,4,7,20
1911011027,1,6,3,5,0,15
1911011028,4,3,4,8,4,23
1911011029,0,2,1,6,4,13
1911011030,9,9,1,2,6,27
1911011031,6,2,1,7,0,16
1911011032,7,1,4,8,3,23
1911011033,0,5,6,0,8,19
1911011034,1,6,5,9,8,29
1911011035,3,6,6,0,2,17
1911011036,3,8,0,2,3,16
1911011037,8,0,0,3,0,11
1911011038,5,5,7,8,3,28
1911011039,0,7,2,0,1,10
1911011040,2,4,0,0,5,11
1911011041,6,5,1,9,7,28
1911011042,6,3,4,5,9,27
1911011043,9,8,9,8,2,36
1911011044,6,3,7,0,2,18
1911011045,6,9,0,1,9,25
1911011046,5,9,4,1,3,22
1911011047,5,7,5,0,2,19
1911011048,0,2,3,8,3,16
1911011049,9,2,9,7,8,35
1911011050,0,4,6,0,3,13
1911011051,3,8,2,3,5,21
1911011052,6,7,9,9,8,39
1911011053,2,7,6,9,2,26
1911011054,9,1,7,6,4,27
1911011055,6,4,5,3,4,22
1911011056,3,8,5,1,8,25
1911011057,0,1,1,8,3,13
1911011058,9,8,0,5,9,31
1911011059,1,4,2,0,1,8
1911011060,6,7,9,9,7,38
1911011061,8,4,1,6,1,20
1911011062,0,9,8,7,0,24
1911011063,5,3,9,6,1,24
1911011064,4,0,0,3,4,11
1911011065,6,9,8,3,3,29
1911011066,2,4,6,7,3,22
1911011067,6,8,3,1,4,22
1911011068,1,0,6,8,0,15
1911011069,5,7,7,3,4,26
1911011070,4,0,0,4,8,16
1911011071,7,3,0,0,1,11
1911011072,0,5,3,5,5,18
1911011073,9,9,7,0,7,32
1911011074,7,0,0,5,5,17
1911011075,9,4,3,2,0,18
1911011076,8,0,0,8,2,18
1911011077,7,6,4,3,6,26
1911011078,9,3,8,0,8,28
1911011079,3,4,4,0,0,11
1911011080,9,1,7,6,8,31
1911011081,8,5,5,7,3,28
1911011082,5,9,9,7,9,39
1911011083,6,3,9,6,4,28
1911011084,6,4,5,2,0,17
1911011085,4,2,8,9,6,29
1911011086,3,5,5,3,7,23
1911011087,6,0,3,6,5,20
1911011088,7,1,9,0,2,19
1911011089,4,7,0,5,9,25
1911011090,4,2,9,2,1,18
1911011091,1,3,2,0,6,12
1911011092,5,7,1,3,0,16
1911011093,3,2,8,2,7,22
1911011094,5,9,5,0,2,21
1911011095,3,0,1,7,6,17
1911011096,7,5,7,9,8,36
1911011097,0,7,1,6,9,23
1911011098,2,5,8,0,8,23
1911011099,1,9,2,9,2,23
1911011100,9,8,3,7,4,31
1911011101,0,8,5,1,9,23
1911011102,5,7,9,6,6,33
1911011103,2,5,7,7,8,29
1911011104,0,8,9,4,2,23
1911011105,4,5,6,5,5,25
191102001,3,4,9,9,7,32
191102002,7,7,9,9,7,39
191102003,3,8,0,1,2,14
191102004,1,1,6,9,7,24
191102005,9,5,9,5,5,33
191102006,1,2,1,5,1,10
191102007,7,7,5,6,2,27
191102008,6,8,0,9,5,28
191102009,9,2,5,9,0,25
191102010,0,0,4,1,6,11
191102011,7,8,2,9,0,26
191102012,7,6,8,3,4,28
191102013,2,1,9,5,3,20
191102014,2,2,4,0,7,15
191102015,2,5,9,0,4,20
191102016,1,0,6,9,6,22
191102017,2,2,8,2,6,20
191102018,2,9,5,8,2,26
191102019,8,0,5,5,0,18
191102020,9,7,6,8,1,31
191102021,7,5,4,3,4,23
191102022,7,2,1,5,4,19
191102023,7,1,2,3,5,18
191102024,6,7,0,6,9,28
191102025,4,0,8,5,2,19
191102026,9,0,5,1,4,19
191102027,0,2,4,5,2,13
191102028,0,3,5,7,2,17
191102029,4,3,9,4,6,26
191102030,4,2,2,7,1,16
191102031,7,5,5,3,5,25
191102032,9,7,1,6,9,32
191102033,2,1,0,3,7,13
191102034,1,6,7,5,3,22
191102035,9,4,2,5,3,23
191102036,9,0,0,4,3,16
191102037,3,4,1,9,5,22
191102038,1,9,7,7,5,29
191102039,6,9,9,2,6,32
191102040,7,7,5,6,7,32
191102041,9,9,5,8,7,38
191102042,7,8,3,6,0,24
191102043,6,4,7,7,9,33
191102044,5,3,5,6,2,21
191102045,1,5,7,2,4,19
191102046,2,1,2,9,0,14
191102047,9,1,5,6,1,22
191102048,2,3,2,3,4,14
191102049,4,7,4,7,6,28
191102050,8,9,8,8,0,33
191102051,6,6,1,3,3,19
191102052,4,4,5,5,7,25
191102053,5,8,3,3,0,19
191102054,2,6,5,0,2,15
191102055,1,5,9,3,6,24
191102056,4,1,6,6,1,18
191102057,8,7,5,1,9,30
191102058,0,4,6,8,5,23
191102059,1,2,8,2,3,16
191102060,9,0,6,5,7,27
191102061,7,3,8,9,7,34
191102062,0,8,3,8,1,20
191102063,0,7,9,8,5,29
191102064,4,4,8,6,1,23
191102065,2,7,6,7,1,23
191102066,2,5,1,7,5,20
191102067,7,9,6,6,2,30
191102068,4,2,5,3,0,14
191102069,5,2,6,2,2,17
191102070,8,5,9,0,9,31
191102071,7,8,9,5,2,31
191102072,4,0,7,9,0,20
191102073,6,8,9,0,9,32
191102074,9,9,5,4,1,28
191102075,6,5,6,0,3,20
191102076,3,7,0,5,4,19
191102077,3,0,6,4,5,18
191102078,7,0,4,3,9,23
191102079,1,4,2,4,2,13
191102080,8,7,4,1,3,23
191102081,9,0,0,0,2,11
191102082,7,1,3,4,2,17
191102083,2,1,1,6,2,12
191102084,6,7,3,9,5,30
191102085,2,2,9,5,8,26
191102086,0,1,4,6,2,13
191102087,4,9,3,7,7,30
191102088,5,1,1,3,8,18
191102089,3,3,7,9,8,30
191102090,6,9,2,2,6,25
191102091,0,1,6,2,7,16
191102092,2,6,5,6,6,25
191102093,3,8,8,6,1,26
191102094,4,5,3,9,5,26
191102095,0,6,7,7,2,22
191102096,6,7,4,1,8,26
191102097,6,4,8,6,1,25
191102098,4,6,3,8,5,26
191102099,8,1,5,8,1,23
191102100,8,2,6,8,1,25
191102101,1,6,7,5,7,26
191102102,8,3,6,6,3,26
191102103,5,7,7,9,1,29
191102104,2,9,2,9,6,28
191102105,1,8,6,6,6,27
191102106,0,1,5,2,0,8
191102107,9,6,6,5,5,31
191102108,2,4,7,5,9,27
191102109,6,8,9,8,0,31
191102110,7,4,9,5,1,26
191102111,6,5,6,1,2,20
191102112,2,5,4,1,8,20
191102113,9,9,7,6,9,40
191102114,5,3,8,4,0,20
191102115,9,4,5,6,0,24
191102116,2,7,2,6,2,19
191102117,3,1,4,2,7,17
191102118,3,0,9,5,0,17
191102119,1,3,5,3,3,15
191102120,5,5,3,5,6,24
191102121,1,7,2,4,4,18
191102122,7,2,2,2,6,19
191102123,8,7,3,2,8,28
191102124,9,0,5,8,8,30
191102125,5,3,5,3,8,24
191102126,8,6,3,0,1,18
191102127,4,4,5,5,6,24
191102128,3,6,4,7,6,26
191102129,5,0,1,0,4,10
191102130,2,0,3,8,6,19
191102131,8,3,7,2,7,27
191102132,9,7,6,0,4,26
191102133,3,7,1,0,1,12
191102134,4,2,7,5,7,25
191102135,7,2,9,9,6,33
191102136,7,4,4,7,5,27
191102137,2,6,6,6,4,24
191102138,8,4,4,8,3,27
191102139,6,1,0,1,3,11
191102140,1,7,2,7,5,22
191102141,9,1,6,2,3,21
191102142,9,8,1,9,3,30
191102143,6,5,4,6,3,24
191102144,9,3,5,5,4,26
191102145,6,1,8,4,2,21
191102146,8,1,7,8,8,32
191102147,9,3,7,5,6,30
191102148,8,1,0,5,2,16
191102149,6,2,0,4,7,19
191102150,1,8,4,0,4,17
191102151,2,6,1,3,1,13
191102152,3,3,4,6,7,23
191102153,1,3,4,1,1,10
191102154,7,5,6,6,6,30
191102155,8,4,0,8,8,28
191102156,0,4,3,6,1,14
191102157,9,4,7,3,3,26
191102158,7,1,2,5,6,21
191102159,3,7,1,2,0,13
191102160,4,8,1,3,9,25
191102161,5,9,9,2,2,27
191102162,3,9,7,4,4,27
191102163,1,5,0,1,4,11
191102164,7,3,6,6,8,30
191102165,4,2,8,4,8,26
191102166,0,8,4,4,0,16
191102167,6,2,8,9,5,30
191102168,0,1,2,4,8,15
191102169,3,2,7,8,6,26
191102170,4,9,8,6,1,28
191102171,1,8,5,6,2,22
191102172,8,1,1,0,8,18
191102173,0,9,7,7,9,32
191102174,9,8,9,2,4,32
191102175,2,5,7,0,0,14
191102176,6,9,8,1,2,26
191102177,7,0,5,5,2,19
191102178,1,0,1,4,7,13
191102179,6,9,5,6,5,31
191102180,1,4,5,3,2,15
191102181,1,5,7,7,0,20
191102182,1,6,6,8,6,27
191102183,1,6,7,6,6,26
191102184,1,0,8,7,6,22
191102185,0,7,1,9,8,25
191102186,6,7,8,8,0,29
191102187,5,2,7,5,5,24
191102188,9,3,3,4,1,20
191102189,4,2,0,1,7,14
191102190,8,8,0,4,8,28
191102191,4,8,5,0,8,25
191102192,3,4,3,7,4,21
191102193,6,1,3,7,9,26
191102194,4,6,0,4,7,21
191102195,0,4,3,5,1,13
191102196,9,4,3,5,7,28
191102197,8,0,5,6,7,26
191102198,1,4,4,5,0,14
191102199,3,1,6,3,8,21
191102200,5,9,3,6,0,23
191102201,3,7,5,6,8,29
191102202,5,7,5,5,1,23
191102203,3,4,8,6,8,29
191102204,6,1,3,9,9,28
191102205,1,4,7,2,2,16
191102206,2,4,2,2,3,13
191102207,5,3,2,0,5,15
191102208,0,0,3,3,6,12
191102209,8,2,1,9,9,29
191102210,6,8,8,1,3,26
191102211,5,4,1,0,6,16
191102212,9,4,1,8,5,27
191102213,0,9,9,2,5,25
191102214,4,7,9,7,3,30
191102215,2,9,5,3,8,27
191102216,0,9,5,3,1,18
191102217,9,3,4,1,7,24
191102218,1,1,4,8,5,19
191102219,2,3,4,2,6,17
191102220,5,0,3,7,1,16
191102221,7,2,2,6,5,22
191102222,4,5,9,9,9,36
191102223,9,8,2,6,4,29
191102224,3,4,6,7,6,26
191102225,0,4,6,7,1,18
191102226,7,7,4,2,4,24
191102227,2,3,8,9,7,29
191102228,2,7,7,1,7,24
191102229,9,8,9,8,8,42
191102230,8,0,9,7,3,27
191102231,5,6,7,2,2,22
191102232,9,7,2,4,0,22
191102233,6,1,2,3,7,19
191102234,4,6,2,7,0,19
191102235,8,8,3,0,9,28
191102236,5,9,6,4,8,32
191102237,5,6,7,8,6,32
191102238,7,2,4,3,1,17
191102239,8,8,4,5,5,30
191102240,5,8,2,9,7,31
191102241,4,8,9,8,6,35
191102242,6,9,4,9,5,33
191102243,8,8,0,5,7,28
191102244,2,7,8,7,4,28
191102245,9,8,2,4,7,30
191102246,6,1,1,0,0,8
191102247,1,1,6,8,6,22
191102248,2,9,9,6,3,29
191102249,2,9,2,6,1,20
191102250,8,6,9,7,5,35
191102251,2,5,6,4,2,19
191102252,9,9,1,0,0,19
191102253,3,9,5,0,3,20
191102254,4,7,1,0,9,21
191102255,2,8,3,7,7,27
191102256,2,3,0,0,7,12
191102257,5,3,2,9,8,27
191102258,9,7,4,2,7,29
191102259,0,7,8,3,0,18
191102260,3,2,4,2,7,18
191102261,8,2,5,5,0,20
191102262,2,7,9,4,7,29
191102263,6,9,6,8,4,33
191102264,5,1,7,4,2,19
191102265,2,0,2,7,4,15
191102266,7,3,8,8,4,30
191102267,7,1,3,5,7,23
191102268,0,5,0,3,3,11
191102269,9,2,1,8,4,24
191102270,0,3,1,3,0,7
191102271,5,6,8,0,3,22
191102272,0,3,2,4,6,15
191102273,6,0,2,3,3,14
191102274,7,7,4,1,1,20
191102275,7,8,6,7,3,31
191102276,4,6,7,7,8,32
191102277,3,6,5,6,6,26
191102278,5,2,2,8,5,22
191102279,2,4,4,8,1,19
191102280,9,2,4,0,3,18
191102281,4,2,5,6,9,26
191102282,0,2,3,5,0,10
191102283,4,6,1,2,9,22
191102284,3,4,6,2,1,16
191102285,2,7,2,1,2,14
191102286,7,4,2,9,5,27
191102287,2,5,7,3,5,22
191102288,8,0,4,6,3,21
191102289,5,0,9,7,4,25
191102290,2,1,1,2,2,8
191102291,5,1,4,0,9,19
191102292,1,7,0,7,9,24
191102293,7,7,6,3,4,27
191102294,5,1,3,7,3,19
191102295,3,7,3,4,7,24
191102296,9,4,6,7,4,30
191102297,2,9,6,9,7,33
191102298,9,5,9,1,1,25
191102299,1,1,8,8,9,27
191102300,4,1,8,8,2,23
191102301,5,5,0,3,8,21
191102302,9,3,6,3,9,30
191102303,4,6,2,7,2,21
191102304,9,4,6,5,7,31
191102305,5,9,6,3,3,26
191102306,2,1,6,0,0,9
191102307,0,5,9,7,5,26
191102308,5,0,9,0,1,15
191102309,5,4,4,2,8,23
191102310,6,9,4,1,4,24
191102311,2,8,5,3,0,18
191102312,1,7,7,6,7,28
191102313,8,9,6,7,4,34
191102314,0,1,7,2,0,10
191102315,5,1,9,7,6,28
191102316,9,3,9,6,7,34
191102317,0,2,4,1,7,14
191102318,8,6,0,2,9,25
191102319,6,4,5,4,0,19
191102320,3,5,6,1,0,15
191102321,7,8,3,0,8,26
191102322,7,7,2,0,9,25
191102323,8,1,2,8,7,26
191102324,3,1,8,9,1,22
191102325,5,3,1,9,8,26
191102326,0,6,7,2,2,17
191102327,2,1,2,5,5,15
191102328,3,4,1,7,9,24
191102329,5,2,9,7,4,27
191102330,9,2,9,8,5,33
191102331,8,7,8,2,5,30
191102332,2,5,1,9,3,20
191102333,3,6,9,1,2,21
191102334,6,6,5,0,7,24
191102335,0,3,9,3,0,15
191102336,5,6,9,9,9,38
191102337,8,2,9,8,8,35
191102338,8,3,8,1,2,22
191102339,4,8,2,1,2,17
191102340,4,3,8,6,9,30
191102341,7,5,2,1,4,19
191102342,0,0,8,5,0,13
191102343,4,6,0,1,1,12
191102344,2,1,0,2,3,8
191102345,9,3,3,2,3,20
191102346,5,5,6,4,9,29
191102347,2,6,2,1,5,16
191102348,0,3,3,4,9,19
191102349,4,6,1,2,1,14
191102350,6,3,3,9,5,26
191102351,3,4,0,5,8,20
191102352,7,4,8,4,3,26
191102353,1,1,6,3,3,14
191102354,3,9,8,8,7,35
191102355,4,2,3,3,3,15
191102356,5,6,5,3,2,21
191102357,3,9,4,1,0,17
191102358,8,5,2,5,0,20
191102359,1,1,7,0,0,9
191102360,4,9,8,1,1,23
191102361,5,4,2,0,7,18
191102362,8,5,9,1,9,32
191102363,6,3,9,0,2,20
191102364,9,2,2,7,4,24
191102365,2,1,2,2,2,9
191102366,4,1,5,4,2,16
191102367,5,2,0,2,9,18
191102368,5,8,0,9,0,22
191102369,7,2,6,3,3,21
191102370,4,1,3,5,8,21
191102371,4,2,3,3,4,16
191102372,0,5,7,9,5,26
191102373,0,8,9,4,0,21
191102374,8,2,4,2,4,20
191102375,9,4,4,3,8,28
191102376,3,5,7,0,3,18
191102377,0,3,0,0,1,4
191102378,8,3,8,7,5,31
191102379,9,5,7,4,5,30
191102380,2,6,7,2,1,18
191102381,0,1,1,7,1,10
191102382,9,1,5,2,3,20
191102383,1,3,2,3,8,17
191102384,2,8,9,3,4,26
191102385,9,9,5,3,9,35
191102386,5,7,8,9,5,34
191102387,4,8,7,7,7,33
191102388,7,1,7,4,9,28
191102389,7,2,1,6,5,21
191102390,5,5,7,6,4,27
191102391,8,1,2,5,8,24
191102392,7,9,9,5,6,36
191102393,1,5,9,6,4,25
191102394,7,2,3,7,5,24
191102395,7,6,9,4,0,26
191102396,6,1,1,4,5,17
191102397,4,6,2,6,2,20
191102398,4,5,6,7,5,27
191102399,0,6,9,5,7,27
191102400,3,2,9,2,5,21
191102401,7,1,6,6,4,24
191102402,2,5,7,6,6,26
191102403,7,4,9,4,7,31
191102404,0,4,6,7,9,26
191102405,0,5,4,6,1,16
191102406,7,0,3,6,7,23
191102407,4,2,0,5,6,17
191102408,7,2,8,4,9,30
191102409,0,3,2,3,2,10
191102410,9,7,5,5,7,33
191102411,3,2,5,3,3,16
191102412,0,3,4,2,4,13
191102413,8,3,3,5,0,19
191102414,5,2,1,5,1,14
191102415,7,5,3,9,2,26
191102416,1,4,7,8,6,26
191102417,9,0,3,2,7,21
191102418,4,4,1,3,4,16
191102419,1,9,0,3,1,14
191102420,2,5,2,0,7,16
191102421,8,2,2,9,0,21
191102422,7,9,8,9,7,40
191102423,2,1,6,6,1,16
191102424,8,2,0,9,6,25
191102425,0,1,9,2,6,18
191102426,6,4,1,8,8,27
191102427,6,0,1,3,3,13
191102428,2,1,3,3,7,16
191102429,0,5,1,6,8,20
191102430,5,4,3,8,5,25
191102431,4,6,3,1,6,20
191102432,6,3,7,4,5,25
191102433,8,7,0,7,4,26
191102434,4,4,1,3,0,12
191102435,9,9,1,0,4,23
191102436,6,6,4,0,4,20
191102437,2,1,1,7,5,16
191102438,0,9,8,0,9,26
191102439,4,1,6,3,4,18
191102440,8,4,2,0,4,18
191102441,4,9,8,0,4,25
191102442,9,5,7,1,0,22
191102443,3,1,0,6,6,16
191102444,5,4,5,8,3,25
191102445,9,4,7,7,3,30
191102446,4,2,5,0,1,12
191102447,6,4,2,9,3,24
191102448,0,3,8,6,0,17
191102449,5,8,7,5,7,32
191102450,6,5,6,7,1,25
191102451,1,9,8,2,5,25
191102452,7,2,6,9,1,25
191102453,5,1,4,4,8,22
191102454,6,0,2,3,7,18
191102455,3,9,1,2,0,15
191102456,6,8,0,3,1,18
191102457,7,7,4,4,0,22
191102458,0,6,4,5,8,23
191102459,1,3,4,5,4,17
191102460,4,6,9,4,1,24
191102461,8,9,1,8,7,33
191102462,3,0,0,3,0,6
191102463,1,1,2,8,0,12
191102464,6,7,2,1,6,22
191102465,0,9,5,5,8,27
191102466,2,5,2,2,1,12
191102467,1,6,1,8,6,22
191102468,3,9,2,9,7,30
191102469,3,8,0,0,9,20
191102470,9,3,1,7,5,25
191102471,5,8,1,1,3,18
191102472,3,6,2,7,6,24
191102473,6,3,3,1,0,13
191102474,7,1,7,2,9,26
191102475,2,8,3,0,8,21
191102476,6,1,3,0,9,19
191102477,6,3,5,1,4,19
191102478,2,8,0,0,9,19
191102479,1,6,5,4,9,25
191102480,1,0,7,2,6,16
191102481,8,1,3,1,1,14
191102482,4,7,5,0,7,23
191102483,7,4,7,0,7,25
191102484,8,7,8,5,7,35
191102485,2,0,4,9,5,20
191102486,1,4,3,2,5,15
191102487,7,7,8,3,6,31
191102488,2,8,7,1,8,26
191102489,2,5,7,3,7,24
191102490,4,6,4,1,1,16
191102491,7,2,9,2,9,29
191102492,1,6,0,0,7,14
191102493,2,5,5,4,9,25
191102494,6,2,9,1,5,23
191102495,5,9,5,8,4,31
191102496,9,0,2,5,4,20
191102497,3,6,1,0,3,13
191102498,6,0,2,1,0,9
191102499,2,8,1,8,1,20
191102500,6,4,2,1,2,15
191102501,1,3,3,7,2,16
191102502,7,4,9,3,2,25
191102503,3,8,6,0,0,17
191102504,7,4,0,7,2,20
191102505,3,0,6,2,8,19
191102506,7,7,7,8,6,35
191102507,0,6,7,9,2,24
191102508,7,5,7,0,0,19
191102509,7,0,8,8,8,31
191102510,8,9,3,7,1,28
191102511,1,7,7,0,5,20
191102512,2,6,4,7,2,21
191102513,7,0,6,6,1,20
191102514,3,7,1,8,0,19
191102515,0,7,2,6,7,22
191102516,3,9,4,1,7,24
191102517,6,6,8,2,5,27
191102518,2,1,8,5,0,16
191102519,4,8,3,5,2,22
191102520,3,9,1,0,9,22
191102521,8,4,0,7,6,25
191102522,1,8,2,1,1,13
191102523,6,1,1,5,4,17
191102524,3,0,8,5,1,17
191102525,4,9,0,4,5,22
191102526,9,7,8,0,5,29
191102527,9,8,4,2,7,30
191102528,1,0,5,6,4,16
191102529,1,3,2,6,2,14
191102530,8,1,8,8,2,27
191102531,5,0,5,2,4,16
191102532,6,8,4,9,0,27
191102533,5,5,8,5,7,30
191102534,5,6,8,3,6,28
191102535,5,0,9,1,6,21
191102536,0,8,3,2,4,17
191102537,7,3,2,9,1,22
191102538,6,5,4,3,9,27
191102539,1,2,0,4,5,12
191102540,7,4,0,4,2,17
191102541,1,3,4,0,7,15
191102542,0,3,6,8,2,19
191102543,1,6,6,7,7,27
191102544,0,5,7,5,3,20
191102545,4,8,1,7,2,22
191102546,5,7,1,5,7,25
191102547,4,5,2,2,8,21
191102548,5,3,3,8,2,21
191102549,9,8,7,7,1,32
191102550,7,8,4,7,1,27
191102551,2,4,9,1,4,20
191102552,9,0,9,5,9,32
191102553,5,6,2,2,7,22
191102554,9,8,2,0,7,26
191102555,9,7,4,8,5,33
191102556,0,1,7,3,2,13
191102557,0,7,2,1,5,15
191102558,4,9,7,0,4,24
191102559,7,9,3,8,9,36
191102560,4,3,3,2,2,14
191102561,4,4,2,0,4,14
191102562,8,6,0,1,8,23
191102563,9,3,1,9,1,23
191102564,5,8,2,4,9,28
191102565,0,9,0,7,1,17
191102566,6,3,0,2,2,13
191102567,7,1,7,3,9,27
191102568,5,0,7,6,6,24
191102569,6,6,8,3,3,26
191102570,1,2,2,7,8,20
191102571,5,1,9,4,8,27
191102572,0,6,2,3,7,18
191102573,3,5,7,6,3,24
191102574,0,0,7,5,9,21
191102575,5,4,5,1,4,19
191102576,6,5,5,3,3,22
191102577,9,4,9,1,0,23
191102578,0,6,7,0,5,18
191102579,6,4,9,7,2,28
191102580,8,7,9,1,0,25
191102581,2,3,3,4,6,18
191102582,4,0,5,9,6,24
191102583,0,1,7,8,6,22
191102584,0,3,5,7,1,16
191102585,6,7,3,7,5,28
191102586,7,9,5,7,3,31
191102587,2,0,4,1,7,14
191102588,2,0,5,4,9,20
191102589,3,7,6,4,2,22
191102590,1,6,3,3,1,14
191102591,0,9,0,8,1,18
191102592,2,1,0,7,1,11
191102593,6,1,1,2,8,18
191102594,7,7,1,1,4,20
191102595,3,5,7,4,1,20
191102596,5,6,6,9,0,26
191102597,6,4,2,1,0,13
191102598,3,7,0,3,8,21
191102599,1,9,3,8,8,29
191102600,1,0,6,2,5,14
191102601,1,0,7,3,9,20
191102602,5,4,0,9,4,22
191102603,5,5,0,8,0,18
191102604,5,7,6,6,3,27
191102605,9,1,6,2,0,18
191102606,0,9,5,5,1,20
191102607,0,3,9,0,8,20
191102608,9,9,8,1,6,33
191102609,4,9,2,5,0,20
191102610,1,3,6,8,1,19
191102611,0,8,3,8,6,25
191102612,1,1,0,1,5,8
191102613,7,9,0,5,7,28
191102614,6,2,8,8,6,30
191102615,4,7,9,2,3,25
191102616,3,1,0,6,1,11
191102617,3,7,6,7,2,25
191102618,4,4,9,2,8,27
191102619,9,7,2,9,9,36
191102620,4,6,3,1,5,19
191102621,0,0,6,8,2,16
191102622,9,9,3,1,4,26
191102623,5,2,4,5,6,22
191102624,6,3,7,4,2,22
191102625,6,6,0,8,1,21
191102626,5,0,6,5,2,18
191102627,5,9,7,2,2,25
191102628,8,2,0,4,1,15
191102629,2,1,5,5,9,22
191102630,8,6,5,6,8,33
191102631,9,2,4,9,8,32
191102632,2,9,2,3,2,18
191102633,4,9,1,3,1,18
191102634,6,1,8,1,8,24
191102635,7,4,2,0,7,20
191102636,0,3,9,7,7,26
191102637,2,4,2,3,5,16
191102638,6,0,7,3,7,23
191102639,6,7,8,2,9,32
191102640,8,2,2,2,6,20
191102641,6,9,7,6,4,32
191102642,4,5,5,4,9,27
191102643,2,1,6,8,5,22
191102644,1,7,9,3,6,26
191102645,5,5,9,6,4,29
191102646,9,3,4,4,9,29
191102647,6,0,8,8,2,24
191102648,9,8,4,5,2,28
191102649,2,6,5,0,8,21
191102650,2,9,6,6,7,30
191102651,8,1,4,0,3,16
191102652,7,0,2,1,0,10
191102653,0,6,0,5,8,19
191102654,1,9,3,5,9,27
191102655,5,1,6,0,1,13
191102656,2,9,3,9,7,30
191102657,3,3,1,6,3,16
191102658,8,2,8,8,2,28
191102659,6,6,0,6,5,23
191102660,5,5,3,3,7,23
191102661,8,6,3,0,5,22
191102662,6,8,3,9,3,29
191102663,8,8,0,0,6,22
191102664,9,4,2,0,4,19
191102665,8,7,8,6,5,34
191102666,6,4,6,9,0,25
191102667,5,9,0,1,1,16
191102668,4,4,6,2,0,16
191102669,5,3,3,2,9,22
191102670,5,1,7,4,5,22
191102671,2,1,1,2,8,14
191102672,6,7,2,9,6,30
191102673,9,4,1,2,1,17
191102674,0,0,4,4,6,14
191102675,8,4,2,8,6,28
191102676,8,0,6,2,8,24
191102677,9,7,5,3,5,29
191102678,8,6,3,2,5,24
191102679,2,5,6,3,4,20
191102680,0,6,4,7,6,23
191102681,2,7,0,2,2,13
191102682,1,0,0,3,2,6
191102683,0,7,0,4,6,17
191102684,2,7,0,7,6,22
191102685,6,2,3,1,8,20
191102686,7,9,1,8,6,31
191102687,6,6,0,3,7,22
191102688,7,6,6,4,7,30
191102689,5,7,3,6,9,30
191102690,6,7,7,4,2,26
191102691,6,8,0,2,7,23
191102692,7,7,5,6,4,29
191102693,5,5,2,4,4,20
191102694,7,9,8,1,0,25
191102695,1,5,5,0,4,15
191102696,3,4,0,7,5,19
191102697,5,8,5,8,3,29
191102698,0,4,1,7,5,17
191102699,2,0,4,5,2,13
191102700,2,7,4,0,0,13
191102701,9,7,1,4,1,22
191102702,3,7,2,9,9,30
191102703,5,0,8,7,1,21
191102704,6,4,3,6,4,23
191102705,8,2,1,3,0,14
191102706,9,7,4,9,6,35
191102707,7,6,5,0,9,27
191102708,7,8,1,8,3,27
191102709,1,6,8,6,2,23
191102710,7,2,1,3,9,22
191102711,5,3,5,5,0,18
191102712,1,0,0,8,0,9
191102713,1,6,4,5,5,21
191102714,8,4,3,1,6,22
191102715,0,5,5,6,4,20
191102716,7,4,9,4,6,30
191102717,4,5,0,4,6,19
191102718,5,0,3,6,0,14
191102719,8,5,1,3,7,24
191102720,7,8,9,1,7,32
191102721,2,0,7,7,6,22
191102722,7,9,8,7,5,36
191102723,2,3,5,3,8,21
191102724,8,4,4,0,4,20
191102725,3,7,1,9,3,23
191102726,8,6,5,2,8,29
191102727,2,8,3,8,5,26
191102728,1,1,8,3,2,15
191102729,9,4,5,1,5,24
191102730,4,0,4,2,8,18
191102731,0,4,0,6,6,16
191102732,5,4,3,7,1,20
191102733,8,5,5,3,2,23
191102734,4,0,0,5,8,17
191102735,2,4,5,1,4,16
191102736,2,6,3,9,5,25
191102737,0,9,9,8,4,30
191102738,4,9,0,8,1,22
191102739,6,2,4,9,0,21
191102740,2,1,5,4,8,20
191102741,4,2,2,7,7,22
191102742,7,1,9,0,5,22
191102743,2,8,6,9,7,32
191102744,1,7,6,1,5,20
191102745,3,7,6,1,0,17
191102746,7,5,7,7,7,33
191102747,5,2,1,7,2,17
191102748,0,3,5,4,3,15
191102749,3,4,1,9,3,20
191102750,4,5,9,0,5,23
191102751,4,7,5,0,5,21
191102752,4,2,9,8,2,25
191102753,7,3,7,4,9,30
191102754,0,5,8,8,2,23
191102755,0,3,8,1,2,14
191102756,1,8,2,9,1,21
191102757,5,2,5,9,0,21
191102758,8,1,5,0,7,21
191102759,0,7,3,4,9,23
191102760,7,0,0,2,0,9
191102761,2,7,6,9,3,27
191102762,6,7,7,0,8,28
191102763,9,3,0,1,8,21
191102764,0,8,4,9,9,30
191102765,0,5,2,7,2,16
191102766,5,0,6,0,8,19
191102767,3,4,9,8,3,27
191102768,1,8,3,7,8,27
191102769,9,3,0,6,3,21
191102770,0,9,4,9,0,22
191102771,5,5,0,2,6,18
191102772,4,5,6,0,9,24
191102773,1,2,0,7,7,17
191102774,2,9,3,4,6,24
191102775,1,9,0,9,8,27
191102776,6,7,5,6,9,33
191102777,5,8,6,1,0,20
191102778,5,0,1,6,6,18
191102779,0,4,9,5,3,21
191102780,2,0,5,9,6,22
191102781,6,3,6,7,5,27
191102782,5,8,4,5,4,26
191102783,0,8,3,4,6,21
191102784,2,4,6,2,5,19
191102785,9,9,9,4,3,34
191102786,7,7,2,6,8,30
191102787,6,9,5,8,8,36
191102788,2,4,2,0,7,15
191102789,3,2,1,1,0,7
191102790,9,7,1,6,2,25
191102791,4,0,7,8,5,24
191102792,1,5,8,6,3,23
191102793,9,9,0,5,9,32
191102794,1,7,3,1,8,20
191102795,3,7,0,8,0,18
191102796,4,2,6,0,5,17
191102797,6,9,6,2,6,29
191102798,3,7,3,6,1,20
191102799,3,4,8,7,1,23
191102800,6,8,6,0,5,25
191102801,9,0,1,6,1,17
191102802,8,4,0,2,1,15
191102803,6,4,4,1,8,23
191102804,0,9,4,8,7,28
191102805,2,5,3,0,2,12
191102806,8,7,2,5,6,28
191102807,9,9,4,9,6,37
191102808,6,9,3,5,5,28
191102809,7,2,3,0,1,13
191102810,5,3,1,9,3,21
191102811,5,8,3,4,8,28
191102812,4,3,5,1,3,16
191102813,5,5,9,8,7,34
191102814,0,7,3,5,0,15
191102815,2,0,6,3,3,14
191102816,0,1,5,3,0,9
191102817,6,2,3,9,0,20
191102818,2,9,4,1,9,25
191102819,3,3,4,0,9,19
191102820,4,4,7,7,9,31
191102821,1,0,4,6,4,15
191102822,6,7,6,7,6,32
191102823,3,8,5,3,6,25
191102824,0,4,4,1,1,10
191102825,5,8,4,0,3,20
191102826,0,1,1,3,0,5
191102827,4,9,3,1,9,26
191102828,6,6,2,2,8,24
191102829,7,8,0,4,8,27
191102830,3,6,4,9,3,25
191102831,4,7,5,4,1,21
191102832,6,9,9,4,6,34
191102833,4,3,3,8,9,27
191102834,8,4,2,3,4,21
191102835,0,5,2,9,5,21
191102836,4,4,7,1,4,20
191102837,4,6,5,9,1,25
191102838,2,0,7,2,9,20
191102839,7,0,8,8,5,28
191102840,4,6,0,2,0,12
191102841,0,9,8,8,9,34
191102842,4,3,7,8,5,27
191102843,3,0,8,2,2,15
191102844,5,8,0,3,3,19
191102845,7,0,1,6,3,17
191102846,1,1,8,8,0,18
191102847,3,2,5,9,6,25
191102848,5,0,7,8,2,22
191102849,8,7,1,5,1,22
191102850,9,6,7,3,6,31
191102851,8,9,1,2,4,24
191102852,4,6,9,7,3,29
191102853,1,4,5,8,9,27
191102854,2,7,3,2,1,15
191102855,8,2,7,1,9,27
191102856,8,6,6,2,8,30
191102857,6,3,7,2,6,24
191102858,2,6,7,5,3,23
191102859,7,3,6,0,1,17
191102860,3,3,0,6,1,13
191102861,4,8,5,4,0,21
191102862,2,6,7,8,1,24
191102863,4,2,9,9,1,25
191102864,1,6,7,1,9,24
191102865,0,1,2,2,6,11
191102866,4,7,9,8,6,34
191102867,6,2,3,1,1,13
191102868,2,1,8,4,5,20
191102869,7,8,8,4,7,34
191102870,6,6,8,2,4,26
191102871,4,8,8,3,5,28
191102872,4,3,9,6,2,24
191102873,3,8,6,9,9,35
191102874,7,6,6,0,2,21
191102875,5,5,2,6,7,25
191102876,1,5,9,2,8,25
191102877,1,2,1,9,6,19
191102878,8,3,2,4,9,26
191102879,5,3,7,1,0,16
191102880,5,8,2,0,9,24
191102881,2,1,9,8,5,25
191102882,7,0,5,5,5,22
191102883,7,6,0,2,7,22
191102884,0,1,1,4,7,13
191102885,3,1,7,3,4,18
191102886,1,4,7,2,0,14
191102887,8,2,6,2,5,23
191102888,4,8,6,8,8,34
191102889,9,1,7,8,1,26
191102890,0,0,9,4,2,15
191102891,6,2,7,0,5,20
191102892,0,2,6,0,3,11
191102893,7,1,0,5,7,20
191102894,2,9,1,2,4,18
191102895,7,5,7,2,8,29
191102896,2,6,6,5,7,26
191102897,6,2,8,6,0,22
191102898,6,1,1,7,2,17
191102899,3,5,8,8,2,26
191102900,8,4,3,7,7,29
191102901,2,7,3,7,2,21
191102902,0,9,7,1,3,20
191102903,8,0,9,2,3,22
191102904,4,9,1,7,8,29
191102905,6,5,7,1,6,25
191102906,0,1,1,6,6,14
191102907,5,6,9,4,0,24
191102908,0,6,1,6,9,22
191102909,9,9,1,2,0,21
191102910,5,8,9,0,8,30
191102911,3,7,4,0,3,17
191102912,4,4,4,7,5,24
191102913,9,5,8,1,0,23
191102914,4,1,4,0,7,16
191102915,9,9,4,3,1,26
191102916,1,8,4,6,8,27
191102917,8,9,7,1,1,26
191102918,0,9,2,0,6,17
191102919,7,7,8,0,7,29
191102920,6,6,4,3,5,24
191102921,7,0,0,5,0,12
191102922,3,5,5,5,2,20
191102923,3,6,0,1,0,10
191102924,9,0,5,5,3,22
191102925,7,9,4,1,6,27
191102926,0,3,5,0,8,16
191102927,0,1,1,4,0,6
191102928,2,4,3,4,0,13
191102929,9,2,3,9,3,26
191102930,2,4,2,9,5,22
191102931,7,9,3,5,9,33
191102932,6,6,0,4,8,24
191102933,4,4,5,7,9,29
191102934,6,9,0,6,4,25
191102935,8,4,6,3,2,23
191102936,8,4,4,9,6,31
191102937,4,1,3,2,8,18
191102938,8,8,6,4,1,27
191102939,7,9,5,3,8,32
191102940,0,5,1,7,9,22
191102941,7,7,0,1,3,18
191102942,8,5,5,4,2,24
191102943,4,4,7,2,9,26
191102944,5,3,9,0,4,21
191102945,0,0,0,1,1,2
191102946,5,8,2,0,3,18
191102947,4,1,7,0,8,20
191102948,7,2,4,5,6,24
191102949,0,2,4,2,4,12
191102950,5,2,4,9,3,23
191102951,1,8,0,8,0,17
191102952,3,5,9,8,4,29
191102953,7,2,1,9,3,22
191102954,6,0,6,6,1,19
191102955,1,2,4,2,9,18
191102956,6,8,7,8,5,34
191102957,2,8,2,0,8,20
191102958,8,2,3,3,7,23
191102959,5,8,9,2,0,24
191102960,0,8,5,1,8,22
191102961,5,5,4,2,5,21
191102962,6,2,4,8,3,23
191102963,1,6,0,3,5,15
191102964,6,8,4,9,8,35
191102965,9,0,0,1,2,12
191102966,5,1,7,8,7,28
191102967,2,9,0,1,7,19
191102968,5,2,4,4,5,20
191102969,5,0,9,1,8,23
191102970,3,9,6,2,3,23
191102971,3,9,5,6,5,28
191102972,2,8,4,6,0,20
191102973,9,8,8,1,4,30
191102974,5,0,2,4,6,17
191102975,4,8,6,6,7,31
191102976,7,1,1,3,1,13
191102977,0,6,2,5,8,21
191102978,0,8,9,1,7,25
191102979,9,8,4,4,9,34
191102980,9,6,2,3,6,26
191102981,3,2,2,8,2,17
191102982,9,8,6,1,3,27
191102983,0,6,7,2,7,22
191102984,2,2,3,1,5,13
191102985,0,3,3,5,8,19
191102986,2,2,4,6,3,17
191102987,8,5,8,5,5,31
191102988,9,5,9,8,3,34
191102989,6,6,9,6,0,27
191102990,7,7,9,3,6,32
191102991,7,8,7,6,2,30
191102992,4,3,0,1,1,9
191102993,1,3,6,1,6,17
191102994,7,8,3,8,1,27
191102995,3,3,1,4,2,13
191102996,9,1,6,2,1,19
191102997,3,2,9,4,7,25
191102998,1,4,1,0,8,14
191102999,6,1,5,7,3,22
1911021000,2,1,4,2,2,11
1911021001,4,0,9,8,8,29
1911021002,0,7,6,9,2,24
1911021003,0,5,1,5,8,19
1911021004,3,8,8,4,1,24
1911021005,8,3,2,0,2,15
1911021006,9,8,4,0,7,28
1911021007,2,6,5,5,6,24
1911021008,0,1,2,5,4,12
1911021009,4,0,9,2,0,15
1911021010,7,6,6,7,5,31
1911021011,9,8,9,5,2,33
1911021012,5,3,3,0,9,20
1911021013,0,6,9,0,3,18
1911021014,2,2,9,6,1,20
1911021015,7,2,5,1,4,19
1911021016,6,6,1,7,4,24
1911021017,0,4,3,3,5,15
1911021018,8,4,8,9,6,35
1911021019,1,2,0,2,5,10
1911021020,6,0,7,9,3,25
1911021021,3,5,5,9,9,31
1911021022,4,2,1,8,9,24
1911021023,3,2,1,4,7,17
1911021024,6,5,9,4,2,26
1911021025,2,2,3,0,5,12
1911021026,5,4,4,9,0,22
1911021027,1,6,7,9,6,29
1911021028,1,1,4,5,9,20
1911021029,0,9,3,4,6,22
1911021030,0,3,0,5,4,12
1911021031,0,2,0,9,4,15
1911021032,3,9,2,1,0,15
1911021033,0,4,7,2,7,20
1911021034,8,5,4,7,3,27
1911021035,4,4,9,6,1,24
1911021036,7,7,4,6,9,33
1911021037,9,4,5,2,1,21
1911021038,0,5,1,3,4,13
1911021039,4,1,3,8,9,25
1911021040,1,3,7,6,7,24
1911021041,9,4,1,6,2,22
1911021042,8,6,3,3,7,27
1911021043,6,5,3,3,2,19
1911021044,0,5,1,0,0,6
1911021045,7,9,5,5,2,28
1911021046,6,4,4,1,7,22
1911021047,5,5,7,4,7,28
1911021048,6,7,8,3,4,28
1911021049,7,4,4,6,1,22
1911021050,3,3,5,3,6,20
1911021051,8,4,9,2,1,24
1911021052,5,1,2,6,1,15
1911021053,7,5,6,8,4,30
1911021054,6,3,8,0,1,18
1911021055,8,3,2,4,7,24
1911021056,2,6,3,3,6,20
1911021057,4,9,0,3,8,24
1911021058,2,2,5,5,8,22
1911021059,9,4,0,3,3,19
1911021060,4,2,2,0,2,10
1911021061,0,1,3,7,1,12
1911021062,5,1,1,3,0,10
1911021063,0,3,7,2,5,17
1911021064,7,7,6,8,6,34
1911021065,1,9,2,7,6,25
1911021066,4,3,2,4,5,18
1911021067,2,1,2,2,5,12
1911021068,3,1,8,1,8,21
1911021069,9,3,6,7,5,30
1911021070,9,0,9,9,4,31
1911021071,5,5,8,5,5,28
1911021072,1,8,5,7,5,26
1911021073,8,4,3,2,2,19
1911021074,8,7,1,3,7,26
1911021075,6,2,2,0,9,19
1911021076,0,5,8,0,1,14
1911021077,8,8,0,0,3,19
1911021078,3,6,0,3,9,21
1911021079,6,9,2,5,7,29
1911021080,2,6,6,0,4,18
1911021081,1,8,8,2,5,24
1911021082,1,6,8,2,1,18
1911021083,2,9,4,2,3,20
1911021084,0,3,7,9,8,27
1911021085,7,2,4,6,8,27
1911021086,4,3,7,9,8,31
1911021087,5,0,1,1,4,11
1911021088,4,4,5,0,8,21
1911021089,2,8,8,8,1,27
1911021090,1,4,5,9,2,21
1911021091,5,5,8,3,9,30
1911021092,1,0,3,6,2,12
1911021093,9,4,7,4,5,29
1911021094,5,6,3,0,8,22
1911021095,9,5,4,4,0,22
1911021096,5,7,8,3,9,32
1911021097,1,6,0,7,3,17
1911021098,7,8,2,6,9,32
1911021099,6,2,6,8,1,23
1911021100,8,9,4,3,0,24
1911021101,8,0,5,8,9,30
1911021102,3,7,5,4,6,25
1911021103,6,2,8,2,2,20
1911021104,5,6,0,5,1,17
1911021105,3,0,5,4,8,20
191103001,7,7,5,0,7,26
191103002,1,1,5,0,2,9
191103003,7,4,6,6,2,25
191103004,1,4,8,4,0,17
191103005,0,6,6,3,6,21
191103006,2,9,6,5,8,30
191103007,1,6,1,6,3,17
191103008,9,8,3,5,1,26
191103009,2,9,5,4,4,24
191103010,4,5,3,8,1,21
191103011,6,1,3,9,4,23
191103012,6,9,3,4,6,28
191103013,4,1,6,8,0,19
191103014,8,1,0,2,6,17
191103015,3,1,4,5,9,22
191103016,7,0,3,8,2,20
191103017,9,6,7,4,5,31
191103018,9,8,8,2,2,29
191103019,1,5,7,4,6,23
191103020,6,0,0,9,2,17
191103021,6,6,7,1,6,26
191103022,6,0,2,1,9,18
191103023,0,4,1,2,6,13
191103024,8,6,9,3,0,26
191103025,2,8,8,2,5,25
191103026,9,4,3,3,2,21
191103027,9,1,5,8,8,31
191103028,9,5,7,5,3,29
191103029,1,5,3,5,5,19
191103030,1,4,1,3,7,16
191103031,1,2,6,5,3,17
191103032,0,9,1,5,6,21
191103033,4,6,6,8,1,25
191103034,2,9,0,9,9,29
191103035,0,3,0,3,6,12
191103036,1,8,9,2,5,25
191103037,6,3,3,4,0,16
191103038,4,0,1,6,5,16
191103039,7,6,5,8,5,31
191103040,0,9,0,4,5,18
191103041,5,3,4,5,9,26
191103042,3,8,8,9,7,35
191103043,9,6,1,0,7,23
191103044,7,3,0,8,8,26
191103045,5,6,3,8,9,31
191103046,4,3,2,2,4,15
191103047,6,6,0,1,1,14
191103048,9,6,5,5,6,31
191103049,8,2,4,1,9,24
191103050,4,1,1,5,9,20
191103051,8,4,3,6,6,27
191103052,9,6,2,9,1,27
191103053,9,0,7,2,0,18
191103054,6,8,1,5,3,23
191103055,0,0,6,7,9,22
191103056,0,5,9,1,6,21
191103057,6,3,9,5,3,26
191103058,9,8,9,9,0,35
191103059,2,7,1,5,6,21
191103060,1,6,9,3,5,24
191103061,2,1,2,6,0,11
191103062,7,3,6,4,3,23
191103063,5,1,7,0,7,20
191103064,2,4,6,5,4,21
191103065,3,6,8,8,9,34
191103066,7,8,5,7,8,35
191103067,7,0,2,6,6,21
191103068,6,9,9,1,3,28
191103069,1,7,6,4,6,24
191103070,8,5,7,8,9,37
191103071,9,6,8,7,4,34
191103072,8,3,7,8,8,34
191103073,3,7,1,2,1,14
191103074,5,2,8,9,0,24
191103075,2,3,6,4,0,15
191103076,7,0,2,3,8,20
191103077,2,6,3,6,1,18
191103078,1,9,0,0,9,19
191103079,3,9,5,5,8,30
191103080,1,0,3,1,9,14
191103081,3,5,9,6,7,30
191103082,3,0,7,8,5,23
191103083,7,3,4,5,5,24
191103084,5,3,5,7,2,22
191103085,0,3,7,9,2,21
191103086,4,6,8,6,2,26
191103087,0,6,0,8,8,22
191103088,2,4,7,6,2,21
191103089,8,1,5,4,7,25
191103090,9,7,8,7,0,31
191103091,8,0,1,0,8,17
191103092,7,2,7,5,8,29
191103093,9,6,0,5,1,21
191103094,2,2,3,0,8,15
191103095,3,0,6,4,2,15
191103096,7,5,5,8,8,33
191103097,3,5,3,1,5,17
191103098,0,8,6,7,3,24
191103099,0,0,2,2,1,5
191103100,7,7,1,4,2,21
191103101,7,2,5,7,9,30
191103102,8,1,5,6,9,29
191103103,8,7,3,1,3,22
191103104,8,6,0,7,3,24
191103105,8,3,6,5,3,25
191103106,2,2,2,2,4,12
191103107,0,5,9,8,7,29
191103108,7,9,9,8,9,42
191103109,2,9,9,6,1,27
191103110,7,9,7,6,4,33
191103111,5,0,8,0,8,21
191103112,4,3,0,4,3,14
191103113,7,3,5,4,0,19
191103114,6,8,7,3,7,31
191103115,1,1,9,5,4,20
191103116,7,7,6,2,9,31
191103117,6,2,8,8,7,31
191103118,6,3,1,3,0,13
191103119,8,7,2,1,3,21
191103120,1,0,7,6,4,18
191103121,3,2,7,1,8,21
191103122,8,3,4,4,6,25
191103123,8,2,9,9,5,33
191103124,8,3,1,9,7,28
191103125,6,5,2,2,1,16
191103126,6,5,4,8,0,23
191103127,7,5,9,7,1,29
191103128,7,0,2,1,4,14
191103129,8,6,3,4,0,21
191103130,1,6,1,5,9,22
191103131,2,2,8,9,4,25
191103132,6,2,6,8,3,25
191103133,1,1,5,1,4,12
191103134,1,6,5,2,7,21
191103135,5,2,3,2,1,13
191103136,2,5,8,6,5,26
191103137,0,1,6,6,6,19
191103138,7,6,9,6,5,33
191103139,2,6,3,5,9,25
191103140,1,0,2,4,9,16
191103141,1,3,4,9,6,23
191103142,1,4,5,0,4,14
191103143,5,8,5,6,8,32
191103144,8,9,7,7,1,32
191103145,2,4,1,7,4,18
191103146,8,5,0,3,9,25
191103147,2,7,1,3,6,19
191103148,1,3,6,5,6,21
191103149,8,4,6,8,9,35
191103150,0,3,8,3,8,22
191103151,7,2,0,4,8,21
191103152,7,7,8,2,6,30
191103153,7,7,3,6,6,29
191103154,4,6,1,6,4,21
191103155,0,2,5,0,9,16
191103156,6,1,0,6,3,16
191103157,4,8,5,2,9,28
191103158,2,4,8,7,0,21
191103159,3,7,4,7,5,26
191103160,4,5,7,7,1,24
191103161,2,2,3,2,6,15
191103162,2,7,0,9,0,18
191103163,6,0,8,8,1,23
191103164,1,1,7,5,8,22
191103165,8,9,2,0,3,22
191103166,1,9,6,9,5,30
191103167,0,1,4,0,0,5
191103168,3,8,7,0,7,25
191103169,1,1,7,7,5,21
191103170,6,9,0,9,1,25
191103171,9,4,1,9,6,29
191103172,3,0,4,8,9,24
191103173,8,7,9,0,6,30
191103174,1,2,6,2,5,16
191103175,9,4,4,5,6,28
191103176,9,6,4,4,7,30
191103177,0,8,3,4,2,17
191103178,8,0,2,1,9,20
191103179,1,1,6,1,8,17
191103180,5,1,2,8,3,19
191103181,6,4,5,8,0,23
191103182,3,5,5,6,2,21
191103183,0,8,5,2,1,16
191103184,1,1,5,8,7,22
191103185,2,5,1,8,6,22
191103186,4,7,4,9,9,33
191103187,5,0,2,2,4,13
191103188,9,6,3,4,5,27
191103189,2,0,0,4,6,12
191103190,8,8,1,9,8,34
191103191,8,2,1,3,6,20
191103192,5,5,3,5,5,23
191103193,9,9,4,7,7,36
191103194,1,1,9,1,4,16
191103195,5,2,6,5,0,18
191103196,2,0,9,5,2,18
191103197,2,3,7,6,7,25
191103198,7,1,9,0,4,21
191103199,3,7,5,9,9,33
191103200,9,5,3,0,6,23
191103201,3,4,2,6,3,18
191103202,7,4,0,6,6,23
191103203,2,8,8,9,6,33
191103204,4,1,1,8,0,14
191103205,1,9,9,0,2,21
191103206,3,3,9,3,3,21
191103207,7,8,7,2,7,31
191103208,7,1,9,4,1,22
191103209,7,4,5,2,9,27
191103210,5,9,2,8,4,28
191103211,4,2,3,9,8,26
191103212,4,1,0,1,2,8
191103213,2,6,8,8,1,25
191103214,7,5,2,2,0,16
191103215,2,0,0,8,5,15
191103216,5,8,2,6,5,26
191103217,0,8,5,2,2,17
191103218,2,1,2,9,9,23
191103219,4,1,9,6,8,28
191103220,6,8,0,5,4,23
191103221,2,2,1,8,1,14
191103222,8,8,5,9,0,30
191103223,4,9,4,8,3,28
191103224,4,3,3,1,3,14
191103225,5,6,0,6,1,18
191103226,5,4,2,8,4,23
191103227,4,3,1,3,5,16
191103228,7,0,5,9,1,22
191103229,2,1,8,7,3,21
191103230,0,8,4,8,4,24
191103231,1,9,8,5,3,26
191103232,7,2,4,9,1,23
191103233,3,4,6,6,5,24
191103234,8,7,9,3,2,29
191103235,1,3,6,5,9,24
191103236,9,0,4,8,4,25
191103237,4,2,9,5,8,28
191103238,4,3,7,2,1,17
191103239,1,3,0,6,2,12
191103240,4,4,1,5,3,17
191103241,3,5,3,1,7,19
191103242,4,6,4,8,2,24
191103243,7,7,5,1,8,28
191103244,2,3,4,6,4,19
191103245,7,5,5,3,8,28
191103246,4,4,5,3,8,24
191103247,0,3,2,1,4,10
191103248,1,7,8,0,7,23
191103249,6,5,0,4,1,16
191103250,8,3,6,4,2,23
191103251,0,3,4,6,4,17
191103252,8,2,4,7,0,21
191103253,5,2,2,4,9,22
191103254,3,9,4,9,0,25
191103255,3,8,7,2,8,28
191103256,5,8,9,5,9,36
191103257,9,2,3,9,9,32
191103258,2,1,9,0,6,18
191103259,2,5,1,1,2,11
191103260,4,1,5,7,0,17
191103261,6,0,5,5,0,16
191103262,8,8,2,5,6,29
191103263,6,8,1,5,7,27
191103264,6,9,3,7,2,27
191103265,4,5,0,0,7,16
191103266,5,1,8,9,5,28
191103267,0,6,9,1,4,20
191103268,2,8,5,9,2,26
191103269,8,8,5,1,5,27
191103270,3,2,5,7,7,24
191103271,5,5,9,0,2,21
191103272,2,2,3,6,0,13
191103273,2,1,7,7,0,17
191103274,4,2,3,3,5,17
191103275,8,0,2,5,5,20
191103276,7,8,2,8,2,27
191103277,9,2,5,4,0,20
191103278,2,1,1,8,1,13
191103279,5,0,4,8,1,18
191103280,3,4,4,8,1,20
191103281,7,1,6,1,3,18
191103282,5,8,1,9,1,24
191103283,6,3,6,5,6,26
191103284,6,8,6,2,8,30
191103285,9,4,2,6,7,28
191103286,9,9,2,7,2,29
191103287,0,1,7,2,6,16
191103288,0,2,5,4,7,18
191103289,2,6,7,3,0,18
191103290,8,7,6,4,1,26
191103291,4,7,9,6,4,30
191103292,8,9,1,7,0,25
191103293,3,9,8,2,9,31
191103294,5,8,2,2,5,22
191103295,0,5,2,3,4,14
191103296,9,4,8,8,7,36
191103297,2,5,0,5,8,20
191103298,8,6,6,1,4,25
191103299,5,8,8,5,7,33
191103300,0,8,4,2,7,21
191103301,9,0,2,4,2,17
191103302,0,0,3,5,4,12
191103303,1,3,2,3,3,12
191103304,7,5,8,6,1,27
191103305,9,0,4,3,2,18
191103306,6,3,4,2,0,15
191103307,9,7,8,4,8,36
191103308,5,6,4,7,7,29
191103309,9,4,8,0,5,26
191103310,5,6,5,1,6,23
191103311,2,5,9,5,1,22
191103312,8,5,4,3,9,29
191103313,6,3,3,4,7,23
191103314,1,7,8,5,8,29
191103315,8,8,0,9,5,30
191103316,4,7,1,0,2,14
191103317,4,1,7,2,9,23
191103318,9,2,4,0,1,16
191103319,6,2,6,3,7,24
191103320,0,3,4,8,2,17
191103321,4,8,6,2,1,21
191103322,8,1,8,6,2,25
191103323,8,5,4,8,0,25
191103324,0,3,9,1,9,22
191103325,1,3,3,6,6,19
191103326,7,9,0,7,6,29
191103327,6,4,6,6,8,30
191103328,7,6,7,0,8,28
191103329,4,9,4,8,9,34
191103330,8,8,3,1,8,28
191103331,8,0,0,3,9,20
191103332,4,6,6,1,3,20
191103333,8,0,4,2,9,23
191103334,9,7,6,8,4,34
191103335,1,9,8,8,7,33
191103336,6,6,2,2,5,21
191103337,2,0,7,9,3,21
191103338,2,6,2,8,1,19
191103339,8,5,6,9,3,31
191103340,9,9,7,2,3,30
191103341,5,5,4,1,8,23
191103342,4,8,8,2,4,26
191103343,7,9,1,8,0,25
191103344,5,5,3,1,4,18
191103345,3,2,6,0,6,17
191103346,0,9,4,7,7,27
191103347,2,6,4,3,0,15
191103348,0,6,0,4,5,15
191103349,4,1,5,5,6,21
191103350,3,5,3,0,2,13
191103351,1,0,2,3,4,10
191103352,9,6,6,7,7,35
191103353,3,6,8,5,2,24
191103354,7,9,8,4,3,31
191103355,1,1,1,7,2,12
191103356,9,4,0,5,2,20
191103357,6,3,2,0,3,14
191103358,0,3,0,1,0,4
191103359,2,6,7,9,0,24
191103360,0,7,4,9,9,29
191103361,5,0,8,8,8,29
191103362,1,2,5,8,7,23
191103363,8,6,6,9,8,37
191103364,5,9,4,1,1,20
191103365,4,0,7,5,8,24
191103366,7,1,1,9,9,27
191103367,8,4,8,2,9,31
191103368,5,3,4,0,5,17
191103369,4,4,2,8,5,23
191103370,5,9,7,9,6,36
191103371,2,3,9,0,1,15
191103372,9,8,7,2,0,26
191103373,1,9,6,9,9,34
191103374,8,4,2,2,7,23
191103375,0,7,5,6,2,20
191103376,7,0,6,1,7,21
191103377,2,8,4,1,1,16
191103378,4,6,0,0,2,12
191103379,7,0,5,2,3,17
191103380,9,1,2,9,7,28
191103381,7,8,2,1,7,25
191103382,8,7,9,1,8,33
191103383,2,7,5,2,9,25
191103384,6,2,5,5,7,25
191103385,8,3,4,5,1,21
191103386,9,4,9,6,6,34
191103387,2,5,7,6,3,23
191103388,5,7,2,3,4,21
191103389,3,1,4,6,2,16
191103390,1,5,8,8,2,24
191103391,8,1,3,7,8,27
191103392,1,9,0,3,2,15
191103393,6,9,9,4,3,31
191103394,0,8,8,5,5,26
191103395,9,7,5,4,6,31
191103396,9,9,1,0,3,22
191103397,6,9,5,7,5,32
191103398,9,6,5,6,9,35
191103399,3,8,9,0,1,21
191103400,3,1,1,7,3,15
191103401,1,8,1,5,5,20
191103402,1,1,5,5,4,16
191103403,6,4,6,1,0,17
191103404,6,5,3,0,7,21
191103405,5,3,6,3,2,19
191103406,8,3,9,0,1,21
191103407,0,2,8,0,2,12
191103408,6,7,7,9,9,38
191103409,0,7,6,3,2,18
191103410,7,9,2,9,3,30
191103411,8,8,8,3,7,34
191103412,9,0,5,4,4,22
191103413,6,8,1,9,3,27
191103414,9,9,9,2,9,38
191103415,7,7,4,9,4,31
191103416,3,0,8,6,0,17
191103417,1,9,0,6,8,24
191103418,9,8,9,6,3,35
191103419,4,7,0,8,9,28
191103420,3,8,6,5,0,22
191103421,8,2,5,1,1,17
191103422,9,9,4,6,0,28
191103423,7,8,1,8,2,26
191103424,5,2,6,5,8,26
191103425,4,2,7,4,9,26
191103426,6,2,1,2,3,14
191103427,6,2,7,8,1,24
191103428,8,0,5,6,2,21
191103429,2,3,2,6,9,22
191103430,5,0,4,4,7,20
191103431,6,3,0,3,6,18
191103432,0,2,8,5,8,23
191103433,9,6,7,8,3,33
191103434,9,3,6,4,9,31
191103435,1,6,5,1,6,19
191103436,8,2,8,3,3,24
191103437,1,6,9,4,4,24
191103438,5,6,1,2,5,19
191103439,9,0,3,5,9,26
191103440,6,3,9,9,6,33
191103441,4,2,5,2,8,21
191103442,9,8,4,7,1,29
191103443,5,0,8,8,7,28
191103444,7,8,6,5,2,28
191103445,8,3,1,3,5,20
191103446,6,2,5,8,7,28
191103447,2,6,5,1,9,23
191103448,0,1,2,6,2,11
191103449,7,4,6,8,0,25
191103450,3,0,3,6,0,12
191103451,8,5,8,8,9,38
191103452,0,0,7,7,8,22
191103453,7,9,1,2,3,22
191103454,3,5,6,8,6,28
191103455,0,1,6,1,8,16
191103456,5,0,7,7,7,26
191103457,7,4,4,0,2,17
191103458,3,7,3,2,0,15
191103459,5,0,4,4,2,15
191103460,2,6,7,3,6,24
191103461,1,2,4,8,3,18
191103462,5,1,6,5,3,20
191103463,3,4,1,3,8,19
191103464,8,9,9,3,1,30
191103465,4,5,1,1,2,13
191103466,8,3,8,7,0,26
191103467,1,1,9,6,0,17
191103468,2,1,6,8,2,19
191103469,3,7,8,1,6,25
191103470,1,4,3,2,4,14
191103471,5,4,7,0,4,20
191103472,1,8,7,2,2,20
191103473,5,4,6,0,2,17
191103474,5,1,9,7,2,24
191103475,9,0,2,7,4,22
191103476,0,3,1,2,6,12
191103477,8,1,3,4,9,25
191103478,3,4,3,5,5,20
191103479,8,0,0,2,1,11
191103480,2,0,1,6,4,13
191103481,9,9,8,4,6,36
191103482,2,0,3,0,2,7
191103483,9,6,0,8,4,27
191103484,5,5,9,5,1,25
191103485,5,0,1,8,2,16
191103486,8,5,4,5,0,22
191103487,7,1,3,6,4,21
191103488,9,0,1,2,6,18
191103489,9,4,3,8,9,33
191103490,2,8,9,7,2,28
191103491,4,3,2,1,0,10
191103492,1,9,2,8,7,27
191103493,8,7,6,4,7,32
191103494,2,5,2,7,7,23
191103495,7,8,7,0,1,23
191103496,8,6,9,3,4,30
191103497,8,5,1,4,4,22
191103498,8,6,8,9,0,31
191103499,1,4,6,1,8,20
191103500,2,2,6,8,8,26
191103501,0,4,4,8,3,19
191103502,5,0,3,0,8,16
191103503,0,9,9,9,6,33
191103504,2,5,6,9,3,25
191103505,5,6,4,8,8,31
191103506,0,1,0,8,1,10
191103507,7,3,1,6,8,25
191103508,6,1,5,6,0,18
191103509,2,3,0,7,0,12
191103510,8,2,6,6,6,28
191103511,1,7,3,2,6,19
191103512,1,4,9,4,4,22
191103513,1,8,7,8,6,30
191103514,9,7,4,2,8,30
191103515,8,4,8,1,1,22
191103516,7,9,3,1,4,24
191103517,0,8,8,4,6,26
191103518,6,3,7,3,1,20
191103519,0,4,4,6,4,18
191103520,8,7,8,6,0,29
191103521,5,4,6,7,0,22
191103522,1,8,2,4,4,19
191103523,8,2,6,4,9,29
191103524,0,8,8,7,6,29
191103525,1,7,8,6,0,22
191103526,4,2,6,1,9,22
191103527,6,1,1,7,0,15
191103528,7,9,2,3,5,26
191103529,7,7,3,4,4,25
191103530,8,8,4,8,9,37
191103531,0,6,5,6,3,20
191103532,4,5,4,0,4,17
191103533,3,5,5,3,2,18
191103534,8,4,8,7,2,29
191103535,8,6,4,0,3,21
191103536,2,2,9,7,0,20
191103537,1,5,7,5,5,23
191103538,2,4,7,6,5,24
191103539,2,7,7,9,1,26
191103540,4,0,1,4,7,16
191103541,7,0,8,2,6,23
191103542,6,0,4,1,4,15
191103543,8,3,3,7,5,26
191103544,2,5,6,5,3,21
191103545,7,6,1,8,4,26
191103546,9,0,8,4,7,28
191103547,5,5,9,9,4,32
191103548,0,4,8,8,7,27
191103549,4,0,4,7,3,18
191103550,7,0,5,1,1,14
191103551,0,9,9,3,2,23
191103552,5,7,5,3,4,24
191103553,4,4,1,7,6,22
191103554,7,3,9,1,8,28
191103555,7,3,6,2,0,18
191103556,3,5,1,8,6,23
191103557,5,1,4,1,0,11
191103558,7,0,6,6,0,19
191103559,0,6,0,3,9,18
191103560,4,5,4,1,0,14
191103561,1,8,3,4,0,16
191103562,7,4,3,0,1,15
191103563,4,7,2,5,4,22
191103564,3,1,2,9,0,15
191103565,8,0,7,8,5,28
191103566,6,0,7,3,5,21
191103567,9,1,8,7,8,33
191103568,9,9,1,1,6,26
191103569,5,9,9,4,8,35
191103570,6,9,3,7,4,29
191103571,1,9,3,3,3,19
191103572,4,4,0,8,9,25
191103573,4,9,8,0,9,30
191103574,5,0,6,5,5,21
191103575,9,9,6,0,2,26
191103576,8,4,2,1,0,15
191103577,8,0,1,1,8,18
191103578,7,2,6,3,9,27
191103579,6,1,8,3,4,22
191103580,5,6,8,0,5,24
191103581,4,2,4,7,5,22
191103582,3,2,4,8,6,23
191103583,9,7,2,6,7,31
191103584,5,2,3,6,1,17
191103585,5,5,0,2,2,14
191103586,2,5,8,6,2,23
191103587,7,1,4,6,1,19
191103588,4,3,3,6,4,20
191103589,2,8,8,7,3,28
191103590,6,1,2,6,8,23
191103591,3,4,9,3,4,23
191103592,3,8,4,9,2,26
191103593,0,0,3,9,9,21
191103594,2,8,7,1,7,25
191103595,9,5,3,9,4,30
191103596,3,1,6,2,1,13
191103597,1,9,2,0,6,18
191103598,8,2,5,3,8,26
191103599,1,4,5,0,8,18
191103600,1,7,1,3,2,14
191103601,4,6,4,9,6,29
191103602,2,2,6,3,3,16
191103603,0,1,4,8,7,20
191103604,8,2,6,4,4,24
191103605,8,4,0,0,8,20
191103606,7,1,6,7,4,25
191103607,1,6,8,5,7,27
191103608,8,8,9,6,7,38
191103609,6,5,9,5,6,31
191103610,8,2,5,3,1,19
191103611,5,3,4,5,2,19
191103612,9,3,8,6,8,34
191103613,2,6,7,3,3,21
191103614,2,2,9,0,6,19
191103615,5,8,9,4,0,26
191103616,0,0,8,8,2,18
191103617,1,5,9,3,7,25
191103618,0,1,3,1,1,6
191103619,0,2,7,2,3,14
191103620,2,2,1,5,9,19
191103621,8,8,0,3,5,24
191103622,2,7,7,2,8,26
191103623,0,7,7,0,7,21
191103624,2,0,9,1,4,16
191103625,9,0,4,1,9,23
191103626,9,6,3,7,0,25
191103627,2,4,2,2,6,16
191103628,3,5,4,9,7,28
191103629,6,8,8,9,8,39
191103630,1,2,9,3,0,15
191103631,4,8,2,8,0,22
191103632,7,1,3,1,4,16
191103633,2,8,9,2,1,22
191103634,3,2,6,2,0,13
191103635,1,5,6,9,0,21
191103636,1,8,2,2,0,13
191103637,6,2,9,2,8,27
191103638,6,4,3,9,8,30
191103639,2,4,8,0,7,21
191103640,1,2,5,8,1,17
191103641,2,7,2,5,4,20
191103642,7,1,7,1,7,23
191103643,0,0,3,8,1,12
191103644,2,0,9,6,0,17
191103645,2,5,8,2,9,26
191103646,5,3,4,1,1,14
191103647,5,6,9,0,8,28
191103648,9,2,2,2,6,21
191103649,4,0,8,3,2,17
191103650,5,1,8,2,4,20
191103651,8,1,7,0,5,21
191103652,6,0,0,5,7,18
191103653,8,7,6,8,4,33
191103654,9,7,2,4,7,29
191103655,2,3,7,9,0,21
191103656,7,1,6,7,5,26
191103657,7,0,1,7,4,19
191103658,1,8,9,6,4,28
191103659,5,6,9,4,4,28
191103660,3,1,5,1,3,13
191103661,6,0,2,4,6,18
191103662,6,1,5,2,9,23
191103663,2,7,6,7,9,31
191103664,8,5,9,9,9,40
191103665,8,7,0,8,7,30
191103666,3,1,3,2,4,13
191103667,5,6,1,3,8,23
191103668,2,0,2,0,3,7
191103669,9,0,5,0,3,17
191103670,7,8,5,4,7,31
191103671,4,0,6,5,2,17
191103672,2,8,6,9,0,25
191103673,5,7,1,1,9,23
191103674,5,9,6,4,3,27
191103675,2,2,7,5,7,23
191103676,8,5,4,1,0,18
191103677,8,7,1,5,7,28
191103678,5,7,4,0,3,19
191103679,7,3,4,0,6,20
191103680,3,1,2,3,1,10
191103681,1,8,7,4,3,23
191103682,2,1,5,6,1,15
191103683,0,4,3,1,9,17
191103684,5,2,1,2,6,16
191103685,0,6,0,9,0,15
191103686,5,1,8,4,1,19
191103687,7,7,0,3,2,19
191103688,2,8,9,8,3,30
191103689,2,4,2,1,2,11
191103690,8,6,9,9,2,34
191103691,2,1,7,2,6,18
191103692,1,5,3,6,9,24
191103693,8,4,4,6,7,29
191103694,8,2,9,8,1,28
191103695,1,3,7,9,9,29
191103696,9,7,6,3,9,34
191103697,8,2,1,1,6,18
191103698,9,4,7,8,2,30
191103699,6,5,3,5,7,26
191103700,9,6,6,5,3,29
191103701,9,1,6,2,5,23
191103702,6,9,9,3,8,35
191103703,2,8,5,5,2,22
191103704,1,6,5,7,0,19
191103705,2,5,1,3,5,16
191103706,4,9,5,2,0,20
191103707,8,7,9,0,8,32
191103708,4,3,0,5,3,15
191103709,0,1,3,8,9,21
191103710,4,2,4,5,7,22
191103711,1,9,6,4,6,26
191103712,8,3,3,3,1,18
191103713,6,6,0,8,3,23
191103714,7,6,3,0,9,25
191103715,7,5,5,9,9,35
191103716,0,3,2,9,3,17
191103717,9,2,5,1,6,23
191103718,8,9,3,6,1,27
191103719,8,4,9,1,8,30
191103720,3,4,7,2,6,22
191103721,3,0,0,1,6,10
191103722,6,4,7,3,2,22
191103723,7,0,9,9,3,28
191103724,0,6,8,9,6,29
191103725,2,1,5,2,7,17
191103726,0,0,0,5,8,13
191103727,4,4,9,5,6,28
191103728,6,5,5,7,2,25
191103729,0,8,1,5,8,22
191103730,5,2,1,2,8,18
191103731,9,3,4,4,2,22
191103732,1,0,0,2,2,5
191103733,0,8,9,4,3,24
191103734,0,7,1,5,3,16
191103735,2,1,1,0,0,4
191103736,1,7,2,7,3,20
191103737,8,3,3,3,9,26
191103738,0,6,1,5,7,19
191103739,5,3,4,0,8,20
191103740,2,2,5,8,4,21
191103741,1,5,2,9,0,17
191103742,2,4,3,7,1,17
191103743,0,2,6,3,8,19
191103744,9,9,6,3,2,29
191103745,0,9,2,1,9,21
191103746,7,1,4,9,0,21
191103747,6,2,5,5,3,21
191103748,7,1,0,4,4,16
191103749,3,2,3,1,8,17
191103750,9,5,7,2,0,23
191103751,6,0,8,4,2,20
191103752,3,1,5,6,0,15
191103753,0,0,4,1,4,9
191103754,8,3,1,8,0,20
191103755,9,4,5,4,0,22
191103756,3,0,4,2,0,9
191103757,3,0,1,7,8,19
191103758,7,7,7,2,9,32
191103759,3,9,8,6,5,31
191103760,8,0,4,4,1,17
191103761,3,5,5,5,4,22
191103762,9,2,4,7,1,23
191103763,0,0,5,8,2,15
191103764,7,0,3,2,0,12
191103765,2,4,2,0,2,10
191103766,0,6,0,0,6,12
191103767,3,1,5,4,5,18
191103768,1,0,4,7,9,21
191103769,6,0,6,9,8,29
191103770,9,5,0,9,4,27
191103771,7,3,4,8,8,30
191103772,2,4,0,7,1,14
191103773,3,5,1,4,4,17
191103774,2,5,2,3,8,20
191103775,5,5,0,2,5,17
191103776,0,6,0,4,9,19
191103777,1,6,7,2,0,16
191103778,0,1,0,2,3,6
191103779,0,8,2,0,3,13
191103780,4,9,3,9,3,28
191103781,6,5,8,7,5,31
191103782,5,4,1,2,7,19
191103783,0,6,5,8,4,23
191103784,9,3,3,1,0,16
191103785,9,2,8,9,3,31
191103786,9,0,8,0,5,22
191103787,6,8,6,4,4,28
191103788,9,2,8,3,2,24
191103789,6,7,3,4,9,29
191103790,6,0,9,0,2,17
191103791,0,0,0,0,4,4
191103792,7,2,7,5,9,30
191103793,8,2,7,2,9,28
191103794,5,8,5,7,7,32
191103795,4,9,6,2,8,29
191103796,2,2,2,8,9,23
191103797,6,4,7,1,1,19
191103798,8,5,9,4,8,34
191103799,2,9,9,8,4,32
191103800,5,5,7,9,5,31
191103801,1,4,2,7,2,16
191103802,0,5,1,2,4,12
191103803,7,0,1,7,1,16
191103804,5,0,3,9,2,19
191103805,3,5,1,3,7,19
191103806,0,6,0,5,3,14
191103807,5,7,6,6,0,24
191103808,6,1,7,2,8,24
191103809,6,8,2,1,4,21
191103810,4,3,9,5,0,21
191103811,9,7,9,3,6,34
191103812,4,3,0,1,3,11
191103813,4,9,6,9,6,34
191103814,8,8,6,1,8,31
191103815,1,3,3,8,2,17
191103816,6,6,0,1,0,13
191103817,0,2,1,6,2,11
191103818,9,6,7,5,0,27
191103819,9,2,6,2,2,21
191103820,0,2,1,1,5,9
191103821,9,3,7,7,6,32
191103822,0,2,5,8,3,18
191103823,1,5,1,8,4,19
191103824,8,9,5,8,2,32
191103825,5,6,9,9,6,35
191103826,2,3,0,0,8,13
191103827,2,4,5,1,1,13
191103828,8,8,6,1,4,27
191103829,6,7,5,2,2,22
191103830,5,0,0,2,0,7
191103831,0,9,4,4,9,26
191103832,2,6,5,6,8,27
191103833,7,7,7,3,5,29
191103834,4,4,6,3,6,23
191103835,1,7,9,6,7,30
191103836,0,3,0,9,3,15
191103837,6,0,3,6,9,24
191103838,4,7,7,0,3,21
191103839,1,2,7,9,8,27
191103840,6,1,8,8,4,27
191103841,8,3,1,1,7,20
191103842,7,8,2,7,7,31
191103843,4,3,2,7,6,22
191103844,1,6,2,7,5,21
191103845,8,4,5,2,3,22
191103846,9,3,1,3,3,19
191103847,2,8,0,4,0,14
191103848,5,5,8,2,3,23
191103849,4,0,2,7,9,22
191103850,9,6,5,5,9,34
191103851,1,4,8,5,0,18
191103852,8,3,0,7,5,23
191103853,8,9,5,7,5,34
191103854,3,7,6,7,3,26
191103855,3,2,2,5,9,21
191103856,8,6,1,0,3,18
191103857,4,9,8,1,0,22
191103858,9,8,2,1,5,25
191103859,4,3,1,4,3,15
191103860,1,6,1,0,3,11
191103861,7,1,1,5,7,21
191103862,9,7,8,4,2,30
191103863,4,8,9,6,7,34
191103864,8,8,5,4,8,33
191103865,0,1,5,0,4,10
191103866,5,2,9,8,7,31
191103867,4,6,8,7,8,33
191103868,2,5,6,0,9,22
191103869,1,2,3,8,0,14
191103870,9,5,6,9,3,32
191103871,0,7,4,6,3,20
191103872,5,5,9,2,4,25
191103873,6,8,8,5,9,36
191103874,3,3,2,1,0,9
191103875,5,7,1,9,9,31
191103876,7,9,7,4,1,28
191103877,3,2,6,5,1,17
191103878,3,2,5,2,0,12
191103879,1,1,7,6,4,19
191103880,6,3,1,5,7,22
191103881,9,3,1,3,6,22
191103882,5,3,2,7,8,25
191103883,2,9,9,3,0,23
191103884,2,0,2,9,3,16
191103885,1,3,4,2,8,18
191103886,5,0,5,1,4,15
191103887,1,8,7,2,8,26
191103888,4,4,1,3,3,15
191103889,2,5,3,1,7,18
191103890,2,3,0,0,0,5
191103891,7,6,6,9,5,33
191103892,6,6,7,0,4,23
191103893,5,4,0,2,4,15
191103894,5,6,9,5,4,29
191103895,1,2,0,3,2,8
191103896,2,2,0,6,4,14
191103897,7,4,0,2,4,17
191103898,9,8,5,0,4,26
191103899,2,9,5,0,6,22
191103900,3,2,7,3,7,22
191103901,9,6,5,7,7,34
191103902,5,1,8,3,2,19
191103903,1,4,8,9,3,25
191103904,5,4,6,7,6,28
191103905,1,3,0,9,4,17
191103906,8,1,6,0,0,15
191103907,3,7,1,1,7,19
191103908,5,6,4,0,6,21
191103909,3,8,1,5,2,19
191103910,2,5,4,8,5,24
191103911,2,8,2,5,1,18
191103912,7,5,3,0,6,21
191103913,6,1,2,3,9,21
191103914,6,8,7,3,6,30
191103915,9,4,0,2,6,21
191103916,6,9,1,9,8,33
191103917,4,6,9,8,7,34
191103918,3,6,8,8,6,31
191103919,5,0,8,5,6,24
191103920,7,7,2,9,4,29
191103921,1,5,3,0,1,10
191103922,0,3,3,0,3,9
191103923,1,9,6,7,3,26
191103924,8,7,7,9,5,36
191103925,4,3,9,1,4,21
191103926,9,5,4,4,3,25
191103927,5,5,8,4,6,28
191103928,0,1,3,1,0,5
191103929,9,5,1,4,4,23
191103930,8,6,8,1,6,29
191103931,9,4,1,7,6,27
191103932,2,6,0,2,8,18
191103933,8,7,1,6,9,31
191103934,5,1,6,3,9,24
191103935,8,7,3,2,1,21
191103936,1,7,1,6,2,17
191103937,5,3,6,4,5,23
191103938,0,1,2,7,9,19
191103939,3,3,1,7,1,15
191103940,2,6,8,4,2,22
191103941,4,6,0,6,2,18
191103942,7,1,5,1,9,23
191103943,7,0,2,9,0,18
191103944,3,3,4,0,3,13
191103945,8,3,2,1,0,14
191103946,1,5,0,8,8,22
191103947,4,9,6,2,0,21
191103948,4,0,9,3,1,17
191103949,9,7,6,6,0,28
191103950,9,2,4,2,0,17
191103951,9,8,7,2,8,34
191103952,0,2,7,7,6,22
191103953,0,9,4,9,1,23
191103954,0,1,6,3,4,14
191103955,6,5,3,2,2,18
191103956,5,3,2,3,1,14
191103957,6,1,6,4,1,18
191103958,1,4,0,5,0,10
191103959,0,7,2,0,9,18
191103960,8,7,8,7,9,39
191103961,6,1,6,0,5,18
191103962,2,2,4,7,8,23
191103963,9,1,3,1,4,18
191103964,2,6,8,5,3,24
191103965,9,1,3,5,4,22
191103966,1,2,4,0,5,12
191103967,3,5,8,5,0,21
191103968,0,8,0,5,9,22
191103969,0,3,4,1,0,8
191103970,1,9,8,1,4,23
191103971,7,0,1,8,7,23
191103972,2,6,1,3,6,18
191103973,7,4,7,0,0,18
191103974,1,2,3,4,9,19
191103975,4,7,5,5,5,26
191103976,7,5,9,9,2,32
191103977,3,4,2,0,9,18
191103978,3,1,6,6,4,20
191103979,7,8,3,3,8,29
191103980,0,3,3,0,2,8
191103981,7,1,4,3,5,20
191103982,8,0,9,0,9,26
191103983,0,8,1,0,1,10
191103984,7,1,0,0,0,8
191103985,5,0,4,2,8,19
191103986,8,7,1,0,1,17
191103987,7,5,6,1,7,26
191103988,6,0,5,0,6,17
191103989,3,5,1,6,2,17
191103990,8,2,7,7,1,25
191103991,0,1,2,3,2,8
191103992,0,4,2,9,3,18
191103993,3,6,7,5,8,29
191103994,5,9,2,2,5,23
191103995,7,9,2,7,7,32
191103996,3,2,6,0,2,13
191103997,5,5,5,7,3,25
191103998,0,7,6,2,8,23
191103999,3,8,7,2,7,27
1911031000,1,9,3,2,8,23
1911031001,7,9,5,1,5,27
1911031002,8,3,7,3,2,23
1911031003,8,7,8,9,6,38
1911031004,2,7,1,3,2,15
1911031005,9,8,1,5,0,23
1911031006,8,7,3,4,9,31
1911031007,5,5,7,7,9,33
1911031008,1,7,9,7,9,33
1911031009,3,4,1,5,3,16
1911031010,8,9,3,3,0,23
1911031011,3,2,8,7,4,24
1911031012,9,7,7,4,5,32
1911031013,2,9,7,3,0,21
1911031014,7,8,7,2,3,27
1911031015,4,5,7,2,1,19
1911031016,8,0,4,6,1,19
1911031017,6,0,4,3,1,14
1911031018,5,4,3,4,8,24
1911031019,1,3,0,9,8,21
1911031020,2,6,4,2,7,21
1911031021,9,0,6,4,9,28
1911031022,7,0,7,8,4,26
1911031023,2,9,7,1,1,20
1911031024,3,8,0,2,2,15
1911031025,9,6,8,5,0,28
1911031026,6,9,3,6,1,25
1911031027,6,9,1,5,7,28
1911031028,7,2,1,5,7,22
1911031029,0,7,5,6,8,26
1911031030,0,3,2,2,4,11
1911031031,1,4,8,7,0,20
1911031032,4,8,3,5,5,25
1911031033,2,3,9,2,0,16
1911031034,6,3,6,6,5,26
1911031035,3,2,7,5,2,19
1911031036,3,2,6,9,4,24
1911031037,8,9,3,5,3,28
1911031038,0,8,4,1,8,21
1911031039,9,4,7,2,7,29
1911031040,2,4,4,1,7,18
1911031041,9,2,4,8,6,29
1911031042,3,1,2,4,3,13
1911031043,0,6,9,2,8,25
1911031044,2,0,1,7,8,18
1911031045,5,5,1,4,5,20
1911031046,2,4,2,6,2,16
1911031047,4,2,9,3,3,21
1911031048,3,2,1,7,8,21
1911031049,2,6,1,2,8,19
1911031050,4,0,4,5,8,21
1911031051,0,8,6,4,2,20
1911031052,9,7,3,2,7,28
1911031053,7,2,7,2,2,20
1911031054,2,8,7,1,3,21
1911031055,3,8,8,4,8,31
1911031056,9,5,0,3,0,17
1911031057,2,4,4,0,4,14
1911031058,5,1,9,7,9,31
1911031059,3,5,4,2,6,20
1911031060,3,7,8,8,5,31
1911031061,5,5,2,3,3,18
1911031062,3,4,2,2,8,19
1911031063,4,2,3,4,4,17
1911031064,9,3,2,8,4,26
1911031065,9,8,9,8,0,34
1911031066,5,2,1,6,6,20
1911031067,8,1,8,6,1,24
1911031068,3,9,2,8,8,30
1911031069,8,0,6,0,4,18
1911031070,7,5,3,3,2,20
1911031071,3,8,0,9,0,20
1911031072,7,3,5,0,1,16
1911031073,5,0,8,3,3,19
1911031074,1,3,9,5,4,22
1911031075,1,2,0,4,8,15
1911031076,6,5,2,2,2,17
1911031077,3,0,6,9,1,19
1911031078,5,6,8,7,8,34
1911031079,6,5,5,7,0,23
1911031080,0,3,9,8,6,26
1911031081,1,4,5,9,5,24
1911031082,5,1,6,6,1,19
1911031083,1,2,9,7,2,21
1911031084,5,7,6,3,8,29
1911031085,0,4,8,8,1,21
1911031086,3,0,9,0,8,20
1911031087,5,3,9,6,6,29
1911031088,3,9,1,5,3,21
1911031089,0,3,0,1,0,4
1911031090,5,0,9,0,0,14
1911031091,0,6,1,9,2,18
1911031092,2,2,7,8,2,21
1911031093,6,5,1,8,4,24
1911031094,9,4,3,7,5,28
1911031095,3,2,1,7,1,14
1911031096,9,8,0,6,4,27
1911031097,2,0,4,2,4,12
1911031098,9,5,1,5,0,20
1911031099,9,5,1,6,9,30
1911031100,7,4,3,2,2,18
1911031101,8,9,3,2,3,25
1911031102,0,1,4,1,6,12
1911031103,2,9,8,2,8,29
1911031104,2,3,9,5,9,28
1911031105,0,6,7,6,9,28
191104001,3,3,1,7,2,16
191104002,8,6,0,7,9,30
191104003,6,6,1,6,7,26
191104004,4,8,7,3,2,24
191104005,3,8,6,5,3,25
191104006,9,7,8,3,4,31
191104007,8,5,2,3,8,26
191104008,9,8,1,1,1,20
191104009,7,5,8,4,9,33
191104010,7,4,2,2,3,18
191104011,8,6,1,1,3,19
191104012,8,8,6,2,6,30
191104013,3,1,7,5,7,23
191104014,9,4,9,1,4,27
191104015,0,9,1,3,7,20
191104016,4,0,3,5,0,12
191104017,9,9,9,6,3,36
191104018,4,1,0,1,1,7
191104019,1,3,3,7,0,14
191104020,0,1,4,4,6,15
191104021,4,5,2,2,4,17
191104022,6,6,5,4,8,29
191104023,6,9,3,4,2,24
191104024,0,2,9,8,5,24
191104025,1,1,4,4,8,18
191104026,7,1,5,3,4,20
191104027,9,4,8,4,0,25
191104028,1,2,8,6,3,20
191104029,7,2,0,7,3,19
191104030,7,8,3,8,9,35
191104031,5,7,9,1,7,29
191104032,4,3,3,9,9,28
191104033,4,3,4,8,8,27
191104034,4,5,0,1,0,10
191104035,1,6,9,4,8,28
191104036,8,1,4,0,0,13
191104037,7,1,7,9,8,32
191104038,7,2,9,4,3,25
191104039,4,8,7,9,2,30
191104040,1,9,3,9,1,23
191104041,6,4,3,0,3,16
191104042,2,9,4,5,7,27
191104043,7,4,5,1,0,17
191104044,9,0,3,4,5,21
191104045,0,7,7,6,8,28
191104046,5,0,6,0,6,17
191104047,8,0,7,2,8,25
191104048,6,8,7,8,3,32
191104049,2,3,7,5,5,22
191104050,1,2,1,0,3,7
191104051,0,8,8,7,6,29
191104052,4,4,0,2,4,14
191104053,2,5,2,3,9,21
191104054,9,3,3,4,8,27
191104055,2,4,5,7,9,27
191104056,2,6,5,2,8,23
191104057,4,9,0,6,5,24
191104058,7,5,4,1,1,18
191104059,8,9,2,4,8,31
191104060,2,7,0,2,5,16
191104061,0,8,2,4,0,14
191104062,9,2,2,3,6,22
191104063,8,3,2,3,3,19
191104064,8,3,4,3,9,27
191104065,0,6,7,4,8,25
191104066,7,8,0,0,8,23
191104067,3,8,6,1,6,24
191104068,5,1,8,1,4,19
191104069,1,2,8,2,1,14
191104070,2,4,6,4,0,16
191104071,5,0,9,3,8,25
191104072,9,2,9,8,0,28
191104073,5,1,0,4,7,17
191104074,5,7,6,6,1,25
191104075,7,8,0,4,4,23
191104076,7,1,1,3,8,20
191104077,7,7,3,0,5,22
191104078,2,2,6,6,9,25
191104079,2,3,1,8,2,16
191104080,9,9,1,7,2,28
191104081,2,3,5,5,9,24
191104082,7,1,4,6,3,21
191104083,6,0,6,6,0,18
191104084,6,9,9,2,1,27
191104085,6,9,2,3,0,20
191104086,8,0,4,4,2,18
191104087,8,6,3,3,5,25
191104088,9,3,7,0,7,26
191104089,6,5,3,9,7,30
191104090,9,3,0,8,4,24
191104091,4,2,5,7,5,23
191104092,7,4,4,4,6,25
191104093,7,4,2,0,6,19
191104094,7,2,0,2,8,19
191104095,6,2,8,0,9,25
191104096,6,5,3,0,6,20
191104097,6,4,4,3,6,23
191104098,5,1,3,2,3,14
191104099,5,5,7,6,3,26
191104100,8,7,6,7,4,32
191104101,2,6,4,4,3,19
191104102,7,7,1,8,2,25
191104103,9,7,2,3,0,21
191104104,8,2,5,2,7,24
191104105,7,0,1,3,3,14
191104106,5,3,4,5,7,24
191104107,3,7,1,7,7,25
191104108,9,3,6,9,3,30
191104109,1,9,2,1,5,18
191104110,8,8,4,0,9,29
191104111,1,1,6,1,5,14
191104112,1,9,8,1,1,20
191104113,9,2,6,3,6,26
191104114,6,4,7,3,3,23
191104115,6,4,2,6,1,19
191104116,7,5,0,7,9,28
191104117,0,6,0,7,3,16
191104118,0,6,5,0,7,18
191104119,5,5,1,1,4,16
191104120,1,6,3,1,6,17
191104121,5,1,7,5,9,27
191104122,2,5,7,0,9,23
191104123,1,2,1,7,1,12
191104124,8,3,1,5,1,18
191104125,4,2,4,1,4,15
191104126,8,5,3,3,2,21
191104127,4,4,0,3,3,14
191104128,3,1,8,2,4,18
191104129,0,2,4,9,7,22
191104130,6,9,3,9,6,33
191104131,5,5,1,1,7,19
191104132,0,2,0,7,5,14
191104133,1,3,7,4,1,16
191104134,9,2,0,2,1,14
191104135,5,5,4,7,1,22
191104136,1,4,9,4,3,21
191104137,5,1,8,1,3,18
191104138,9,2,2,0,9,22
191104139,0,6,3,3,4,16
191104140,9,2,3,0,6,20
191104141,7,8,2,9,5,31
191104142,8,6,3,7,7,31
191104143,5,2,9,8,0,24
191104144,7,0,5,7,2,21
191104145,7,5,7,5,1,25
191104146,4,6,7,1,3,21
191104147,8,9,9,4,2,32
191104148,6,1,6,9,3,25
191104149,5,2,0,2,4,13
191104150,4,5,1,6,2,18
191104151,1,2,4,4,2,13
191104152,7,0,9,9,8,33
191104153,1,1,2,5,2,11
191104154,5,1,1,1,0,8
191104155,1,9,3,0,0,13
191104156,8,1,4,6,5,24
191104157,6,5,4,1,4,20
191104158,0,7,3,3,6,19
191104159,5,8,6,0,1,20
191104160,3,3,1,7,0,14
191104161,1,5,8,0,0,14
191104162,7,6,2,9,1,25
191104163,3,8,1,8,3,23
191104164,3,9,0,7,1,20
191104165,5,6,4,5,4,24
191104166,0,4,4,2,5,15
191104167,0,6,0,4,3,13
191104168,6,4,6,3,0,19
191104169,3,8,3,4,0,18
191104170,1,1,9,6,4,21
191104171,7,5,4,0,7,23
191104172,5,7,5,9,2,28
191104173,6,5,4,9,2,26
191104174,0,5,2,7,5,19
191104175,8,8,9,4,2,31
191104176,9,2,5,1,2,19
191104177,0,0,7,1,3,11
191104178,8,6,3,4,9,30
191104179,4,5,5,1,7,22
191104180,2,3,0,8,1,14
191104181,4,1,4,9,7,25
191104182,9,9,3,3,1,25
191104183,8,7,2,9,9,35
191104184,6,6,3,9,1,25
191104185,0,3,3,1,9,16
191104186,1,0,2,0,0,3
191104187,2,0,2,3,6,13
191104188,4,0,5,5,4,18
191104189,4,4,2,9,0,19
191104190,4,5,4,5,7,25
191104191,1,5,5,8,1,20
191104192,9,9,2,8,8,36
191104193,1,8,0,5,9,23
191104194,7,1,1,5,0,14
191104195,4,0,1,8,2,15
191104196,9,7,4,8,9,37
191104197,9,6,9,4,0,28
191104198,9,1,7,1,9,27
191104199,5,6,0,0,6,17
191104200,1,1,3,1,7,13
191104201,4,7,2,6,4,23
191104202,8,2,1,5,3,19
191104203,6,8,1,7,8,30
191104204,9,5,8,9,0,31
191104205,3,5,7,5,3,23
191104206,3,9,1,3,6,22
191104207,6,0,3,5,4,18
191104208,5,3,7,8,0,23
191104209,8,7,3,8,4,30
191104210,0,6,2,3,4,15
191104211,0,9,4,7,9,29
191104212,9,6,3,2,1,21
191104213,6,7,8,7,3,31
191104214,4,4,9,0,7,24
191104215,0,1,2,7,4,14
191104216,0,8,7,1,0,16
191104217,3,6,1,7,8,25
191104218,5,5,0,9,4,23
191104219,4,3,9,5,9,30
191104220,8,1,4,8,5,26
191104221,5,1,9,2,0,17
191104222,4,6,9,5,2,26
191104223,0,7,3,4,3,17
191104224,2,3,2,8,8,23
191104225,5,8,1,7,7,28
191104226,1,4,7,8,4,24
191104227,2,3,6,8,1,20
191104228,5,8,0,2,6,21
191104229,6,9,7,2,0,24
191104230,4,8,5,5,2,24
191104231,2,3,5,7,6,23
191104232,5,4,6,9,0,24
191104233,8,9,1,9,4,31
191104234,7,4,7,1,0,19
191104235,4,7,4,1,0,16
191104236,5,2,7,3,1,18
191104237,7,9,3,7,5,31
191104238,8,8,1,2,3,22
191104239,0,6,3,7,2,18
191104240,4,7,1,5,2,19
191104241,9,2,9,7,6,33
191104242,4,0,0,1,0,5
191104243,9,9,4,7,7,36
191104244,5,3,6,7,4,25
191104245,0,7,2,9,7,25
191104246,0,4,2,4,7,17
191104247,6,5,5,9,2,27
191104248,5,4,0,1,3,13
191104249,7,1,6,1,1,16
191104250,7,9,9,7,1,33
191104251,5,8,5,1,5,24
191104252,3,4,9,8,4,28
191104253,2,9,4,4,0,19
191104254,8,2,8,7,5,30
191104255,2,7,9,5,7,30
191104256,8,1,3,7,7,26
191104257,5,6,4,1,5,21
191104258,3,8,9,2,1,23
191104259,6,3,7,0,9,25
191104260,6,8,2,9,4,29
191104261,0,3,6,4,0,13
191104262,1,0,0,8,8,17
191104263,5,0,6,5,8,24
191104264,5,8,9,4,5,31
191104265,0,7,7,7,4,25
191104266,8,9,6,5,0,28
191104267,0,6,0,0,5,11
191104268,3,6,4,3,3,19
191104269,9,6,9,1,2,27
191104270,3,5,9,8,7,32
191104271,9,6,3,4,5,27
191104272,9,5,0,4,6,24
191104273,5,7,0,9,6,27
191104274,9,0,7,2,3,21
191104275,0,4,5,9,0,18
191104276,4,5,8,1,8,26
191104277,1,9,1,8,1,20
191104278,4,8,7,3,8,30
191104279,0,7,9,9,3,28
191104280,4,8,3,6,1,22
191104281,3,9,7,1,2,22
191104282,7,3,7,1,1,19
191104283,0,0,7,2,4,13
191104284,3,3,2,0,0,8
191104285,0,5,9,8,5,27
191104286,9,1,7,9,0,26
191104287,8,8,6,9,0,31
191104288,7,3,8,2,5,25
191104289,0,2,8,7,4,21
191104290,7,5,4,2,4,22
191104291,4,5,4,9,6,28
191104292,2,1,3,5,2,13
191104293,7,1,2,4,9,23
191104294,0,1,3,3,2,9
191104295,0,4,4,8,9,25
191104296,4,9,9,6,0,28
191104297,9,5,3,0,4,21
191104298,7,1,6,6,7,27
191104299,5,3,1,5,8,22
191104300,7,5,7,2,2,23
191104301,3,8,5,3,4,23
191104302,1,9,5,7,9,31
191104303,9,8,9,7,9,42
191104304,5,7,1,3,1,17
191104305,3,8,9,9,2,31
191104306,4,8,6,3,7,28
191104307,7,1,7,3,3,21
191104308,0,1,6,6,2,15
191104309,6,9,7,4,8,34
191104310,2,8,9,1,8,28
191104311,5,9,5,9,5,33
191104312,3,8,5,3,9,28
191104313,7,1,1,1,2,12
191104314,4,8,8,9,4,33
191104315,7,3,9,9,9,37
191104316,0,1,7,1,7,16
191104317,3,7,3,8,0,21
191104318,6,0,3,8,7,24
191104319,2,3,3,6,9,23
191104320,4,5,2,8,0,19
191104321,2,3,6,4,2,17
191104322,1,9,5,3,6,24
191104323,7,5,0,4,9,25
191104324,2,8,5,6,3,24
191104325,8,5,3,9,1,26
191104326,6,5,3,3,0,17
191104327,3,4,4,8,7,26
191104328,6,1,0,2,6,15
191104329,4,3,7,2,1,17
191104330,2,4,4,0,2,12
191104331,5,7,3,3,0,18
191104332,4,5,6,5,1,21
191104333,8,5,1,7,6,27
191104334,8,3,8,3,9,31
191104335,3,6,5,3,4,21
191104336,6,7,9,7,5,34
191104337,7,9,3,0,3,22
191104338,5,6,0,6,3,20
191104339,8,1,2,6,2,19
191104340,4,9,7,2,4,26
191104341,9,2,4,2,3,20
191104342,2,2,1,5,4,14
191104343,0,0,3,8,7,18
191104344,8,6,7,3,9,33
191104345,2,9,1,4,8,24
191104346,9,3,3,1,2,18
191104347,6,8,9,2,0,25
191104348,7,2,5,6,8,28
191104349,6,7,7,7,8,35
191104350,3,2,0,9,2,16
191104351,6,4,6,6,2,24
191104352,9,6,2,4,5,26
191104353,5,7,0,3,0,15
191104354,4,3,9,7,3,26
191104355,6,0,4,0,7,17
191104356,8,9,7,0,1,25
191104357,5,3,1,6,8,23
191104358,4,3,9,4,7,27
191104359,2,9,9,2,8,30
191104360,1,8,1,6,5,21
191104361,4,0,0,3,3,10
191104362,4,2,1,6,8,21
191104363,5,5,0,1,0,11
191104364,4,4,5,1,8,22
191104365,0,6,2,1,7,16
191104366,1,5,0,0,1,7
191104367,2,3,0,7,3,15
191104368,4,6,2,9,9,30
191104369,8,7,9,5,8,37
191104370,5,8,3,4,5,25
191104371,6,4,6,7,7,30
191104372,3,8,9,8,0,28
191104373,9,8,0,5,6,28
191104374,3,6,3,8,4,24
191104375,3,7,4,4,8,26
191104376,1,4,7,7,6,25
191104377,8,6,9,4,1,28
191104378,4,9,0,8,2,23
191104379,8,0,4,1,4,17
191104380,7,0,6,9,7,29
191104381,5,2,8,7,5,27
191104382,6,0,4,4,2,16
191104383,5,0,6,5,3,19
191104384,3,9,4,2,9,27
191104385,3,0,9,1,5,18
191104386,3,7,2,7,3,22
191104387,2,2,1,3,8,16
191104388,5,7,6,1,5,24
191104389,9,1,6,0,9,25
191104390,3,9,4,0,6,22
191104391,0,5,9,9,3,26
191104392,0,5,2,1,8,16
191104393,6,4,7,7,2,26
191104394,3,5,1,6,8,23
191104395,6,6,4,9,7,32
191104396,3,7,8,5,2,25
191104397,2,5,7,0,5,19
191104398,1,4,9,2,8,24
191104399,4,9,0,5,0,18
191104400,0,6,1,4,8,19
191104401,6,3,6,9,9,33
191104402,9,2,7,8,9,35
191104403,6,9,1,1,3,20
191104404,7,9,9,0,1,26
191104405,2,2,1,7,4,16
191104406,6,7,3,0,3,19
191104407,3,8,9,6,8,34
191104408,9,3,7,6,2,27
191104409,9,0,8,9,6,32
191104410,3,4,7,3,8,25
191104411,4,0,0,1,6,11
191104412,2,7,4,6,7,26
191104413,0,1,9,3,4,17
191104414,2,1,3,2,2,10
191104415,2,7,7,6,6,28
191104416,4,8,5,2,9,28
191104417,1,4,8,9,4,26
191104418,2,8,8,6,7,31
191104419,1,0,2,0,8,11
191104420,2,9,7,7,3,28
191104421,2,4,4,3,4,17
191104422,5,8,2,2,8,25
191104423,2,7,5,9,1,24
191104424,9,7,1,5,7,29
191104425,7,8,2,8,0,25
191104426,3,4,0,1,8,16
191104427,7,3,6,5,8,29
191104428,5,6,8,2,5,26
191104429,8,1,0,1,1,11
191104430,4,9,5,5,4,27
191104431,3,6,4,6,9,28
191104432,5,1,3,8,6,23
191104433,9,7,0,2,0,18
191104434,1,3,0,0,1,5
191104435,0,9,6,9,9,33
191104436,5,3,2,0,7,17
191104437,4,4,7,3,2,20
191104438,1,2,4,7,4,18
191104439,9,9,6,9,1,34
191104440,7,2,4,9,9,31
191104441,0,1,6,7,2,16
191104442,9,1,2,4,8,24
191104443,3,2,3,5,7,20
191104444,5,1,2,8,8,24
191104445,2,3,8,9,8,30
191104446,3,3,5,7,8,26
191104447,9,5,8,1,4,27
191104448,0,1,2,5,1,9
191104449,6,5,7,8,8,34
191104450,0,6,4,2,9,21
191104451,0,1,5,0,1,7
191104452,8,2,0,3,5,18
191104453,2,8,4,3,4,21
191104454,4,1,2,6,9,22
191104455,2,6,6,9,8,31
191104456,8,9,5,7,3,32
191104457,3,9,8,8,3,31
191104458,6,4,3,1,2,16
191104459,0,7,5,1,0,13
191104460,8,7,2,2,9,28
191104461,9,3,8,4,0,24
191104462,2,3,1,4,6,16
191104463,6,5,9,2,0,22
191104464,7,6,3,5,0,21
191104465,3,9,7,6,2,27
191104466,4,7,3,9,0,23
191104467,3,6,1,5,3,18
191104468,0,5,8,8,1,22
191104469,0,3,8,0,7,18
191104470,2,5,2,1,3,13
191104471,4,4,8,3,2,21
191104472,7,0,5,2,5,19
191104473,0,0,9,6,2,17
191104474,9,0,3,6,2,20
191104475,3,7,9,1,3,23
191104476,8,5,7,7,4,31
191104477,0,1,6,6,1,14
191104478,6,1,4,1,3,15
191104479,0,7,1,4,3,15
191104480,6,0,0,1,5,12
191104481,7,5,0,9,0,21
191104482,3,6,8,7,9,33
191104483,0,9,1,4,2,16
191104484,6,4,5,7,7,29
191104485,3,7,1,3,5,19
191104486,3,9,1,0,4,17
191104487,4,6,4,4,8,26
191104488,5,9,5,7,8,34
191104489,4,9,8,7,8,36
191104490,1,9,0,0,8,18
191104491,6,3,6,8,0,23
191104492,0,4,7,3,7,21
191104493,6,7,1,2,6,22
191104494,5,6,6,1,5,23
191104495,5,9,5,2,2,23
191104496,8,3,9,8,2,30
191104497,8,4,3,2,3,20
191104498,2,4,5,3,5,19
191104499,9,4,6,1,3,23
191104500,3,7,2,2,6,20
191104501,0,0,2,3,7,12
191104502,9,5,2,9,0,25
191104503,9,1,4,1,3,18
191104504,5,5,4,9,8,31
191104505,3,2,8,9,9,31
191104506,7,6,0,5,8,26
191104507,3,4,2,9,2,20
191104508,4,6,6,6,3,25
191104509,7,7,2,3,6,25
191104510,4,2,7,0,5,18
191104511,4,7,7,6,2,26
191104512,5,3,8,5,1,22
191104513,1,6,9,5,4,25
191104514,8,7,4,6,9,34
191104515,2,6,0,0,2,10
191104516,2,1,5,7,5,20
191104517,7,4,9,6,7,33
191104518,2,8,0,2,4,16
191104519,8,9,9,8,9,43
191104520,2,6,0,2,4,14
191104521,2,5,7,9,2,25
191104522,4,0,3,0,5,12
191104523,2,5,3,4,3,17
191104524,6,6,9,6,5,32
191104525,7,3,6,3,4,23
191104526,1,5,6,2,2,16
191104527,7,9,3,8,4,31
191104528,7,9,4,4,5,29
191104529,1,9,2,1,8,21
191104530,7,9,0,8,4,28
191104531,5,5,0,7,5,22
191104532,7,4,6,0,3,20
191104533,6,4,1,4,9,24
191104534,6,6,7,5,5,29
191104535,3,2,6,5,0,16
191104536,8,5,8,0,6,27
191104537,6,5,2,6,0,19
191104538,5,2,2,5,9,23
191104539,4,5,8,0,8,25
191104540,3,4,2,8,1,18
191104541,5,6,5,0,6,22
191104542,0,1,7,9,7,24
191104543,1,6,2,0,4,13
191104544,8,3,7,3,7,28
191104545,7,9,2,1,8,27
191104546,5,7,7,7,8,34
191104547,4,8,6,9,4,31
191104548,2,4,6,4,7,23
191104549,1,3,8,0,4,16
191104550,3,6,7,4,2,22
191104551,4,4,4,7,4,23
191104552,4,6,1,4,2,17
191104553,2,9,1,8,5,25
191104554,4,6,3,8,6,27
191104555,6,7,3,9,4,29
191104556,3,1,1,4,8,17
191104557,0,6,1,8,2,17
191104558,8,2,3,3,1,17
191104559,7,0,0,9,3,19
191104560,9,0,8,8,7,32
191104561,1,3,6,3,7,20
191104562,8,4,9,4,6,31
191104563,1,1,6,7,4,19
191104564,2,0,8,9,7,26
191104565,4,1,6,7,1,19
191104566,7,3,1,6,6,23
191104567,6,4,3,9,0,22
191104568,7,6,6,0,4,23
191104569,7,2,5,3,2,19
191104570,2,3,0,3,9,17
191104571,5,6,4,8,9,32
191104572,2,3,9,6,7,27
191104573,1,2,7,5,1,16
191104574,6,5,4,3,5,23
191104575,1,7,0,3,4,15
191104576,3,3,9,5,6,26
191104577,4,8,9,4,9,34
191104578,1,9,8,8,9,35
191104579,4,9,0,4,2,19
191104580,1,6,9,5,2,23
191104581,5,9,0,1,4,19
191104582,7,8,3,3,4,25
191104583,8,4,6,9,7,34
191104584,5,9,2,7,9,32
191104585,4,4,9,3,5,25
191104586,3,5,0,7,7,22
191104587,9,7,7,8,4,35
191104588,0,0,9,9,3,21
191104589,2,1,2,3,1,9
191104590,0,3,6,7,8,24
191104591,4,7,2,8,2,23
191104592,6,9,6,4,2,27
191104593,4,0,1,0,5,10
191104594,7,2,9,8,3,29
191104595,3,6,6,7,7,29
191104596,7,5,1,0,9,22
191104597,5,5,6,6,9,31
191104598,0,0,1,6,9,16
191104599,4,5,1,2,3,15
191104600,7,1,9,1,2,20
191104601,1,1,7,5,1,15
191104602,2,7,9,2,8,28
191104603,0,8,6,4,8,26
191104604,1,7,2,5,9,24
191104605,8,9,5,8,9,39
191104606,0,0,4,9,2,15
191104607,0,2,4,7,8,21
191104608,1,3,8,1,5,18
191104609,3,1,3,0,1,8
191104610,1,8,4,6,1,20
191104611,0,3,6,8,7,24
191104612,2,2,3,7,8,22
191104613,5,9,7,6,2,29
191104614,6,0,2,8,8,24
191104615,2,3,1,7,8,21
191104616,7,9,9,8,8,41
191104617,1,9,5,4,3,22
191104618,7,3,1,0,7,18
191104619,8,5,3,7,1,24
191104620,8,0,7,2,9,26
191104621,9,9,6,7,2,33
191104622,2,6,4,6,8,26
191104623,4,9,9,6,8,36
191104624,4,0,0,3,0,7
191104625,7,5,7,0,6,25
191104626,9,0,9,8,0,26
191104627,2,6,6,5,2,21
191104628,6,3,2,6,9,26
191104629,1,4,4,7,1,17
191104630,5,4,6,3,4,22
191104631,0,9,4,3,1,17
191104632,6,7,4,3,5,25
191104633,2,2,1,6,6,17
191104634,1,0,8,1,3,13
191104635,8,7,1,8,0,24
191104636,7,8,7,8,0,30
191104637,3,4,0,4,3,14
191104638,6,5,9,6,3,29
191104639,7,4,5,8,8,32
191104640,6,5,2,9,1,23
191104641,9,1,3,7,3,23
191104642,9,8,6,7,9,39
191104643,9,9,4,0,6,28
191104644,8,9,8,7,0,32
191104645,5,6,8,2,9,30
191104646,4,9,6,1,0,20
191104647,4,6,5,8,5,28
191104648,2,3,3,9,7,24
191104649,2,8,2,4,3,19
191104650,0,5,2,8,9,24
191104651,8,2,9,9,2,30
191104652,3,7,0,2,9,21
191104653,8,0,4,4,5,21
191104654,2,8,0,4,9,23
191104655,4,6,2,9,4,25
191104656,3,3,2,2,6,16
191104657,7,9,9,6,9,40
191104658,1,8,7,1,2,19
191104659,9,5,3,5,7,29
191104660,6,0,0,8,9,23
191104661,4,1,4,9,9,27
191104662,1,5,4,7,9,26
191104663,1,0,3,9,1,14
191104664,9,1,1,5,4,20
191104665,2,7,1,0,1,11
191104666,7,0,8,6,1,22
191104667,8,8,3,3,9,31
191104668,8,6,2,1,8,25
191104669,9,9,3,7,8,36
191104670,8,0,2,3,4,17
191104671,0,1,8,3,2,14
191104672,2,6,4,0,6,18
191104673,0,2,6,4,7,19
191104674,4,5,2,8,3,22
191104675,4,8,3,3,7,25
191104676,8,4,8,9,8,37
191104677,4,3,9,2,1,19
191104678,1,3,5,1,6,16
191104679,1,3,8,6,6,24
191104680,1,4,8,8,4,25
191104681,4,0,6,4,3,17
191104682,2,4,9,5,3,23
191104683,9,5,3,6,5,28
191104684,4,3,6,7,9,29
191104685,0,5,3,8,2,18
191104686,8,9,6,1,2,26
191104687,8,0,8,2,6,24
191104688,5,4,3,0,9,21
191104689,5,7,7,6,8,33
191104690,8,2,5,6,5,26
191104691,6,5,6,4,5,26
191104692,9,3,0,6,9,27
191104693,7,3,5,1,7,23
191104694,5,5,0,1,1,12
191104695,6,0,5,4,4,19
191104696,1,8,5,4,3,21
191104697,0,7,1,0,7,15
191104698,5,2,9,1,2,19
191104699,7,8,0,4,8,27
191104700,1,0,7,2,2,12
191104701,0,3,3,7,5,18
191104702,9,8,2,6,0,25
191104703,4,9,2,7,1,23
191104704,7,7,0,5,1,20
191104705,7,8,1,5,7,28
191104706,3,4,9,4,3,23
191104707,4,1,6,8,3,22
191104708,2,7,0,9,9,27
191104709,2,8,2,6,0,18
191104710,8,4,0,6,4,22
191104711,6,8,1,3,0,18
191104712,4,7,1,1,8,21
191104713,2,1,1,6,3,13
191104714,9,1,7,7,0,24
191104715,9,2,5,8,9,33
191104716,1,4,5,1,6,17
191104717,7,0,2,5,8,22
191104718,3,4,8,3,8,26
191104719,7,1,6,5,2,21
191104720,1,5,2,9,5,22
191104721,9,8,9,5,4,35
191104722,0,0,6,3,7,16
191104723,9,6,8,5,6,34
191104724,0,2,8,4,5,19
191104725,3,3,4,2,0,12
191104726,1,1,1,5,9,17
191104727,2,8,1,0,1,12
191104728,5,0,5,9,3,22
191104729,8,6,9,9,9,41
191104730,1,4,2,6,6,19
191104731,2,3,4,2,8,19
191104732,8,9,6,4,1,28
191104733,5,6,4,1,9,25
191104734,2,3,0,4,9,18
191104735,4,6,5,5,9,29
191104736,5,3,3,1,0,12
191104737,1,4,9,1,4,19
191104738,3,7,1,6,6,23
191104739,7,6,2,6,0,21
191104740,8,4,3,1,5,21
191104741,1,4,6,0,5,16
191104742,3,8,3,9,0,23
191104743,4,9,6,2,3,24
191104744,9,2,4,4,7,26
191104745,2,9,2,8,1,22
191104746,2,8,4,2,5,21
191104747,2,9,8,7,4,30
191104748,1,1,4,0,1,7
191104749,5,5,6,9,4,29
191104750,1,9,8,4,7,29
191104751,4,2,5,6,6,23
191104752,6,4,1,4,5,20
191104753,6,6,8,5,1,26
191104754,7,2,2,9,0,20
191104755,7,1,8,2,1,19
191104756,1,9,7,1,6,24
191104757,6,7,0,1,0,14
191104758,1,3,1,4,4,13
191104759,4,7,7,9,4,31
191104760,5,3,8,3,9,28
191104761,5,6,8,7,9,35
191104762,7,7,6,0,8,28
191104763,2,7,4,1,9,23
191104764,7,2,0,9,8,26
191104765,2,1,9,6,2,20
191104766,1,6,0,4,4,15
191104767,3,9,6,8,8,34
191104768,4,0,2,0,8,14
191104769,0,0,4,0,0,4
191104770,7,4,3,5,6,25
191104771,0,7,4,0,5,16
191104772,5,7,5,1,8,26
191104773,2,7,6,6,1,22
191104774,4,0,6,1,3,14
191104775,2,4,0,7,5,18
191104776,6,0,9,9,7,31
191104777,9,6,0,4,3,22
191104778,8,4,2,8,1,23
191104779,0,7,5,4,9,25
191104780,7,5,2,7,3,24
191104781,6,7,9,5,5,32
191104782,4,6,2,8,8,28
191104783,9,3,0,5,2,19
191104784,7,4,3,9,2,25
191104785,7,6,2,4,0,19
191104786,1,0,2,3,1,7
191104787,3,1,2,8,1,15
191104788,0,5,0,7,0,12
191104789,1,3,9,5,7,25
191104790,1,2,1,4,8,16
191104791,6,4,1,4,2,17
191104792,0,1,2,6,5,14
191104793,2,6,0,4,2,14
191104794,8,6,4,3,8,29
191104795,7,2,5,0,2,16
191104796,2,3,0,8,3,16
191104797,0,0,0,2,2,4
191104798,4,2,4,8,2,20
191104799,6,9,7,8,7,37
191104800,1,1,5,3,5,15
191104801,7,9,0,0,0,16
191104802,2,6,8,6,5,27
191104803,1,2,7,6,8,24
191104804,5,6,6,9,2,28
191104805,5,8,0,4,2,19
191104806,6,6,8,7,1,28
191104807,2,4,2,2,9,19
191104808,2,8,0,9,1,20
191104809,4,7,8,3,1,23
191104810,4,3,2,7,8,24
191104811,1,1,5,9,3,19
191104812,5,3,7,2,5,22
191104813,5,5,6,5,8,29
191104814,9,2,2,1,4,18
191104815,4,0,0,3,1,8
191104816,2,7,1,4,1,15
191104817,1,1,5,5,7,19
191104818,6,4,7,7,5,29
191104819,2,9,4,7,1,23
191104820,4,2,2,8,6,22
191104821,9,1,7,5,5,27
191104822,8,8,1,1,5,23
191104823,3,5,9,8,0,25
191104824,4,6,1,2,7,20
191104825,4,2,8,3,6,23
191104826,9,1,1,4,0,15
191104827,4,1,4,9,6,24
191104828,8,7,6,0,9,30
191104829,7,9,0,2,1,19
191104830,7,0,4,3,7,21
191104831,3,0,3,6,2,14
191104832,7,7,5,2,2,23
191104833,2,8,7,3,7,27
191104834,0,4,4,6,7,21
191104835,8,1,2,0,0,11
191104836,4,0,4,0,3,11
191104837,6,1,9,1,8,25
191104838,9,0,9,9,9,36
191104839,2,6,7,7,5,27
191104840,6,6,5,0,0,17
191104841,9,8,7,3,9,36
191104842,8,7,3,3,0,21
191104843,2,3,5,1,5,16
191104844,0,4,9,9,1,23
191104845,1,8,5,3,4,21
191104846,4,2,3,6,9,24
191104847,6,5,1,6,4,22
191104848,1,0,7,6,0,14
191104849,9,8,5,6,9,37
191104850,7,7,9,2,9,34
191104851,0,2,4,6,4,16
191104852,0,7,8,6,9,30
191104853,4,2,8,8,5,27
191104854,9,2,6,8,4,29
191104855,2,9,0,0,3,14
191104856,2,2,1,3,4,12
191104857,7,8,9,4,1,29
191104858,0,0,7,5,7,19
191104859,1,0,0,8,6,15
191104860,5,7,0,2,4,18
191104861,3,8,7,6,4,28
191104862,6,3,0,8,1,18
191104863,8,3,2,3,9,25
191104864,7,3,2,5,5,22
191104865,7,1,8,3,5,24
191104866,3,9,0,9,2,23
191104867,7,9,6,9,6,37
191104868,5,8,2,1,5,21
191104869,9,3,9,0,1,22
191104870,3,8,5,5,2,23
191104871,2,8,2,4,1,17
191104872,4,4,1,4,9,22
191104873,6,0,1,5,6,18
191104874,5,4,0,8,4,21
191104875,4,4,3,0,8,19
191104876,6,3,9,2,2,22
191104877,5,5,4,5,8,27
191104878,8,3,9,3,6,29
191104879,7,1,0,0,2,10
191104880,5,5,5,5,9,29
191104881,8,3,0,6,5,22
191104882,8,0,5,8,6,27
191104883,1,5,9,5,4,24
191104884,7,6,1,6,0,20
191104885,4,5,6,3,3,21
191104886,7,4,5,8,1,25
191104887,7,8,5,9,7,36
191104888,8,0,0,7,2,17
191104889,4,0,4,4,6,18
191104890,6,2,0,8,6,22
191104891,3,9,4,3,0,19
191104892,6,2,8,0,3,19
191104893,0,7,4,3,3,17
191104894,7,9,2,2,4,24
191104895,6,2,5,2,6,21
191104896,1,1,2,5,5,14
191104897,7,7,4,0,1,19
191104898,9,0,7,3,9,28
191104899,7,6,4,6,2,25
191104900,8,6,0,1,2,17
191104901,2,1,6,3,7,19
191104902,6,1,8,7,4,26
191104903,8,5,4,1,8,26
191104904,3,0,1,6,7,17
191104905,3,7,2,8,0,20
191104906,3,9,6,7,8,33
191104907,6,5,4,8,8,31
191104908,6,9,4,9,4,32
191104909,8,5,7,0,1,21
191104910,5,7,8,5,7,32
191104911,5,8,7,9,6,35
191104912,2,1,5,0,3,11
191104913,9,4,1,7,4,25
191104914,1,6,7,3,1,18
191104915,7,7,6,3,2,25
191104916,5,4,3,1,8,21
191104917,6,6,7,9,5,33
191104918,1,8,2,9,7,27
191104919,7,4,5,4,9,29
191104920,0,2,8,6,0,16
191104921,5,2,9,5,1,22
191104922,5,4,9,1,6,25
191104923,5,1,4,1,6,17
191104924,6,5,4,1,2,18
191104925,1,6,4,3,2,16
191104926,9,0,0,7,5,21
191104927,4,8,9,3,8,32
191104928,0,7,9,6,8,30
191104929,1,4,5,4,5,19
191104930,1,2,8,6,4,21
191104931,0,9,9,4,6,28
191104932,2,0,0,9,7,18
191104933,4,7,1,0,5,17
191104934,7,9,1,3,8,28
191104935,3,2,5,1,2,13
191104936,5,9,1,0,3,18
191104937,0,3,8,9,4,24
191104938,2,4,7,6,4,23
191104939,3,7,9,0,1,20
191104940,4,6,3,6,2,21
191104941,6,7,3,6,7,29
191104942,8,6,1,9,7,31
191104943,3,9,1,0,5,18
191104944,9,8,3,2,0,22
191104945,6,1,7,4,9,27
191104946,6,1,7,2,9,25
191104947,8,9,5,4,8,34
191104948,7,4,1,0,2,14
191104949,8,6,7,2,5,28
191104950,4,2,9,8,6,29
191104951,2,2,0,4,7,15
191104952,1,3,9,4,5,22
191104953,8,9,7,3,2,29
191104954,1,0,9,1,7,18
191104955,3,1,0,8,7,19
191104956,4,5,6,3,6,24
191104957,5,8,5,3,7,28
191104958,9,1,1,9,6,26
191104959,9,5,3,7,4,28
191104960,8,5,4,2,9,28
191104961,6,0,3,1,1,11
191104962,2,4,9,9,8,32
191104963,7,4,5,7,6,29
191104964,8,2,0,6,3,19
191104965,5,6,3,2,2,18
191104966,5,0,8,9,0,22
191104967,4,1,5,5,6,21
191104968,2,2,8,5,0,17
191104969,4,6,1,3,2,16
191104970,5,7,2,7,2,23
191104971,5,6,2,8,5,26
191104972,5,0,8,8,7,28
191104973,9,5,4,7,6,31
191104974,7,9,4,5,3,28
191104975,1,0,5,3,3,12
191104976,0,9,4,6,3,22
191104977,5,4,3,8,3,23
191104978,0,1,2,9,9,21
191104979,6,7,7,9,9,38
191104980,2,0,3,0,9,14
191104981,1,7,4,2,0,14
191104982,9,3,9,7,3,31
191104983,9,8,3,2,7,29
191104984,3,3,2,9,8,25
191104985,3,3,4,8,6,24
191104986,6,7,0,1,7,21
191104987,8,4,6,8,1,27
191104988,0,8,1,7,1,17
191104989,5,6,1,3,9,24
191104990,2,2,6,0,1,11
191104991,6,9,7,1,2,25
191104992,6,8,5,8,9,36
191104993,0,4,3,5,9,21
191104994,0,5,3,1,1,10
191104995,6,3,2,5,6,22
191104996,9,2,4,4,0,19
191104997,4,3,6,0,6,19
191104998,5,0,3,2,2,12
191104999,8,8,5,6,9,36
1911041000,3,1,2,3,5,14
1911041001,9,9,9,6,5,38
1911041002,7,2,3,4,4,20
1911041003,2,0,5,3,6,16
1911041004,7,6,8,3,8,32
1911041005,2,5,2,2,2,13
1911041006,6,6,0,4,3,19
1911041007,3,5,4,6,8,26
1911041008,6,5,2,0,8,21
1911041009,3,9,2,5,6,25
1911041010,6,9,2,3,8,28
1911041011,9,6,7,6,8,36
1911041012,6,3,7,5,9,30
1911041013,9,8,3,8,2,30
1911041014,1,8,2,7,3,21
1911041015,9,0,7,3,4,23
1911041016,2,6,2,3,6,19
1911041017,0,1,4,7,3,15
1911041018,1,2,9,1,3,16
1911041019,1,7,2,4,7,21
1911041020,5,9,7,7,8,36
1911041021,9,3,1,9,1,23
1911041022,8,2,2,6,5,23
1911041023,2,3,1,1,4,11
1911041024,5,7,2,0,4,18
1911041025,2,9,0,6,6,23
1911041026,8,4,9,0,0,21
1911041027,3,7,2,0,2,14
1911041028,4,6,6,6,6,28
1911041029,3,7,3,8,9,30
1911041030,3,2,7,4,1,17
1911041031,2,5,9,0,6,22
1911041032,9,5,2,8,2,26
1911041033,6,1,1,8,1,17
1911041034,6,0,5,4,6,21
1911041035,0,5,0,3,6,14
1911041036,7,2,0,7,0,16
1911041037,1,8,2,3,7,21
1911041038,7,0,7,4,3,21
1911041039,9,2,4,8,5,28
1911041040,0,3,2,7,3,15
1911041041,6,4,6,4,3,23
1911041042,5,9,5,0,3,22
1911041043,5,2,6,6,6,25
1911041044,2,5,4,2,8,21
1911041045,5,0,7,6,0,18
1911041046,1,8,5,6,9,29
1911041047,7,9,9,7,2,34
1911041048,8,2,8,1,5,24
1911041049,0,3,1,4,5,13
1911041050,2,7,3,2,7,21
1911041051,5,7,8,1,2,23
1911041052,5,4,9,6,2,26
1911041053,5,6,7,0,1,19
1911041054,6,9,1,0,6,22
1911041055,6,0,5,3,9,23
1911041056,5,2,2,6,1,16
1911041057,1,9,2,1,4,17
1911041058,0,4,6,4,7,21
1911041059,5,2,2,8,1,18
1911041060,7,4,5,0,2,18
1911041061,4,6,8,0,6,24
1911041062,1,0,0,4,0,5
1911041063,6,9,6,4,5,30
1911041064,2,0,6,8,4,20
1911041065,9,7,9,3,2,30
1911041066,5,6,6,0,2,19
1911041067,7,9,5,4,1,26
1911041068,3,9,0,1,4,17
1911041069,3,0,8,4,9,24
1911041070,4,3,8,5,7,27
1911041071,3,4,5,2,8,22
1911041072,5,7,8,3,9,32
1911041073,6,2,0,9,6,23
1911041074,9,0,0,6,4,19
1911041075,4,7,8,3,3,25
1911041076,9,2,2,5,2,20
1911041077,3,2,2,4,9,20
1911041078,1,2,8,2,7,20
1911041079,7,2,6,3,7,25
1911041080,7,7,5,1,7,27
1911041081,8,7,0,7,8,30
1911041082,8,0,1,2,0,11
1911041083,4,7,4,4,6,25
1911041084,1,5,6,6,9,27
1911041085,2,8,0,0,9,19
1911041086,4,1,9,2,3,19
1911041087,0,8,6,1,3,18
1911041088,7,4,9,1,8,29
1911041089,8,1,2,5,7,23
1911041090,9,5,3,8,0,25
1911041091,1,8,5,7,4,25
1911041092,0,0,8,5,1,14
1911041093,1,1,6,4,3,15
1911041094,6,7,6,0,7,26
1911041095,7,7,8,4,9,35
1911041096,2,2,4,8,5,21
1911041097,0,8,3,9,1,21
1911041098,4,5,1,3,6,19
1911041099,6,8,0,4,2,20
1911041100,8,6,6,4,3,27
1911041101,4,6,5,6,4,25
1911041102,0,0,8,3,9,20
1911041103,4,2,8,4,7,25
1911041104,7,0,5,0,7,19
1911041105,1,0,5,1,4,11
191105001,4,6,2,6,4,22
191105002,8,5,3,2,8,26
191105003,6,5,8,4,3,26
191105004,6,5,4,5,8,28
191105005,4,7,5,1,3,20
191105006,8,0,4,0,9,21
191105007,6,2,2,7,3,20
191105008,4,3,8,8,1,24
191105009,5,3,1,3,0,12
191105010,2,7,1,5,9,24
191105011,7,6,8,6,6,33
191105012,2,9,3,6,3,23
191105013,7,4,0,7,5,23
191105014,2,0,5,8,6,21
191105015,4,1,4,2,0,11
191105016,9,7,8,5,4,33
191105017,0,9,8,4,8,29
191105018,1,4,1,8,8,22
191105019,0,9,4,8,1,22
191105020,7,0,7,8,0,22
191105021,5,8,9,6,1,29
191105022,3,7,1,7,2,20
191105023,5,3,1,2,3,14
191105024,2,7,2,3,4,18
191105025,0,0,4,7,6,17
191105026,0,3,8,3,5,19
191105027,3,0,0,9,0,12
191105028,1,3,2,6,9,21
191105029,4,4,9,3,7,27
191105030,4,5,3,5,5,22
191105031,9,6,9,0,4,28
191105032,1,3,7,0,0,11
191105033,5,7,9,8,1,30
191105034,0,0,9,6,1,16
191105035,7,7,6,4,4,28
191105036,7,3,8,0,4,22
191105037,5,6,4,3,0,18
191105038,5,2,4,0,3,14
191105039,8,8,2,0,9,27
191105040,5,7,3,8,0,23
191105041,4,3,8,2,4,21
191105042,3,9,8,8,9,37
191105043,1,0,8,2,5,16
191105044,2,0,9,9,8,28
191105045,0,1,6,8,8,23
191105046,0,9,8,8,3,28
191105047,8,7,2,5,0,22
191105048,8,0,2,6,3,19
191105049,9,5,1,4,3,22
191105050,7,2,2,7,9,27
191105051,1,5,6,4,3,19
191105052,2,2,1,3,1,9
191105053,5,9,8,9,0,31
191105054,2,9,9,9,6,35
191105055,7,4,3,5,1,20
191105056,3,5,2,0,8,18
191105057,0,1,6,8,3,18
191105058,4,2,6,2,9,23
191105059,5,4,6,2,8,25
191105060,4,5,2,9,5,25
191105061,9,9,8,6,0,32
191105062,0,5,3,1,9,18
191105063,7,4,3,8,3,25
191105064,1,2,8,9,6,26
191105065,1,9,0,5,0,15
191105066,0,3,9,8,7,27
191105067,7,7,0,3,7,24
191105068,3,2,0,1,1,7
191105069,3,6,9,4,9,31
191105070,4,1,7,6,0,18
191105071,3,2,9,6,9,29
191105072,5,5,3,9,7,29
191105073,5,5,6,3,6,25
191105074,9,0,0,5,4,18
191105075,3,8,7,8,8,34
191105076,9,0,1,0,2,12
191105077,4,5,5,8,3,25
191105078,6,3,2,1,3,15
191105079,8,3,2,6,2,21
191105080,5,6,2,1,7,21
191105081,7,4,4,0,8,23
191105082,5,8,3,9,8,33
191105083,1,3,7,5,5,21
191105084,1,8,2,5,0,16
191105085,7,7,0,3,1,18
191105086,6,5,6,6,4,27
191105087,5,9,6,3,0,23
191105088,9,8,2,8,0,27
191105089,4,3,8,5,0,20
191105090,8,7,8,9,2,34
191105091,4,0,3,3,3,13
191105092,5,8,8,4,1,26
191105093,2,1,2,2,7,14
191105094,9,0,4,5,0,18
191105095,5,5,3,3,3,19
191105096,4,0,6,6,4,20
191105097,5,0,7,9,3,24
191105098,4,3,6,0,0,13
191105099,4,3,0,6,7,20
191105100,3,5,4,4,1,17
191105101,7,9,9,5,3,33
191105102,1,9,5,6,9,30
191105103,9,5,0,9,9,32
191105104,9,9,7,1,0,26
191105105,9,5,8,8,1,31
191105106,5,5,4,7,4,25
191105107,8,9,1,6,0,24
191105108,9,7,4,7,8,35
191105109,8,4,6,4,0,22
191105110,7,6,5,8,9,35
191105111,3,4,4,6,3,20
191105112,8,5,2,2,3,20
191105113,1,2,2,3,6,14
191105114,1,5,9,0,6,21
191105115,3,7,3,1,4,18
191105116,8,1,9,7,2,27
191105117,6,5,3,0,0,14
191105118,2,8,0,6,3,19
191105119,8,6,5,0,7,26
191105120,9,5,0,3,6,23
191105121,2,8,6,1,0,17
191105122,8,2,6,5,4,25
191105123,5,6,8,3,0,22
191105124,5,4,0,6,1,16
191105125,2,1,5,4,2,14
191105126,6,2,7,6,7,28
191105127,4,2,7,1,4,18
191105128,5,5,7,5,7,29
191105129,4,1,8,1,1,15
191105130,9,4,5,3,1,22
191105131,2,0,2,1,5,10
191105132,7,7,0,9,8,31
191105133,8,2,0,8,0,18
191105134,2,3,4,2,7,18
191105135,9,3,0,4,7,23
191105136,0,4,3,4,6,17
191105137,8,9,8,0,6,31
191105138,5,5,8,3,3,24
191105139,4,4,9,4,5,26
191105140,9,5,2,0,8,24
191105141,7,6,0,0,8,21
191105142,8,6,3,2,7,26
191105143,5,0,5,1,1,12
191105144,1,1,6,4,5,17
191105145,7,6,1,3,4,21
191105146,5,3,8,7,3,26
191105147,5,7,5,6,3,26
191105148,1,7,2,3,9,22
191105149,5,7,2,0,2,16
191105150,3,8,0,8,3,22
191105151,9,8,8,7,8,40
191105152,4,7,6,3,8,28
191105153,6,2,9,1,3,21
191105154,4,5,5,8,0,22
191105155,6,8,2,2,8,26
191105156,4,3,9,3,5,24
191105157,4,4,2,3,5,18
191105158,6,4,1,8,9,28
191105159,0,6,8,5,8,27
191105160,6,6,6,3,0,21
191105161,2,7,0,4,3,16
191105162,1,2,2,0,8,13
191105163,4,5,3,7,3,22
191105164,6,9,9,8,2,34
191105165,5,8,7,2,7,29
191105166,9,9,9,4,7,38
191105167,9,0,3,6,4,22
191105168,4,4,5,5,9,27
191105169,2,3,6,5,7,23
191105170,0,9,2,7,9,27
191105171,1,5,4,0,6,16
191105172,0,4,3,5,8,20
191105173,9,1,8,2,3,23
191105174,6,3,7,3,9,28
191105175,9,6,4,6,1,26
191105176,3,7,8,9,2,29
191105177,9,9,3,0,0,21
191105178,4,1,0,2,5,12
191105179,2,8,5,1,9,25
191105180,9,8,1,5,6,29
191105181,4,8,0,4,9,25
191105182,9,2,3,5,4,23
191105183,3,5,6,0,9,23
191105184,1,1,0,0,4,6
191105185,6,0,0,2,6,14
191105186,2,5,3,6,9,25
191105187,6,6,6,5,5,28
191105188,6,0,8,6,5,25
191105189,2,4,3,8,0,17
191105190,5,4,8,4,6,27
191105191,4,3,8,5,2,22
191105192,8,5,9,8,4,34
191105193,7,6,8,1,4,26
191105194,9,7,7,2,3,28
191105195,5,0,9,4,3,21
191105196,4,0,0,2,9,15
191105197,6,8,3,9,2,28
191105198,4,3,8,2,3,20
191105199,2,4,5,0,8,19
191105200,6,4,1,7,9,27
191105201,5,3,0,4,6,18
191105202,6,6,8,1,6,27
191105203,5,4,0,0,6,15
191105204,2,7,1,8,2,20
191105205,8,5,1,5,8,27
191105206,2,3,3,2,7,17
191105207,1,4,7,6,0,18
191105208,8,2,9,2,0,21
191105209,1,4,1,5,0,11
191105210,3,9,3,9,0,24
191105211,0,6,5,1,5,17
191105212,8,4,5,2,5,24
191105213,3,1,3,8,8,23
191105214,9,2,4,2,9,26
191105215,3,8,4,2,1,18
191105216,0,0,7,1,8,16
191105217,8,8,6,3,8,33
191105218,4,9,6,6,2,27
191105219,7,1,1,6,9,24
191105220,8,2,3,2,1,16
191105221,8,6,1,9,5,29
191105222,4,4,2,6,6,22
191105223,0,0,9,5,7,21
191105224,4,7,6,9,2,28
191105225,6,9,1,6,4,26
191105226,6,0,2,8,7,23
191105227,3,3,1,1,0,8
191105228,2,3,9,5,1,20
191105229,7,3,2,2,8,22
191105230,3,2,4,8,9,26
191105231,8,1,7,2,3,21
191105232,6,4,8,7,9,34
191105233,8,2,3,8,8,29
191105234,2,5,7,2,1,17
191105235,5,0,4,0,1,10
191105236,6,1,3,3,1,14
191105237,5,9,5,1,3,23
191105238,7,1,3,5,1,17
191105239,2,6,5,0,4,17
191105240,5,2,8,6,3,24
191105241,2,7,0,9,6,24
191105242,6,1,3,2,3,15
191105243,5,2,0,8,2,17
191105244,2,0,0,6,1,9
191105245,3,9,1,1,0,14
191105246,1,1,0,9,7,18
191105247,2,6,1,3,3,15
191105248,8,1,7,5,4,25
191105249,4,9,6,9,2,30
191105250,8,7,3,7,6,31
191105251,9,3,8,6,1,27
191105252,9,1,2,9,6,27
191105253,4,8,5,3,0,20
191105254,5,5,3,4,9,26
191105255,5,9,8,8,6,36
191105256,4,9,6,1,3,23
191105257,7,0,6,7,9,29
191105258,9,6,7,1,1,24
191105259,6,4,6,4,6,26
191105260,3,7,5,4,6,25
191105261,5,5,9,0,7,26
191105262,2,8,6,0,7,23
191105263,4,1,8,5,5,23
191105264,9,8,6,7,3,33
191105265,0,7,8,2,3,20
191105266,7,0,1,6,1,15
191105267,5,6,4,2,5,22
191105268,8,1,9,6,9,33
191105269,3,5,7,2,2,19
191105270,8,5,8,0,2,23
191105271,7,0,8,9,7,31
191105272,2,8,8,9,8,35
191105273,9,2,8,1,2,22
191105274,0,2,7,2,5,16
191105275,2,3,5,6,6,22
191105276,3,0,2,4,4,13
191105277,1,2,6,3,4,16
191105278,4,6,2,1,2,15
191105279,6,9,7,8,9,39
191105280,3,0,4,1,5,13
191105281,1,5,4,0,7,17
191105282,4,3,3,6,3,19
191105283,4,2,9,8,1,24
191105284,2,1,0,1,1,5
191105285,6,1,4,1,5,17
191105286,2,0,2,0,9,13
191105287,9,2,2,1,3,17
191105288,4,2,6,0,0,12
191105289,0,4,2,9,0,15
191105290,9,8,6,2,5,30
191105291,2,7,9,4,1,23
191105292,4,0,3,5,6,18
191105293,7,7,5,5,0,24
191105294,2,2,9,3,8,24
191105295,7,9,7,2,7,32
191105296,2,4,8,8,0,22
191105297,0,8,0,3,5,16
191105298,5,7,2,1,8,23
191105299,4,5,8,2,5,24
191105300,3,0,9,7,3,22
191105301,8,3,4,9,9,33
191105302,0,9,5,4,7,25
191105303,0,4,8,6,8,26
191105304,5,0,7,2,7,21
191105305,5,7,3,2,3,20
191105306,2,1,4,4,1,12
191105307,7,3,8,3,0,21
191105308,8,1,6,5,9,29
191105309,3,7,2,5,0,17
191105310,6,7,7,8,9,37
191105311,3,1,2,5,6,17
191105312,6,9,2,9,9,35
191105313,6,6,2,4,0,18
191105314,4,8,8,1,6,27
191105315,1,6,0,7,0,14
191105316,2,9,9,1,6,27
191105317,5,4,0,8,3,20
191105318,7,5,6,2,2,22
191105319,3,9,7,4,7,30
191105320,1,7,1,5,5,19
191105321,3,6,6,8,8,31
191105322,6,7,6,8,2,29
191105323,4,7,8,6,4,29
191105324,7,4,8,5,8,32
191105325,1,7,5,6,8,27
191105326,7,8,0,5,4,24
191105327,4,8,9,4,1,26
191105328,6,1,7,0,5,19
191105329,3,0,5,9,1,18
191105330,9,3,6,9,2,29
191105331,8,0,5,1,5,19
191105332,3,6,5,5,6,25
191105333,4,0,7,4,8,23
191105334,4,3,5,2,5,19
191105335,0,6,2,5,4,17
191105336,9,1,0,0,2,12
191105337,0,8,9,2,4,23
191105338,6,7,3,1,2,19
191105339,5,3,2,3,7,20
191105340,8,8,4,2,4,26
191105341,8,7,7,3,8,33
191105342,3,1,9,9,9,31
191105343,0,8,2,7,2,19
191105344,3,8,7,4,9,31
191105345,1,1,7,1,6,16
191105346,7,8,7,6,7,35
191105347,7,0,7,0,3,17
191105348,0,4,8,8,8,28
191105349,7,4,1,7,0,19
191105350,2,9,9,1,4,25
191105351,1,2,9,9,0,21
191105352,1,4,5,5,9,24
191105353,9,5,5,4,4,27
191105354,0,0,5,0,3,8
191105355,1,5,3,7,4,20
191105356,9,6,3,7,1,26
191105357,1,7,0,0,3,11
191105358,4,7,7,7,6,31
191105359,8,4,1,2,6,21
191105360,6,3,8,9,9,35
191105361,5,4,1,3,2,15
191105362,5,0,8,3,4,20
191105363,1,9,4,8,6,28
191105364,9,3,8,4,9,33
191105365,1,5,0,3,3,12
191105366,8,9,9,4,5,35
191105367,9,4,5,1,6,25
191105368,4,5,6,8,5,28
191105369,4,8,1,0,3,16
191105370,1,0,0,2,6,9
191105371,9,1,1,1,5,17
191105372,0,6,2,2,0,10
191105373,9,5,4,9,9,36
191105374,3,5,6,1,0,15
191105375,7,2,2,8,2,21
191105376,1,3,2,6,7,19
191105377,7,0,9,3,8,27
191105378,5,6,3,8,3,25
191105379,6,4,7,3,8,28
191105380,3,9,4,0,7,23
191105381,3,6,2,7,2,20
191105382,0,9,7,1,2,19
191105383,5,6,9,4,0,24
191105384,0,1,1,5,6,13
191105385,8,2,4,5,3,22
191105386,5,9,5,3,9,31
191105387,4,4,8,9,9,34
191105388,2,9,5,2,9,27
191105389,5,6,5,2,8,26
191105390,4,0,9,5,2,20
191105391,8,0,5,4,3,20
191105392,2,2,0,6,5,15
191105393,7,9,7,3,8,34
191105394,5,8,3,9,1,26
191105395,9,1,0,5,1,16
191105396,5,0,5,1,0,11
191105397,7,6,3,7,1,24
191105398,1,5,9,5,6,26
191105399,4,8,9,1,0,22
191105400,3,4,4,1,2,14
191105401,1,0,3,7,8,19
191105402,1,4,3,2,9,19
191105403,0,2,3,2,4,11
191105404,3,8,8,6,9,34
191105405,1,6,1,5,0,13
191105406,0,0,6,6,3,15
191105407,7,5,8,5,3,28
191105408,1,4,5,8,5,23
191105409,8,4,0,8,0,20
191105410,6,3,5,4,8,26
191105411,1,3,5,0,6,15
191105412,9,0,2,2,5,18
191105413,9,8,0,6,3,26
191105414,4,8,2,1,5,20
191105415,1,0,9,6,6,22
191105416,7,1,4,4,7,23
191105417,7,4,8,9,9,37
191105418,9,6,5,8,4,32
191105419,5,4,2,1,7,19
191105420,9,7,6,9,4,35
191105421,2,1,0,1,0,4
191105422,0,7,8,6,6,27
191105423,6,5,9,5,8,33
191105424,9,1,6,6,2,24
191105425,6,4,8,5,5,28
191105426,7,7,9,7,0,30
191105427,1,9,2,2,4,18
191105428,8,0,3,6,2,19
191105429,1,8,1,2,3,15
191105430,1,6,9,3,8,27
191105431,3,8,9,9,5,34
191105432,1,5,5,0,4,15
191105433,3,9,7,8,4,31
191105434,4,9,8,2,6,29
191105435,3,0,9,3,3,18
191105436,5,5,2,0,7,19
191105437,8,6,7,7,3,31
191105438,0,5,3,2,4,14
191105439,1,9,6,3,2,21
191105440,4,2,8,6,6,26
191105441,6,4,1,1,4,16
191105442,8,6,4,7,4,29
191105443,4,4,5,4,2,19
191105444,0,2,9,9,6,26
191105445,7,2,9,9,7,34
191105446,3,5,8,5,7,28
191105447,5,2,3,3,2,15
191105448,7,7,9,6,9,38
191105449,7,6,4,0,4,21
191105450,4,2,9,2,3,20
191105451,5,0,5,9,9,28
191105452,9,2,2,6,3,22
191105453,1,4,0,6,5,16
191105454,7,0,9,4,7,27
191105455,1,3,8,3,1,16
191105456,5,0,6,7,2,20
191105457,1,5,6,3,5,20
191105458,9,0,4,0,5,18
191105459,0,1,1,8,3,13
191105460,5,7,5,6,7,30
191105461,2,0,9,2,2,15
191105462,0,4,7,6,9,26
191105463,7,5,0,1,7,20
191105464,8,6,7,6,5,32
191105465,6,9,9,2,3,29
191105466,2,1,3,8,1,15
191105467,6,7,1,0,0,14
191105468,5,5,4,6,2,22
191105469,6,8,0,1,1,16
191105470,2,0,4,2,1,9
191105471,5,5,0,2,3,15
191105472,1,3,7,6,6,23
191105473,6,4,9,8,9,36
191105474,8,4,0,2,1,15
191105475,3,2,9,3,2,19
191105476,4,8,7,7,3,29
191105477,6,3,0,3,5,17
191105478,0,2,1,7,1,11
191105479,6,9,1,7,7,30
191105480,6,7,5,4,2,24
191105481,6,3,8,7,6,30
191105482,4,9,0,5,9,27
191105483,3,3,7,8,2,23
191105484,9,2,3,9,3,26
191105485,7,3,2,7,3,22
191105486,4,8,3,5,3,23
191105487,7,5,8,8,1,29
191105488,5,9,8,2,5,29
191105489,6,2,6,7,9,30
191105490,1,8,5,8,2,24
191105491,1,7,5,3,0,16
191105492,8,8,0,4,5,25
191105493,3,2,7,6,5,23
191105494,7,4,1,0,0,12
191105495,8,4,4,6,4,26
191105496,9,6,9,6,5,35
191105497,5,5,5,9,8,32
191105498,6,3,3,7,1,20
191105499,4,4,8,5,3,24
191105500,9,6,0,6,0,21
191105501,5,4,1,5,6,21
191105502,0,6,0,0,0,6
191105503,1,8,3,1,4,17
191105504,7,5,3,0,5,20
191105505,3,0,7,6,5,21
191105506,6,0,1,6,4,17
191105507,0,0,3,8,3,14
191105508,6,4,9,6,9,34
191105509,9,5,9,3,3,29
191105510,8,9,4,4,1,26
191105511,4,3,6,4,5,22
191105512,0,9,8,6,2,25
191105513,3,7,8,4,3,25
191105514,0,6,5,8,0,19
191105515,1,4,2,3,8,18
191105516,2,7,4,5,2,20
191105517,4,7,6,9,3,29
191105518,6,9,8,0,9,32
191105519,8,1,9,5,2,25
191105520,0,4,2,5,2,13
191105521,5,8,4,3,8,28
191105522,1,5,3,0,0,9
191105523,4,9,5,0,5,23
191105524,4,7,1,2,0,14
191105525,4,0,7,2,2,15
191105526,8,2,7,9,3,29
191105527,0,5,1,5,7,18
191105528,9,8,3,2,8,30
191105529,7,8,3,2,1,21
191105530,2,4,7,7,0,20
191105531,9,4,7,0,4,24
191105532,6,4,5,3,9,27
191105533,8,3,8,8,7,34
191105534,0,9,8,1,1,19
191105535,4,1,9,9,6,29
191105536,5,0,4,7,9,25
191105537,8,1,6,5,5,25
191105538,7,1,8,2,3,21
191105539,7,8,5,0,5,25
191105540,5,9,6,0,8,28
191105541,7,8,9,5,6,35
191105542,0,6,9,8,9,32
191105543,9,5,9,2,3,28
191105544,6,7,4,4,0,21
191105545,4,7,0,5,2,18
191105546,9,4,2,4,2,21
191105547,7,1,5,2,9,24
191105548,4,2,0,6,1,13
191105549,3,7,1,5,2,18
191105550,0,9,7,1,1,18
191105551,4,0,5,2,0,11
191105552,2,3,5,3,5,18
191105553,6,0,1,1,5,13
191105554,0,8,3,1,4,16
191105555,0,2,3,4,9,18
191105556,4,4,5,4,5,22
191105557,6,0,9,2,9,26
191105558,3,7,5,2,0,17
191105559,7,2,5,4,1,19
191105560,0,7,7,0,3,17
191105561,8,0,8,6,8,30
191105562,7,1,7,3,4,22
191105563,6,8,2,7,3,26
191105564,1,4,6,2,7,20
191105565,9,5,8,2,4,28
191105566,6,4,4,3,4,21
191105567,0,4,6,5,1,16
191105568,3,0,0,6,6,15
191105569,1,0,7,1,2,11
191105570,4,4,9,8,8,33
191105571,5,5,5,2,9,26
191105572,5,0,3,4,1,13
191105573,1,4,9,9,8,31
191105574,5,8,9,1,7,30
191105575,9,7,5,7,9,37
191105576,2,6,4,9,2,23
191105577,9,7,5,1,3,25
191105578,9,9,1,6,9,34
191105579,9,7,3,7,8,34
191105580,8,0,5,6,5,24
191105581,5,9,1,6,3,24
191105582,8,0,9,1,5,23
191105583,8,1,4,8,0,21
191105584,3,1,8,3,5,20
191105585,9,8,1,4,8,30
191105586,7,1,0,9,1,18
191105587,0,5,0,0,8,13
191105588,3,9,6,0,3,21
191105589,6,4,5,4,7,26
191105590,1,5,7,0,0,13
191105591,7,5,6,5,5,28
191105592,7,3,3,0,2,15
191105593,9,0,2,0,8,19
191105594,2,2,4,3,1,12
191105595,2,8,6,5,2,23
191105596,6,7,8,5,6,32
191105597,4,5,8,9,6,32
191105598,9,6,8,2,4,29
191105599,6,2,3,8,1,20
191105600,7,2,1,2,2,14
191105601,9,8,2,7,1,27
191105602,1,3,2,5,5,16
191105603,8,9,5,0,9,31
191105604,8,1,0,6,1,16
191105605,3,4,8,4,6,25
191105606,0,0,2,5,3,10
191105607,3,1,8,1,7,20
191105608,3,4,1,3,5,16
191105609,7,0,6,8,7,28
191105610,8,8,4,6,0,26
191105611,4,1,0,0,5,10
191105612,4,6,6,8,7,31
191105613,2,0,3,8,1,14
191105614,8,4,1,9,7,29
191105615,9,7,1,7,2,26
191105616,8,1,3,0,5,17
191105617,9,9,8,9,4,39
191105618,1,8,9,8,3,29
191105619,4,8,5,3,3,23
191105620,1,0,6,2,6,15
191105621,8,1,2,4,7,22
191105622,1,6,9,1,6,23
191105623,8,7,5,8,2,30
191105624,4,6,9,4,7,30
191105625,9,0,0,8,8,25
191105626,4,7,9,1,9,30
191105627,8,7,5,2,2,24
191105628,5,1,0,3,2,11
191105629,4,7,2,3,4,20
191105630,8,3,0,7,3,21
191105631,1,5,3,4,1,14
191105632,8,7,3,9,8,35
191105633,9,2,2,2,9,24
191105634,3,4,2,4,9,22
191105635,1,1,4,6,3,15
191105636,8,2,4,5,7,26
191105637,5,5,6,6,0,22
191105638,6,8,6,6,0,26
191105639,9,4,2,4,4,23
191105640,2,5,0,3,5,15
191105641,0,4,6,9,8,27
191105642,2,5,7,2,0,16
191105643,9,8,4,0,6,27
191105644,4,1,3,7,6,21
191105645,0,8,9,4,8,29
191105646,6,1,7,0,0,14
191105647,1,8,2,1,7,19
191105648,9,7,9,0,3,28
191105649,8,1,0,6,7,22
191105650,0,6,4,0,8,18
191105651,6,5,6,0,7,24
191105652,4,8,2,1,0,15
191105653,8,8,0,9,6,31
191105654,6,3,0,7,3,19
191105655,3,6,0,2,3,14
191105656,0,6,4,5,6,21
191105657,1,3,9,3,1,17
191105658,2,4,6,4,9,25
191105659,7,3,0,6,9,25
191105660,5,9,6,6,5,31
191105661,8,2,6,6,1,23
191105662,1,3,7,4,0,15
191105663,4,8,8,8,4,32
191105664,9,1,5,6,3,24
191105665,3,9,6,0,5,23
191105666,9,4,2,0,5,20
191105667,9,3,2,5,8,27
191105668,6,6,2,3,1,18
191105669,3,2,4,0,1,10
191105670,8,7,8,3,9,35
191105671,3,5,4,5,7,24
191105672,7,5,7,3,9,31
191105673,6,2,0,6,6,20
191105674,3,6,5,4,9,27
191105675,0,2,7,7,4,20
191105676,1,1,2,4,2,10
191105677,0,6,4,0,2,12
191105678,3,6,9,9,9,36
191105679,3,2,2,2,1,10
191105680,8,4,0,8,8,28
191105681,5,4,7,2,6,24
191105682,5,4,6,1,8,24
191105683,0,0,5,0,2,7
191105684,6,5,5,2,0,18
191105685,8,0,5,4,4,21
191105686,1,4,6,0,9,20
191105687,8,9,1,7,1,26
191105688,8,5,2,7,7,29
191105689,7,2,7,8,8,32
191105690,0,5,7,4,6,22
191105691,0,8,1,2,7,18
191105692,2,4,1,2,7,16
191105693,9,7,9,0,1,26
191105694,9,6,5,2,9,31
191105695,0,2,0,5,2,9
191105696,7,2,5,9,1,24
191105697,1,0,0,1,1,3
191105698,5,2,8,8,9,32
191105699,8,7,9,0,1,25
191105700,7,8,9,6,5,35
191105701,4,5,6,4,3,22
191105702,8,0,5,2,7,22
191105703,3,7,1,7,9,27
191105704,4,6,2,7,8,27
191105705,8,3,9,7,1,28
191105706,1,8,2,1,8,20
191105707,1,5,0,9,2,17
191105708,5,3,4,7,9,28
191105709,3,1,1,3,0,8
191105710,6,9,3,2,6,26
191105711,5,7,2,3,8,25
191105712,3,6,3,5,7,24
191105713,7,2,9,0,3,21
191105714,6,8,3,3,7,27
191105715,7,5,7,3,8,30
191105716,8,6,8,8,8,38
191105717,3,2,5,5,5,20
191105718,8,9,9,9,4,39
191105719,9,1,2,0,4,16
191105720,6,4,3,1,4,18
191105721,7,2,0,6,8,23
191105722,8,8,9,4,3,32
191105723,2,4,5,0,9,20
191105724,3,8,2,7,5,25
191105725,9,3,5,1,0,18
191105726,5,4,6,0,4,19
191105727,9,5,9,5,5,33
191105728,0,7,6,2,9,24
191105729,4,6,5,6,7,28
191105730,9,0,4,9,1,23
191105731,4,4,4,4,6,22
191105732,5,3,1,6,9,24
191105733,5,5,6,5,5,26
191105734,7,6,0,6,8,27
191105735,2,0,4,0,2,8
191105736,8,1,8,2,7,26
191105737,4,3,8,8,2,25
191105738,6,2,3,2,8,21
191105739,2,1,4,5,7,19
191105740,1,4,5,3,3,16
191105741,7,0,8,0,1,16
191105742,8,8,8,4,0,28
191105743,1,1,7,5,4,18
191105744,3,4,6,1,1,15
191105745,9,4,1,3,7,24
191105746,8,5,2,2,2,19
191105747,3,8,8,1,1,21
191105748,5,6,4,0,5,20
191105749,0,9,6,9,4,28
191105750,1,3,3,9,3,19
191105751,1,8,7,2,9,27
191105752,8,5,5,8,8,34
191105753,4,2,4,8,6,24
191105754,4,4,9,1,1,19
191105755,2,5,4,4,9,24
191105756,6,8,9,3,3,29
191105757,3,6,2,8,6,25
191105758,7,6,4,8,0,25
191105759,4,8,2,9,3,26
191105760,5,5,8,4,7,29
191105761,1,7,0,9,2,19
191105762,1,0,3,3,8,15
191105763,3,5,5,0,2,15
191105764,5,2,9,9,6,31
191105765,7,2,8,3,9,29
191105766,7,3,1,8,5,24
191105767,7,0,4,3,8,22
191105768,9,7,0,9,0,25
191105769,6,0,5,2,5,18
191105770,2,9,5,9,8,33
191105771,4,9,0,7,9,29
191105772,8,8,6,5,3,30
191105773,2,3,4,1,6,16
191105774,0,3,9,4,1,17
191105775,0,5,4,0,5,14
191105776,6,0,9,1,1,17
191105777,2,3,8,1,4,18
191105778,3,9,0,9,8,29
191105779,0,5,5,4,1,15
191105780,0,4,2,8,7,21
191105781,7,7,9,1,4,28
191105782,5,1,6,7,4,23
191105783,6,1,1,1,9,18
191105784,3,6,3,2,8,22
191105785,6,7,0,7,8,28
191105786,2,9,3,8,2,24
191105787,0,6,1,0,3,10
191105788,4,8,6,9,3,30
191105789,5,2,9,5,3,24
191105790,0,6,3,8,1,18
191105791,0,5,2,9,3,19
191105792,1,0,0,9,7,17
191105793,7,1,4,0,0,12
191105794,3,9,3,8,3,26
191105795,9,5,0,1,2,17
191105796,6,3,3,3,2,17
191105797,2,0,4,8,0,14
191105798,5,8,2,3,2,20
191105799,3,6,1,0,8,18
191105800,9,2,5,5,9,30
191105801,3,5,5,0,9,22
191105802,2,8,2,9,2,23
191105803,0,4,9,4,8,25
191105804,4,2,0,1,8,15
191105805,1,4,0,1,8,14
191105806,3,1,9,7,1,21
191105807,1,2,8,3,5,19
191105808,6,4,9,6,4,29
191105809,7,8,2,1,0,18
191105810,5,4,4,4,6,23
191105811,8,6,7,1,6,28
191105812,8,9,7,1,9,34
191105813,0,8,6,4,4,22
191105814,2,5,4,1,6,18
191105815,1,0,6,6,7,20
191105816,7,0,9,8,9,33
191105817,9,4,1,7,5,26
191105818,2,1,1,4,3,11
191105819,2,0,6,8,2,18
191105820,1,5,6,1,5,18
191105821,7,4,2,4,3,20
191105822,1,7,0,7,2,17
191105823,7,9,5,2,1,24
191105824,0,6,2,9,6,23
191105825,2,7,1,9,5,24
191105826,0,0,4,6,8,18
191105827,7,4,4,4,1,20
191105828,1,0,9,1,2,13
191105829,0,3,2,0,6,11
191105830,3,5,5,7,2,22
191105831,4,9,6,3,5,27
191105832,9,2,4,5,9,29
191105833,3,0,0,4,7,14
191105834,1,2,7,7,6,23
191105835,5,8,8,5,7,33
191105836,9,4,6,6,0,25
191105837,6,0,7,7,1,21
191105838,1,7,5,7,6,26
191105839,5,2,4,1,3,15
191105840,8,0,5,0,7,20
191105841,5,4,7,9,1,26
191105842,8,6,1,8,2,25
191105843,2,3,7,2,5,19
191105844,7,0,3,4,8,22
191105845,7,0,2,3,0,12
191105846,7,7,1,5,6,26
191105847,9,7,7,5,9,37
191105848,7,4,7,9,5,32
191105849,6,9,7,7,5,34
191105850,7,4,8,4,3,26
191105851,6,1,4,6,7,24
191105852,0,5,0,3,2,10
191105853,5,7,8,7,8,35
191105854,8,4,7,4,5,28
191105855,8,9,1,8,5,31
191105856,1,2,0,8,3,14
191105857,6,3,6,0,5,20
191105858,1,4,4,5,7,21
191105859,6,7,5,2,2,22
191105860,8,2,4,6,7,27
191105861,8,5,8,1,6,28
191105862,0,4,0,1,1,6
191105863,7,0,6,7,7,27
191105864,1,4,3,8,1,17
191105865,2,6,8,9,7,32
191105866,3,7,2,3,4,19
191105867,4,8,2,5,5,24
191105868,1,3,7,0,5,16
191105869,9,2,9,0,2,22
191105870,8,6,3,1,3,21
191105871,7,5,4,7,9,32
191105872,8,9,5,9,1,32
191105873,0,8,3,6,4,21
191105874,3,2,9,3,9,26
191105875,8,8,8,3,6,33
191105876,1,2,9,4,7,23
191105877,8,6,3,0,8,25
191105878,9,0,6,9,2,26
191105879,0,6,5,8,7,26
191105880,3,2,3,9,0,17
191105881,8,2,3,9,6,28
191105882,8,7,5,7,6,33
191105883,2,3,9,1,1,16
191105884,0,3,8,5,0,16
191105885,6,1,8,1,6,22
191105886,6,2,2,3,2,15
191105887,7,2,2,0,3,14
191105888,8,7,8,1,8,32
191105889,3,6,2,3,1,15
191105890,3,9,0,0,9,21
191105891,8,3,3,3,3,20
191105892,0,8,4,6,3,21
191105893,2,1,5,7,3,18
191105894,5,8,0,7,6,26
191105895,9,7,5,1,5,27
191105896,9,3,0,8,9,29
191105897,5,8,2,3,8,26
191105898,4,8,4,1,5,22
191105899,9,1,6,2,4,22
191105900,4,8,5,6,8,31
191105901,0,8,7,7,6,28
191105902,3,9,2,7,2,23
191105903,3,4,2,6,1,16
191105904,2,9,8,9,1,29
191105905,8,1,7,4,7,27
191105906,3,9,2,2,1,17
191105907,6,1,3,5,5,20
191105908,1,6,9,5,1,22
191105909,9,6,7,6,1,29
191105910,5,3,9,3,8,28
191105911,1,4,0,7,7,19
191105912,0,2,6,8,2,18
191105913,4,6,7,4,4,25
191105914,3,6,0,6,6,21
191105915,3,4,7,1,0,15
191105916,3,2,0,0,7,12
191105917,4,5,6,3,2,20
191105918,4,4,6,2,5,21
191105919,4,4,7,6,9,30
191105920,8,6,5,3,0,22
191105921,5,5,2,7,9,28
191105922,3,7,2,9,2,23
191105923,5,6,7,8,5,31
191105924,6,6,2,3,2,19
191105925,4,1,3,4,6,18
191105926,8,5,6,2,4,25
191105927,3,8,5,1,1,18
191105928,2,1,7,5,7,22
191105929,8,7,3,8,8,34
191105930,9,9,1,5,3,27
191105931,1,8,2,3,4,18
191105932,5,8,9,7,4,33
191105933,6,8,1,0,8,23
191105934,9,8,9,2,9,37
191105935,9,7,4,6,4,30
191105936,8,7,1,1,4,21
191105937,9,9,4,3,8,33
191105938,1,1,3,1,3,9
191105939,1,8,4,1,6,20
191105940,4,0,6,2,1,13
191105941,0,1,1,6,9,17
191105942,8,5,1,6,1,21
191105943,6,1,8,0,4,19
191105944,8,7,4,8,3,30
191105945,5,9,1,4,2,21
191105946,9,5,7,6,3,30
191105947,2,7,4,6,9,28
191105948,0,0,5,5,6,16
191105949,4,2,8,8,1,23
191105950,7,4,6,9,5,31
191105951,1,1,3,6,6,17
191105952,9,8,8,9,4,38
191105953,6,1,9,3,6,25
191105954,8,1,8,4,4,25
191105955,1,2,1,5,7,16
191105956,3,7,4,1,5,20
191105957,6,3,8,6,4,27
191105958,7,6,6,9,7,35
191105959,9,4,4,3,9,29
191105960,7,0,0,9,0,16
191105961,4,1,4,6,5,20
191105962,2,4,0,1,9,16
191105963,4,9,0,5,7,25
191105964,3,6,0,1,8,18
191105965,3,9,6,3,6,27
191105966,1,6,5,0,0,12
191105967,7,7,4,5,3,26
191105968,9,1,1,4,7,22
191105969,5,7,9,7,9,37
191105970,6,3,3,3,1,16
191105971,1,0,7,5,5,18
191105972,1,3,0,1,4,9
191105973,0,4,2,6,1,13
191105974,7,9,3,1,8,28
191105975,1,5,8,7,6,27
191105976,8,3,9,9,8,37
191105977,0,1,1,8,1,11
191105978,4,5,5,2,5,21
191105979,2,1,2,2,5,12
191105980,0,9,0,5,4,18
191105981,8,6,9,5,4,32
191105982,4,4,0,6,7,21
191105983,6,3,1,4,9,23
191105984,7,8,2,8,3,28
191105985,9,1,5,2,6,23
191105986,0,3,8,1,7,19
191105987,6,8,0,9,1,24
191105988,5,7,4,0,9,25
191105989,6,9,2,2,1,20
191105990,2,0,1,9,3,15
191105991,6,0,1,4,6,17
191105992,0,0,2,6,7,15
191105993,0,0,3,5,5,13
191105994,2,5,6,3,1,17
191105995,2,0,5,3,9,19
191105996,3,2,8,3,5,21
191105997,1,3,9,2,1,16
191105998,6,5,2,8,2,23
191105999,3,1,0,2,4,10
1911051000,4,2,5,0,3,14
1911051001,0,7,2,6,2,17
1911051002,2,6,6,6,6,26
1911051003,8,1,9,0,9,27
1911051004,3,0,6,7,5,21
1911051005,3,9,2,6,6,26
1911051006,5,8,7,6,0,26
1911051007,5,3,8,2,2,20
1911051008,7,0,9,7,1,24
1911051009,0,4,7,5,8,24
1911051010,6,4,0,7,6,23
1911051011,6,6,5,5,1,23
1911051012,2,0,7,1,5,15
1911051013,5,6,7,2,0,20
1911051014,8,8,6,5,5,32
1911051015,1,7,6,8,0,22
1911051016,7,0,7,8,7,29
1911051017,2,4,6,0,4,16
1911051018,9,0,9,5,8,31
1911051019,2,3,5,7,2,19
1911051020,6,2,9,0,3,20
1911051021,3,0,6,3,7,19
1911051022,6,1,4,6,8,25
1911051023,2,5,3,2,5,17
1911051024,3,9,2,4,6,24
1911051025,8,8,6,8,3,33
1911051026,3,0,7,0,4,14
1911051027,9,5,0,5,1,20
1911051028,1,0,4,1,8,14
1911051029,9,8,1,2,1,21
1911051030,3,8,3,0,7,21
1911051031,8,3,2,6,7,26
1911051032,8,1,1,2,7,19
1911051033,5,7,0,0,3,15
1911051034,1,5,8,1,1,16
1911051035,1,1,1,9,8,20
1911051036,6,2,4,8,5,25
1911051037,3,1,8,2,2,16
1911051038,5,9,3,7,1,25
1911051039,6,9,8,3,8,34
1911051040,0,6,8,2,0,16
1911051041,8,1,6,8,3,26
1911051042,0,3,3,3,0,9
1911051043,0,2,7,1,6,16
1911051044,3,0,5,2,9,19
1911051045,9,9,3,2,2,25
1911051046,0,8,9,3,2,22
1911051047,7,3,3,1,9,23
1911051048,9,0,3,4,8,24
1911051049,5,8,2,0,5,20
1911051050,2,2,3,9,5,21
1911051051,7,7,9,9,6,38
1911051052,8,5,2,4,1,20
1911051053,2,8,6,3,7,26
1911051054,1,5,2,0,5,13
1911051055,5,9,1,7,2,24
1911051056,3,1,1,4,3,12
1911051057,1,6,7,3,2,19
1911051058,3,7,7,0,8,25
1911051059,1,6,1,0,3,11
1911051060,4,8,1,2,5,20
1911051061,5,0,8,2,2,17
1911051062,0,2,8,2,9,21
1911051063,7,7,5,1,3,23
1911051064,8,0,4,6,2,20
1911051065,8,1,3,5,3,20
1911051066,5,9,3,1,5,23
1911051067,7,8,5,4,5,29
1911051068,6,3,8,5,0,22
1911051069,3,6,5,9,7,30
1911051070,3,1,0,7,4,15
1911051071,0,3,2,6,0,11
1911051072,5,8,3,2,4,22
1911051073,7,5,6,0,2,20
1911051074,8,6,5,1,6,26
1911051075,5,4,5,6,9,29
1911051076,0,1,5,3,4,13
1911051077,3,1,9,6,2,21
1911051078,0,5,0,6,1,12
1911051079,6,6,6,7,2,27
1911051080,2,2,3,8,3,18
1911051081,4,0,3,8,8,23
1911051082,6,9,8,4,3,30
1911051083,4,7,1,6,0,18
1911051084,3,7,1,3,0,14
1911051085,5,9,1,6,1,22
1911051086,4,0,0,1,1,6
1911051087,0,6,0,1,0,7
1911051088,5,6,5,5,5,26
1911051089,7,5,8,5,1,26
1911051090,2,5,4,8,5,24
1911051091,0,1,8,7,4,20
1911051092,1,1,3,9,4,18
1911051093,8,5,3,9,7,32
1911051094,2,8,5,9,9,33
1911051095,5,6,5,6,0,22
1911051096,4,3,5,6,9,27
1911051097,1,7,6,6,8,28
1911051098,7,9,8,4,8,36
1911051099,3,5,0,0,7,15
1911051100,9,7,8,0,0,24
1911051101,5,3,2,9,6,25
1911051102,3,3,1,6,7,20
1911051103,7,0,7,8,3,25
1911051104,3,4,1,3,0,11
1911051105,7,1,6,3,7,24
191106001,1,6,9,0,7,23
191106002,7,4,0,6,2,19
191106003,1,6,5,8,0,20
191106004,7,5,7,1,1,21
191106005,1,4,5,6,0,16
191106006,6,4,7,3,1,21
191106007,6,8,0,3,3,20
191106008,7,7,5,9,4,32
191106009,1,7,7,0,1,16
191106010,6,9,3,6,9,33
191106011,3,1,4,3,7,18
191106012,0,7,5,8,0,20
191106013,7,9,4,5,1,26
191106014,4,0,1,5,1,11
191106015,4,6,8,4,4,26
191106016,2,1,4,2,4,13
191106017,9,5,6,6,4,30
191106018,4,5,9,3,9,30
191106019,8,1,8,6,3,26
191106020,0,7,5,7,0,19
191106021,9,2,8,6,4,29
191106022,9,9,5,2,2,27
191106023,0,1,3,9,7,20
191106024,5,1,9,6,2,23
191106025,0,4,5,2,3,14
191106026,9,2,9,0,6,26
191106027,6,1,2,0,5,14
191106028,8,9,6,2,3,28
191106029,6,6,1,7,4,24
191106030,9,5,4,5,1,24
191106031,8,1,5,1,1,16
191106032,8,2,3,5,4,22
191106033,3,5,2,1,3,14
191106034,4,0,8,3,6,21
191106035,3,5,6,3,0,17
191106036,3,2,2,5,5,17
191106037,2,3,1,4,8,18
191106038,5,0,2,0,7,14
191106039,6,4,8,6,7,31
191106040,4,8,3,4,4,23
191106041,4,8,5,7,6,30
191106042,8,4,2,6,7,27
191106043,6,2,5,1,4,18
191106044,9,5,5,6,5,30
191106045,8,8,3,3,8,30
191106046,1,5,9,8,8,31
191106047,6,1,2,0,0,9
191106048,3,4,2,5,7,21
191106049,0,8,1,5,2,16
191106050,0,8,3,3,7,21
191106051,2,5,7,1,1,16
191106052,9,6,6,1,1,23
191106053,6,5,0,2,7,20
191106054,3,3,5,2,5,18
191106055,1,1,2,2,8,14
191106056,6,3,4,7,9,29
191106057,6,9,2,1,8,26
191106058,1,2,7,6,5,21
191106059,7,8,2,3,0,20
191106060,2,9,2,1,8,22
191106061,5,0,1,9,8,23
191106062,3,5,9,4,9,30
191106063,7,9,9,9,2,36
191106064,4,4,6,6,9,29
191106065,9,6,5,7,9,36
191106066,9,6,5,9,9,38
191106067,8,0,0,2,5,15
191106068,9,2,2,1,0,14
191106069,9,3,2,4,1,19
191106070,3,0,6,9,4,22
191106071,0,9,2,4,6,21
191106072,5,9,5,8,3,30
191106073,3,3,2,2,5,15
191106074,3,5,5,3,6,22
191106075,5,1,9,5,6,26
191106076,3,5,9,8,2,27
191106077,1,6,9,0,8,24
191106078,3,3,1,3,6,16
191106079,3,1,4,3,4,15
191106080,6,6,4,0,8,24
191106081,3,0,6,3,9,21
191106082,3,7,0,6,1,17
191106083,4,4,3,9,1,21
191106084,5,4,2,4,3,18
191106085,2,9,6,8,0,25
191106086,8,3,1,9,6,27
191106087,2,8,5,3,2,20
191106088,9,4,7,4,9,33
191106089,9,0,8,3,8,28
191106090,3,7,0,8,0,18
191106091,8,5,6,4,0,23
191106092,7,9,7,4,7,34
191106093,6,6,8,7,8,35
191106094,6,4,4,1,3,18
191106095,5,0,5,1,3,14
191106096,4,6,0,3,6,19
191106097,1,0,2,5,2,10
191106098,4,8,7,3,4,26
191106099,0,7,6,4,6,23
191106100,2,8,4,0,5,19
191106101,5,2,2,9,7,25
191106102,4,1,5,0,1,11
191106103,0,9,9,1,6,25
191106104,4,3,5,7,6,25
191106105,6,8,9,8,8,39
191106106,7,3,5,5,5,25
191106107,3,8,7,9,0,27
191106108,4,7,5,1,2,19
191106109,7,8,8,7,6,36
191106110,1,8,5,0,5,19
191106111,2,1,1,1,4,9
191106112,6,6,9,5,2,28
191106113,3,0,9,2,9,23
191106114,5,8,9,2,4,28
191106115,0,6,9,5,5,25
191106116,8,5,8,6,2,29
191106117,4,8,6,3,2,23
191106118,8,9,7,2,6,32
191106119,8,3,1,5,9,26
191106120,2,0,3,2,9,16
191106121,3,6,1,3,8,21
191106122,0,0,3,2,9,14
191106123,9,8,4,0,9,30
191106124,8,8,3,4,2,25
191106125,4,8,8,4,3,27
191106126,7,0,4,9,3,23
191106127,1,8,1,7,2,19
191106128,6,4,8,3,6,27
191106129,2,2,0,3,1,8
191106130,0,3,5,2,5,15
191106131,3,0,9,4,7,23
191106132,7,4,6,3,3,23
191106133,2,7,6,9,6,30
191106134,8,9,5,9,6,37
191106135,8,5,8,3,7,31
191106136,2,9,6,4,8,29
191106137,0,2,1,0,9,12
191106138,6,8,9,3,4,30
191106139,4,9,5,0,1,19
191106140,1,2,6,4,7,20
191106141,7,3,1,3,1,15
191106142,9,0,9,8,3,29
191106143,2,2,4,4,3,15
191106144,2,5,9,6,8,30
191106145,0,3,7,7,4,21
191106146,5,0,0,1,3,9
191106147,7,9,2,2,1,21
191106148,2,0,6,6,4,18
191106149,5,3,3,2,8,21
191106150,4,2,2,4,5,17
191106151,0,6,2,4,0,12
191106152,3,0,4,1,6,14
191106153,9,3,2,7,7,28
191106154,5,6,9,8,9,37
191106155,3,7,6,6,3,25
191106156,1,2,5,2,0,10
191106157,2,1,7,1,3,14
191106158,4,0,7,2,8,21
191106159,4,5,1,8,0,18
191106160,4,2,4,1,3,14
191106161,7,8,1,8,1,25
191106162,9,3,3,2,8,25
191106163,4,2,8,6,3,23
191106164,3,7,0,8,9,27
191106165,3,5,3,9,1,21
191106166,8,9,7,5,4,33
191106167,0,6,6,7,6,25
191106168,1,6,0,1,6,14
191106169,7,6,9,7,9,38
191106170,7,2,0,4,4,17
191106171,9,6,0,1,6,22
191106172,5,3,6,6,0,20
191106173,5,1,3,4,3,16
191106174,9,3,9,1,4,26
191106175,5,2,7,3,7,24
191106176,8,4,7,9,4,32
191106177,2,8,6,9,9,34
191106178,0,6,5,8,6,25
191106179,9,3,1,7,7,27
191106180,6,4,7,1,9,27
191106181,9,9,7,1,2,28
191106182,7,5,4,0,4,20
191106183,1,3,5,9,3,21
191106184,1,0,9,0,3,13
191106185,1,0,1,1,9,12
191106186,3,5,0,4,8,20
191106187,3,7,2,8,2,22
191106188,7,7,3,6,5,28
191106189,5,1,3,3,1,13
191106190,7,0,0,3,8,18
191106191,4,7,1,2,7,21
191106192,0,9,5,6,2,22
191106193,5,6,5,6,6,28
191106194,3,0,3,1,1,8
191106195,1,0,4,4,2,11
191106196,4,5,5,7,7,28
191106197,9,0,6,7,1,23
191106198,5,2,0,5,6,18
191106199,6,6,1,8,3,24
191106200,2,7,0,8,9,26
191106201,9,2,2,0,4,17
191106202,8,7,8,5,5,33
191106203,5,9,2,9,1,26
191106204,1,2,0,0,1,4
191106205,8,2,9,2,5,26
191106206,1,1,3,9,8,22
191106207,3,7,7,7,2,26
191106208,9,8,5,7,1,30
191106209,0,5,1,1,3,10
191106210,0,5,6,8,8,27
191106211,7,8,5,8,1,29
191106212,7,3,8,7,3,28
191106213,6,9,6,2,5,28
191106214,5,7,4,7,8,31
191106215,2,8,9,4,4,27
191106216,3,8,9,7,4,31
191106217,4,0,3,9,9,25
191106218,6,9,1,4,3,23
191106219,0,2,0,5,5,12
191106220,4,3,5,0,7,19
191106221,0,3,1,1,4,9
191106222,2,5,4,3,6,20
191106223,9,2,8,4,7,30
191106224,3,5,7,1,7,23
191106225,7,0,5,6,7,25
191106226,7,7,8,2,0,24
191106227,1,5,0,9,1,16
191106228,1,7,6,6,4,24
191106229,2,8,2,5,6,23
191106230,4,7,6,9,7,33
191106231,0,5,5,7,5,22
191106232,1,3,5,0,4,13
191106233,8,3,3,3,4,21
191106234,2,7,3,2,8,22
191106235,5,2,8,2,6,23
191106236,7,1,4,1,8,21
191106237,7,3,4,7,8,29
191106238,5,6,5,0,8,24
191106239,1,1,7,7,6,22
191106240,5,9,6,7,6,33
191106241,7,6,4,0,5,22
191106242,9,6,6,8,0,29
191106243,1,8,3,2,3,17
191106244,7,7,6,3,1,24
191106245,1,2,1,2,1,7
191106246,1,7,4,7,1,20
191106247,6,8,8,5,3,30
191106248,0,4,0,7,3,14
191106249,5,7,4,0,4,20
191106250,2,6,7,1,6,22
191106251,7,4,2,6,1,20
191106252,0,1,2,7,6,16
191106253,1,7,5,5,4,22
191106254,0,8,0,0,5,13
191106255,2,5,6,5,2,20
191106256,5,2,4,3,4,18
191106257,5,4,7,1,0,17
191106258,6,4,6,6,5,27
191106259,4,4,5,2,9,24
191106260,0,8,5,7,9,29
191106261,7,2,7,5,3,24
191106262,3,0,4,7,0,14
191106263,6,6,2,4,3,21
191106264,9,6,9,2,5,31
191106265,6,1,0,7,7,21
191106266,8,4,1,7,0,20
191106267,8,4,7,7,6,32
191106268,2,0,9,8,8,27
191106269,8,2,8,7,6,31
191106270,0,5,3,9,6,23
191106271,4,3,4,5,7,23
191106272,8,8,4,7,3,30
191106273,4,2,6,9,7,28
191106274,9,7,6,4,3,29
191106275,3,6,4,7,0,20
191106276,0,3,1,1,2,7
191106277,0,3,3,1,8,15
191106278,6,1,4,6,6,23
191106279,2,9,0,9,7,27
191106280,1,9,4,1,7,22
191106281,9,2,1,4,0,16
191106282,8,7,3,5,1,24
191106283,5,0,1,1,0,7
191106284,9,0,2,4,7,22
191106285,5,7,3,4,9,28
191106286,8,0,1,8,4,21
191106287,6,9,1,2,1,19
191106288,1,1,8,1,6,17
191106289,4,5,4,0,8,21
191106290,1,4,6,7,3,21
191106291,6,7,6,8,6,33
191106292,5,5,6,2,1,19
191106293,0,2,0,5,1,8
191106294,0,3,4,6,1,14
191106295,6,4,3,4,7,24
191106296,8,3,7,2,5,25
191106297,6,0,3,2,5,16
191106298,5,5,1,2,0,13
191106299,0,3,5,1,9,18
191106300,1,2,8,4,6,21
191106301,7,5,6,9,6,33
191106302,4,9,8,9,2,32
191106303,1,5,3,3,7,19
191106304,4,4,0,7,5,20
191106305,2,3,8,1,6,20
191106306,3,9,4,1,8,25
191106307,2,7,5,7,3,24
191106308,6,2,1,3,6,18
191106309,3,4,0,8,6,21
191106310,0,9,2,0,3,14
191106311,4,5,2,5,1,17
191106312,4,2,1,7,4,18
191106313,0,0,2,9,7,18
191106314,6,2,8,7,3,26
191106315,6,3,4,0,8,21
191106316,2,8,4,6,5,25
191106317,9,1,8,2,0,20
191106318,4,0,2,2,5,13
191106319,5,0,7,1,0,13
191106320,4,2,8,6,8,28
191106321,3,7,8,2,1,21
191106322,9,3,6,5,3,26
191106323,7,1,6,8,2,24
191106324,1,6,0,4,8,19
191106325,2,8,4,1,4,19
191106326,6,7,5,1,9,28
191106327,8,4,1,7,3,23
191106328,5,8,0,1,3,17
191106329,2,4,8,5,5,24
191106330,3,9,8,6,4,30
191106331,8,7,2,8,1,26
191106332,6,0,4,3,2,15
191106333,6,6,9,0,2,23
191106334,7,9,1,9,2,28
191106335,9,4,9,3,8,33
191106336,9,9,4,2,1,25
191106337,2,6,0,5,3,16
191106338,8,0,2,7,4,21
191106339,6,9,6,6,0,27
191106340,1,7,7,1,0,16
191106341,8,9,3,6,8,34
191106342,3,5,3,2,1,14
191106343,8,1,2,6,4,21
191106344,8,0,4,8,8,28
191106345,6,9,5,3,0,23
191106346,6,1,1,0,4,12
191106347,2,6,3,8,4,23
191106348,9,4,5,8,3,29
191106349,8,0,8,9,8,33
191106350,0,3,5,8,3,19
191106351,1,6,8,3,9,27
191106352,9,0,8,0,2,19
191106353,3,4,1,8,0,16
191106354,5,9,2,6,1,23
191106355,9,8,6,5,7,35
191106356,5,2,4,9,4,24
191106357,8,4,1,1,7,21
191106358,0,7,3,8,9,27
191106359,9,9,0,0,0,18
191106360,7,3,6,5,6,27
191106361,4,8,7,2,6,27
191106362,9,9,2,7,4,31
191106363,4,8,0,2,0,14
191106364,3,5,1,5,0,14
191106365,6,3,0,6,9,24
191106366,8,0,3,9,3,23
191106367,5,4,0,0,7,16
191106368,9,0,6,5,2,22
191106369,6,7,6,2,1,22
191106370,2,5,0,6,2,15
191106371,7,8,8,4,8,35
191106372,0,2,9,8,8,27
191106373,1,2,8,5,6,22
191106374,4,8,8,8,6,34
191106375,1,4,4,9,3,21
191106376,5,3,3,8,0,19
191106377,8,8,7,7,2,32
191106378,7,1,9,5,1,23
191106379,4,2,8,3,3,20
191106380,1,8,3,1,6,19
191106381,4,3,1,8,8,24
191106382,4,1,1,3,3,12
191106383,3,6,8,8,0,25
191106384,8,0,6,6,3,23
191106385,1,1,6,1,7,16
191106386,7,7,2,4,6,26
191106387,8,0,8,4,7,27
191106388,0,0,9,3,8,20
191106389,5,2,4,5,3,19
191106390,0,8,3,5,1,17
191106391,2,2,4,2,5,15
191106392,2,3,6,8,5,24
191106393,4,6,1,7,8,26
191106394,9,6,7,6,0,28
191106395,4,2,1,4,7,18
191106396,6,5,6,1,3,21
191106397,5,2,5,4,8,24
191106398,9,3,1,1,5,19
191106399,8,5,8,3,9,33
191106400,5,2,9,5,6,27
191106401,9,8,4,9,3,33
191106402,0,2,5,2,2,11
191106403,8,0,0,3,3,14
191106404,7,5,0,8,4,24
191106405,5,9,3,3,8,28
191106406,3,5,4,7,0,19
191106407,7,7,8,0,3,25
191106408,8,3,8,4,8,31
191106409,5,8,9,9,0,31
191106410,6,2,3,7,4,22
191106411,0,5,5,6,7,23
191106412,7,5,1,6,7,26
191106413,5,6,6,9,4,30
191106414,5,5,2,1,9,22
191106415,6,7,1,6,6,26
191106416,0,1,0,0,3,4
191106417,1,2,8,0,5,16
191106418,2,9,6,5,9,31
191106419,9,0,1,5,0,15
191106420,0,8,5,5,2,20
191106421,7,7,6,2,8,30
191106422,8,6,1,6,7,28
191106423,2,0,0,4,6,12
191106424,2,1,3,4,5,15
191106425,3,2,0,8,0,13
191106426,4,1,9,7,9,30
191106427,0,4,1,6,6,17
191106428,6,6,8,1,8,29
191106429,7,5,6,1,5,24
191106430,0,4,1,5,5,15
191106431,0,9,2,5,4,20
191106432,7,6,1,1,2,17
191106433,8,0,4,5,4,21
191106434,0,1,5,8,8,22
191106435,9,4,0,0,5,18
191106436,4,2,0,2,3,11
191106437,9,9,6,3,4,31
191106438,0,7,8,4,2,21
191106439,2,1,4,5,0,12
191106440,1,6,8,4,6,25
191106441,0,5,8,7,1,21
191106442,8,1,6,0,1,16
191106443,9,1,4,1,1,16
191106444,9,2,0,4,1,16
191106445,0,0,3,6,8,17
191106446,8,7,1,2,5,23
191106447,2,5,7,4,0,18
191106448,1,0,4,8,4,17
191106449,8,7,0,9,3,27
191106450,9,5,4,8,8,34
191106451,9,8,0,1,0,18
191106452,4,1,1,5,1,12
191106453,2,7,5,3,3,20
191106454,6,1,5,3,0,15
191106455,4,4,7,8,3,26
191106456,8,1,0,5,1,15
191106457,7,6,9,6,0,28
191106458,0,8,5,7,0,20
191106459,2,7,9,3,8,29
191106460,9,5,9,4,7,34
191106461,7,9,8,8,9,41
191106462,3,0,8,9,0,20
191106463,9,6,7,9,9,40
191106464,7,9,8,0,5,29
191106465,2,2,6,9,8,27
191106466,0,7,8,2,1,18
191106467,5,6,0,0,6,17
191106468,9,8,4,4,4,29
191106469,8,5,5,6,9,33
191106470,7,4,7,3,3,24
191106471,3,5,1,8,1,18
191106472,4,0,7,3,0,14
191106473,9,7,4,1,3,24
191106474,8,9,6,4,9,36
191106475,9,8,5,0,6,28
191106476,3,4,0,9,9,25
191106477,1,0,6,0,4,11
191106478,6,0,3,3,9,21
191106479,8,4,5,8,7,32
191106480,8,2,8,9,0,27
191106481,3,2,9,8,9,31
191106482,3,2,7,8,6,26
191106483,7,9,2,2,5,25
191106484,7,7,3,9,3,29
191106485,4,5,2,0,9,20
191106486,0,1,1,5,0,7
191106487,1,3,0,6,9,19
191106488,3,8,4,5,1,21
191106489,7,3,2,8,2,22
191106490,8,2,8,2,2,22
191106491,5,2,2,0,4,13
191106492,3,0,1,4,9,17
191106493,4,6,9,1,9,29
191106494,9,9,5,6,5,34
191106495,0,2,7,9,3,21
191106496,6,3,3,7,8,27
191106497,5,2,7,6,9,29
191106498,7,3,7,1,3,21
191106499,2,1,0,9,1,13
191106500,2,8,7,0,0,17
191106501,4,7,1,0,9,21
191106502,6,4,3,9,4,26
191106503,0,3,7,4,4,18
191106504,8,0,0,7,7,22
191106505,6,4,2,6,8,26
191106506,8,9,2,1,1,21
191106507,2,1,2,0,2,7
191106508,0,6,9,8,2,25
191106509,7,5,7,7,4,30
191106510,1,5,5,7,4,22
191106511,1,6,2,6,7,22
191106512,1,5,2,2,2,12
191106513,1,9,6,8,5,29
191106514,5,1,9,8,3,26
191106515,8,3,1,1,3,16
191106516,5,4,5,0,5,19
191106517,0,6,4,4,3,17
191106518,3,7,7,3,0,20
191106519,0,4,0,7,6,17
191106520,4,2,1,8,6,21
191106521,1,8,3,2,1,15
191106522,2,2,3,8,6,21
191106523,7,1,5,7,8,28
191106524,8,9,5,9,4,35
191106525,7,2,7,1,1,18
191106526,2,2,2,4,4,14
191106527,5,5,0,4,4,18
191106528,4,1,7,0,1,13
191106529,1,1,2,3,2,9
191106530,0,3,1,0,8,12
191106531,0,2,7,8,0,17
191106532,4,7,6,1,2,20
191106533,0,0,5,2,7,14
191106534,4,7,1,9,6,27
191106535,5,6,2,5,8,26
191106536,4,3,1,9,6,23
191106537,0,3,1,8,9,21
191106538,4,0,5,5,5,19
191106539,8,7,0,7,5,27
191106540,3,3,1,1,1,9
191106541,8,5,5,9,0,27
191106542,8,2,1,3,0,14
191106543,0,9,2,0,1,12
191106544,4,6,1,8,4,23
191106545,4,4,9,5,3,25
191106546,8,6,6,1,3,24
191106547,4,6,0,1,2,13
191106548,5,2,5,5,2,19
191106549,3,3,4,2,4,16
191106550,0,6,5,2,8,21
191106551,2,4,3,4,1,14
191106552,0,3,0,7,7,17
191106553,5,0,3,9,8,25
191106554,0,3,9,5,8,25
191106555,5,8,0,6,6,25
191106556,4,4,1,6,1,16
191106557,8,7,5,3,8,31
191106558,0,6,4,4,2,16
191106559,4,2,8,9,2,25
191106560,2,2,5,1,0,10
191106561,4,8,1,2,1,16
191106562,8,3,9,2,2,24
191106563,7,8,4,3,3,25
191106564,6,4,2,4,2,18
191106565,9,3,6,9,3,30
191106566,9,2,5,7,5,28
191106567,2,3,6,6,3,20
191106568,4,1,7,7,4,23
191106569,2,4,5,1,3,15
191106570,2,4,0,7,3,16
191106571,8,8,3,1,3,23
191106572,6,6,4,9,2,27
191106573,6,0,2,4,3,15
191106574,4,3,0,3,1,11
191106575,7,7,7,4,4,29
191106576,0,1,7,2,5,15
191106577,3,6,6,4,6,25
191106578,1,0,5,5,4,15
191106579,1,7,5,7,7,27
191106580,4,0,8,8,0,20
191106581,2,1,9,2,6,20
191106582,3,8,1,8,4,24
191106583,3,1,4,3,1,12
191106584,0,3,4,2,8,17
191106585,3,2,0,2,8,15
191106586,7,3,6,8,6,30
191106587,5,4,0,3,9,21
191106588,6,9,6,4,1,26
191106589,2,0,4,8,1,15
191106590,8,3,3,8,2,24
191106591,1,8,3,3,3,18
191106592,0,4,2,2,1,9
191106593,9,9,0,8,9,35
191106594,8,0,4,8,6,26
191106595,1,8,2,3,5,19
191106596,8,2,5,1,1,17
191106597,0,2,2,5,3,12
191106598,0,8,0,5,4,17
191106599,2,1,7,8,0,18
191106600,3,8,3,2,7,23
191106601,6,6,9,2,3,26
191106602,3,1,7,8,3,22
191106603,8,3,7,8,7,33
191106604,6,0,1,6,9,22
191106605,1,6,1,0,9,17
191106606,1,7,7,8,9,32
191106607,8,5,9,9,1,32
191106608,3,3,0,0,3,9
191106609,4,6,5,9,1,25
191106610,3,5,4,5,1,18
191106611,6,8,0,8,6,28
191106612,5,3,9,3,3,23
191106613,2,2,4,6,7,21
191106614,4,3,6,9,2,24
191106615,5,4,6,0,1,16
191106616,3,4,3,6,8,24
191106617,2,1,6,4,3,16
191106618,0,3,2,7,2,14
191106619,5,3,8,4,6,26
191106620,7,2,3,3,7,22
191106621,9,9,5,4,1,28
191106622,0,9,8,1,3,21
191106623,6,2,1,8,3,20
191106624,2,9,9,6,2,28
191106625,1,7,7,2,9,26
191106626,8,6,8,9,0,31
191106627,9,0,0,2,0,11
191106628,2,9,0,4,8,23
191106629,9,8,8,2,6,33
191106630,1,1,4,1,9,16
191106631,0,3,2,0,0,5
191106632,5,3,2,4,6,20
191106633,8,6,4,2,2,22
191106634,0,8,0,6,7,21
191106635,7,2,6,8,5,28
191106636,4,2,5,3,0,14
191106637,0,0,9,4,0,13
191106638,0,9,9,9,5,32
191106639,6,2,0,4,0,12
191106640,6,0,4,8,6,24
191106641,4,6,6,5,7,28
191106642,9,6,2,6,6,29
191106643,4,2,7,4,1,18
191106644,0,0,9,5,0,14
191106645,2,6,9,7,8,32
191106646,2,1,3,8,2,16
191106647,6,8,9,9,3,35
191106648,9,6,4,7,1,27
191106649,5,3,7,6,7,28
191106650,9,6,4,4,8,31
191106651,5,6,8,9,4,32
191106652,7,3,6,1,7,24
191106653,9,9,4,6,0,28
191106654,4,6,4,6,9,29
191106655,1,3,5,5,6,20
191106656,8,3,1,8,4,24
191106657,4,9,4,9,9,35
191106658,0,6,7,7,2,22
191106659,2,5,1,9,8,25
191106660,6,6,1,2,9,24
191106661,5,8,1,0,3,17
191106662,7,9,0,0,2,18
191106663,3,9,9,5,7,33
191106664,1,7,6,2,0,16
191106665,9,8,6,4,6,33
191106666,2,7,8,9,1,27
191106667,2,4,3,1,0,10
191106668,0,5,4,6,5,20
191106669,1,4,0,8,1,14
191106670,9,5,3,9,3,29
191106671,6,4,4,1,9,24
191106672,6,4,9,4,6,29
191106673,6,6,6,0,3,21
191106674,9,3,4,8,0,24
191106675,4,3,1,6,5,19
191106676,5,0,5,2,7,19
191106677,0,3,7,9,7,26
191106678,1,8,7,1,6,23
191106679,0,5,6,2,4,17
191106680,8,8,7,9,8,40
191106681,6,8,0,3,0,17
191106682,2,0,6,4,7,19
191106683,2,3,3,7,9,24
191106684,3,6,5,2,5,21
191106685,8,9,3,1,5,26
191106686,4,5,0,8,3,20
191106687,4,9,6,0,0,19
191106688,5,5,0,3,4,17
191106689,1,7,3,6,8,25
191106690,6,2,1,0,7,16
191106691,8,2,2,4,5,21
191106692,2,8,0,5,1,16
191106693,3,5,3,0,1,12
191106694,3,5,5,7,3,23
191106695,0,1,3,6,6,16
191106696,9,1,0,9,3,22
191106697,0,7,4,7,9,27
191106698,5,8,9,5,0,27
191106699,3,5,1,1,9,19
191106700,9,9,1,4,7,30
191106701,4,2,0,3,3,12
191106702,3,1,3,2,1,10
191106703,7,4,5,3,1,20
191106704,4,7,7,7,2,27
191106705,8,4,1,6,6,25
191106706,7,2,6,1,9,25
191106707,4,4,4,6,0,18
191106708,5,5,8,1,4,23
191106709,2,6,3,1,6,18
191106710,7,6,2,7,8,30
191106711,7,3,3,2,0,15
191106712,4,7,5,7,1,24
191106713,7,9,6,0,9,31
191106714,9,1,5,5,5,25
191106715,0,1,2,8,6,17
191106716,4,5,0,6,7,22
191106717,2,3,0,0,2,7
191106718,7,5,6,5,6,29
191106719,1,5,5,2,5,18
191106720,4,7,4,0,6,21
191106721,5,4,6,0,2,17
191106722,9,3,1,8,0,21
191106723,8,1,8,3,6,26
191106724,5,0,1,8,4,18
191106725,0,6,7,5,6,24
191106726,7,8,3,3,6,27
191106727,0,0,5,1,5,11
191106728,4,9,7,9,0,29
191106729,1,7,0,7,0,15
191106730,2,9,3,2,5,21
191106731,8,6,7,3,2,26
191106732,2,9,8,6,2,27
191106733,7,4,4,2,1,18
191106734,3,8,9,5,7,32
191106735,0,2,1,5,9,17
191106736,4,6,5,2,2,19
191106737,4,1,6,0,0,11
191106738,0,8,3,7,7,25
191106739,1,4,1,3,0,9
191106740,6,7,0,8,4,25
191106741,3,7,6,1,3,20
191106742,7,6,6,5,0,24
191106743,3,8,5,3,4,23
191106744,6,6,3,0,7,22
191106745,8,2,4,6,6,26
191106746,1,5,6,1,3,16
191106747,8,8,4,0,9,29
191106748,0,9,8,0,8,25
191106749,6,9,4,6,3,28
191106750,0,2,2,1,7,12
191106751,4,6,3,3,3,19
191106752,9,1,7,5,6,28
191106753,1,3,8,5,2,19
191106754,1,3,7,3,2,16
191106755,5,1,9,2,0,17
191106756,6,9,0,3,1,19
191106757,1,3,5,4,8,21
191106758,4,7,9,6,6,32
191106759,2,6,3,4,2,17
191106760,4,2,4,3,9,22
191106761,0,0,0,9,1,10
191106762,3,8,4,9,4,28
191106763,1,1,2,2,1,7
191106764,9,4,2,9,4,28
191106765,7,2,2,7,8,26
191106766,8,7,0,0,5,20
191106767,5,4,1,0,1,11
191106768,8,8,0,3,8,27
191106769,4,3,3,1,0,11
191106770,8,4,4,7,9,32
191106771,9,9,3,6,7,34
191106772,6,8,0,9,7,30
191106773,2,5,5,3,4,19
191106774,1,3,8,0,6,18
191106775,3,3,4,4,3,17
191106776,3,8,2,0,5,18
191106777,8,2,9,2,6,27
191106778,0,5,5,4,2,16
191106779,1,9,2,7,2,21
191106780,0,5,6,8,0,19
191106781,2,9,1,0,2,14
191106782,4,8,9,9,8,38
191106783,1,6,6,3,0,16
191106784,7,5,8,1,6,27
191106785,6,3,0,7,4,20
191106786,8,3,3,9,2,25
191106787,7,0,3,0,4,14
191106788,2,7,9,5,3,26
191106789,7,6,3,9,1,26
191106790,7,9,6,6,3,31
191106791,6,9,1,2,9,27
191106792,0,8,4,5,6,23
191106793,7,2,8,5,5,27
191106794,1,6,7,7,3,24
191106795,7,5,9,5,7,33
191106796,4,2,5,4,7,22
191106797,1,5,8,1,7,22
191106798,4,3,0,3,4,14
191106799,3,1,2,7,2,15
191106800,3,2,4,4,1,14
191106801,1,8,7,8,8,32
191106802,0,4,2,6,4,16
191106803,7,7,5,1,1,21
191106804,0,4,9,1,2,16
191106805,3,4,9,8,0,24
191106806,7,6,9,6,3,31
191106807,4,1,4,0,1,10
191106808,2,6,1,2,4,15
191106809,5,4,0,6,7,22
191106810,2,1,2,0,3,8
191106811,9,9,1,7,2,28
191106812,3,7,9,3,6,28
191106813,1,7,1,6,0,15
191106814,2,7,4,0,1,14
191106815,8,7,6,6,6,33
191106816,7,4,2,2,3,18
191106817,5,1,6,1,2,15
191106818,0,2,2,5,8,17
191106819,3,5,5,5,4,22
191106820,7,1,3,4,4,19
191106821,4,4,3,9,8,28
191106822,3,3,7,1,5,19
191106823,6,8,6,7,9,36
191106824,5,8,2,5,6,26
191106825,1,1,5,1,9,17
191106826,6,4,0,3,4,17
191106827,1,5,4,7,3,20
191106828,0,5,3,2,1,11
191106829,3,1,4,2,8,18
191106830,8,2,1,4,9,24
191106831,9,3,1,4,5,22
191106832,7,7,3,9,9,35
191106833,5,3,1,4,7,20
191106834,4,1,6,3,6,20
191106835,3,4,5,2,1,15
191106836,1,1,9,5,6,22
191106837,1,1,6,0,0,8
191106838,7,3,3,2,4,19
191106839,1,6,3,6,1,17
191106840,2,1,3,4,4,14
191106841,7,0,1,9,3,20
191106842,4,7,1,6,9,27
191106843,4,8,9,0,1,22
191106844,7,8,3,0,6,24
191106845,3,6,0,7,0,16
191106846,1,7,9,6,4,27
191106847,0,0,3,3,7,13
191106848,0,3,7,0,1,11
191106849,1,3,7,6,2,19
191106850,4,2,1,7,5,19
191106851,6,3,5,2,1,17
191106852,3,2,5,4,8,22
191106853,7,1,3,2,5,18
191106854,6,1,5,1,0,13
191106855,3,8,8,0,8,27
191106856,1,4,0,2,9,16
191106857,6,9,4,2,6,27
191106858,9,4,2,2,3,20
191106859,0,3,8,4,5,20
191106860,8,0,7,9,9,33
191106861,1,0,4,5,5,15
191106862,3,3,7,3,1,17
191106863,3,5,2,4,4,18
191106864,2,0,9,5,6,22
191106865,7,4,7,8,0,26
191106866,4,7,0,8,2,21
191106867,8,4,6,6,2,26
191106868,9,4,6,6,2,27
191106869,9,4,6,4,9,32
191106870,0,5,1,6,5,17
191106871,8,5,9,3,4,29
191106872,1,9,5,0,2,17
191106873,2,6,0,0,9,17
191106874,5,8,7,3,0,23
191106875,2,8,6,2,7,25
191106876,9,9,9,2,6,35
191106877,4,4,2,6,8,24
191106878,0,8,5,3,4,20
191106879,2,9,7,9,4,31
191106880,4,2,0,8,1,15
191106881,3,4,2,3,7,19
191106882,7,8,9,4,9,37
191106883,7,2,0,2,0,11
191106884,3,1,1,1,6,12
191106885,7,0,9,3,1,20
191106886,8,3,6,5,5,27
191106887,7,5,9,0,3,24
191106888,4,7,7,8,2,28
191106889,2,0,3,9,4,18
191106890,0,0,1,1,3,5
191106891,6,8,0,7,2,23
191106892,2,1,9,2,3,17
191106893,0,1,4,4,8,17
191106894,4,2,3,8,4,21
191106895,8,9,4,0,6,27
191106896,3,8,6,7,1,25
191106897,5,8,6,6,9,34
191106898,7,5,4,3,2,21
191106899,5,9,4,2,3,23
191106900,8,0,0,4,2,14
191106901,0,4,6,2,3,15
191106902,5,9,7,2,2,25
191106903,5,6,6,2,6,25
191106904,9,7,6,4,6,32
191106905,7,2,3,6,1,19
191106906,5,3,1,4,3,16
191106907,6,5,8,9,8,36
191106908,7,2,2,9,4,24
191106909,3,3,8,1,9,24
191106910,9,0,5,9,6,29
191106911,0,1,9,0,5,15
191106912,6,3,2,8,5,24
191106913,7,8,9,7,6,37
191106914,3,6,0,7,2,18
191106915,6,1,4,0,5,16
191106916,1,6,9,6,4,26
191106917,2,4,2,0,4,12
191106918,3,4,4,3,7,21
191106919,6,6,0,6,9,27
191106920,9,7,1,8,9,34
191106921,8,8,3,6,8,33
191106922,7,1,0,6,8,22
191106923,2,2,1,7,2,14
191106924,5,0,0,9,0,14
191106925,6,0,5,9,1,21
191106926,4,1,6,4,9,24
191106927,5,0,6,4,6,21
191106928,8,6,8,1,0,23
191106929,1,2,4,9,0,16
191106930,9,1,8,1,4,23
191106931,6,7,8,7,5,33
191106932,8,3,1,6,4,22
191106933,8,8,9,9,1,35
191106934,2,7,9,5,1,24
191106935,2,3,7,2,4,18
191106936,1,9,6,5,1,22
191106937,6,0,9,2,3,20
191106938,1,0,3,8,9,21
191106939,0,4,9,2,7,22
191106940,0,5,6,6,9,26
191106941,3,2,9,4,6,24
191106942,3,7,3,6,8,27
191106943,0,9,4,0,7,20
191106944,7,6,6,3,9,31
191106945,7,0,9,1,8,25
191106946,0,2,1,0,2,5
191106947,8,5,6,1,8,28
191106948,8,9,2,4,2,25
191106949,1,9,2,8,4,24
191106950,7,7,1,0,0,15
191106951,8,4,3,1,6,22
191106952,0,6,3,0,6,15
191106953,2,3,7,1,9,22
191106954,5,7,8,9,0,29
191106955,4,4,2,3,2,15
191106956,4,6,3,7,3,23
191106957,5,6,2,3,6,22
191106958,7,9,8,2,1,27
191106959,3,4,6,6,1,20
191106960,7,2,0,0,0,9
191106961,8,2,7,1,8,26
191106962,0,7,5,9,7,28
191106963,8,6,4,1,5,24
191106964,0,9,0,1,1,11
191106965,8,5,7,9,1,30
191106966,5,0,0,4,9,18
191106967,3,9,4,2,1,19
191106968,5,3,3,4,8,23
191106969,7,5,3,1,0,16
191106970,6,8,0,8,5,27
191106971,6,8,8,4,0,26
191106972,8,5,0,5,2,20
191106973,4,1,3,2,8,18
191106974,1,9,7,2,0,19
191106975,7,6,0,5,0,18
191106976,4,3,4,9,6,26
191106977,4,6,7,1,3,21
191106978,4,1,7,6,3,21
191106979,4,4,5,3,6,22
191106980,2,0,0,9,7,18
191106981,9,9,4,0,3,25
191106982,5,1,6,4,8,24
191106983,7,8,1,3,1,20
191106984,9,4,8,7,1,29
191106985,9,3,9,6,9,36
191106986,6,0,4,0,3,13
191106987,4,8,5,5,5,27
191106988,9,0,8,5,4,26
191106989,8,4,9,3,9,33
191106990,2,2,1,5,3,13
191106991,4,1,4,6,9,24
191106992,6,2,4,4,1,17
191106993,8,6,7,1,4,26
191106994,1,4,5,2,5,17
191106995,6,9,6,6,4,31
191106996,8,6,8,6,5,33
191106997,4,2,1,9,3,19
191106998,0,1,1,8,4,14
191106999,1,5,5,3,0,14
1911061000,6,4,6,8,1,25
1911061001,1,2,5,3,4,15
1911061002,2,5,9,3,9,28
1911061003,5,9,7,0,0,21
1911061004,2,3,3,9,4,21
1911061005,9,7,9,8,4,37
1911061006,4,7,2,2,4,19
1911061007,1,9,9,5,7,31
1911061008,5,0,4,8,6,23
1911061009,8,3,8,4,0,23
1911061010,1,1,6,4,0,12
1911061011,9,3,4,8,9,33
1911061012,6,9,6,2,3,26
1911061013,5,2,3,4,5,19
1911061014,6,3,6,9,9,33
1911061015,3,9,6,5,7,30
1911061016,9,8,0,8,7,32
1911061017,9,1,9,9,4,32
1911061018,7,3,8,9,4,31
1911061019,6,8,8,9,3,34
1911061020,6,5,2,8,6,27
1911061021,4,1,4,1,7,17
1911061022,1,1,8,7,7,24
1911061023,1,4,1,6,4,16
1911061024,1,1,8,6,4,20
1911061025,6,5,7,7,8,33
1911061026,8,3,7,0,4,22
1911061027,3,4,3,7,9,26
1911061028,7,8,6,4,8,33
1911061029,1,7,0,9,6,23
1911061030,4,0,5,3,8,20
1911061031,7,0,9,6,0,22
1911061032,2,7,7,8,1,25
1911061033,5,9,8,5,8,35
1911061034,1,4,5,6,4,20
1911061035,0,1,7,1,1,10
1911061036,7,4,4,5,7,27
1911061037,8,4,9,2,9,32
1911061038,5,7,7,5,2,26
1911061039,2,4,7,2,9,24
1911061040,0,1,7,5,0,13
1911061041,4,3,2,3,1,13
1911061042,5,3,0,1,1,10
1911061043,8,5,2,1,2,18
1911061044,9,5,0,4,1,19
1911061045,7,0,3,1,9,20
1911061046,1,4,7,5,8,25
1911061047,9,4,1,3,5,22
1911061048,2,3,2,9,9,25
1911061049,6,4,4,3,7,24
1911061050,7,2,6,4,3,22
1911061051,9,7,4,6,0,26
1911061052,5,6,1,0,5,17
1911061053,5,6,4,6,7,28
1911061054,9,0,2,8,9,28
1911061055,6,8,3,3,2,22
1911061056,3,0,2,4,6,15
1911061057,1,2,0,3,3,9
1911061058,6,8,5,6,7,32
1911061059,1,9,9,4,2,25
1911061060,4,7,0,3,0,14
1911061061,2,7,8,6,0,23
1911061062,9,2,8,5,3,27
1911061063,5,7,5,6,8,31
1911061064,1,4,4,9,4,22
1911061065,3,9,3,1,2,18
1911061066,1,4,5,5,2,17
1911061067,7,4,6,4,3,24
1911061068,1,5,8,7,5,26
1911061069,9,1,8,6,4,28
1911061070,4,8,7,6,8,33
1911061071,5,9,6,6,0,26
1911061072,4,2,1,8,7,22
1911061073,0,4,1,3,9,17
1911061074,8,5,3,5,1,22
1911061075,7,9,3,2,4,25
1911061076,1,4,4,1,2,12
1911061077,4,5,9,6,6,30
1911061078,9,2,2,3,2,18
1911061079,5,3,4,4,4,20
1911061080,4,2,6,3,7,22
1911061081,5,1,4,7,0,17
1911061082,9,3,6,6,8,32
1911061083,8,5,9,7,4,33
1911061084,0,4,9,6,6,25
1911061085,9,8,4,2,9,32
1911061086,5,2,8,4,8,27
1911061087,5,3,5,1,2,16
1911061088,2,6,3,5,2,18
1911061089,4,5,0,9,7,25
1911061090,3,8,8,4,2,25
1911061091,5,5,4,4,8,26
1911061092,0,9,2,8,1,20
1911061093,3,1,5,2,9,20
1911061094,6,2,8,8,2,26
1911061095,6,5,7,1,6,25
1911061096,9,2,1,3,6,21
1911061097,0,1,7,3,4,15
1911061098,7,7,1,8,7,30
1911061099,8,9,2,7,0,26
1911061100,5,3,9,6,6,29
1911061101,4,0,5,9,4,22
1911061102,3,2,8,6,5,24
1911061103,9,0,0,5,7,21
1911061104,4,2,0,1,2,9
1911061105,6,3,1,5,8,23
191107001,9,1,5,4,4,23
191107002,7,7,1,8,8,31
191107003,3,6,2,5,5,21
191107004,2,8,6,0,2,18
191107005,7,3,4,5,2,21
191107006,3,3,6,5,7,24
191107007,8,8,7,6,3,32
191107008,1,0,9,5,4,19
191107009,4,6,1,2,5,18
191107010,0,3,3,6,6,18
191107011,9,7,9,1,3,29
191107012,5,3,4,6,0,18
191107013,4,3,3,2,7,19
191107014,2,8,5,8,8,31
191107015,8,4,1,1,8,22
191107016,6,1,8,3,7,25
191107017,5,5,9,1,0,20
191107018,9,5,4,8,9,35
191107019,2,8,2,4,0,16
191107020,4,6,0,1,6,17
191107021,7,0,6,7,2,22
191107022,7,1,3,1,2,14
191107023,1,4,9,7,8,29
191107024,4,8,4,5,1,22
191107025,8,3,8,5,9,33
191107026,0,1,9,1,7,18
191107027,4,3,4,9,1,21
191107028,6,0,8,6,0,20
191107029,5,5,0,3,0,13
191107030,2,6,9,1,4,22
191107031,0,7,7,2,2,18
191107032,4,5,7,6,8,30
191107033,5,2,6,6,1,20
191107034,0,8,7,6,3,24
191107035,1,6,4,6,4,21
191107036,1,6,3,4,0,14
191107037,8,2,7,0,1,18
191107038,6,1,1,1,3,12
191107039,1,4,3,8,2,18
191107040,5,4,2,4,0,15
191107041,9,3,5,2,0,19
191107042,9,0,3,4,0,16
191107043,5,6,1,1,8,21
191107044,1,3,3,8,6,21
191107045,5,4,6,6,7,28
191107046,6,4,4,9,4,27
191107047,2,6,5,1,0,14
191107048,9,9,3,2,4,27
191107049,1,3,9,1,7,21
191107050,3,2,2,6,0,13
191107051,4,8,1,8,0,21
191107052,6,7,1,7,7,28
191107053,4,4,1,4,4,17
191107054,5,0,0,6,2,13
191107055,3,0,2,6,6,17
191107056,4,6,8,4,9,31
191107057,4,7,3,9,8,31
191107058,4,4,2,1,5,16
191107059,3,9,8,1,9,30
191107060,4,9,6,9,3,31
191107061,4,8,8,0,2,22
191107062,3,2,5,0,1,11
191107063,2,9,3,9,4,27
191107064,4,6,5,7,4,26
191107065,9,0,0,0,7,16
191107066,1,9,1,2,2,15
191107067,0,7,1,8,4,20
191107068,2,0,1,8,6,17
191107069,6,2,0,4,8,20
191107070,1,5,8,7,3,24
191107071,4,8,1,0,6,19
191107072,1,1,1,1,3,7
191107073,6,3,5,7,2,23
191107074,5,0,2,9,6,22
191107075,3,5,0,0,6,14
191107076,5,0,5,7,9,26
191107077,2,2,3,4,2,13
191107078,8,4,8,3,9,32
191107079,1,2,6,5,7,21
191107080,3,1,9,5,1,19
191107081,3,8,4,1,2,18
191107082,0,7,9,7,3,26
191107083,3,8,8,2,2,23
191107084,2,4,6,8,7,27
191107085,9,8,7,2,3,29
191107086,7,3,2,0,4,16
191107087,7,1,8,0,8,24
191107088,6,4,7,7,5,29
191107089,2,2,5,7,2,18
191107090,9,0,1,2,0,12
191107091,8,7,2,6,6,29
191107092,6,2,1,9,7,25
191107093,5,7,9,8,6,35
191107094,9,1,3,1,6,20
191107095,0,7,5,4,5,21
191107096,9,1,1,1,2,14
191107097,3,8,1,4,4,20
191107098,2,0,5,3,0,10
191107099,4,9,7,1,8,29
191107100,9,8,2,6,5,30
191107101,8,9,3,3,4,27
191107102,4,5,3,0,5,17
191107103,8,8,0,7,4,27
191107104,3,8,2,3,1,17
191107105,9,9,2,4,8,32
191107106,2,1,4,0,4,11
191107107,0,5,9,3,5,22
191107108,8,2,5,7,2,24
191107109,0,8,0,3,3,14
191107110,7,6,5,3,7,28
191107111,2,0,6,0,8,16
191107112,7,0,2,6,0,15
191107113,3,3,0,5,0,11
191107114,4,1,6,4,0,15
191107115,8,5,2,8,9,32
191107116,3,9,3,0,5,20
191107117,3,6,7,0,1,17
191107118,8,1,3,3,0,15
191107119,2,7,5,8,4,26
191107120,5,0,6,0,8,19
191107121,3,5,4,0,9,21
191107122,6,6,5,3,1,21
191107123,5,7,1,1,0,14
191107124,1,6,3,5,8,23
191107125,5,4,5,4,9,27
191107126,4,3,2,5,6,20
191107127,7,2,5,4,2,20
191107128,1,9,9,6,2,27
191107129,6,4,7,5,7,29
191107130,1,2,8,8,2,21
191107131,6,0,8,1,8,23
191107132,2,0,6,4,6,18
191107133,7,1,7,7,3,25
191107134,2,5,4,7,9,27
191107135,5,2,1,7,5,20
191107136,5,8,2,5,3,23
191107137,4,0,6,7,3,20
191107138,0,2,6,1,8,17
191107139,9,5,5,2,2,23
191107140,8,0,0,2,4,14
191107141,0,9,3,6,7,25
191107142,5,9,1,5,0,20
191107143,5,5,7,2,1,20
191107144,6,1,5,5,1,18
191107145,0,9,1,3,1,14
191107146,2,0,3,9,0,14
191107147,9,3,3,5,5,25
191107148,0,9,6,9,6,30
191107149,9,4,1,6,6,26
191107150,9,7,8,8,2,34
191107151,5,2,9,1,4,21
191107152,0,9,5,7,6,27
191107153,6,3,0,7,1,17
191107154,9,1,7,1,2,20
191107155,7,3,2,5,5,22
191107156,0,5,1,7,5,18
191107157,7,6,9,3,4,29
191107158,5,2,1,7,1,16
191107159,0,9,9,3,2,23
191107160,8,2,1,6,6,23
191107161,3,9,3,6,6,27
191107162,5,5,5,3,7,25
191107163,8,0,5,4,9,26
191107164,3,9,1,7,0,20
191107165,3,3,5,8,4,23
191107166,5,3,2,9,3,22
191107167,6,9,3,7,0,25
191107168,7,6,0,2,7,22
191107169,0,5,3,8,9,25
191107170,8,2,3,3,0,16
191107171,1,5,2,8,5,21
191107172,1,9,8,5,3,26
191107173,9,5,1,3,5,23
191107174,0,9,4,2,5,20
191107175,2,8,3,8,0,21
191107176,5,8,4,9,4,30
191107177,8,0,2,0,3,13
191107178,8,3,0,3,0,14
191107179,5,4,3,8,1,21
191107180,9,0,1,5,2,17
191107181,7,7,9,1,8,32
191107182,3,9,0,3,4,19
191107183,0,4,5,1,8,18
191107184,4,3,4,2,7,20
191107185,9,4,8,2,7,30
191107186,8,6,2,5,9,30
191107187,2,7,7,2,1,19
191107188,3,4,1,5,7,20
191107189,4,4,8,8,1,25
191107190,9,0,5,8,6,28
191107191,2,4,0,5,8,19
191107192,6,8,0,4,0,18
191107193,7,7,4,6,4,28
191107194,3,4,0,3,3,13
191107195,4,6,6,1,6,23
191107196,7,2,1,9,8,27
191107197,5,8,7,8,3,31
191107198,1,1,4,3,6,15
191107199,8,5,4,8,5,30
191107200,6,6,7,1,1,21
191107201,3,4,7,9,1,24
191107202,8,8,7,2,5,30
191107203,7,1,1,2,9,20
191107204,1,0,5,7,8,21
191107205,3,2,7,3,8,23
191107206,2,0,7,4,5,18
191107207,8,7,5,8,8,36
191107208,3,5,6,4,7,25
191107209,2,6,9,0,4,21
191107210,4,3,4,2,3,16
191107211,5,9,3,4,5,26
191107212,7,1,4,4,2,18
191107213,4,7,3,2,9,25
191107214,4,6,1,1,2,14
191107215,2,8,8,9,3,30
191107216,2,3,6,2,1,14
191107217,8,0,3,4,0,15
191107218,0,6,3,2,2,13
191107219,3,3,4,0,9,19
191107220,5,3,4,8,7,27
191107221,7,0,4,1,1,13
191107222,4,8,5,5,3,25
191107223,8,3,2,6,1,20
191107224,6,0,3,5,0,14
191107225,8,4,7,8,1,28
191107226,1,0,5,9,4,19
191107227,8,7,1,7,0,23
191107228,2,9,3,9,5,28
191107229,0,2,2,6,4,14
191107230,4,0,1,3,3,11
191107231,2,2,3,0,9,16
191107232,1,1,1,6,6,15
191107233,4,1,2,9,5,21
191107234,7,4,6,6,1,24
191107235,1,6,6,0,1,14
191107236,4,7,5,6,3,25
191107237,2,3,5,5,7,22
191107238,6,9,5,4,0,24
191107239,8,6,9,9,5,37
191107240,1,2,7,1,3,14
191107241,8,7,8,7,5,35
191107242,2,7,0,5,0,14
191107243,3,3,1,9,6,22
191107244,4,0,0,6,7,17
191107245,9,6,7,8,5,35
191107246,1,3,7,0,4,15
191107247,9,7,7,1,3,27
191107248,5,9,0,6,4,24
191107249,8,8,7,0,6,29
191107250,5,7,3,5,1,21
191107251,1,1,9,6,2,19
191107252,6,1,6,7,1,21
191107253,7,0,3,1,0,11
191107254,8,9,4,4,2,27
191107255,2,5,6,2,7,22
191107256,8,8,9,6,0,31
191107257,8,1,5,0,4,18
191107258,5,6,1,5,8,25
191107259,4,4,9,8,3,28
191107260,1,2,0,8,2,13
191107261,5,2,6,7,6,26
191107262,2,2,8,2,4,18
191107263,7,1,8,3,0,19
191107264,1,5,6,5,0,17
191107265,6,2,3,7,8,26
191107266,2,6,6,5,4,23
191107267,9,5,2,4,9,29
191107268,3,3,8,6,7,27
191107269,6,3,7,2,5,23
191107270,5,8,7,2,8,30
191107271,9,6,9,3,6,33
191107272,5,0,4,1,1,11
191107273,4,8,7,5,6,30
191107274,9,8,2,3,1,23
191107275,7,0,8,8,8,31
191107276,6,0,8,3,4,21
191107277,2,2,4,5,6,19
191107278,0,5,3,8,3,19
191107279,8,5,7,9,0,29
191107280,1,3,5,6,1,16
191107281,0,2,1,9,4,16
191107282,0,4,0,8,2,14
191107283,7,5,8,1,7,28
191107284,2,2,5,5,2,16
191107285,3,6,1,9,5,24
191107286,7,9,7,3,9,35
191107287,6,1,1,4,8,20
191107288,8,3,4,1,4,20
191107289,3,6,7,5,1,22
191107290,3,3,0,6,1,13
191107291,7,5,2,3,7,24
191107292,2,7,2,0,3,14
191107293,4,6,9,0,0,19
191107294,9,9,7,8,1,34
191107295,0,7,0,9,3,19
191107296,9,8,4,2,0,23
191107297,7,2,3,4,0,16
191107298,4,5,9,2,0,20
191107299,6,7,6,5,3,27
191107300,1,8,7,9,4,29
191107301,8,1,1,2,5,17
191107302,7,5,5,9,5,31
191107303,5,8,9,3,5,30
191107304,6,4,5,0,1,16
191107305,8,8,5,7,4,32
191107306,7,2,3,3,9,24
191107307,6,9,8,1,4,28
191107308,3,5,6,8,1,23
191107309,9,0,2,5,4,20
191107310,2,0,6,4,0,12
191107311,5,4,5,9,1,24
191107312,9,2,8,8,4,31
191107313,4,7,8,4,7,30
191107314,9,7,3,8,3,30
191107315,3,9,5,1,9,27
191107316,9,2,7,2,6,26
191107317,5,2,0,2,4,13
191107318,3,9,9,4,9,34
191107319,5,4,1,1,6,17
191107320,8,9,4,7,1,29
191107321,8,4,8,0,6,26
191107322,5,8,5,1,4,23
191107323,2,0,8,8,1,19
191107324,2,1,2,1,5,11
191107325,5,9,3,8,0,25
191107326,7,0,7,2,7,23
191107327,6,0,5,2,0,13
191107328,3,6,2,1,3,15
191107329,4,8,8,2,0,22
191107330,1,9,9,9,8,36
191107331,3,4,5,7,2,21
191107332,0,6,7,7,8,28
191107333,5,6,8,7,0,26
191107334,6,5,2,6,5,24
191107335,8,4,7,0,1,20
191107336,4,4,4,4,5,21
191107337,1,0,4,6,2,13
191107338,2,7,1,0,0,10
191107339,8,3,2,3,5,21
191107340,3,7,4,0,1,15
191107341,4,3,1,3,8,19
191107342,4,1,0,4,5,14
191107343,8,8,5,0,1,22
191107344,4,6,4,7,9,30
191107345,7,4,2,8,0,21
191107346,0,9,3,9,7,28
191107347,9,3,3,4,2,21
191107348,1,6,4,1,5,17
191107349,4,1,4,0,5,14
191107350,0,4,0,0,2,6
191107351,2,4,7,8,2,23
191107352,7,0,7,9,5,28
191107353,0,1,3,9,5,18
191107354,7,9,9,1,1,27
191107355,1,5,1,2,6,15
191107356,0,1,7,4,3,15
191107357,0,1,4,2,6,13
191107358,4,2,9,0,2,17
191107359,4,4,4,0,7,19
191107360,6,3,2,0,7,18
191107361,7,1,9,7,8,32
191107362,1,0,6,9,7,23
191107363,2,3,9,2,7,23
191107364,6,2,1,7,0,16
191107365,3,5,8,1,0,17
191107366,4,2,2,9,1,18
191107367,0,6,8,1,2,17
191107368,6,5,6,3,0,20
191107369,2,2,2,8,7,21
191107370,8,9,8,0,3,28
191107371,3,6,9,0,8,26
191107372,0,2,2,8,9,21
191107373,6,3,5,1,6,21
191107374,7,7,4,8,2,28
191107375,3,3,4,1,2,13
191107376,2,8,6,5,4,25
191107377,6,8,6,9,8,37
191107378,2,3,9,9,5,28
191107379,1,4,9,8,9,31
191107380,7,7,0,7,2,23
191107381,4,8,2,4,3,21
191107382,0,0,3,3,8,14
191107383,5,1,7,4,3,20
191107384,7,4,6,1,0,18
191107385,9,5,5,9,0,28
191107386,6,6,6,6,4,28
191107387,5,7,9,7,6,34
191107388,4,1,5,6,2,18
191107389,3,0,1,0,9,13
191107390,6,4,2,6,1,19
191107391,9,4,2,8,1,24
191107392,9,0,4,0,3,16
191107393,9,9,5,9,1,33
191107394,5,9,3,7,6,30
191107395,4,7,0,0,2,13
191107396,8,3,4,6,0,21
191107397,7,4,7,6,5,29
191107398,8,9,0,5,6,28
191107399,4,7,9,6,2,28
191107400,0,1,5,5,0,11
191107401,1,9,4,3,1,18
191107402,6,4,8,3,2,23
191107403,2,4,5,1,6,18
191107404,1,6,7,8,7,29
191107405,6,2,3,3,6,20
191107406,3,5,8,9,7,32
191107407,3,1,5,3,6,18
191107408,8,3,1,2,5,19
191107409,2,6,0,1,6,15
191107410,9,6,9,4,0,28
191107411,3,7,4,5,2,21
191107412,1,5,8,1,3,18
191107413,8,6,8,8,7,37
191107414,6,1,2,0,1,10
191107415,7,2,1,0,9,19
191107416,0,7,8,7,3,25
191107417,1,4,5,9,4,23
191107418,8,2,8,4,1,23
191107419,2,7,7,5,8,29
191107420,7,9,2,9,0,27
191107421,3,7,4,7,2,23
191107422,2,2,0,0,2,6
191107423,5,5,5,0,1,16
191107424,2,7,9,1,1,20
191107425,3,9,7,4,0,23
191107426,7,5,2,2,1,17
191107427,8,5,2,9,3,27
191107428,7,2,2,8,4,23
191107429,1,6,4,2,2,15
191107430,8,4,5,4,1,22
191107431,2,1,6,5,3,17
191107432,5,2,1,9,3,20
191107433,7,7,4,3,4,25
191107434,1,9,8,0,0,18
191107435,0,6,3,7,0,16
191107436,5,2,7,3,2,19
191107437,1,3,3,9,9,25
191107438,0,6,3,3,5,17
191107439,0,9,8,4,4,25
191107440,0,4,8,5,6,23
191107441,5,3,3,1,8,20
191107442,9,9,8,0,6,32
191107443,3,1,7,3,3,17
191107444,2,9,8,4,2,25
191107445,2,2,6,7,1,18
191107446,6,4,9,9,4,32
191107447,0,0,2,5,1,8
191107448,6,3,0,5,7,21
191107449,4,4,1,7,5,21
191107450,6,6,3,2,7,24
191107451,9,0,9,0,9,27
191107452,5,5,2,3,3,18
191107453,3,3,8,0,1,15
191107454,8,7,8,3,7,33
191107455,2,9,7,6,8,32
191107456,7,4,1,9,7,28
191107457,5,7,1,4,6,23
191107458,1,5,7,4,4,21
191107459,3,5,6,1,9,24
191107460,5,6,8,0,6,25
191107461,3,5,4,1,9,22
191107462,1,9,9,6,8,33
191107463,6,1,9,3,9,28
191107464,8,4,5,5,8,30
191107465,5,8,1,8,0,22
191107466,5,5,2,2,7,21
191107467,8,0,8,6,7,29
191107468,9,6,8,7,2,32
191107469,7,9,9,8,4,37
191107470,5,2,6,0,9,22
191107471,1,7,0,0,4,12
191107472,2,9,1,1,2,15
191107473,9,6,9,6,1,31
191107474,5,0,0,0,3,8
191107475,1,4,9,8,8,30
191107476,6,8,6,5,4,29
191107477,4,7,7,7,8,33
191107478,3,9,1,2,7,22
191107479,2,6,9,2,7,26
191107480,6,7,9,5,8,35
191107481,3,4,1,5,2,15
191107482,2,1,1,6,1,11
191107483,0,0,8,8,5,21
191107484,0,2,6,0,9,17
191107485,4,3,3,3,8,21
191107486,4,4,1,2,9,20
191107487,0,4,3,1,7,15
191107488,0,0,8,3,7,18
191107489,1,9,0,3,2,15
191107490,1,0,7,8,9,25
191107491,0,7,0,8,2,17
191107492,4,0,3,4,2,13
191107493,3,4,6,7,1,21
191107494,3,3,6,5,3,20
191107495,7,1,0,2,4,14
191107496,6,8,1,8,0,23
191107497,7,5,0,2,7,21
191107498,9,6,5,7,1,28
191107499,6,9,9,7,7,38
191107500,1,4,1,2,0,8
191107501,2,6,2,7,3,20
191107502,4,6,5,4,4,23
191107503,5,6,1,5,0,17
191107504,1,7,8,3,7,26
191107505,2,1,9,9,2,23
191107506,7,5,6,4,9,31
191107507,7,8,3,5,4,27
191107508,1,0,1,8,7,17
191107509,1,3,1,9,8,22
191107510,4,9,0,5,0,18
191107511,3,6,4,6,4,23
191107512,4,9,9,8,1,31
191107513,6,1,8,2,7,24
191107514,9,8,1,1,1,20
191107515,2,5,6,9,7,29
191107516,3,4,7,8,8,30
191107517,6,5,5,4,8,28
191107518,0,1,2,5,3,11
191107519,8,2,9,3,0,22
191107520,9,4,1,9,2,25
191107521,9,8,9,3,3,32
191107522,4,5,0,3,5,17
191107523,7,0,0,7,5,19
191107524,7,6,4,4,9,30
191107525,0,3,9,4,1,17
191107526,5,4,3,3,2,17
191107527,4,7,3,0,2,16
191107528,5,6,5,7,5,28
191107529,4,0,1,2,1,8
191107530,4,6,6,6,5,27
191107531,5,6,6,0,5,22
191107532,2,7,8,7,9,33
191107533,1,0,2,8,6,17
191107534,8,8,8,4,4,32
191107535,6,6,0,9,9,30
191107536,7,9,5,2,7,30
191107537,9,2,5,8,1,25
191107538,3,6,8,4,3,24
191107539,7,9,7,6,6,35
191107540,8,0,2,8,0,18
191107541,0,3,8,8,7,26
191107542,8,8,1,1,1,19
191107543,6,4,2,2,8,22
191107544,0,3,9,4,0,16
191107545,3,4,0,9,7,23
191107546,7,6,2,7,9,31
191107547,7,6,3,8,9,33
191107548,6,4,7,3,9,29
191107549,1,6,0,6,2,15
191107550,9,3,4,4,1,21
191107551,8,1,8,6,5,28
191107552,2,1,2,9,2,16
191107553,6,3,3,4,3,19
191107554,7,4,2,5,7,25
191107555,7,0,1,6,7,21
191107556,9,1,5,4,0,19
191107557,5,2,3,2,2,14
191107558,9,6,3,1,8,27
191107559,4,8,4,2,0,18
191107560,2,8,9,1,6,26
191107561,7,9,1,5,9,31
191107562,1,5,1,1,5,13
191107563,6,2,5,6,3,22
191107564,2,4,2,3,3,14
191107565,2,0,3,4,9,18
191107566,9,8,0,0,7,24
191107567,2,6,9,6,4,27
191107568,3,0,4,7,9,23
191107569,5,0,7,0,3,15
191107570,1,6,4,8,1,20
191107571,7,9,0,5,8,29
191107572,0,6,9,0,0,15
191107573,3,2,5,2,8,20
191107574,5,4,0,2,9,20
191107575,8,8,0,6,4,26
191107576,0,7,4,0,7,18
191107577,0,0,4,5,9,18
191107578,1,8,7,7,5,28
191107579,6,2,1,4,3,16
191107580,3,6,9,2,9,29
191107581,9,5,3,2,1,20
191107582,2,6,8,7,5,28
191107583,1,3,9,5,6,24
191107584,5,6,3,0,9,23
191107585,5,2,6,2,4,19
191107586,4,2,7,8,8,29
191107587,5,2,4,0,5,16
191107588,1,0,1,0,3,5
191107589,8,6,9,1,2,26
191107590,0,2,1,0,8,11
191107591,9,3,6,8,8,34
191107592,2,2,1,7,7,19
191107593,2,8,8,9,7,34
191107594,5,1,3,0,8,17
191107595,0,6,6,4,4,20
191107596,5,9,8,4,2,28
191107597,2,5,0,7,1,15
191107598,5,1,0,4,2,12
191107599,3,9,0,2,4,18
191107600,1,0,9,0,2,12
191107601,5,9,2,7,7,30
191107602,9,8,2,5,7,31
191107603,7,8,9,9,5,38
191107604,4,0,9,4,6,23
191107605,7,9,7,2,0,25
191107606,0,3,1,7,8,19
191107607,0,0,4,3,3,10
191107608,2,7,3,2,3,17
191107609,7,5,6,1,4,23
191107610,4,8,1,8,9,30
191107611,4,1,4,6,0,15
191107612,5,6,9,9,2,31
191107613,7,2,9,4,2,24
191107614,6,6,8,9,3,32
191107615,0,8,0,2,5,15
191107616,7,5,4,5,0,21
191107617,1,4,9,9,2,25
191107618,3,1,6,6,8,24
191107619,0,2,1,9,1,13
191107620,1,1,5,9,2,18
191107621,2,0,8,0,0,10
191107622,8,5,5,6,3,27
191107623,9,2,5,0,2,18
191107624,6,2,1,5,6,20
191107625,6,5,2,1,9,23
191107626,8,7,2,4,0,21
191107627,0,8,4,4,1,17
191107628,2,7,9,3,5,26
191107629,2,9,0,9,1,21
191107630,3,8,0,8,2,21
191107631,9,2,8,8,1,28
191107632,4,1,9,1,3,18
191107633,6,4,2,0,5,17
191107634,4,6,9,9,4,32
191107635,6,7,9,4,8,34
191107636,2,1,5,7,5,20
191107637,4,1,0,5,7,17
191107638,2,9,9,8,6,34
191107639,2,7,8,2,0,19
191107640,1,1,4,1,6,13
191107641,2,2,9,0,5,18
191107642,7,8,3,7,5,30
191107643,6,9,4,7,9,35
191107644,6,2,7,2,8,25
191107645,1,0,8,3,4,16
191107646,0,3,7,9,3,22
191107647,6,1,4,0,3,14
191107648,9,9,9,7,1,35
191107649,8,0,5,4,0,17
191107650,5,4,4,8,5,26
191107651,1,2,1,4,1,9
191107652,9,7,4,0,8,28
191107653,5,2,0,4,9,20
191107654,0,7,9,6,1,23
191107655,8,6,0,3,7,24
191107656,6,9,8,9,6,38
191107657,3,1,2,4,7,17
191107658,3,1,8,1,7,20
191107659,0,7,2,9,7,25
191107660,6,2,1,3,4,16
191107661,5,9,7,4,1,26
191107662,7,0,5,7,7,26
191107663,6,1,9,4,0,20
191107664,4,1,0,9,1,15
191107665,7,8,7,4,5,31
191107666,9,1,0,2,1,13
191107667,9,0,1,0,9,19
191107668,0,1,1,0,6,8
191107669,6,8,2,2,4,22
191107670,5,5,0,0,1,11
191107671,6,8,1,8,4,27
191107672,2,0,4,3,9,18
191107673,0,0,9,5,8,22
191107674,0,1,4,8,0,13
191107675,1,4,4,3,2,14
191107676,8,4,3,9,8,32
191107677,7,2,0,2,1,12
191107678,3,4,1,9,9,26
191107679,9,0,2,9,3,23
191107680,1,2,3,7,3,16
191107681,6,6,5,9,5,31
191107682,2,4,9,9,1,25
191107683,4,6,1,6,0,17
191107684,6,1,1,6,7,21
191107685,6,8,0,8,1,23
191107686,4,5,3,2,9,23
191107687,3,1,3,7,0,14
191107688,2,4,2,2,7,17
191107689,8,0,3,5,0,16
191107690,4,2,6,2,5,19
191107691,7,8,0,9,0,24
191107692,9,8,9,9,2,37
191107693,6,8,9,2,7,32
191107694,4,0,6,0,3,13
191107695,2,4,5,2,4,17
191107696,6,7,0,1,7,21
191107697,4,5,0,8,8,25
191107698,6,5,5,3,0,19
191107699,1,4,7,9,1,22
191107700,8,8,7,5,3,31
191107701,5,7,6,5,2,25
191107702,8,3,3,6,0,20
191107703,5,5,7,8,7,32
191107704,1,6,3,6,9,25
191107705,4,9,2,0,5,20
191107706,9,0,1,6,7,23
191107707,1,7,2,9,8,27
191107708,2,7,4,4,9,26
191107709,7,4,6,3,8,28
191107710,4,7,3,6,0,20
191107711,7,2,9,6,1,25
191107712,8,4,2,0,6,20
191107713,6,0,9,0,2,17
191107714,0,9,3,0,9,21
191107715,0,2,9,9,4,24
191107716,5,2,8,0,3,18
191107717,6,3,4,5,5,23
191107718,6,2,8,2,1,19
191107719,9,6,9,9,2,35
191107720,4,8,9,3,0,24
191107721,2,2,4,9,5,22
191107722,4,2,9,8,8,31
191107723,8,9,7,6,1,31
191107724,4,7,9,9,0,29
191107725,1,5,0,8,0,14
191107726,2,8,2,1,7,20
191107727,0,7,7,9,7,30
191107728,5,3,6,8,5,27
191107729,1,0,5,2,3,11
191107730,2,0,8,7,2,19
191107731,0,8,2,8,3,21
191107732,8,2,5,6,2,23
191107733,6,0,6,6,8,26
191107734,5,0,1,4,2,12
191107735,4,7,3,6,9,29
191107736,7,2,0,8,9,26
191107737,7,7,7,7,3,31
191107738,5,3,0,5,6,19
191107739,7,1,9,7,9,33
191107740,8,3,3,7,5,26
191107741,8,8,3,0,6,25
191107742,5,0,7,5,1,18
191107743,9,0,0,1,0,10
191107744,5,9,3,9,8,34
191107745,6,7,9,1,5,28
191107746,6,7,1,9,1,24
191107747,5,1,3,6,0,15
191107748,6,3,3,6,4,22
191107749,1,2,7,3,9,22
191107750,1,2,3,6,3,15
191107751,3,0,7,6,6,22
191107752,9,9,3,6,4,31
191107753,0,6,3,5,2,16
191107754,0,4,5,0,2,11
191107755,9,9,1,9,7,35
191107756,4,4,7,9,4,28
191107757,3,9,9,5,9,35
191107758,1,7,7,1,8,24
191107759,6,9,7,7,9,38
191107760,0,4,4,8,1,17
191107761,8,1,2,6,8,25
191107762,4,5,1,6,9,25
191107763,5,2,0,4,3,14
191107764,5,0,4,9,2,20
191107765,7,2,5,4,4,22
191107766,9,3,5,5,3,25
191107767,7,0,1,9,4,21
191107768,8,3,6,3,6,26
191107769,5,5,3,7,8,28
191107770,6,9,6,1,9,31
191107771,8,9,9,9,8,43
191107772,7,4,4,1,2,18
191107773,4,5,9,6,8,32
191107774,5,8,2,9,4,28
191107775,9,1,9,6,1,26
191107776,3,1,7,1,0,12
191107777,8,3,8,6,9,34
191107778,7,2,2,8,9,28
191107779,8,8,6,0,0,22
191107780,7,0,2,8,4,21
191107781,5,9,2,6,9,31
191107782,7,9,3,7,4,30
191107783,9,8,2,1,4,24
191107784,2,3,1,3,6,15
191107785,3,9,7,9,8,36
191107786,0,0,7,6,4,17
191107787,8,7,1,4,7,27
191107788,7,6,0,7,7,27
191107789,1,9,5,1,8,24
191107790,2,1,2,0,1,6
191107791,7,1,4,7,9,28
191107792,0,4,4,8,3,19
191107793,3,6,8,6,9,32
191107794,6,4,2,8,7,27
191107795,9,7,2,3,0,21
191107796,1,3,2,2,6,14
191107797,2,8,0,5,9,24
191107798,2,9,5,1,9,26
191107799,5,2,3,0,7,17
191107800,2,4,9,4,5,24
191107801,3,3,2,9,1,18
191107802,4,6,5,3,0,18
191107803,9,5,0,9,8,31
191107804,5,4,1,9,1,20
191107805,1,5,3,1,7,17
191107806,9,7,3,9,0,28
191107807,4,7,1,8,6,26
191107808,1,1,1,9,5,17
191107809,9,5,7,3,5,29
191107810,3,1,3,8,0,15
191107811,3,0,5,1,2,11
191107812,2,2,9,0,9,22
191107813,2,0,9,9,3,23
191107814,3,4,2,5,3,17
191107815,0,8,7,1,9,25
191107816,4,0,0,5,3,12
191107817,5,0,5,3,1,14
191107818,5,5,2,2,1,15
191107819,5,6,3,1,0,15
191107820,4,9,6,4,4,27
191107821,1,3,8,4,1,17
191107822,2,3,6,4,9,24
191107823,5,1,2,0,8,16
191107824,6,6,8,2,7,29
191107825,9,3,5,6,7,30
191107826,2,4,1,2,4,13
191107827,9,1,7,1,7,25
191107828,0,1,3,6,3,13
191107829,8,2,4,0,9,23
191107830,9,2,4,1,9,25
191107831,8,0,5,4,8,25
191107832,3,9,2,9,2,25
191107833,9,9,5,0,5,28
191107834,5,6,0,8,9,28
191107835,2,6,7,8,0,23
191107836,2,9,8,4,3,26
191107837,9,3,8,6,0,26
191107838,9,7,0,5,4,25
191107839,8,5,4,3,7,27
191107840,2,6,8,0,6,22
191107841,0,9,2,8,3,22
191107842,4,3,6,8,4,25
191107843,0,0,0,6,6,12
191107844,6,8,0,4,3,21
191107845,7,4,7,9,9,36
191107846,1,8,3,0,0,12
191107847,0,6,9,0,2,17
191107848,5,3,6,8,0,22
191107849,0,7,4,4,0,15
191107850,4,3,8,7,9,31
191107851,1,0,0,8,3,12
191107852,6,0,8,1,3,18
191107853,2,9,7,2,0,20
191107854,0,6,9,2,6,23
191107855,2,3,9,6,5,25
191107856,9,9,4,2,2,26
191107857,0,3,0,8,0,11
191107858,9,9,3,9,9,39
191107859,9,0,8,6,8,31
191107860,6,5,2,5,9,27
191107861,0,5,5,5,4,19
191107862,8,3,6,2,7,26
191107863,5,2,5,5,5,22
191107864,8,5,5,7,6,31
191107865,5,8,6,3,7,29
191107866,3,4,2,7,1,17
191107867,5,0,6,3,8,22
191107868,8,3,3,6,2,22
191107869,5,9,5,9,4,32
191107870,2,6,8,8,4,28
191107871,3,8,1,2,2,16
191107872,8,8,5,6,0,27
191107873,9,1,0,1,0,11
191107874,2,7,2,0,4,15
191107875,3,1,9,9,1,23
191107876,2,4,6,1,1,14
191107877,4,1,9,4,7,25
191107878,3,5,7,7,2,24
191107879,2,6,7,3,1,19
191107880,1,4,4,9,8,26
191107881,5,1,0,0,8,14
191107882,5,9,3,8,9,34
191107883,7,9,5,1,3,25
191107884,6,2,2,9,0,19
191107885,7,2,2,5,2,18
191107886,3,0,2,2,4,11
191107887,1,8,8,4,4,25
191107888,5,7,7,9,8,36
191107889,6,2,4,5,8,25
191107890,5,7,2,6,7,27
191107891,8,9,6,0,7,30
191107892,1,4,3,9,4,21
191107893,2,5,5,8,8,28
191107894,2,5,3,1,4,15
191107895,9,3,9,1,8,30
191107896,6,4,1,6,5,22
191107897,3,1,3,8,4,19
191107898,4,5,2,6,8,25
191107899,9,3,9,8,5,34
191107900,9,4,2,3,1,19
191107901,8,8,4,3,2,25
191107902,3,9,0,7,1,20
191107903,0,8,5,1,2,16
191107904,1,6,0,0,5,12
191107905,8,1,2,7,7,25
191107906,6,3,9,3,0,21
191107907,0,8,6,7,7,28
191107908,4,7,5,2,2,20
191107909,6,8,4,1,4,23
191107910,3,9,7,6,6,31
191107911,2,2,8,8,3,23
191107912,0,1,9,2,5,17
191107913,4,5,3,7,7,26
191107914,4,8,2,2,1,17
191107915,4,6,2,3,3,18
191107916,7,8,3,9,0,27
191107917,9,2,6,0,8,25
191107918,5,4,3,7,5,24
191107919,9,3,5,0,2,19
191107920,1,3,9,8,3,24
191107921,3,8,6,3,3,23
191107922,8,5,9,1,9,32
191107923,2,9,9,8,8,36
191107924,2,6,2,8,8,26
191107925,0,8,0,2,1,11
191107926,7,9,1,3,4,24
191107927,1,4,6,7,6,24
191107928,5,6,2,7,0,20
191107929,0,3,4,1,4,12
191107930,9,8,2,6,7,32
191107931,6,5,6,1,9,27
191107932,6,6,9,9,2,32
191107933,7,0,5,5,3,20
191107934,9,8,0,0,1,18
191107935,0,1,5,6,4,16
191107936,9,5,7,0,4,25
191107937,0,6,3,1,8,18
191107938,1,1,6,0,2,10
191107939,6,7,2,9,3,27
191107940,4,7,6,6,8,31
191107941,4,3,7,4,9,27
191107942,9,2,1,4,5,21
191107943,7,2,9,0,0,18
191107944,6,3,3,4,0,16
191107945,3,7,1,3,3,17
191107946,4,0,4,1,2,11
191107947,2,0,5,7,3,17
191107948,0,3,6,3,2,14
191107949,7,7,2,8,0,24
191107950,4,0,2,7,1,14
191107951,2,3,4,9,2,20
191107952,0,9,9,9,8,35
191107953,2,1,3,9,2,17
191107954,7,3,3,0,4,17
191107955,1,1,1,2,4,9
191107956,9,7,4,8,4,32
191107957,6,5,1,7,7,26
191107958,5,4,3,0,2,14
191107959,3,7,3,7,5,25
191107960,5,5,7,6,8,31
191107961,5,6,7,2,2,22
191107962,2,2,5,8,2,19
191107963,1,7,2,2,3,15
191107964,6,6,6,3,5,26
191107965,1,2,7,2,2,14
191107966,2,3,8,3,2,18
191107967,8,0,3,1,1,13
191107968,8,4,0,9,7,28
191107969,0,0,4,6,9,19
191107970,6,9,7,7,3,32
191107971,9,7,2,8,6,32
191107972,2,2,9,8,1,22
191107973,4,8,3,8,9,32
191107974,7,8,4,4,4,27
191107975,2,8,9,1,5,25
191107976,5,7,1,4,3,20
191107977,9,3,4,5,1,22
191107978,6,8,6,6,4,30
191107979,6,0,2,7,0,15
191107980,7,2,1,4,4,18
191107981,1,3,9,4,7,24
191107982,0,9,1,1,4,15
191107983,5,6,1,8,2,22
191107984,3,4,5,7,8,27
191107985,6,5,3,4,3,21
191107986,0,1,4,9,8,22
191107987,1,2,7,0,7,17
191107988,5,9,7,7,9,37
191107989,9,0,7,8,5,29
191107990,1,6,2,9,3,21
191107991,8,0,8,4,2,22
191107992,2,9,4,1,1,17
191107993,5,3,9,8,3,28
191107994,0,2,5,5,8,20
191107995,1,7,7,8,5,28
191107996,6,0,9,5,1,21
191107997,5,8,7,0,0,20
191107998,8,0,3,3,2,16
191107999,2,3,2,3,1,11
1911071000,7,0,7,4,7,25
1911071001,4,8,7,9,6,34
1911071002,5,4,1,7,9,26
1911071003,3,9,5,8,3,28
1911071004,9,2,0,4,2,17
1911071005,5,9,5,1,2,22
1911071006,9,0,7,5,2,23
1911071007,0,4,9,6,2,21
1911071008,4,1,2,3,6,16
1911071009,6,9,6,2,0,23
1911071010,8,7,9,5,9,38
1911071011,8,3,9,3,2,25
1911071012,2,2,8,3,7,22
1911071013,8,0,6,5,2,21
1911071014,4,4,6,9,4,27
1911071015,0,7,2,5,7,21
1911071016,2,6,6,4,8,26
1911071017,7,5,7,4,7,30
1911071018,6,8,3,4,3,24
1911071019,8,8,2,0,7,25
1911071020,9,5,0,6,0,20
1911071021,8,7,4,0,0,19
1911071022,8,3,7,8,1,27
1911071023,6,5,9,2,5,27
1911071024,0,7,5,2,4,18
1911071025,8,9,1,7,5,30
1911071026,2,1,8,5,3,19
1911071027,5,0,8,6,7,26
1911071028,9,1,5,7,6,28
1911071029,8,9,5,7,2,31
1911071030,5,5,4,8,1,23
1911071031,9,6,5,1,7,28
1911071032,4,4,4,8,4,24
1911071033,2,8,5,0,3,18
1911071034,4,3,7,5,5,24
1911071035,5,0,7,3,2,17
1911071036,7,8,0,1,5,21
1911071037,0,3,3,7,3,16
1911071038,3,3,1,6,2,15
1911071039,1,0,0,2,3,6
1911071040,1,4,8,0,2,15
1911071041,2,4,3,9,9,27
1911071042,5,1,6,2,3,17
1911071043,7,1,9,5,3,25
1911071044,8,8,1,5,3,25
1911071045,2,3,6,8,0,19
1911071046,9,8,7,6,8,38
1911071047,9,5,0,3,1,18
1911071048,6,1,9,0,8,24
1911071049,6,7,6,3,4,26
1911071050,2,2,8,7,1,20
1911071051,9,4,8,6,6,33
1911071052,7,3,9,6,8,33
1911071053,7,4,8,9,9,37
1911071054,1,6,0,0,9,16
1911071055,5,4,2,7,2,20
1911071056,5,3,2,4,8,22
1911071057,3,4,1,9,6,23
1911071058,4,4,2,7,3,20
1911071059,4,6,4,5,6,25
1911071060,9,1,6,1,8,25
1911071061,2,9,4,4,6,25
1911071062,8,7,0,5,3,23
1911071063,0,9,5,0,7,21
1911071064,2,2,5,9,3,21
1911071065,1,4,5,1,7,18
1911071066,4,6,0,6,1,17
1911071067,1,8,3,8,0,20
1911071068,9,3,7,9,7,35
1911071069,2,8,8,9,6,33
1911071070,6,4,4,2,5,21
1911071071,7,9,0,5,7,28
1911071072,3,9,1,3,5,21
1911071073,5,8,0,0,0,13
1911071074,0,4,0,5,6,15
1911071075,6,6,5,9,0,26
1911071076,1,9,6,6,7,29
1911071077,8,8,9,3,5,33
1911071078,9,0,8,6,7,30
1911071079,3,8,8,7,3,29
1911071080,7,8,4,2,2,23
1911071081,0,4,7,9,2,22
1911071082,2,4,5,6,9,26
1911071083,0,1,1,1,5,8
1911071084,9,3,0,2,8,22
1911071085,8,3,0,3,3,17
1911071086,9,2,0,2,9,22
1911071087,2,1,2,8,1,14
1911071088,9,2,0,1,3,15
1911071089,3,2,9,1,6,21
1911071090,0,9,3,5,1,18
1911071091,9,2,8,9,6,34
1911071092,1,3,9,2,7,22
1911071093,9,7,2,2,6,26
1911071094,2,9,1,0,3,15
1911071095,7,0,4,4,4,19
1911071096,4,3,4,7,7,25
1911071097,3,6,1,7,2,19
1911071098,5,1,2,3,3,14
1911071099,8,7,9,0,3,27
1911071100,3,3,4,2,6,18
1911071101,0,3,0,3,2,8
1911071102,9,1,5,3,0,18
1911071103,8,5,0,4,8,25
1911071104,6,3,7,7,0,23
1911071105,5,4,6,3,6,24
191108001,7,5,9,3,3,27
191108002,8,8,9,3,7,35
191108003,8,4,4,4,6,26
191108004,7,6,0,0,1,14
191108005,9,1,7,8,9,34
191108006,3,1,7,4,6,21
191108007,9,7,2,1,3,22
191108008,0,7,9,5,2,23
191108009,5,0,3,6,0,14
191108010,6,1,6,2,4,19
191108011,0,1,4,8,6,19
191108012,4,1,7,7,6,25
191108013,0,3,6,7,4,20
191108014,5,3,3,7,6,24
191108015,2,9,7,0,7,25
191108016,0,2,0,8,9,19
191108017,6,0,5,5,2,18
191108018,3,8,3,3,9,26
191108019,3,1,4,3,0,11
191108020,8,6,8,3,5,30
191108021,3,1,4,8,9,25
191108022,6,5,7,5,7,30
191108023,6,7,1,4,8,26
191108024,7,0,4,6,8,25
191108025,8,2,3,7,9,29
191108026,3,6,0,1,4,14
191108027,6,2,4,1,2,15
191108028,0,2,3,4,3,12
191108029,7,3,9,1,5,25
191108030,2,8,3,0,1,14
191108031,9,8,7,8,7,39
191108032,1,7,7,4,1,20
191108033,6,3,3,7,7,26
191108034,9,1,4,0,7,21
191108035,9,8,0,2,3,22
191108036,8,8,9,9,0,34
191108037,9,0,2,2,2,15
191108038,8,7,1,8,6,30
191108039,2,5,9,8,6,30
191108040,1,3,2,9,5,20
191108041,9,1,0,5,3,18
191108042,3,7,7,2,9,28
191108043,0,8,3,1,0,12
191108044,8,1,9,9,9,36
191108045,1,5,5,1,9,21
191108046,6,6,0,4,1,17
191108047,6,8,4,6,8,32
191108048,2,2,5,9,2,20
191108049,1,6,6,6,0,19
191108050,3,2,6,2,4,17
191108051,1,8,0,3,9,21
191108052,9,7,1,8,2,27
191108053,4,4,7,6,0,21
191108054,0,5,5,1,5,16
191108055,3,4,7,0,0,14
191108056,2,1,2,9,3,17
191108057,5,9,1,0,8,23
191108058,7,1,0,4,1,13
191108059,5,5,5,9,7,31
191108060,1,7,4,3,1,16
191108061,8,0,2,1,2,13
191108062,1,0,2,7,7,17
191108063,3,1,7,9,2,22
191108064,8,3,9,1,9,30
191108065,7,0,7,8,5,27
191108066,6,8,2,4,4,24
191108067,7,3,4,5,6,25
191108068,9,6,1,5,0,21
191108069,8,3,6,5,3,25
191108070,7,1,4,3,9,24
191108071,5,2,4,0,1,12
191108072,0,8,4,8,3,23
191108073,0,8,0,8,9,25
191108074,6,7,2,4,0,19
191108075,8,0,3,8,3,22
191108076,7,3,0,1,3,14
191108077,4,1,1,4,6,16
191108078,3,1,9,8,9,30
191108079,5,0,9,7,1,22
191108080,0,7,7,4,3,21
191108081,3,5,2,5,6,21
191108082,4,9,2,9,0,24
191108083,4,3,5,7,5,24
191108084,6,4,5,4,5,24
191108085,8,3,0,7,6,24
191108086,4,9,1,2,2,18
191108087,6,2,1,3,8,20
191108088,6,4,5,5,8,28
191108089,5,0,6,5,6,22
191108090,7,2,8,8,6,31
191108091,4,7,6,3,3,23
191108092,1,1,8,7,0,17
191108093,0,8,2,4,8,22
191108094,2,6,0,1,8,17
191108095,0,1,3,9,4,17
191108096,8,1,7,2,7,25
191108097,0,5,8,2,9,24
191108098,0,7,6,9,0,22
191108099,2,3,2,0,4,11
191108100,4,2,1,2,0,9
191108101,7,4,7,0,9,27
191108102,3,7,5,5,5,25
191108103,2,4,0,7,0,13
191108104,4,8,0,2,6,20
191108105,7,4,2,4,5,22
191108106,4,5,6,0,8,23
191108107,3,5,9,6,9,32
191108108,3,8,8,4,0,23
191108109,2,8,5,2,7,24
191108110,1,6,5,1,4,17
191108111,5,7,5,7,3,27
191108112,2,3,2,3,3,13
191108113,0,4,0,9,4,17
191108114,1,8,9,5,6,29
191108115,7,9,1,8,7,32
191108116,1,4,0,4,1,10
191108117,5,0,9,2,3,19
191108118,2,2,2,1,7,14
191108119,5,4,6,5,9,29
191108120,4,8,7,7,7,33
191108121,8,1,9,2,5,25
191108122,6,3,6,8,3,26
191108123,6,9,2,5,0,22
191108124,9,4,0,0,4,17
191108125,3,2,2,6,1,14
191108126,0,1,2,2,6,11
191108127,6,3,8,9,5,31
191108128,1,9,8,6,9,33
191108129,4,3,8,7,1,23
191108130,8,3,4,0,2,17
191108131,6,3,9,7,2,27
191108132,9,0,0,1,4,14
191108133,0,3,3,7,6,19
191108134,3,9,5,9,3,29
191108135,3,7,5,2,7,24
191108136,8,0,0,9,1,18
191108137,1,5,7,9,7,29
191108138,5,0,2,4,1,12
191108139,1,9,8,2,9,29
191108140,4,4,9,9,4,30
191108141,6,4,5,0,5,20
191108142,9,2,0,1,9,21
191108143,8,9,8,2,4,31
191108144,3,7,3,0,7,20
191108145,2,2,5,1,3,13
191108146,8,8,9,9,5,39
191108147,1,7,8,3,5,24
191108148,6,1,2,7,2,18
191108149,7,4,3,6,2,22
191108150,7,0,4,7,2,20
191108151,8,7,7,8,6,36
191108152,6,0,6,5,7,24
191108153,3,4,0,4,4,15
191108154,8,5,7,8,0,28
191108155,7,0,2,1,6,16
191108156,8,7,6,2,3,26
191108157,6,9,4,3,8,30
191108158,8,1,4,3,6,22
191108159,6,9,7,0,4,26
191108160,3,7,8,4,8,30
191108161,6,0,0,2,6,14
191108162,2,7,3,8,4,24
191108163,1,2,2,7,5,17
191108164,0,0,2,6,0,8
191108165,7,4,7,1,9,28
191108166,4,0,1,6,2,13
191108167,5,3,9,9,2,28
191108168,1,4,2,7,8,22
191108169,0,0,3,7,3,13
191108170,9,4,1,9,0,23
191108171,4,0,9,4,2,19
191108172,3,9,3,4,3,22
191108173,8,8,4,7,0,27
191108174,1,0,7,5,8,21
191108175,6,6,2,7,8,29
191108176,5,1,9,7,6,28
191108177,2,5,9,1,8,25
191108178,2,7,2,5,2,18
191108179,5,0,3,8,6,22
191108180,5,6,0,9,2,22
191108181,7,8,8,6,3,32
191108182,2,1,6,6,5,20
191108183,9,3,5,1,8,26
191108184,8,4,2,7,5,26
191108185,7,6,1,2,7,23
191108186,7,6,1,6,8,28
191108187,4,8,6,5,2,25
191108188,0,5,0,2,7,14
191108189,3,2,0,3,4,12
191108190,2,6,2,3,8,21
191108191,5,9,4,3,5,26
191108192,4,7,6,8,8,33
191108193,4,1,8,1,7,21
191108194,3,9,2,1,6,21
191108195,0,4,0,5,3,12
191108196,2,2,0,1,1,6
191108197,5,0,2,8,8,23
191108198,4,1,5,3,2,15
191108199,7,1,5,2,5,20
191108200,8,5,3,7,2,25
191108201,2,7,2,9,2,22
191108202,8,9,0,7,0,24
191108203,4,7,8,9,8,36
191108204,5,3,9,0,0,17
191108205,7,6,7,1,8,29
191108206,4,5,4,6,7,26
191108207,8,6,7,4,7,32
191108208,6,4,0,4,8,22
191108209,6,7,2,2,6,23
191108210,5,5,4,3,7,24
191108211,8,2,8,0,7,25
191108212,3,1,8,5,6,23
191108213,7,6,8,2,2,25
191108214,4,1,2,3,9,19
191108215,9,8,4,1,1,23
191108216,9,8,5,8,0,30
191108217,4,6,1,5,7,23
191108218,9,3,2,1,5,20
191108219,1,8,8,4,9,30
191108220,7,2,8,4,6,27
191108221,2,9,5,6,7,29
191108222,7,2,6,0,7,22
191108223,6,7,6,1,2,22
191108224,6,9,8,5,3,31
191108225,0,1,9,4,1,15
191108226,7,2,8,8,4,29
191108227,5,2,9,8,0,24
191108228,3,9,7,7,1,27
191108229,0,8,7,2,0,17
191108230,9,4,3,4,6,26
191108231,5,4,9,6,4,28
191108232,5,7,9,9,0,30
191108233,6,4,0,5,5,20
191108234,7,5,3,3,6,24
191108235,1,6,1,1,5,14
191108236,2,7,8,4,6,27
191108237,0,9,6,6,3,24
191108238,5,8,5,1,0,19
191108239,9,0,7,5,6,27
191108240,2,4,6,2,5,19
191108241,5,4,3,2,2,16
191108242,1,5,3,9,9,27
191108243,5,8,8,8,0,29
191108244,9,2,3,3,0,17
191108245,0,5,5,6,8,24
191108246,6,1,3,8,9,27
191108247,2,0,1,2,7,12
191108248,8,8,4,8,1,29
191108249,3,6,4,9,6,28
191108250,8,3,5,0,8,24
191108251,7,0,6,2,4,19
191108252,6,9,8,8,1,32
191108253,9,8,6,2,0,25
191108254,8,9,1,3,0,21
191108255,3,6,1,6,2,18
191108256,9,7,9,5,2,32
191108257,7,4,8,2,6,27
191108258,9,1,5,9,5,29
191108259,5,2,0,0,6,13
191108260,5,5,6,6,1,23
191108261,3,8,6,9,7,33
191108262,7,6,5,4,3,25
191108263,0,3,7,8,9,27
191108264,4,0,0,6,0,10
191108265,6,9,6,5,1,27
191108266,1,7,1,5,5,19
191108267,2,0,3,1,0,6
191108268,8,8,8,8,3,35
191108269,3,2,4,4,5,18
191108270,7,8,4,9,4,32
191108271,3,0,1,8,4,16
191108272,3,1,7,1,8,20
191108273,6,0,6,5,1,18
191108274,2,0,0,1,4,7
191108275,7,1,7,7,5,27
191108276,4,1,0,3,8,16
191108277,7,4,0,2,0,13
191108278,2,0,3,0,3,8
191108279,4,0,6,6,3,19
191108280,9,6,4,6,6,31
191108281,1,6,6,2,5,20
191108282,8,8,4,1,4,25
191108283,6,8,8,2,0,24
191108284,2,8,7,6,5,28
191108285,7,3,0,2,2,14
191108286,8,5,6,0,6,25
191108287,4,5,4,8,9,30
191108288,0,9,1,3,1,14
191108289,3,9,0,6,8,26
191108290,7,2,2,4,4,19
191108291,5,4,2,8,3,22
191108292,7,5,4,4,5,25
191108293,2,0,3,1,7,13
191108294,9,3,0,6,2,20
191108295,2,7,8,5,0,22
191108296,3,6,1,4,1,15
191108297,3,1,3,1,0,8
191108298,4,5,9,9,6,33
191108299,9,1,6,0,3,19
191108300,3,5,3,8,0,19
191108301,3,4,4,2,8,21
191108302,9,3,8,6,2,28
191108303,8,3,0,1,3,15
191108304,2,3,6,2,5,18
191108305,2,6,3,8,9,28
191108306,7,3,1,6,0,17
191108307,9,1,3,4,5,22
191108308,6,9,5,5,8,33
191108309,7,7,6,9,2,31
191108310,9,3,4,2,3,21
191108311,3,6,8,0,7,24
191108312,4,8,1,5,5,23
191108313,4,6,3,3,4,20
191108314,0,2,3,5,5,15
191108315,8,0,1,7,5,21
191108316,9,9,5,7,8,38
191108317,4,4,0,3,0,11
191108318,1,9,3,3,1,17
191108319,5,8,2,2,0,17
191108320,3,3,8,6,0,20
191108321,5,3,2,0,9,19
191108322,7,5,0,7,5,24
191108323,8,2,0,5,1,16
191108324,2,6,4,8,5,25
191108325,6,5,6,2,8,27
191108326,0,9,1,5,8,23
191108327,3,4,8,2,6,23
191108328,5,7,9,7,8,36
191108329,0,7,4,1,6,18
191108330,6,6,6,5,4,27
191108331,4,6,2,1,0,13
191108332,6,0,3,8,9,26
191108333,7,7,3,3,3,23
191108334,3,7,6,0,0,16
191108335,3,6,9,9,0,27
191108336,7,5,5,1,4,22
191108337,9,8,8,1,0,26
191108338,9,1,3,7,7,27
191108339,5,9,2,9,5,30
191108340,6,0,9,2,5,22
191108341,2,3,2,7,7,21
191108342,3,8,3,7,9,30
191108343,4,5,9,1,4,23
191108344,2,8,8,0,7,25
191108345,6,7,0,6,5,24
191108346,5,3,7,1,4,20
191108347,1,8,3,0,6,18
191108348,5,0,3,3,2,13
191108349,5,5,6,7,7,30
191108350,3,7,6,4,5,25
191108351,0,7,6,5,4,22
191108352,6,3,7,6,4,26
191108353,9,2,3,4,5,23
191108354,6,0,3,7,1,17
191108355,5,9,2,0,7,23
191108356,4,0,8,3,8,23
191108357,2,9,6,4,3,24
191108358,4,9,5,4,7,29
191108359,5,9,5,4,8,31
191108360,5,9,5,2,3,24
191108361,1,2,8,7,9,27
191108362,6,0,6,0,6,18
191108363,8,5,5,0,4,22
191108364,5,5,9,6,3,28
191108365,0,6,7,3,1,17
191108366,1,1,5,9,9,25
191108367,3,4,8,5,3,23
191108368,8,3,4,9,5,29
191108369,4,6,9,8,0,27
191108370,1,2,2,2,3,10
191108371,8,0,6,0,9,23
191108372,7,3,4,4,5,23
191108373,7,3,5,9,9,33
191108374,8,4,0,8,8,28
191108375,8,6,3,0,1,18
191108376,3,2,7,0,1,13
191108377,9,9,6,5,9,38
191108378,0,5,1,9,2,17
191108379,6,7,3,8,8,32
191108380,8,7,4,3,8,30
191108381,4,9,3,3,7,26
191108382,3,0,7,6,7,23
191108383,5,7,3,9,5,29
191108384,6,2,1,7,1,17
191108385,3,8,6,3,4,24
191108386,0,0,8,8,8,24
191108387,5,9,7,3,2,26
191108388,2,6,7,4,7,26
191108389,7,3,0,9,2,21
191108390,1,1,6,2,9,19
191108391,0,3,0,1,8,12
191108392,1,5,7,5,8,26
191108393,9,3,7,9,8,36
191108394,0,0,9,2,3,14
191108395,7,5,0,8,7,27
191108396,9,3,5,2,3,22
191108397,6,7,9,7,8,37
191108398,5,6,9,6,6,32
191108399,7,9,5,7,0,28
191108400,1,9,1,8,9,28
191108401,8,0,1,9,1,19
191108402,6,1,6,2,7,22
191108403,0,8,1,5,8,22
191108404,8,1,5,4,7,25
191108405,5,6,1,7,4,23
191108406,2,7,5,5,1,20
191108407,3,0,4,7,8,22
191108408,5,9,4,2,4,24
191108409,1,5,9,2,4,21
191108410,0,9,1,3,7,20
191108411,0,2,8,9,0,19
191108412,8,7,6,4,0,25
191108413,5,6,5,8,5,29
191108414,5,3,0,4,4,16
191108415,5,2,4,9,9,29
191108416,6,3,7,8,7,31
191108417,7,1,6,4,8,26
191108418,3,6,4,5,2,20
191108419,3,7,9,3,8,30
191108420,7,8,6,6,6,33
191108421,9,1,4,1,7,22
191108422,5,5,3,5,0,18
191108423,7,9,1,5,1,23
191108424,1,5,0,7,1,14
191108425,4,2,5,9,6,26
191108426,9,9,8,4,9,39
191108427,3,4,7,4,1,19
191108428,5,0,8,1,7,21
191108429,8,5,6,4,4,27
191108430,3,0,8,5,9,25
191108431,7,3,4,0,7,21
191108432,1,3,5,6,7,22
191108433,0,8,3,0,9,20
191108434,3,9,0,1,2,15
191108435,5,9,6,1,1,22
191108436,3,5,5,7,5,25
191108437,9,9,6,3,1,28
191108438,8,9,1,7,8,33
191108439,2,6,7,9,3,27
191108440,8,9,3,7,6,33
191108441,5,4,4,3,9,25
191108442,8,7,6,7,2,30
191108443,6,0,5,8,4,23
191108444,9,5,2,0,2,18
191108445,4,6,3,8,7,28
191108446,3,2,1,1,4,11
191108447,0,2,9,3,4,18
191108448,4,7,5,5,6,27
191108449,6,7,5,2,9,29
191108450,1,5,5,6,8,25
191108451,7,4,0,7,6,24
191108452,4,5,0,8,7,24
191108453,4,8,5,8,0,25
191108454,3,7,7,4,6,27
191108455,2,8,3,4,9,26
191108456,3,2,5,0,9,19
191108457,8,9,5,1,3,26
191108458,1,8,4,0,5,18
191108459,1,7,8,5,5,26
191108460,8,8,3,7,0,26
191108461,8,2,9,2,1,22
191108462,0,5,1,2,0,8
191108463,7,8,7,9,6,37
191108464,1,8,4,2,6,21
191108465,6,3,8,7,0,24
191108466,4,7,5,0,1,17
191108467,8,9,6,6,9,38
191108468,1,9,7,8,7,32
191108469,2,7,7,9,0,25
191108470,8,0,7,8,9,32
191108471,3,8,0,6,4,21
191108472,6,1,0,6,3,16
191108473,3,7,5,4,6,25
191108474,1,8,1,9,2,21
191108475,9,3,9,4,8,33
191108476,7,1,8,4,8,28
191108477,4,1,9,2,3,19
191108478,5,9,5,3,4,26
191108479,4,1,7,3,4,19
191108480,7,9,9,9,1,35
191108481,4,5,8,6,9,32
191108482,4,6,6,3,5,24
191108483,8,0,8,2,0,18
191108484,7,1,5,4,6,23
191108485,9,8,9,1,3,30
191108486,8,6,4,7,7,32
191108487,9,1,8,8,8,34
191108488,2,8,6,3,0,19
191108489,0,2,4,3,6,15
191108490,4,8,5,3,3,23
191108491,8,4,3,4,0,19
191108492,5,1,1,6,3,16
191108493,9,3,7,0,0,19
191108494,4,1,4,4,9,22
191108495,2,3,0,7,2,14
191108496,5,6,7,6,3,27
191108497,0,0,7,4,8,19
191108498,9,1,9,6,6,31
191108499,7,9,7,0,0,23
191108500,0,8,4,6,9,27
191108501,5,1,1,9,0,16
191108502,9,5,1,6,4,25
191108503,3,7,2,2,6,20
191108504,1,3,2,3,2,11
191108505,6,9,9,8,6,38
191108506,9,1,1,3,8,22
191108507,4,4,5,2,7,22
191108508,2,9,0,9,4,24
191108509,7,9,1,7,3,27
191108510,0,5,9,4,0,18
191108511,7,0,6,5,0,18
191108512,5,2,5,7,1,20
191108513,0,3,1,9,1,14
191108514,6,1,3,0,6,16
191108515,3,7,7,7,9,33
191108516,8,0,0,5,3,16
191108517,2,3,0,8,5,18
191108518,3,0,4,6,6,19
191108519,1,9,6,2,1,19
191108520,3,2,2,3,3,13
191108521,9,6,7,0,5,27
191108522,5,0,7,2,9,23
191108523,9,5,6,5,4,29
191108524,2,7,2,7,0,18
191108525,4,2,0,4,4,14
191108526,3,1,4,5,8,21
191108527,5,4,2,0,0,11
191108528,6,4,6,2,3,21
191108529,1,7,6,3,1,18
191108530,1,1,3,3,9,17
191108531,9,2,5,4,0,20
191108532,7,9,0,2,4,22
191108533,2,9,4,9,5,29
191108534,5,3,8,6,4,26
191108535,7,3,9,5,5,29
191108536,7,1,1,7,4,20
191108537,9,9,9,1,9,37
191108538,0,4,5,4,6,19
191108539,8,8,3,4,9,32
191108540,0,8,2,4,5,19
191108541,3,0,6,7,1,17
191108542,0,5,5,7,6,23
191108543,1,7,7,3,0,18
191108544,4,5,0,4,4,17
191108545,5,8,7,8,0,28
191108546,4,5,3,0,3,15
191108547,4,0,3,6,2,15
191108548,7,3,8,7,6,31
191108549,2,7,6,5,2,22
191108550,4,6,9,4,4,27
191108551,1,5,8,6,0,20
191108552,7,9,7,2,8,33
191108553,4,8,8,2,6,28
191108554,2,8,1,2,1,14
191108555,5,7,3,2,2,19
191108556,8,0,6,7,5,26
191108557,5,0,0,2,6,13
191108558,9,0,8,1,1,19
191108559,0,4,4,0,9,17
191108560,1,3,9,1,8,22
191108561,7,3,7,1,9,27
191108562,3,9,7,7,7,33
191108563,5,6,2,6,8,27
191108564,3,2,1,8,6,20
191108565,7,1,2,8,2,20
191108566,9,3,1,1,4,18
191108567,5,0,9,6,2,22
191108568,3,5,6,7,8,29
191108569,7,9,5,1,4,26
191108570,5,0,2,8,5,20
191108571,1,3,0,0,5,9
191108572,5,1,1,5,8,20
191108573,9,6,9,5,8,37
191108574,0,7,9,7,7,30
191108575,3,9,0,4,9,25
191108576,3,2,2,2,5,14
191108577,2,1,5,2,6,16
191108578,9,5,9,7,5,35
191108579,1,5,2,9,3,20
191108580,9,1,7,8,7,32
191108581,9,8,4,1,8,30
191108582,1,8,5,7,7,28
191108583,8,6,6,4,6,30
191108584,6,0,7,4,2,19
191108585,8,7,9,3,1,28
191108586,4,8,9,6,9,36
191108587,2,0,5,6,4,17
191108588,2,2,7,7,0,18
191108589,3,9,6,8,6,32
191108590,6,5,9,2,7,29
191108591,1,1,2,7,1,12
191108592,5,1,7,7,8,28
191108593,7,9,6,5,3,30
191108594,0,9,0,4,1,14
191108595,8,8,1,2,0,19
191108596,5,9,6,8,3,31
191108597,3,4,1,9,1,18
191108598,7,2,6,8,7,30
191108599,8,7,3,9,0,27
191108600,4,1,0,8,5,18
191108601,7,6,6,0,1,20
191108602,7,7,6,1,6,27
191108603,5,8,6,0,7,26
191108604,1,1,1,1,8,12
191108605,2,4,2,8,9,25
191108606,6,6,9,8,8,37
191108607,1,8,0,1,2,12
191108608,1,6,0,1,0,8
191108609,7,1,4,1,9,22
191108610,3,3,2,4,1,13
191108611,8,2,3,6,4,23
191108612,3,3,2,8,0,16
191108613,8,7,1,0,7,23
191108614,0,3,4,7,4,18
191108615,4,9,4,3,1,21
191108616,5,4,3,8,8,28
191108617,7,6,9,9,0,31
191108618,2,3,1,4,8,18
191108619,9,0,9,4,1,23
191108620,9,3,4,0,6,22
191108621,6,1,0,9,4,20
191108622,9,4,8,7,2,30
191108623,7,6,1,7,2,23
191108624,4,5,9,8,1,27
191108625,5,7,2,9,5,28
191108626,9,5,7,7,3,31
191108627,8,5,4,2,3,22
191108628,9,0,3,3,0,15
191108629,2,2,3,8,7,22
191108630,6,6,6,4,8,30
191108631,9,4,6,9,9,37
191108632,6,8,9,6,5,34
191108633,8,6,3,7,3,27
191108634,7,8,7,6,9,37
191108635,5,4,0,8,3,20
191108636,2,6,6,1,9,24
191108637,8,6,1,3,8,26
191108638,0,3,1,5,8,17
191108639,0,0,7,8,6,21
191108640,4,9,9,8,7,37
191108641,5,0,3,4,5,17
191108642,2,5,9,4,1,21
191108643,3,2,3,7,0,15
191108644,4,3,8,5,5,25
191108645,7,3,2,9,6,27
191108646,8,9,3,4,3,27
191108647,6,3,4,9,5,27
191108648,2,4,3,8,9,26
191108649,0,4,2,4,7,17
191108650,7,3,6,5,8,29
191108651,3,2,0,4,9,18
191108652,9,9,9,9,5,41
191108653,7,8,7,7,1,30
191108654,3,6,0,5,3,17
191108655,5,6,1,3,6,21
191108656,7,0,7,3,8,25
191108657,4,6,5,2,7,24
191108658,1,9,7,5,2,24
191108659,1,8,4,8,7,28
191108660,1,6,7,1,8,23
191108661,3,8,1,6,9,27
191108662,3,6,7,7,5,28
191108663,9,2,0,7,5,23
191108664,2,3,1,4,7,17
191108665,9,4,7,0,6,26
191108666,1,7,1,7,8,24
191108667,7,0,5,4,3,19
191108668,8,1,0,6,7,22
191108669,5,7,7,2,8,29
191108670,9,1,6,7,5,28
191108671,8,3,0,5,6,22
191108672,4,8,4,8,9,33
191108673,8,5,0,0,8,21
191108674,8,9,7,4,5,33
191108675,7,1,2,8,5,23
191108676,5,9,1,2,7,24
191108677,7,5,2,9,6,29
191108678,2,6,4,0,5,17
191108679,0,4,9,5,2,20
191108680,5,9,4,8,9,35
191108681,2,2,5,0,5,14
191108682,5,1,4,6,5,21
191108683,2,2,6,8,7,25
191108684,7,6,0,9,6,28
191108685,5,5,6,3,0,19
191108686,6,3,4,9,2,24
191108687,5,1,7,1,1,15
191108688,5,5,6,0,6,22
191108689,3,7,0,9,0,19
191108690,7,5,1,9,7,29
191108691,2,9,9,0,6,26
191108692,9,9,5,7,2,32
191108693,9,6,0,1,1,17
191108694,2,6,8,6,1,23
191108695,3,6,9,0,6,24
191108696,8,2,5,4,7,26
191108697,8,6,1,4,7,26
191108698,4,4,4,3,1,16
191108699,8,8,4,4,7,31
191108700,8,9,7,3,6,33
191108701,2,7,2,4,4,19
191108702,8,2,9,6,6,31
191108703,2,9,3,1,7,22
191108704,9,2,6,5,1,23
191108705,1,9,0,2,0,12
191108706,3,2,2,8,2,17
191108707,6,7,4,7,1,25
191108708,8,8,2,3,5,26
191108709,1,5,7,2,1,16
191108710,7,0,4,8,5,24
191108711,8,7,5,6,4,30
191108712,7,6,9,4,2,28
191108713,7,8,1,3,3,22
191108714,5,0,8,8,3,24
191108715,1,7,5,1,5,19
191108716,3,2,0,0,7,12
191108717,3,4,9,1,4,21
191108718,8,8,9,5,7,37
191108719,9,7,9,9,4,38
191108720,6,2,6,2,5,21
191108721,6,6,5,1,4,22
191108722,9,0,2,6,1,18
191108723,9,3,3,9,3,27
191108724,3,7,8,9,8,35
191108725,8,6,5,4,2,25
191108726,8,0,3,2,0,13
191108727,1,5,1,4,8,19
191108728,3,6,3,6,7,25
191108729,9,3,2,6,3,23
191108730,2,6,8,9,8,33
191108731,4,0,1,6,0,11
191108732,2,7,9,1,7,26
191108733,2,5,2,9,9,27
191108734,7,0,8,4,6,25
191108735,7,4,8,0,5,24
191108736,3,5,9,8,9,34
191108737,3,0,2,7,5,17
191108738,2,7,9,4,6,28
191108739,4,6,6,0,2,18
191108740,8,9,1,9,2,29
191108741,7,0,7,6,7,27
191108742,4,5,2,1,0,12
191108743,3,9,8,9,6,35
191108744,6,3,2,8,2,21
191108745,0,9,8,0,3,20
191108746,1,2,0,5,5,13
191108747,8,5,3,2,9,27
191108748,3,5,8,7,8,31
191108749,8,4,4,8,0,24
191108750,7,6,1,2,4,20
191108751,6,5,5,4,2,22
191108752,3,6,0,2,8,19
191108753,5,6,7,4,5,27
191108754,6,4,0,6,8,24
191108755,0,0,7,7,5,19
191108756,5,3,5,2,5,20
191108757,3,7,4,2,3,19
191108758,9,6,1,5,7,28
191108759,9,5,3,8,5,30
191108760,9,8,4,7,9,37
191108761,2,5,0,9,3,19
191108762,2,8,6,5,8,29
191108763,4,9,8,6,0,27
191108764,4,0,5,8,7,24
191108765,3,0,9,7,1,20
191108766,8,2,1,7,7,25
191108767,6,2,6,5,6,25
191108768,6,8,9,3,5,31
191108769,1,3,1,3,2,10
191108770,9,9,4,0,6,28
191108771,6,9,3,4,0,22
191108772,0,5,5,2,3,15
191108773,5,7,4,9,2,27
191108774,7,5,3,3,1,19
191108775,4,8,2,9,7,30
191108776,8,2,9,5,5,29
191108777,9,1,2,2,9,23
191108778,5,6,7,7,4,29
191108779,7,7,1,2,2,19
191108780,8,2,4,8,9,31
191108781,2,7,2,0,0,11
191108782,0,6,4,5,2,17
191108783,2,3,6,5,2,18
191108784,3,9,1,7,9,29
191108785,1,8,7,2,2,20
191108786,8,4,8,1,7,28
191108787,3,6,9,2,6,26
191108788,6,4,9,6,6,31
191108789,2,7,4,8,0,21
191108790,7,2,4,2,1,16
191108791,3,1,1,8,1,14
191108792,5,9,6,7,6,33
191108793,2,1,5,2,7,17
191108794,5,7,7,6,6,31
191108795,5,2,2,3,5,17
191108796,7,6,2,7,1,23
191108797,7,7,0,8,8,30
191108798,0,7,4,0,4,15
191108799,6,7,0,1,1,15
191108800,0,0,4,7,6,17
191108801,7,8,4,4,9,32
191108802,8,5,6,6,1,26
191108803,0,4,6,9,9,28
191108804,9,6,4,0,0,19
191108805,0,8,7,9,1,25
191108806,9,3,1,1,8,22
191108807,6,8,4,0,8,26
191108808,8,1,6,7,1,23
191108809,4,3,1,2,4,14
191108810,7,7,0,2,1,17
191108811,8,8,2,7,0,25
191108812,9,5,2,7,1,24
191108813,0,3,4,6,4,17
191108814,1,3,9,4,1,18
191108815,3,5,8,0,3,19
191108816,6,6,0,7,0,19
191108817,1,0,4,1,0,6
191108818,8,2,0,7,3,20
191108819,0,7,0,1,5,13
191108820,0,7,1,4,1,13
191108821,2,2,8,5,3,20
191108822,7,9,2,7,1,26
191108823,7,9,9,0,1,26
191108824,4,2,8,9,4,27
191108825,4,9,5,3,4,25
191108826,4,9,5,8,3,29
191108827,2,2,2,9,7,22
191108828,6,4,8,2,9,29
191108829,1,5,5,4,3,18
191108830,8,4,9,6,3,30
191108831,8,0,3,7,6,24
191108832,9,7,7,0,2,25
191108833,8,1,6,7,0,22
191108834,1,2,1,1,0,5
191108835,6,3,3,6,7,25
191108836,5,4,0,4,4,17
191108837,5,2,3,3,2,15
191108838,8,6,6,1,3,24
191108839,1,9,9,9,4,32
191108840,7,2,7,6,3,25
191108841,3,6,0,7,8,24
191108842,4,8,6,8,0,26
191108843,6,7,4,7,6,30
191108844,8,4,4,6,1,23
191108845,0,6,8,5,9,28
191108846,9,8,5,9,9,40
191108847,5,6,1,9,2,23
191108848,1,8,3,5,3,20
191108849,2,4,5,4,0,15
191108850,4,3,4,9,4,24
191108851,4,1,5,2,6,18
191108852,3,0,6,1,3,13
191108853,7,4,8,4,1,24
191108854,5,6,7,1,9,28
191108855,5,0,2,7,4,18
191108856,7,8,4,7,5,31
191108857,7,0,5,8,1,21
191108858,0,5,2,0,7,14
191108859,8,0,6,8,9,31
191108860,4,1,0,7,1,13
191108861,5,5,3,1,2,16
191108862,7,1,2,7,6,23
191108863,9,7,4,2,4,26
191108864,4,5,1,9,8,27
191108865,0,8,7,8,3,26
191108866,6,6,6,7,2,27
191108867,7,0,8,1,4,20
191108868,7,0,2,2,1,12
191108869,7,8,1,9,1,26
191108870,4,4,2,5,5,20
191108871,6,5,2,9,6,28
191108872,3,7,9,0,2,21
191108873,8,8,2,1,7,26
191108874,3,1,4,5,6,19
191108875,6,4,3,0,0,13
191108876,8,8,8,7,8,39
191108877,8,9,7,6,7,37
191108878,8,0,9,4,6,27
191108879,0,8,7,7,0,22
191108880,4,1,3,4,6,18
191108881,3,7,7,2,8,27
191108882,1,8,8,5,8,30
191108883,8,4,2,8,6,28
191108884,2,2,9,1,6,20
191108885,3,9,7,6,3,28
191108886,7,2,6,7,8,30
191108887,3,1,4,6,9,23
191108888,5,2,2,1,6,16
191108889,0,3,3,9,1,16
191108890,3,9,5,8,9,34
191108891,6,3,4,0,1,14
191108892,7,7,8,4,9,35
191108893,0,8,1,8,4,21
191108894,4,5,2,1,4,16
191108895,2,0,6,6,6,20
191108896,4,0,6,6,1,17
191108897,5,4,0,2,0,11
191108898,6,2,4,0,4,16
191108899,8,9,1,5,1,24
191108900,3,0,0,0,9,12
191108901,7,3,6,6,3,25
191108902,6,0,3,2,6,17
191108903,5,4,8,3,6,26
191108904,4,1,4,8,4,21
191108905,4,4,8,4,4,24
191108906,7,0,7,1,7,22
191108907,3,1,7,1,5,17
191108908,7,6,7,3,4,27
191108909,8,5,0,3,9,25
191108910,8,9,6,5,0,28
191108911,8,3,1,8,5,25
191108912,4,0,6,8,7,25
191108913,0,3,8,1,5,17
191108914,3,8,6,0,8,25
191108915,4,1,8,5,5,23
191108916,4,7,0,8,8,27
191108917,0,3,4,1,5,13
191108918,4,2,0,5,9,20
191108919,5,2,8,8,6,29
191108920,6,9,7,6,8,36
191108921,6,4,1,1,6,18
191108922,9,4,2,0,9,24
191108923,5,6,4,3,7,25
191108924,3,7,1,6,3,20
191108925,9,2,7,4,5,27
191108926,2,4,0,2,3,11
191108927,1,5,9,5,7,27
191108928,8,0,0,5,8,21
191108929,4,7,6,2,3,22
191108930,4,8,6,3,6,27
191108931,0,8,2,8,2,20
191108932,9,7,9,3,2,30
191108933,2,5,9,6,7,29
191108934,6,8,8,8,5,35
191108935,2,3,9,2,1,17
191108936,2,0,5,7,5,19
191108937,1,0,3,4,4,12
191108938,9,5,2,7,8,31
191108939,8,0,7,3,9,27
191108940,4,2,1,4,2,13
191108941,9,8,3,0,6,26
191108942,6,2,3,9,0,20
191108943,6,1,3,5,6,21
191108944,8,5,1,8,5,27
191108945,4,9,0,0,6,19
191108946,6,8,7,6,0,27
191108947,9,6,6,8,4,33
191108948,8,2,8,1,7,26
191108949,9,9,5,7,7,37
191108950,1,6,7,0,5,19
191108951,5,7,3,7,6,28
191108952,5,2,9,8,6,30
191108953,4,6,8,4,8,30
191108954,0,0,9,1,6,16
191108955,9,8,1,2,2,22
191108956,8,9,1,9,1,28
191108957,9,3,9,2,3,26
191108958,7,2,6,7,4,26
191108959,2,7,6,4,3,22
191108960,1,2,7,2,0,12
191108961,3,6,5,8,4,26
191108962,4,2,1,3,3,13
191108963,4,7,4,4,6,25
191108964,1,5,6,2,9,23
191108965,7,3,7,0,0,17
191108966,2,1,0,2,2,7
191108967,4,2,3,9,4,22
191108968,8,3,9,2,9,31
191108969,7,1,8,7,5,28
191108970,4,6,6,4,3,23
191108971,9,1,0,7,6,23
191108972,0,8,2,8,8,26
191108973,0,5,6,1,3,15
191108974,2,3,6,3,1,15
191108975,5,7,3,7,4,26
191108976,4,6,5,7,8,30
191108977,4,3,5,8,3,23
191108978,7,9,7,2,6,31
191108979,1,0,0,8,9,18
191108980,8,2,2,2,5,19
191108981,0,3,8,7,4,22
191108982,1,2,6,4,4,17
191108983,9,6,5,6,8,34
191108984,4,9,7,6,6,32
191108985,0,2,8,6,3,19
191108986,9,5,2,4,5,25
191108987,4,8,1,9,8,30
191108988,9,3,2,9,6,29
191108989,3,0,1,4,2,10
191108990,1,9,3,1,8,22
191108991,8,9,6,7,6,36
191108992,2,2,6,3,7,20
191108993,4,8,1,0,9,22
191108994,3,0,1,5,5,14
191108995,1,1,2,4,6,14
191108996,6,5,7,4,8,30
191108997,2,1,3,1,2,9
191108998,8,6,0,8,9,31
191108999,3,9,1,6,8,27
1911081000,8,6,4,9,6,33
1911081001,2,8,1,6,3,20
1911081002,3,2,4,7,7,23
1911081003,2,7,3,1,1,14
1911081004,3,2,3,8,2,18
1911081005,2,5,0,5,6,18
1911081006,6,6,2,2,0,16
1911081007,1,6,9,3,5,24
1911081008,7,8,4,5,5,29
1911081009,9,5,9,6,5,34
1911081010,9,0,7,5,5,26
1911081011,4,9,8,9,3,33
1911081012,7,4,8,0,8,27
1911081013,6,6,4,1,5,22
1911081014,1,6,9,5,4,25
1911081015,6,1,3,8,5,23
1911081016,4,8,8,2,8,30
1911081017,6,3,5,0,8,22
1911081018,9,5,0,8,2,24
1911081019,1,6,7,0,1,15
1911081020,2,7,9,6,0,24
1911081021,0,7,4,4,6,21
1911081022,9,9,6,4,4,32
1911081023,4,7,5,6,6,28
1911081024,4,3,9,1,0,17
1911081025,5,0,0,0,4,9
1911081026,7,2,2,0,4,15
1911081027,0,8,4,1,1,14
1911081028,1,9,8,9,9,36
1911081029,8,4,2,3,7,24
1911081030,0,5,1,9,5,20
1911081031,2,3,3,8,3,19
1911081032,5,3,6,5,8,27
1911081033,3,8,7,7,1,26
1911081034,6,3,9,5,9,32
1911081035,8,8,0,1,6,23
1911081036,5,0,4,9,6,24
1911081037,2,9,0,7,2,20
1911081038,2,1,3,9,6,21
1911081039,6,7,4,0,2,19
1911081040,6,9,4,1,5,25
1911081041,9,5,7,2,0,23
1911081042,6,5,4,0,2,17
1911081043,6,0,7,5,9,27
1911081044,0,7,5,0,7,19
1911081045,1,2,1,8,5,17
1911081046,0,9,0,6,6,21
1911081047,5,3,0,0,7,15
1911081048,3,2,7,7,7,26
1911081049,5,9,8,6,4,32
1911081050,1,0,4,4,5,14
1911081051,1,1,4,5,8,19
1911081052,2,6,7,0,9,24
1911081053,1,3,7,5,2,18
1911081054,7,1,0,3,3,14
1911081055,9,5,1,6,3,24
1911081056,1,7,0,6,1,15
1911081057,9,4,4,7,6,30
1911081058,9,0,4,7,1,21
1911081059,4,7,4,2,8,25
1911081060,6,3,5,0,0,14
1911081061,6,0,0,5,5,16
1911081062,3,1,0,1,9,14
1911081063,4,1,1,0,4,10
1911081064,7,8,8,1,5,29
1911081065,5,2,9,2,6,24
1911081066,1,9,9,4,4,27
1911081067,1,7,4,1,9,22
1911081068,3,3,8,2,2,18
1911081069,6,7,5,1,7,26
1911081070,7,4,4,4,3,22
1911081071,5,0,3,0,9,17
1911081072,1,5,4,6,6,22
1911081073,3,9,0,1,9,22
1911081074,0,9,4,9,8,30
1911081075,2,2,2,7,7,20
1911081076,5,6,4,2,9,26
1911081077,6,4,7,8,1,26
1911081078,4,6,3,0,8,21
1911081079,2,0,8,3,7,20
1911081080,8,6,8,4,2,28
1911081081,0,7,3,8,9,27
1911081082,4,3,8,8,9,32
1911081083,5,6,6,5,7,29
1911081084,5,4,6,0,0,15
1911081085,0,8,1,8,6,23
1911081086,9,2,2,2,8,23
1911081087,8,5,2,5,7,27
1911081088,2,9,5,6,1,23
1911081089,1,0,1,5,2,9
1911081090,0,2,1,3,1,7
1911081091,7,1,6,9,0,23
1911081092,7,0,3,6,5,21
1911081093,2,2,2,2,2,10
1911081094,3,2,9,8,2,24
1911081095,6,1,9,4,5,25
1911081096,8,5,4,7,4,28
1911081097,0,5,7,2,7,21
1911081098,1,0,7,8,0,16
1911081099,0,3,8,9,6,26
1911081100,3,8,6,9,4,30
1911081101,6,3,8,4,3,24
1911081102,1,1,8,6,6,22
1911081103,1,6,6,7,2,22
1911081104,8,8,7,3,7,33
1911081105,7,9,9,5,5,35
191109001,8,6,8,7,4,33
191109002,6,6,5,2,0,19
191109003,2,8,5,2,0,17
191109004,0,6,5,7,6,24
191109005,0,3,0,9,5,17
191109006,8,6,5,3,3,25
191109007,8,1,9,1,9,28
191109008,6,0,3,7,5,21
191109009,7,1,5,2,2,17
191109010,1,5,5,5,5,21
191109011,2,0,4,4,0,10
191109012,7,9,7,3,6,32
191109013,3,4,3,3,5,18
191109014,0,7,7,0,8,22
191109015,1,4,1,6,0,12
191109016,9,9,6,5,3,32
191109017,2,6,4,9,9,30
191109018,1,9,2,9,2,23
191109019,2,5,3,9,3,22
191109020,3,7,1,2,1,14
191109021,5,2,4,2,7,20
191109022,9,3,4,0,3,19
191109023,0,5,3,4,4,16
191109024,1,6,1,1,3,12
191109025,9,5,1,0,6,21
191109026,3,2,6,5,4,20
191109027,1,1,4,4,5,15
191109028,8,6,0,3,1,18
191109029,9,5,6,2,9,31
191109030,8,3,0,3,2,16
191109031,6,2,0,3,3,14
191109032,5,6,9,0,9,29
191109033,8,7,6,6,2,29
191109034,2,5,5,8,9,29
191109035,7,7,6,5,9,34
191109036,6,2,1,8,8,25
191109037,5,1,7,2,7,22
191109038,1,9,7,4,6,27
191109039,0,3,2,4,2,11
191109040,4,4,8,8,2,26
191109041,2,7,5,1,8,23
191109042,0,1,4,2,7,14
191109043,8,3,2,9,5,27
191109044,3,4,9,5,3,24
191109045,0,8,5,2,5,20
191109046,9,0,0,4,8,21
191109047,2,2,2,1,3,10
191109048,1,5,6,6,5,23
191109049,5,3,6,7,4,25
191109050,5,8,7,8,2,30
191109051,7,9,0,1,4,21
191109052,5,4,7,1,0,17
191109053,2,8,1,8,2,21
191109054,1,9,9,9,6,34
191109055,3,0,9,0,0,12
191109056,7,4,4,9,4,28
191109057,8,5,4,1,5,23
191109058,3,2,0,3,1,9
191109059,5,4,2,5,7,23
191109060,8,7,6,8,8,37
191109061,0,2,3,9,3,17
191109062,3,5,2,8,8,26
191109063,5,2,2,0,3,12
191109064,0,5,4,2,4,15
191109065,1,2,7,9,7,26
191109066,8,4,5,7,1,25
191109067,2,9,2,6,6,25
191109068,9,7,1,5,2,24
191109069,3,5,5,7,7,27
191109070,6,3,0,7,7,23
191109071,9,0,7,0,1,17
191109072,2,9,5,5,4,25
191109073,3,2,3,6,6,20
191109074,0,1,0,2,6,9
191109075,1,8,0,4,8,21
191109076,1,6,6,9,9,31
191109077,2,1,1,1,6,11
191109078,1,0,3,6,6,16
191109079,5,2,4,8,0,19
191109080,1,7,1,0,9,18
191109081,0,2,1,6,3,12
191109082,0,2,3,4,6,15
191109083,4,1,6,2,4,17
191109084,0,2,6,6,5,19
191109085,0,1,7,4,4,16
191109086,3,7,4,7,6,27
191109087,2,6,4,3,9,24
191109088,4,3,7,1,5,20
191109089,5,4,2,2,3,16
191109090,5,7,7,3,5,27
191109091,7,3,7,6,8,31
191109092,7,5,4,2,1,19
191109093,1,1,8,3,4,17
191109094,7,3,0,0,3,13
191109095,6,5,7,7,9,34
191109096,0,5,5,2,5,17
191109097,1,9,7,3,7,27
191109098,6,1,2,3,7,19
191109099,1,4,7,0,4,16
191109100,8,7,5,0,0,20
191109101,4,5,5,6,4,24
191109102,5,4,4,5,6,24
191109103,0,7,2,6,9,24
191109104,3,3,5,8,5,24
191109105,5,5,3,2,1,16
191109106,3,0,6,7,6,22
191109107,2,3,2,3,7,17
191109108,3,4,1,7,0,15
191109109,6,4,6,6,8,30
191109110,9,9,1,5,5,29
191109111,5,7,9,0,6,27
191109112,2,0,7,6,9,24
191109113,0,5,8,7,7,27
191109114,5,6,9,4,4,28
191109115,3,6,9,9,5,32
191109116,6,1,2,9,6,24
191109117,9,6,8,8,4,35
191109118,1,7,2,3,8,21
191109119,1,5,0,3,9,18
191109120,8,2,6,4,4,24
191109121,9,8,8,1,4,30
191109122,2,7,2,3,1,15
191109123,8,4,9,2,5,28
191109124,0,1,7,1,3,12
191109125,1,1,4,7,1,14
191109126,0,9,0,9,8,26
191109127,0,6,7,1,7,21
191109128,6,5,1,2,1,15
191109129,0,0,2,9,3,14
191109130,9,0,3,9,8,29
191109131,4,1,6,4,8,23
191109132,2,5,7,7,9,30
191109133,1,2,4,2,3,12
191109134,9,1,3,6,9,28
191109135,1,0,8,5,4,18
191109136,8,0,3,6,8,25
191109137,9,5,9,3,4,30
191109138,6,6,9,9,5,35
191109139,0,1,7,5,2,15
191109140,8,0,1,0,4,13
191109141,0,9,2,5,5,21
191109142,9,2,8,7,0,26
191109143,1,8,6,5,7,27
191109144,9,2,9,2,1,23
191109145,8,9,8,8,0,33
191109146,5,5,4,4,3,21
191109147,8,7,8,1,3,27
191109148,0,9,9,4,4,26
191109149,9,1,9,3,8,30
191109150,3,0,3,1,4,11
191109151,7,3,9,5,0,24
191109152,2,1,2,5,4,14
191109153,6,5,9,2,1,23
191109154,2,9,9,4,6,30
191109155,3,4,7,3,1,18
191109156,2,8,7,9,2,28
191109157,9,4,2,6,8,29
191109158,5,2,6,7,9,29
191109159,8,6,1,7,6,28
191109160,7,6,0,5,1,19
191109161,9,9,0,2,8,28
191109162,1,3,6,7,7,24
191109163,0,1,4,0,8,13
191109164,7,8,4,8,4,31
191109165,9,2,0,0,8,19
191109166,2,3,2,6,8,21
191109167,5,3,7,9,5,29
191109168,6,1,5,8,4,24
191109169,0,2,9,1,1,13
191109170,7,4,0,8,8,27
191109171,4,9,0,3,8,24
191109172,5,3,9,3,3,23
191109173,5,5,9,6,0,25
191109174,5,5,9,9,8,36
191109175,8,6,8,0,7,29
191109176,9,5,3,1,1,19
191109177,2,9,1,1,9,22
191109178,8,4,7,0,8,27
191109179,5,2,7,7,6,27
191109180,0,3,0,6,5,14
191109181,2,0,6,2,7,17
191109182,4,6,6,6,0,22
191109183,6,6,5,3,3,23
191109184,7,5,6,1,2,21
191109185,3,5,7,9,0,24
191109186,1,5,2,8,8,24
191109187,1,4,9,3,0,17
191109188,3,3,5,0,3,14
191109189,1,4,3,8,0,16
191109190,0,8,6,4,5,23
191109191,3,0,8,2,9,22
191109192,3,4,3,6,7,23
191109193,4,4,9,5,0,22
191109194,2,5,9,9,8,33
191109195,8,6,2,0,6,22
191109196,1,9,8,8,0,26
191109197,5,8,9,2,4,28
191109198,1,0,7,2,6,16
191109199,0,3,4,8,0,15
191109200,5,2,7,6,9,29
191109201,9,7,2,7,2,27
191109202,6,9,3,6,2,26
191109203,7,6,2,2,2,19
191109204,7,3,9,0,9,28
191109205,7,7,3,2,6,25
191109206,5,1,2,2,5,15
191109207,8,5,9,3,7,32
191109208,8,4,4,7,5,28
191109209,6,7,9,8,0,30
191109210,1,2,1,4,5,13
191109211,7,5,2,3,4,21
191109212,7,9,1,7,4,28
191109213,7,7,9,9,6,38
191109214,7,1,1,1,2,12
191109215,1,4,2,4,4,15
191109216,1,5,8,3,6,23
191109217,6,2,9,6,3,26
191109218,0,9,1,5,8,23
191109219,7,1,3,5,2,18
191109220,3,2,9,2,5,21
191109221,9,8,6,7,7,37
191109222,1,5,5,7,4,22
191109223,0,2,0,4,1,7
191109224,1,8,9,3,0,21
191109225,8,1,7,5,6,27
191109226,6,6,9,6,6,33
191109227,7,4,8,1,9,29
191109228,1,5,7,4,0,17
191109229,1,9,0,6,0,16
191109230,4,6,7,4,3,24
191109231,1,3,7,7,9,27
191109232,0,1,2,6,2,11
191109233,4,9,4,9,3,29
191109234,5,3,3,7,2,20
191109235,1,1,9,3,1,15
191109236,0,1,8,5,4,18
191109237,8,4,9,5,0,26
191109238,2,3,2,0,9,16
191109239,9,0,4,0,1,14
191109240,1,8,0,0,1,10
191109241,4,8,6,1,9,28
191109242,1,6,4,3,5,19
191109243,8,4,5,3,4,24
191109244,6,7,7,3,4,27
191109245,1,1,7,8,0,17
191109246,2,7,9,2,3,23
191109247,7,3,9,4,7,30
191109248,5,2,9,6,2,24
191109249,2,5,3,9,8,27
191109250,2,9,9,7,1,28
191109251,4,6,8,7,7,32
191109252,7,8,3,9,4,31
191109253,2,3,3,2,0,10
191109254,7,2,2,1,1,13
191109255,9,4,1,5,4,23
191109256,2,1,2,6,3,14
191109257,8,4,7,5,1,25
191109258,2,4,8,0,4,18
191109259,5,2,8,9,7,31
191109260,7,3,6,5,1,22
191109261,2,5,5,2,5,19
191109262,1,9,2,8,5,25
191109263,9,3,6,9,1,28
191109264,5,0,9,9,7,30
191109265,6,2,6,6,1,21
191109266,4,9,1,6,9,29
191109267,2,0,3,7,7,19
191109268,4,8,0,8,9,29
191109269,3,0,4,2,7,16
191109270,7,8,0,7,1,23
191109271,8,4,5,7,4,28
191109272,4,8,7,9,2,30
191109273,9,7,6,8,9,39
191109274,1,5,6,2,8,22
191109275,5,0,9,2,0,16
191109276,2,7,6,9,2,26
191109277,0,6,9,6,0,21
191109278,6,6,3,2,3,20
191109279,7,7,6,0,0,20
191109280,3,4,1,9,7,24
191109281,5,8,4,7,6,30
191109282,7,5,0,4,7,23
191109283,0,1,6,9,6,22
191109284,0,8,1,4,0,13
191109285,3,2,5,0,0,10
191109286,2,6,5,8,4,25
191109287,1,9,6,1,4,21
191109288,7,1,0,7,3,18
191109289,6,4,4,6,8,28
191109290,7,9,1,3,9,29
191109291,8,2,3,4,8,25
191109292,8,6,2,5,7,28
191109293,4,3,1,8,7,23
191109294,1,4,4,5,8,22
191109295,9,4,3,0,9,25
191109296,1,5,2,5,9,22
191109297,8,8,3,0,0,19
191109298,4,2,4,3,3,16
191109299,4,0,0,0,9,13
191109300,1,5,6,3,3,18
191109301,2,3,7,2,2,16
191109302,1,0,9,5,1,16
191109303,6,1,7,0,5,19
191109304,5,2,9,4,6,26
191109305,5,9,6,5,3,28
191109306,3,0,3,4,4,14
191109307,2,2,3,1,2,10
191109308,9,7,8,4,5,33
191109309,8,4,8,7,0,27
191109310,6,9,4,3,9,31
191109311,7,7,8,1,3,26
191109312,8,9,7,3,1,28
191109313,2,5,4,0,9,20
191109314,7,6,6,8,5,32
191109315,9,1,3,8,7,28
191109316,8,6,0,0,7,21
191109317,5,1,4,7,7,24
191109318,1,4,9,2,1,17
191109319,2,6,7,1,2,18
191109320,6,3,5,7,7,28
191109321,0,3,3,5,5,16
191109322,9,1,5,5,4,24
191109323,6,3,5,3,8,25
191109324,4,9,4,5,3,25
191109325,5,4,4,1,5,19
191109326,6,4,5,2,9,26
191109327,6,7,6,0,2,21
191109328,3,3,2,0,1,9
191109329,2,5,9,9,7,32
191109330,5,9,0,8,1,23
191109331,9,2,2,6,8,27
191109332,3,4,8,2,0,17
191109333,8,2,8,3,4,25
191109334,2,7,5,1,0,15
191109335,3,7,2,9,3,24
191109336,0,5,0,0,4,9
191109337,1,0,1,0,7,9
191109338,1,7,1,1,1,11
191109339,3,6,0,5,8,22
191109340,5,1,6,3,1,16
191109341,7,4,4,5,5,25
191109342,3,2,1,2,7,15
191109343,3,0,7,5,8,23
191109344,2,4,7,8,7,28
191109345,5,9,1,7,8,30
191109346,4,8,8,3,2,25
191109347,2,2,7,0,7,18
191109348,8,3,9,1,7,28
191109349,7,9,2,5,9,32
191109350,2,2,3,8,2,17
191109351,2,0,5,9,0,16
191109352,3,3,9,4,1,20
191109353,6,6,2,5,0,19
191109354,8,2,3,7,2,22
191109355,4,2,1,5,0,12
191109356,2,2,0,3,5,12
191109357,7,2,9,4,7,29
191109358,0,5,3,3,8,19
191109359,4,1,7,5,1,18
191109360,0,0,0,1,8,9
191109361,1,5,0,4,5,15
191109362,8,9,2,9,1,29
191109363,4,3,0,7,1,15
191109364,9,6,3,9,0,27
191109365,4,2,3,8,8,25
191109366,7,2,3,8,1,21
191109367,6,8,3,1,4,22
191109368,3,2,7,6,9,27
191109369,2,3,6,7,9,27
191109370,3,4,3,4,5,19
191109371,9,2,2,9,5,27
191109372,6,5,9,6,9,35
191109373,9,1,5,4,3,22
191109374,7,3,4,3,4,21
191109375,5,4,2,1,5,17
191109376,7,2,0,3,5,17
191109377,4,1,9,9,1,24
191109378,9,8,3,0,3,23
191109379,3,3,7,9,7,29
191109380,8,9,4,8,3,32
191109381,0,5,9,5,6,25
191109382,3,2,9,5,4,23
191109383,9,6,7,1,6,29
191109384,0,9,7,7,1,24
191109385,0,7,7,1,1,16
191109386,0,7,8,0,3,18
191109387,6,2,5,3,6,22
191109388,1,1,4,8,9,23
191109389,4,3,1,3,9,20
191109390,7,3,8,9,3,30
191109391,9,2,6,7,3,27
191109392,8,0,3,8,0,19
191109393,1,6,2,9,3,21
191109394,6,7,7,6,8,34
191109395,8,5,5,5,8,31
191109396,0,2,2,9,3,16
191109397,2,5,9,6,6,28
191109398,0,5,7,9,5,26
191109399,5,8,9,5,7,34
191109400,3,6,8,1,8,26
191109401,1,8,3,6,6,24
191109402,1,9,3,9,3,25
191109403,9,4,5,0,5,23
191109404,7,0,1,3,6,17
191109405,1,1,0,6,2,10
191109406,5,7,7,4,3,26
191109407,2,4,6,0,8,20
191109408,7,0,1,7,5,20
191109409,6,6,3,3,4,22
191109410,4,1,4,8,8,25
191109411,9,1,8,8,9,35
191109412,2,1,7,4,9,23
191109413,1,4,5,7,4,21
191109414,8,2,0,6,4,20
191109415,1,4,4,4,9,22
191109416,9,5,7,9,9,39
191109417,4,2,4,8,0,18
191109418,4,9,1,4,0,18
191109419,2,8,2,3,3,18
191109420,7,1,7,8,0,23
191109421,2,4,6,0,2,14
191109422,5,4,6,9,6,30
191109423,4,6,4,6,4,24
191109424,2,9,0,9,8,28
191109425,7,7,1,8,4,27
191109426,8,3,6,7,5,29
191109427,4,1,5,4,8,22
191109428,6,9,1,2,2,20
191109429,9,1,8,4,6,28
191109430,5,3,7,0,3,18
191109431,3,6,6,6,9,30
191109432,6,1,9,7,8,31
191109433,2,7,2,1,8,20
191109434,6,7,7,8,7,35
191109435,1,6,6,3,8,24
191109436,3,7,7,2,4,23
191109437,9,8,1,8,0,26
191109438,9,2,2,4,8,25
191109439,6,4,1,4,9,24
191109440,5,0,5,8,5,23
191109441,7,5,4,6,1,23
191109442,5,5,7,2,2,21
191109443,2,9,1,5,4,21
191109444,4,5,4,5,0,18
191109445,1,8,5,3,5,22
191109446,1,7,4,3,1,16
191109447,3,0,4,2,3,12
191109448,2,5,3,3,8,21
191109449,1,2,7,7,5,22
191109450,9,4,4,1,0,18
191109451,6,9,1,2,0,18
191109452,8,0,4,0,3,15
191109453,1,6,0,9,6,22
191109454,1,5,3,5,1,15
191109455,6,2,0,8,0,16
191109456,0,3,8,2,9,22
191109457,6,2,1,9,2,20
191109458,1,9,7,5,6,28
191109459,1,0,0,3,4,8
191109460,6,0,0,1,6,13
191109461,1,8,0,0,9,18
191109462,6,7,3,5,3,24
191109463,9,3,2,3,2,19
191109464,7,4,9,4,3,27
191109465,2,3,7,8,6,26
191109466,8,5,4,8,3,28
191109467,3,3,5,5,6,22
191109468,3,9,5,3,3,23
191109469,1,7,3,4,9,24
191109470,4,9,8,8,0,29
191109471,5,5,5,1,2,18
191109472,4,7,6,5,5,27
191109473,2,5,9,7,0,23
191109474,2,2,6,0,5,15
191109475,0,1,1,4,2,8
191109476,1,2,8,4,3,18
191109477,4,8,1,8,4,25
191109478,7,6,7,0,9,29
191109479,6,4,6,5,4,25
191109480,0,5,9,9,7,30
191109481,4,1,1,5,7,18
191109482,6,7,5,8,8,34
191109483,1,3,7,8,2,21
191109484,8,8,2,8,7,33
191109485,2,9,4,9,2,26
191109486,2,5,3,3,6,19
191109487,8,2,8,4,7,29
191109488,0,7,4,5,3,19
191109489,6,2,3,2,5,18
191109490,3,5,2,6,2,18
191109491,2,8,5,2,1,18
191109492,2,8,0,8,2,20
191109493,8,0,2,5,1,16
191109494,5,5,0,7,7,24
191109495,4,4,8,6,4,26
191109496,2,6,7,9,6,30
191109497,8,2,8,5,2,25
191109498,6,1,0,5,5,17
191109499,1,1,7,9,7,25
191109500,7,3,4,1,3,18
191109501,4,4,0,0,8,16
191109502,7,0,7,6,5,25
191109503,7,0,6,3,4,20
191109504,3,2,6,9,5,25
191109505,2,1,6,2,3,14
191109506,5,4,2,1,6,18
191109507,1,6,4,6,2,19
191109508,4,2,3,3,1,13
191109509,2,8,8,7,9,34
191109510,0,7,6,8,4,25
191109511,9,3,5,0,3,20
191109512,0,3,4,4,9,20
191109513,3,1,1,1,9,15
191109514,6,3,2,5,7,23
191109515,7,5,9,3,0,24
191109516,7,5,2,1,5,20
191109517,7,9,3,4,4,27
191109518,9,2,3,3,5,22
191109519,3,1,3,9,6,22
191109520,5,5,3,6,0,19
191109521,1,4,9,5,0,19
191109522,4,0,8,7,3,22
191109523,3,1,6,3,4,17
191109524,0,6,1,6,8,21
191109525,0,7,2,8,0,17
191109526,6,0,7,6,3,22
191109527,8,6,2,6,4,26
191109528,0,3,3,5,8,19
191109529,4,2,3,0,5,14
191109530,9,1,1,7,8,26
191109531,2,2,8,3,2,17
191109532,8,9,2,4,4,27
191109533,4,6,2,6,9,27
191109534,3,0,1,0,7,11
191109535,3,9,8,8,0,28
191109536,5,0,3,0,5,13
191109537,9,5,4,6,4,28
191109538,2,0,5,7,8,22
191109539,8,4,2,3,2,19
191109540,1,2,6,2,7,18
191109541,0,8,0,3,9,20
191109542,3,1,7,3,8,22
191109543,5,4,9,7,6,31
191109544,6,8,8,8,6,36
191109545,9,6,4,9,3,31
191109546,8,1,9,1,5,24
191109547,0,2,7,4,7,20
191109548,3,6,1,3,4,17
191109549,7,9,2,9,9,36
191109550,6,7,2,3,3,21
191109551,0,1,4,7,0,12
191109552,4,3,3,0,5,15
191109553,0,5,5,3,1,14
191109554,7,4,2,9,6,28
191109555,7,9,4,3,2,25
191109556,8,0,9,6,7,30
191109557,8,1,0,4,6,19
191109558,9,1,2,6,1,19
191109559,0,3,6,9,5,23
191109560,4,9,0,6,1,20
191109561,7,7,9,7,0,30
191109562,3,4,7,8,9,31
191109563,5,2,7,9,4,27
191109564,4,3,8,5,0,20
191109565,4,0,2,5,4,15
191109566,5,0,7,7,2,21
191109567,5,9,4,4,9,31
191109568,2,0,6,8,3,19
191109569,4,6,0,0,2,12
191109570,6,2,3,4,5,20
191109571,8,1,9,0,6,24
191109572,0,0,9,3,6,18
191109573,9,7,9,6,6,37
191109574,2,1,3,4,6,16
191109575,0,0,1,6,5,12
191109576,9,9,0,5,6,29
191109577,4,5,1,1,8,19
191109578,9,4,6,7,4,30
191109579,3,5,5,9,0,22
191109580,5,8,0,5,9,27
191109581,9,8,7,4,0,28
191109582,7,3,7,5,6,28
191109583,2,1,9,5,3,20
191109584,2,7,2,9,3,23
191109585,5,6,6,8,4,29
191109586,3,6,8,8,0,25
191109587,9,1,2,4,6,22
191109588,7,9,1,0,2,19
191109589,8,5,8,4,6,31
191109590,0,9,5,2,8,24
191109591,0,9,2,1,8,20
191109592,8,5,6,9,6,34
191109593,1,9,5,2,5,22
191109594,0,7,5,6,5,23
191109595,4,8,8,9,1,30
191109596,1,2,0,1,4,8
191109597,7,3,9,8,1,28
191109598,2,4,2,8,6,22
191109599,6,9,5,7,1,28
191109600,1,7,0,2,0,10
191109601,6,2,0,4,9,21
191109602,0,7,5,7,4,23
191109603,6,1,8,6,3,24
191109604,6,2,0,5,6,19
191109605,6,3,9,7,2,27
191109606,7,5,6,6,2,26
191109607,5,2,1,6,9,23
191109608,4,9,4,1,5,23
191109609,3,1,8,7,2,21
191109610,4,8,1,0,2,15
191109611,8,1,7,6,3,25
191109612,1,8,3,9,3,24
191109613,6,6,2,1,9,24
191109614,7,9,2,2,4,24
191109615,8,2,6,9,4,29
191109616,0,5,7,0,8,20
191109617,5,6,9,8,6,34
191109618,7,3,0,2,5,17
191109619,1,7,1,3,9,21
191109620,5,6,2,4,1,18
191109621,3,2,5,7,5,22
191109622,9,2,8,7,7,33
191109623,4,3,5,9,5,26
191109624,2,2,0,2,3,9
191109625,4,0,0,0,3,7
191109626,6,7,8,5,0,26
191109627,7,5,7,3,5,27
191109628,8,7,4,2,3,24
191109629,2,6,3,0,3,14
191109630,4,2,4,2,1,13
191109631,8,8,7,3,4,30
191109632,8,1,1,1,7,18
191109633,1,0,9,7,0,17
191109634,1,2,4,6,4,17
191109635,4,2,4,3,6,19
191109636,5,5,7,4,7,28
191109637,3,3,1,5,8,20
191109638,3,6,8,5,9,31
191109639,3,0,8,8,0,19
191109640,5,0,5,9,0,19
191109641,4,5,1,9,2,21
191109642,4,9,3,7,3,26
191109643,3,1,9,9,2,24
191109644,8,0,1,5,0,14
191109645,9,0,0,2,9,20
191109646,5,5,0,7,6,23
191109647,3,3,7,1,9,23
191109648,6,3,3,5,8,25
191109649,7,9,4,2,9,31
191109650,5,0,4,5,6,20
191109651,5,7,2,8,2,24
191109652,4,3,0,1,9,17
191109653,2,0,6,7,9,24
191109654,3,5,3,2,8,21
191109655,3,9,0,1,3,16
191109656,9,9,8,1,6,33
191109657,6,3,0,1,6,16
191109658,6,0,0,2,0,8
191109659,0,5,7,7,6,25
191109660,5,1,5,0,5,16
191109661,0,2,1,6,6,15
191109662,1,2,5,1,6,15
191109663,4,6,9,5,3,27
191109664,6,2,0,4,4,16
191109665,3,2,3,5,3,16
191109666,8,7,7,7,4,33
191109667,5,8,5,9,1,28
191109668,5,3,1,5,9,23
191109669,1,4,1,7,6,19
191109670,0,9,7,5,6,27
191109671,5,6,4,2,1,18
191109672,8,2,1,2,5,18
191109673,6,6,1,5,0,18
191109674,0,7,3,7,8,25
191109675,6,3,4,3,2,18
191109676,9,1,9,2,4,25
191109677,2,1,7,0,0,10
191109678,8,4,5,5,0,22
191109679,3,3,5,5,9,25
191109680,3,8,4,3,6,24
191109681,9,8,2,4,4,27
191109682,3,1,6,5,5,20
191109683,6,9,0,5,3,23
191109684,5,5,9,4,6,29
191109685,1,1,0,3,5,10
191109686,5,9,8,2,4,28
191109687,3,6,6,7,0,22
191109688,6,7,2,1,5,21
191109689,8,0,0,2,2,12
191109690,3,0,5,7,9,24
191109691,8,3,6,0,4,21
191109692,5,3,8,8,7,31
191109693,3,2,1,9,9,24
191109694,3,1,5,0,0,9
191109695,5,0,3,6,7,21
191109696,9,3,8,1,0,21
191109697,0,3,0,1,3,7
191109698,2,9,9,5,0,25
191109699,3,1,7,4,7,22
191109700,8,2,3,0,0,13
191109701,1,2,9,2,6,20
191109702,3,8,0,2,2,15
191109703,3,4,0,1,0,8
191109704,1,0,5,5,3,14
191109705,8,1,9,3,1,22
191109706,7,7,2,6,5,27
191109707,8,6,2,8,2,26
191109708,9,2,9,6,1,27
191109709,1,5,7,1,0,14
191109710,9,0,9,7,2,27
191109711,2,7,6,3,0,18
191109712,2,3,8,8,2,23
191109713,1,4,1,1,6,13
191109714,3,9,6,5,8,31
191109715,8,4,6,8,1,27
191109716,2,3,2,0,8,15
191109717,8,4,0,9,1,22
191109718,1,7,5,3,0,16
191109719,7,9,4,2,1,23
191109720,5,2,8,4,0,19
191109721,5,6,0,1,8,20
191109722,4,9,7,9,5,34
191109723,2,5,1,2,6,16
191109724,5,7,1,0,9,22
191109725,8,7,1,0,1,17
191109726,1,2,2,2,0,7
191109727,1,1,4,9,2,17
191109728,8,9,1,2,7,27
191109729,8,7,4,8,0,27
191109730,2,5,7,1,8,23
191109731,2,1,8,8,2,21
191109732,7,4,6,3,6,26
191109733,3,6,9,3,4,25
191109734,0,3,1,1,4,9
191109735,5,8,8,6,6,33
191109736,1,6,4,3,7,21
191109737,9,0,1,3,2,15
191109738,0,1,9,9,8,27
191109739,9,9,5,7,0,30
191109740,3,5,8,7,4,27
191109741,6,7,5,2,6,26
191109742,6,7,9,2,6,30
191109743,9,2,9,6,3,29
191109744,6,8,6,9,6,35
191109745,1,6,0,8,6,21
191109746,5,0,3,7,6,21
191109747,9,7,2,0,5,23
191109748,0,9,3,4,3,19
191109749,6,4,4,7,8,29
191109750,6,2,1,4,4,17
191109751,1,5,2,3,5,16
191109752,0,9,9,2,1,21
191109753,7,5,9,7,2,30
191109754,7,6,3,2,9,27
191109755,9,8,6,2,9,34
191109756,9,0,2,6,8,25
191109757,2,5,2,4,0,13
191109758,2,3,5,4,4,18
191109759,5,5,5,0,7,22
191109760,3,9,6,2,2,22
191109761,4,2,2,2,5,15
191109762,3,4,2,0,5,14
191109763,7,7,8,2,8,32
191109764,2,2,5,4,1,14
191109765,8,3,5,4,3,23
191109766,6,4,8,3,0,21
191109767,7,8,1,4,8,28
191109768,8,4,1,8,0,21
191109769,6,6,9,1,0,22
191109770,7,1,6,6,9,29
191109771,0,1,0,5,2,8
191109772,8,9,5,9,8,39
191109773,3,0,8,3,9,23
191109774,8,8,7,1,6,30
191109775,0,7,2,0,7,16
191109776,1,6,6,6,3,22
191109777,5,0,8,8,1,22
191109778,1,5,0,4,4,14
191109779,2,0,3,4,6,15
191109780,2,3,2,3,3,13
191109781,2,8,2,1,3,16
191109782,4,6,4,5,0,19
191109783,7,2,8,0,6,23
191109784,5,0,6,6,5,22
191109785,3,1,4,8,6,22
191109786,9,8,5,1,9,32
191109787,4,8,6,0,8,26
191109788,0,4,7,3,7,21
191109789,2,7,6,7,4,26
191109790,2,9,1,5,3,20
191109791,3,0,2,5,3,13
191109792,1,8,5,8,0,22
191109793,7,4,6,3,3,23
191109794,6,8,6,2,9,31
191109795,3,9,5,1,4,22
191109796,0,7,0,8,4,19
191109797,2,0,7,3,3,15
191109798,4,9,9,6,7,35
191109799,2,5,7,3,5,22
191109800,2,3,8,0,8,21
191109801,1,4,1,5,3,14
191109802,2,2,5,6,4,19
191109803,3,0,9,7,9,28
191109804,9,5,3,5,9,31
191109805,2,3,8,3,1,17
191109806,8,4,2,0,7,21
191109807,5,1,7,7,1,21
191109808,2,0,2,2,6,12
191109809,9,3,9,9,3,33
191109810,1,2,9,1,2,15
191109811,9,0,3,5,0,17
191109812,5,1,2,8,2,18
191109813,7,9,4,8,1,29
191109814,4,5,4,8,5,26
191109815,6,5,1,9,4,25
191109816,2,4,6,3,1,16
191109817,9,6,3,4,4,26
191109818,2,6,5,1,2,16
191109819,1,9,8,2,5,25
191109820,9,9,5,5,6,34
191109821,7,2,6,2,1,18
191109822,8,3,5,4,7,27
191109823,6,5,6,1,9,27
191109824,2,9,5,5,3,24
191109825,4,9,7,7,0,27
191109826,9,6,8,6,4,33
191109827,0,6,7,7,1,21
191109828,2,5,2,2,3,14
191109829,7,2,6,6,6,27
191109830,8,2,9,5,7,31
191109831,2,6,9,9,6,32
191109832,7,9,2,8,9,35
191109833,3,2,2,4,4,15
191109834,7,7,0,1,4,19
191109835,4,3,0,4,7,18
191109836,3,5,9,5,9,31
191109837,3,9,3,9,5,29
191109838,5,6,8,0,6,25
191109839,8,9,7,6,4,34
191109840,3,6,7,5,6,27
191109841,3,4,9,0,0,16
191109842,6,4,1,1,7,19
191109843,7,8,2,2,4,23
191109844,3,7,1,5,4,20
191109845,6,6,9,5,7,33
191109846,4,5,0,2,6,17
191109847,9,3,2,8,0,22
191109848,8,8,3,8,0,27
191109849,3,2,9,5,5,24
191109850,2,4,4,3,8,21
191109851,1,1,5,8,2,17
191109852,5,2,3,6,2,18
191109853,5,2,7,0,0,14
191109854,9,4,7,3,8,31
191109855,6,8,2,8,2,26
191109856,0,8,0,5,5,18
191109857,8,1,6,6,0,21
191109858,1,3,0,2,2,8
191109859,7,1,8,4,7,27
191109860,2,1,4,3,0,10
191109861,8,1,8,1,6,24
191109862,3,7,7,6,1,24
191109863,1,3,5,7,6,22
191109864,7,3,9,9,4,32
191109865,4,3,5,5,5,22
191109866,8,4,9,0,3,24
191109867,5,0,3,0,0,8
191109868,5,3,5,5,7,25
191109869,1,1,0,8,7,17
191109870,1,7,7,1,2,18
191109871,2,8,4,4,1,19
191109872,3,2,8,8,8,29
191109873,8,7,9,0,0,24
191109874,5,9,6,3,1,24
191109875,0,5,4,2,8,19
191109876,9,5,6,7,8,35
191109877,4,8,9,8,2,31
191109878,3,2,0,5,1,11
191109879,1,9,1,1,8,20
191109880,7,0,0,0,2,9
191109881,0,0,1,9,4,14
191109882,5,8,9,8,8,38
191109883,8,0,6,9,0,23
191109884,0,5,3,3,5,16
191109885,8,9,0,1,9,27
191109886,9,8,0,2,5,24
191109887,1,5,8,0,0,14
191109888,0,0,4,6,0,10
191109889,5,4,2,3,6,20
191109890,5,8,7,7,6,33
191109891,5,9,2,0,4,20
191109892,7,2,5,5,5,24
191109893,1,3,2,2,1,9
191109894,8,4,5,8,6,31
191109895,8,6,4,2,5,25
191109896,4,4,9,9,6,32
191109897,1,0,5,8,9,23
191109898,3,9,1,0,2,15
191109899,9,3,9,8,2,31
191109900,1,1,8,0,8,18
191109901,3,6,7,4,5,25
191109902,3,7,5,8,8,31
191109903,6,8,7,7,5,33
191109904,3,3,5,6,6,23
191109905,8,4,7,5,2,26
191109906,2,4,4,8,3,21
191109907,4,6,4,7,0,21
191109908,4,8,3,6,3,24
191109909,2,6,8,3,8,27
191109910,3,5,5,1,5,19
191109911,2,6,8,0,4,20
191109912,3,1,5,2,3,14
191109913,9,4,3,4,5,25
191109914,1,3,0,6,6,16
191109915,0,3,5,9,2,19
191109916,3,4,5,0,9,21
191109917,4,2,3,6,4,19
191109918,4,6,8,6,8,32
191109919,9,5,1,1,5,21
191109920,2,7,4,4,9,26
191109921,1,7,6,3,7,24
191109922,8,7,7,7,0,29
191109923,5,7,6,1,8,27
191109924,5,5,0,4,1,15
191109925,5,7,3,2,9,26
191109926,5,2,8,6,6,27
191109927,2,1,6,1,3,13
191109928,9,6,2,5,8,30
191109929,7,0,7,9,0,23
191109930,8,2,3,0,3,16
191109931,5,2,8,1,6,22
191109932,7,7,7,1,7,29
191109933,0,1,2,8,4,15
191109934,1,4,8,9,8,30
191109935,0,3,7,6,3,19
191109936,8,9,9,8,3,37
191109937,0,1,6,8,0,15
191109938,8,6,5,6,2,27
191109939,4,5,0,7,5,21
191109940,3,3,5,9,7,27
191109941,3,4,2,3,5,17
191109942,4,6,8,2,6,26
191109943,3,7,5,0,7,22
191109944,3,2,9,5,6,25
191109945,4,6,6,0,3,19
191109946,9,7,4,6,8,34
191109947,4,7,9,6,3,29
191109948,4,3,0,3,7,17
191109949,5,0,7,7,9,28
191109950,5,5,8,8,2,28
191109951,4,7,3,1,4,19
191109952,6,6,6,0,7,25
191109953,8,2,2,5,5,22
191109954,2,3,0,1,9,15
191109955,4,2,1,7,8,22
191109956,4,2,0,2,3,11
191109957,1,8,2,2,1,14
191109958,5,3,4,5,9,26
191109959,4,5,4,1,4,18
191109960,7,0,6,6,7,26
191109961,9,2,9,4,7,31
191109962,1,6,1,2,5,15
191109963,1,8,1,0,1,11
191109964,0,8,0,9,7,24
191109965,6,0,4,3,4,17
191109966,5,5,4,6,4,24
191109967,3,9,2,3,6,23
191109968,3,0,8,0,6,17
191109969,9,9,7,9,6,40
191109970,8,1,1,2,8,20
191109971,6,9,9,5,6,35
191109972,9,2,7,0,7,25
191109973,8,2,9,4,4,27
191109974,3,2,1,7,1,14
191109975,3,8,3,6,4,24
191109976,6,5,9,8,9,37
191109977,7,9,2,7,4,29
191109978,9,5,0,4,3,21
191109979,8,5,8,8,1,30
191109980,5,6,5,4,1,21
191109981,2,9,0,7,0,18
191109982,6,2,0,2,8,18
191109983,6,8,0,5,9,28
191109984,4,8,2,3,2,19
191109985,7,7,4,5,2,25
191109986,3,8,9,3,4,27
191109987,0,4,7,6,1,18
191109988,2,1,2,0,6,11
191109989,2,9,4,7,7,29
191109990,4,7,7,2,9,29
191109991,0,9,4,7,6,26
191109992,6,5,0,1,9,21
191109993,1,4,9,3,1,18
191109994,6,8,9,2,3,28
191109995,3,4,5,1,8,21
191109996,2,2,9,7,0,20
191109997,9,1,9,5,7,31
191109998,4,0,4,6,4,18
191109999,4,5,3,5,3,20
1911091000,2,6,2,2,5,17
1911091001,1,3,6,7,3,20
1911091002,3,2,6,4,6,21
1911091003,3,1,3,6,2,15
1911091004,4,7,3,8,6,28
1911091005,1,2,7,0,3,13
1911091006,8,7,4,3,1,23
1911091007,3,1,8,0,4,16
1911091008,5,4,2,4,7,22
1911091009,2,2,7,4,6,21
1911091010,4,0,5,6,7,22
1911091011,1,3,4,2,1,11
1911091012,4,8,2,5,8,27
1911091013,0,8,5,6,8,27
1911091014,2,7,4,0,0,13
1911091015,6,3,5,3,3,20
1911091016,8,0,7,4,7,26
1911091017,2,5,7,9,9,32
1911091018,6,3,4,5,3,21
1911091019,8,9,2,9,3,31
1911091020,2,3,0,1,7,13
1911091021,3,4,9,4,0,20
1911091022,1,4,3,0,5,13
1911091023,8,5,4,4,2,23
1911091024,3,0,7,3,4,17
1911091025,9,2,2,2,7,22
1911091026,1,1,7,1,1,11
1911091027,9,0,7,0,5,21
1911091028,0,5,4,4,4,17
1911091029,6,5,2,3,3,19
1911091030,0,2,0,7,0,9
1911091031,0,6,7,9,6,28
1911091032,3,5,0,9,4,21
1911091033,6,1,0,3,4,14
1911091034,4,3,1,1,9,18
1911091035,5,8,7,7,5,32
1911091036,9,2,4,3,0,18
1911091037,7,4,0,9,7,27
1911091038,0,4,4,7,2,17
1911091039,0,9,5,1,6,21
1911091040,7,6,2,5,4,24
1911091041,8,8,6,4,9,35
1911091042,5,0,5,3,1,14
1911091043,2,1,2,7,4,16
1911091044,2,8,3,4,0,17
1911091045,6,9,7,4,6,32
1911091046,6,1,4,8,8,27
1911091047,8,6,8,4,3,29
1911091048,9,2,5,0,5,21
1911091049,0,8,8,6,6,28
1911091050,5,3,0,8,8,24
1911091051,9,5,1,9,3,27
1911091052,0,0,6,4,3,13
1911091053,3,5,1,6,8,23
1911091054,7,7,6,0,1,21
1911091055,7,7,3,7,7,31
1911091056,3,8,3,0,0,14
1911091057,2,9,5,7,7,30
1911091058,1,2,3,5,8,19
1911091059,6,2,5,1,5,19
1911091060,5,0,4,5,1,15
1911091061,0,4,3,3,5,15
1911091062,8,4,1,5,6,24
1911091063,4,2,2,3,3,14
1911091064,9,6,9,0,0,24
1911091065,8,3,8,6,1,26
1911091066,1,2,9,2,8,22
1911091067,4,3,9,0,5,21
1911091068,2,5,2,3,8,20
1911091069,9,6,4,4,8,31
1911091070,7,9,3,3,7,29
1911091071,4,1,6,9,0,20
1911091072,2,6,9,2,1,20
1911091073,1,6,9,1,9,26
1911091074,0,0,0,4,8,12
1911091075,1,9,4,2,6,22
1911091076,9,5,0,0,4,18
1911091077,2,2,3,4,9,20
1911091078,7,4,8,6,4,29
1911091079,6,9,3,5,8,31
1911091080,2,3,9,8,9,31
1911091081,8,2,1,4,3,18
1911091082,4,0,7,1,3,15
1911091083,9,4,0,6,9,28
1911091084,5,6,2,6,0,19
1911091085,8,3,9,5,1,26
1911091086,4,7,8,9,1,29
1911091087,2,5,8,4,1,20
1911091088,9,7,5,3,2,26
1911091089,9,5,9,7,4,34
1911091090,0,3,1,0,2,6
1911091091,9,9,9,4,8,39
1911091092,2,5,9,3,4,23
1911091093,6,9,9,8,0,32
1911091094,6,9,6,8,0,29
1911091095,4,5,6,6,7,28
1911091096,8,4,0,3,3,18
1911091097,6,9,3,5,0,23
1911091098,7,6,5,2,4,24
1911091099,8,8,1,4,4,25
1911091100,7,7,2,7,2,25
1911091101,8,0,8,3,9,28
1911091102,6,1,1,7,7,22
1911091103,6,7,6,3,7,29
1911091104,1,6,5,8,5,25
1911091105,4,1,7,1,9,22
191110001,3,7,4,6,8,28
191110002,0,3,9,1,4,17
191110003,6,5,5,2,4,22
191110004,4,0,7,7,7,25
191110005,4,0,1,2,2,9
191110006,5,7,6,2,3,23
191110007,1,1,4,0,5,11
191110008,3,4,5,5,1,18
191110009,0,2,5,1,7,15
191110010,2,1,6,8,1,18
191110011,8,7,2,9,1,27
191110012,3,7,4,2,9,25
191110013,3,5,7,5,1,21
191110014,3,7,0,9,5,24
191110015,5,9,1,9,1,25
191110016,1,6,4,4,0,15
191110017,1,0,4,8,5,18
191110018,3,3,3,7,2,18
191110019,7,0,4,3,6,20
191110020,6,6,9,3,4,28
191110021,0,8,5,3,5,21
191110022,9,9,4,8,9,39
191110023,1,5,5,9,5,25
191110024,7,4,0,9,5,25
191110025,1,0,2,9,7,19
191110026,3,2,8,1,3,17
191110027,4,7,9,3,5,28
191110028,7,6,4,2,1,20
191110029,8,5,9,3,6,31
191110030,8,6,5,6,0,25
191110031,0,9,1,0,9,19
191110032,3,2,3,4,1,13
191110033,7,7,0,2,8,24
191110034,8,4,4,5,2,23
191110035,2,8,2,3,7,22
191110036,4,9,0,4,2,19
191110037,1,8,2,2,6,19
191110038,1,0,8,6,8,23
191110039,8,2,9,6,2,27
191110040,0,6,7,6,9,28
191110041,0,7,1,6,0,14
191110042,7,2,3,2,2,16
191110043,0,5,1,5,6,17
191110044,2,0,0,7,9,18
191110045,3,3,4,8,1,19
191110046,5,0,9,0,5,19
191110047,7,7,0,6,2,22
191110048,6,8,6,8,3,31
191110049,8,1,2,7,0,18
191110050,1,3,4,9,5,22
191110051,3,0,0,6,9,18
191110052,8,9,9,7,5,38
191110053,8,3,8,0,7,26
191110054,6,2,0,3,7,18
191110055,4,0,9,0,4,17
191110056,3,2,3,6,0,14
191110057,8,5,3,5,0,21
191110058,7,2,9,7,8,33
191110059,9,9,7,6,7,38
191110060,0,7,5,4,4,20
191110061,6,3,5,3,0,17
191110062,8,1,3,8,7,27
191110063,4,0,8,1,8,21
191110064,6,0,8,9,4,27
191110065,5,9,3,9,6,32
191110066,2,2,6,4,4,18
191110067,1,2,0,5,8,16
191110068,9,3,5,6,4,27
191110069,0,0,4,0,0,4
191110070,4,0,7,8,1,20
191110071,4,7,0,2,8,21
191110072,7,8,5,0,3,23
191110073,4,2,9,2,4,21
191110074,9,1,2,8,1,21
191110075,4,5,2,0,1,12
191110076,9,9,0,6,4,28
191110077,2,2,1,6,0,11
191110078,1,6,1,9,1,18
191110079,1,2,3,9,9,24
191110080,8,4,0,1,5,18
191110081,9,2,3,0,3,17
191110082,7,6,9,6,2,30
191110083,4,4,8,6,7,29
191110084,7,0,4,1,0,12
191110085,0,9,4,2,7,22
191110086,4,3,6,9,5,27
191110087,5,3,2,6,4,20
191110088,5,9,1,3,5,23
191110089,5,0,3,0,8,16
191110090,0,6,6,1,8,21
191110091,2,0,9,1,3,15
191110092,6,4,0,2,4,16
191110093,2,5,3,0,9,19
191110094,2,4,3,9,6,24
191110095,3,6,7,9,3,28
191110096,7,5,9,8,1,30
191110097,3,0,1,0,8,12
191110098,6,3,2,5,5,21
191110099,2,5,4,8,1,20
191110100,3,7,6,4,6,26
191110101,1,9,9,8,4,31
191110102,9,7,1,2,4,23
191110103,0,6,6,2,2,16
191110104,8,0,4,8,4,24
191110105,0,9,7,2,3,21
191110106,5,8,8,5,8,34
191110107,5,7,2,0,8,22
191110108,7,5,6,7,5,30
191110109,8,0,4,4,1,17
191110110,2,4,9,6,8,29
191110111,4,1,5,6,3,19
191110112,3,9,8,8,8,36
191110113,0,8,5,9,9,31
191110114,4,4,0,2,4,14
191110115,4,6,1,8,3,22
191110116,6,8,5,1,1,21
191110117,0,2,4,3,0,9
191110118,6,9,8,1,7,31
191110119,8,8,9,9,2,36
191110120,3,2,3,0,2,10
191110121,3,7,2,0,2,14
191110122,7,7,8,1,7,30
191110123,4,0,6,0,5,15
191110124,9,0,5,0,7,21
191110125,2,2,0,6,7,17
191110126,5,5,0,9,0,19
191110127,9,4,9,5,8,35
191110128,2,7,1,8,8,26
191110129,2,6,2,6,9,25
191110130,3,3,3,3,8,20
191110131,2,9,8,2,4,25
191110132,4,7,4,6,1,22
191110133,9,6,7,1,3,26
191110134,4,4,1,7,6,22
191110135,7,2,6,6,8,29
191110136,1,8,0,6,9,24
191110137,1,1,7,3,0,12
191110138,2,6,9,0,1,18
191110139,2,3,1,7,4,17
191110140,2,9,8,0,9,28
191110141,5,2,2,3,8,20
191110142,4,6,2,3,9,24
191110143,1,9,9,4,6,29
191110144,3,4,1,1,5,14
191110145,4,9,4,4,7,28
191110146,3,5,8,6,9,31
191110147,9,7,3,0,1,20
191110148,9,9,0,4,1,23
191110149,9,7,7,2,1,26
191110150,7,1,3,2,3,16
191110151,5,5,0,9,1,20
191110152,9,6,9,2,1,27
191110153,2,5,1,3,6,17
191110154,3,2,6,1,2,14
191110155,3,0,2,2,0,7
191110156,2,6,2,4,1,15
191110157,7,9,9,4,9,38
191110158,9,0,1,9,5,24
191110159,9,0,1,2,1,13
191110160,5,1,4,1,4,15
191110161,4,2,1,2,5,14
191110162,3,3,5,2,8,21
191110163,3,9,7,3,4,26
191110164,0,7,4,1,1,13
191110165,1,0,3,6,9,19
191110166,6,4,9,1,0,20
191110167,1,4,5,4,5,19
191110168,7,0,3,2,9,21
191110169,8,7,5,0,4,24
191110170,3,3,0,1,0,7
191110171,7,2,5,3,7,24
191110172,4,4,0,7,2,17
191110173,1,6,7,3,8,25
191110174,4,4,7,0,7,22
191110175,9,2,5,9,7,32
191110176,8,9,3,8,5,33
191110177,5,8,7,2,6,28
191110178,9,7,9,1,4,30
191110179,3,1,9,5,1,19
191110180,8,1,9,0,1,19
191110181,9,9,7,0,2,27
191110182,0,4,6,9,4,23
191110183,6,2,9,1,9,27
191110184,5,3,9,8,2,27
191110185,0,6,4,2,1,13
191110186,9,8,9,6,9,41
191110187,3,1,0,5,5,14
191110188,3,2,7,8,3,23
191110189,9,6,0,5,9,29
191110190,9,2,8,6,6,31
191110191,7,9,8,5,8,37
191110192,9,2,8,0,2,21
191110193,4,9,6,6,8,33
191110194,9,5,6,4,6,30
191110195,6,7,6,2,4,25
191110196,6,4,6,7,5,28
191110197,4,2,7,7,3,23
191110198,6,2,2,2,2,14
191110199,3,5,3,4,6,21
191110200,9,2,0,0,7,18
191110201,6,6,1,7,1,21
191110202,1,1,1,4,8,15
191110203,0,1,1,3,3,8
191110204,4,4,3,9,4,24
191110205,5,3,2,3,3,16
191110206,9,7,4,4,5,29
191110207,0,8,9,1,9,27
191110208,4,1,6,9,3,23
191110209,5,1,9,9,5,29
191110210,6,8,9,7,9,39
191110211,2,3,2,5,0,12
191110212,5,7,5,1,4,22
191110213,6,8,0,6,4,24
191110214,0,1,0,8,4,13
191110215,8,1,1,2,6,18
191110216,2,8,1,4,1,16
191110217,8,4,5,6,5,28
191110218,1,8,7,5,5,26
191110219,2,3,6,1,9,21
191110220,3,8,3,9,2,25
191110221,0,4,9,1,4,18
191110222,0,2,1,6,0,9
191110223,0,2,6,9,9,26
191110224,9,7,6,7,8,37
191110225,5,0,3,9,4,21
191110226,7,2,7,9,3,28
191110227,9,6,6,0,8,29
191110228,0,4,4,6,5,19
191110229,2,6,9,6,3,26
191110230,0,5,4,7,7,23
191110231,8,5,1,3,7,24
191110232,2,0,4,0,2,8
191110233,6,3,4,8,6,27
191110234,9,9,0,2,6,26
191110235,6,1,5,3,0,15
191110236,4,8,1,0,5,18
191110237,0,6,8,2,4,20
191110238,6,6,3,6,0,21
191110239,5,0,9,9,1,24
191110240,3,8,2,7,7,27
191110241,3,4,4,9,2,22
191110242,2,1,1,9,0,13
191110243,0,9,7,6,6,28
191110244,7,6,6,1,4,24
191110245,1,5,5,6,1,18
191110246,4,0,2,9,7,22
191110247,7,9,1,5,3,25
191110248,6,5,8,2,4,25
191110249,3,4,8,0,4,19
191110250,2,4,5,2,6,19
191110251,0,4,0,2,2,8
191110252,8,7,7,1,2,25
191110253,0,9,1,6,4,20
191110254,1,0,6,8,0,15
191110255,1,8,1,4,1,15
191110256,7,4,1,5,3,20
191110257,0,0,3,6,7,16
191110258,3,9,6,8,1,27
191110259,3,8,8,4,9,32
191110260,3,7,4,5,4,23
191110261,3,7,2,7,2,21
191110262,2,1,7,0,2,12
191110263,7,8,4,2,4,25
191110264,1,6,3,4,3,17
191110265,4,2,9,4,7,26
191110266,7,6,4,3,3,23
191110267,3,4,5,3,9,24
191110268,2,5,3,5,5,20
191110269,8,1,7,3,2,21
191110270,0,7,6,6,2,21
191110271,5,4,3,7,5,24
191110272,8,4,5,4,0,21
191110273,5,3,0,7,3,18
191110274,2,5,1,7,5,20
191110275,7,9,1,6,2,25
191110276,4,3,3,4,3,17
191110277,9,4,9,2,3,27
191110278,0,9,7,3,7,26
191110279,7,2,5,8,4,26
191110280,9,6,0,4,9,28
191110281,3,4,8,4,0,19
191110282,2,3,1,4,6,16
191110283,8,4,7,1,5,25
191110284,8,7,8,0,0,23
191110285,2,4,5,8,1,20
191110286,8,2,2,1,2,15
191110287,5,5,2,5,6,23
191110288,7,0,5,2,5,19
191110289,0,9,9,0,3,21
191110290,8,2,0,7,1,18
191110291,4,9,2,8,1,24
191110292,9,9,3,2,7,30
191110293,0,5,1,9,6,21
191110294,7,4,8,4,8,31
191110295,8,9,6,2,5,30
191110296,0,0,6,3,4,13
191110297,2,6,9,6,6,29
191110298,3,8,0,5,1,17
191110299,5,0,4,9,0,18
191110300,9,8,0,8,5,30
191110301,5,1,9,2,1,18
191110302,7,1,6,1,8,23
191110303,7,6,8,2,0,23
191110304,0,2,6,1,7,16
191110305,6,8,9,6,9,38
191110306,9,8,4,6,5,32
191110307,9,2,9,5,1,26
191110308,3,5,1,8,4,21
191110309,8,1,1,4,3,17
191110310,4,1,6,0,5,16
191110311,0,3,3,5,7,18
191110312,5,0,7,6,0,18
191110313,1,7,7,2,9,26
191110314,0,9,6,2,3,20
191110315,2,5,4,2,5,18
191110316,4,3,2,1,8,18
191110317,6,8,8,0,0,22
191110318,7,1,5,1,5,19
191110319,6,5,3,8,0,22
191110320,1,4,2,0,7,14
191110321,4,5,2,1,7,19
191110322,3,7,8,4,0,22
191110323,8,7,1,1,0,17
191110324,3,1,9,1,2,16
191110325,1,4,4,1,6,16
191110326,9,4,3,3,4,23
191110327,0,0,0,3,4,7
191110328,9,4,9,0,2,24
191110329,2,3,4,1,7,17
191110330,5,3,9,1,5,23
191110331,7,6,7,5,4,29
191110332,2,7,3,6,7,25
191110333,6,5,1,6,3,21
191110334,0,9,1,2,9,21
191110335,9,2,4,7,6,28
191110336,1,0,7,7,4,19
191110337,0,3,2,9,0,14
191110338,3,7,7,4,7,28
191110339,3,6,6,5,5,25
191110340,1,5,3,7,2,18
191110341,7,8,3,2,8,28
191110342,6,7,1,6,1,21
191110343,7,3,1,7,4,22
191110344,5,1,2,9,6,23
191110345,2,3,7,5,2,19
191110346,8,6,8,1,2,25
191110347,6,1,7,0,4,18
191110348,9,6,0,4,0,19
191110349,8,5,0,9,9,31
191110350,9,7,2,4,5,27
191110351,3,8,6,4,5,26
191110352,7,4,6,4,4,25
191110353,3,2,8,3,6,22
191110354,3,6,7,8,1,25
191110355,6,3,0,9,9,27
191110356,5,2,7,7,4,25
191110357,1,7,8,1,8,25
191110358,1,6,8,0,6,21
191110359,3,6,0,9,2,20
191110360,8,5,4,3,9,29
191110361,5,8,5,3,8,29
191110362,8,3,2,4,6,23
191110363,3,2,1,7,3,16
191110364,6,6,8,2,3,25
191110365,6,0,7,5,5,23
191110366,8,2,1,6,9,26
191110367,9,2,8,2,4,25
191110368,5,2,0,1,9,17
191110369,1,4,6,2,4,17
191110370,1,5,3,0,6,15
191110371,1,7,7,5,8,28
191110372,8,6,5,9,6,34
191110373,0,1,6,1,2,10
191110374,9,4,0,3,5,21
191110375,0,4,9,9,0,22
191110376,5,4,1,6,1,17
191110377,8,6,7,4,8,33
191110378,7,0,7,8,3,25
191110379,4,9,7,6,7,33
191110380,2,5,2,2,7,18
191110381,5,2,4,4,8,23
191110382,5,6,6,9,5,31
191110383,2,0,0,1,4,7
191110384,2,5,9,5,9,30
191110385,7,3,7,7,5,29
191110386,0,6,1,3,9,19
191110387,4,5,1,6,0,16
191110388,8,9,2,6,0,25
191110389,9,9,7,8,0,33
191110390,9,4,7,9,0,29
191110391,6,4,3,1,0,14
191110392,9,0,1,3,9,22
191110393,8,3,3,1,5,20
191110394,0,5,5,7,9,26
191110395,4,1,6,0,6,17
191110396,9,7,3,2,6,27
191110397,4,8,7,2,0,21
191110398,1,4,7,1,0,13
191110399,3,5,5,6,5,24
191110400,1,0,6,2,7,16
191110401,2,1,3,2,5,13
191110402,8,3,7,1,4,23
191110403,6,1,7,4,6,24
191110404,0,1,2,4,0,7
191110405,6,6,6,6,1,25
191110406,5,5,8,0,2,20
191110407,9,7,8,2,0,26
191110408,5,9,8,6,0,28
191110409,0,7,6,8,7,28
191110410,6,6,6,1,6,25
191110411,9,4,4,6,8,31
191110412,3,5,9,6,7,30
191110413,6,3,4,8,2,23
191110414,4,2,3,2,8,19
191110415,2,1,0,1,8,12
191110416,1,3,6,6,7,23
191110417,5,4,2,0,8,19
191110418,9,6,2,7,8,32
191110419,0,3,1,2,7,13
191110420,7,7,8,9,0,31
191110421,2,9,1,4,8,24
191110422,0,9,4,9,5,27
191110423,1,4,3,4,6,18
191110424,7,8,1,0,8,24
191110425,7,5,8,3,6,29
191110426,0,0,2,8,8,18
191110427,1,7,5,1,7,21
191110428,7,1,5,6,1,20
191110429,4,2,0,8,4,18
191110430,3,4,6,6,4,23
191110431,9,6,1,6,5,27
191110432,2,0,8,7,6,23
191110433,6,7,4,9,4,30
191110434,4,7,2,8,5,26
191110435,2,4,0,2,5,13
191110436,9,6,7,3,0,25
191110437,3,0,6,2,4,15
191110438,9,5,5,2,2,23
191110439,8,7,2,3,9,29
191110440,1,5,3,5,2,16
191110441,6,4,8,8,6,32
191110442,2,3,0,9,8,22
191110443,1,5,6,7,8,27
191110444,2,6,8,6,8,30
191110445,1,9,8,0,9,27
191110446,2,9,0,5,6,22
191110447,4,4,7,1,9,25
191110448,2,1,1,2,9,15
191110449,6,9,6,4,9,34
191110450,2,2,9,6,5,24
191110451,1,1,0,2,1,5
191110452,5,4,8,8,6,31
191110453,0,3,0,6,3,12
191110454,5,3,3,0,0,11
191110455,8,5,9,6,8,36
191110456,2,4,7,6,8,27
191110457,1,9,7,0,2,19
191110458,3,5,4,3,8,23
191110459,7,3,7,7,1,25
191110460,3,3,8,3,1,18
191110461,1,0,8,9,3,21
191110462,4,9,7,0,1,21
191110463,4,3,4,8,3,22
191110464,8,9,7,6,9,39
191110465,7,3,4,6,9,29
191110466,7,6,9,7,5,34
191110467,0,5,2,7,2,16
191110468,4,5,7,5,3,24
191110469,6,8,8,3,7,32
191110470,2,9,8,7,9,35
191110471,3,1,8,9,9,30
191110472,8,5,2,9,0,24
191110473,0,9,6,9,4,28
191110474,5,9,5,7,3,29
191110475,2,0,3,5,3,13
191110476,5,0,2,9,1,17
191110477,7,8,1,8,7,31
191110478,0,6,2,9,7,24
191110479,2,3,0,3,8,16
191110480,7,0,4,8,4,23
191110481,1,0,9,8,8,26
191110482,2,6,2,7,6,23
191110483,0,6,1,6,5,18
191110484,5,1,4,1,7,18
191110485,2,0,2,7,5,16
191110486,0,3,6,7,5,21
191110487,8,0,3,1,7,19
191110488,8,3,2,7,9,29
191110489,0,2,7,2,8,19
191110490,4,3,0,2,6,15
191110491,4,3,6,2,9,24
191110492,8,8,7,6,7,36
191110493,4,6,8,9,2,29
191110494,0,6,9,2,5,22
191110495,3,7,6,6,1,23
191110496,8,6,6,9,1,30
191110497,1,5,8,1,9,24
191110498,5,0,5,1,8,19
191110499,7,1,7,0,7,22
191110500,7,7,3,3,4,24
191110501,1,5,7,9,7,29
191110502,8,6,5,9,2,30
191110503,8,2,5,9,1,25
191110504,0,1,7,4,0,12
191110505,9,5,1,1,2,18
191110506,3,3,8,9,8,31
191110507,2,1,1,4,2,10
191110508,8,9,0,6,4,27
191110509,1,9,5,7,0,22
191110510,2,7,4,8,1,22
191110511,0,9,8,1,5,23
191110512,1,7,2,5,5,20
191110513,9,2,8,7,4,30
191110514,3,6,0,4,7,20
191110515,5,4,9,3,9,30
191110516,0,2,1,8,2,13
191110517,1,5,9,1,2,18
191110518,6,0,5,7,5,23
191110519,2,0,3,0,9,14
191110520,6,2,4,7,2,21
191110521,3,6,1,9,6,25
191110522,0,8,5,7,8,28
191110523,9,8,2,2,6,27
191110524,8,1,7,5,3,24
191110525,7,5,9,4,7,32
191110526,6,8,6,0,0,20
191110527,5,4,6,5,3,23
191110528,4,6,8,5,1,24
191110529,9,6,4,5,0,24
191110530,5,6,2,1,6,20
191110531,3,5,8,8,7,31
191110532,2,8,0,1,3,14
191110533,8,2,9,6,5,30
191110534,5,9,9,8,4,35
191110535,0,7,1,0,1,9
191110536,5,9,2,3,2,21
191110537,9,3,8,6,5,31
191110538,4,0,3,5,9,21
191110539,5,7,0,6,3,21
191110540,3,8,3,3,0,17
191110541,1,5,9,1,0,16
191110542,7,9,1,8,4,29
191110543,9,5,3,6,3,26
191110544,5,4,2,2,7,20
191110545,4,2,6,7,7,26
191110546,1,1,3,5,7,17
191110547,5,7,6,9,6,33
191110548,4,1,7,1,5,18
191110549,6,7,0,5,3,21
191110550,6,6,7,3,4,26
191110551,9,2,4,1,9,25
191110552,7,8,2,4,2,23
191110553,2,5,4,0,0,11
191110554,8,9,9,8,6,40
191110555,2,8,0,6,5,21
191110556,0,3,4,8,6,21
191110557,5,7,0,8,4,24
191110558,2,2,0,0,4,8
191110559,7,4,2,5,9,27
191110560,3,6,1,0,7,17
191110561,9,3,9,2,7,30
191110562,6,2,9,4,0,21
191110563,4,6,2,6,4,22
191110564,5,1,2,7,5,20
191110565,7,0,0,4,9,20
191110566,6,9,0,3,0,18
191110567,3,2,8,2,4,19
191110568,8,7,6,3,7,31
191110569,2,1,2,3,1,9
191110570,7,5,2,1,7,22
191110571,4,2,5,4,8,23
191110572,2,7,8,9,6,32
191110573,6,7,6,6,6,31
191110574,2,7,8,3,4,24
191110575,3,8,6,6,7,30
191110576,1,2,6,5,9,23
191110577,2,7,5,1,2,17
191110578,9,3,8,5,0,25
191110579,6,5,2,7,2,22
191110580,1,3,0,4,0,8
191110581,3,7,9,5,3,27
191110582,9,5,8,5,3,30
191110583,7,8,1,8,9,33
191110584,8,3,3,5,8,27
191110585,1,5,0,3,6,15
191110586,7,8,2,7,6,30
191110587,5,0,3,9,5,22
191110588,5,1,2,9,3,20
191110589,5,2,4,7,9,27
191110590,2,1,5,2,8,18
191110591,7,7,3,1,7,25
191110592,2,4,3,0,9,18
191110593,6,6,0,4,4,20
191110594,6,1,8,0,9,24
191110595,5,1,8,7,3,24
191110596,3,2,9,1,5,20
191110597,4,2,5,5,6,22
191110598,9,7,3,9,3,31
191110599,9,7,3,1,1,21
191110600,9,6,9,0,9,33
191110601,4,1,5,7,0,17
191110602,6,5,8,7,8,34
191110603,3,7,7,8,2,27
191110604,5,3,7,1,0,16
191110605,3,6,0,7,7,23
191110606,7,5,7,7,5,31
191110607,0,8,9,1,1,19
191110608,3,8,6,7,1,25
191110609,0,0,4,2,4,10
191110610,4,7,7,8,6,32
191110611,1,8,3,8,4,24
191110612,0,5,8,9,6,28
191110613,7,7,4,0,6,24
191110614,8,8,4,8,0,28
191110615,5,8,6,1,4,24
191110616,6,1,5,1,7,20
191110617,5,3,8,4,1,21
191110618,7,4,0,2,2,15
191110619,6,9,0,0,6,21
191110620,5,6,4,0,3,18
191110621,0,6,2,7,4,19
191110622,6,4,6,7,9,32
191110623,3,6,7,6,5,27
191110624,2,1,9,2,1,15
191110625,4,0,3,5,5,17
191110626,3,2,8,6,3,22
191110627,6,2,7,7,4,26
191110628,9,9,5,4,5,32
191110629,4,0,2,5,5,16
191110630,4,8,8,2,6,28
191110631,2,8,3,4,2,19
191110632,2,5,2,4,9,22
191110633,7,0,1,0,2,10
191110634,4,2,8,6,1,21
191110635,9,0,4,1,1,15
191110636,5,6,2,5,9,27
191110637,9,9,6,0,2,26
191110638,0,6,1,9,8,24
191110639,5,6,6,1,8,26
191110640,6,2,2,0,0,10
191110641,8,4,3,3,9,27
191110642,2,1,4,8,2,17
191110643,3,5,4,9,8,29
191110644,7,1,2,4,5,19
191110645,2,2,0,4,6,14
191110646,3,3,0,8,7,21
191110647,3,2,7,4,4,20
191110648,1,7,9,2,2,21
191110649,7,9,9,1,8,34
191110650,2,6,7,1,5,21
191110651,9,5,6,3,3,26
191110652,5,0,4,4,4,17
191110653,4,1,2,2,4,13
191110654,6,5,1,8,3,23
191110655,7,6,0,0,9,22
191110656,6,5,4,8,2,25
191110657,2,2,6,8,5,23
191110658,9,2,5,9,2,27
191110659,9,8,7,7,6,37
191110660,1,9,7,7,6,30
191110661,0,3,5,8,8,24
191110662,3,6,1,7,8,25
191110663,0,9,3,1,9,22
191110664,7,4,1,5,6,23
191110665,7,2,3,3,8,23
191110666,1,3,2,6,9,21
191110667,4,6,9,6,2,27
191110668,8,2,4,3,1,18
191110669,1,5,5,8,9,28
191110670,2,1,6,4,0,13
191110671,0,2,4,3,6,15
191110672,9,0,8,4,2,23
191110673,3,1,0,8,1,13
191110674,0,4,7,7,1,19
191110675,8,9,6,2,1,26
191110676,1,1,9,1,6,18
191110677,5,0,7,0,3,15
191110678,4,2,4,7,7,24
191110679,7,2,5,9,1,24
191110680,2,2,6,1,9,20
191110681,5,3,3,7,7,25
191110682,0,0,6,8,0,14
191110683,9,1,0,0,7,17
191110684,1,5,6,6,2,20
191110685,6,5,8,1,4,24
191110686,8,0,5,3,9,25
191110687,5,9,7,7,8,36
191110688,7,2,0,8,5,22
191110689,8,3,1,2,3,17
191110690,0,4,8,6,6,24
191110691,9,9,9,0,2,29
191110692,7,2,1,9,5,24
191110693,8,3,5,8,2,26
191110694,7,4,5,0,9,25
191110695,3,1,2,3,7,16
191110696,5,3,9,9,9,35
191110697,8,5,2,7,3,25
191110698,7,1,2,1,9,20
191110699,8,5,8,5,3,29
191110700,6,6,0,6,0,18
191110701,1,4,4,8,8,25
191110702,6,1,2,2,9,20
191110703,5,6,2,6,6,25
191110704,8,7,9,2,4,30
191110705,6,2,8,0,7,23
191110706,4,3,1,4,4,16
191110707,0,6,7,5,4,22
191110708,6,2,7,6,5,26
191110709,4,8,8,1,9,30
191110710,4,0,3,5,3,15
191110711,1,7,8,6,1,23
191110712,2,3,5,6,5,21
191110713,2,0,1,7,5,15
191110714,5,2,5,9,1,22
191110715,6,3,2,4,9,24
191110716,0,4,4,2,5,15
191110717,6,9,8,7,0,30
191110718,6,7,2,7,2,24
191110719,2,5,4,8,0,19
191110720,8,6,5,6,8,33
191110721,3,4,1,9,0,17
191110722,4,5,5,0,7,21
191110723,3,6,4,8,8,29
191110724,9,4,8,4,6,31
191110725,1,3,1,8,1,14
191110726,0,3,9,3,9,24
191110727,3,6,3,3,9,24
191110728,7,0,4,0,6,17
191110729,9,2,1,1,0,13
191110730,7,1,8,4,3,23
191110731,9,8,5,0,6,28
191110732,0,1,3,6,2,12
191110733,5,4,7,1,7,24
191110734,2,4,9,1,1,17
191110735,6,0,7,9,6,28
191110736,5,2,9,0,5,21
191110737,0,9,0,9,7,25
191110738,7,1,6,6,3,23
191110739,5,3,9,4,9,30
191110740,0,0,6,7,2,15
191110741,5,0,3,6,5,19
191110742,8,2,9,8,6,33
191110743,2,6,5,0,0,13
191110744,3,0,5,9,1,18
191110745,0,7,0,8,0,15
191110746,9,2,6,8,2,27
191110747,7,9,4,1,0,21
191110748,3,8,6,1,1,19
191110749,2,5,6,1,0,14
191110750,4,6,3,8,5,26
191110751,3,8,0,2,3,16
191110752,0,5,7,3,3,18
191110753,6,7,3,7,9,32
191110754,4,2,9,5,8,28
191110755,7,1,3,6,7,24
191110756,6,6,0,6,1,19
191110757,8,0,8,6,4,26
191110758,7,2,5,3,3,20
191110759,3,0,8,9,8,28
191110760,4,3,5,0,3,15
191110761,7,1,9,3,3,23
191110762,0,8,9,1,0,18
191110763,8,3,6,0,1,18
191110764,7,7,0,0,4,18
191110765,4,5,0,4,1,14
191110766,4,7,7,6,0,24
191110767,6,5,4,1,7,23
191110768,9,0,7,3,0,19
191110769,9,1,3,0,0,13
191110770,1,7,8,5,7,28
191110771,6,0,7,4,7,24
191110772,6,6,5,5,6,28
191110773,9,0,8,5,0,22
191110774,4,1,8,9,1,23
191110775,3,0,8,1,8,20
191110776,0,1,2,1,3,7
191110777,6,7,9,0,3,25
191110778,3,9,1,0,3,16
191110779,3,9,1,7,5,25
191110780,3,5,7,7,6,28
191110781,7,2,6,5,1,21
191110782,0,5,8,2,2,17
191110783,0,0,1,2,7,10
191110784,4,4,8,9,6,31
191110785,2,7,7,7,2,25
191110786,7,1,9,8,4,29
191110787,4,3,1,8,3,19
191110788,3,9,8,3,7,30
191110789,6,8,0,3,8,25
191110790,9,1,3,7,4,24
191110791,3,3,0,2,1,9
191110792,3,8,4,9,1,25
191110793,4,6,8,8,3,29
191110794,6,7,9,4,6,32
191110795,7,4,3,9,9,32
191110796,9,2,3,1,2,17
191110797,2,8,4,1,6,21
191110798,8,9,1,3,9,30
191110799,9,0,4,8,2,23
191110800,7,2,7,2,9,27
191110801,7,9,3,8,5,32
191110802,6,0,5,1,3,15
191110803,0,9,4,6,3,22
191110804,6,6,1,6,5,24
191110805,8,9,0,6,6,29
191110806,8,5,7,8,8,36
191110807,9,0,1,8,4,22
191110808,5,8,4,2,5,24
191110809,6,9,9,2,2,28
191110810,5,6,0,3,9,23
191110811,1,2,6,9,1,19
191110812,1,5,2,1,7,16
191110813,0,5,3,5,7,20
191110814,1,5,4,9,1,20
191110815,8,1,6,0,7,22
191110816,7,3,0,1,2,13
191110817,3,2,4,2,7,18
191110818,2,1,2,4,5,14
191110819,1,3,5,1,2,12
191110820,5,3,6,4,8,26
191110821,1,1,4,9,3,18
191110822,7,2,5,4,4,22
191110823,7,0,9,9,5,30
191110824,8,2,6,1,7,24
191110825,5,2,8,3,4,22
191110826,0,9,5,6,5,25
191110827,3,6,4,4,4,21
191110828,6,7,3,8,7,31
191110829,2,2,0,1,3,8
191110830,0,4,8,0,1,13
191110831,9,9,2,2,8,30
191110832,6,6,4,1,7,24
191110833,7,7,4,9,6,33
191110834,6,6,5,6,1,24
191110835,2,6,4,0,0,12
191110836,3,0,0,8,6,17
191110837,8,7,4,5,7,31
191110838,2,2,0,9,2,15
191110839,4,5,3,9,6,27
191110840,5,9,4,7,1,26
191110841,7,8,0,5,7,27
191110842,5,3,9,0,4,21
191110843,2,5,1,4,8,20
191110844,2,3,1,1,6,13
191110845,0,3,7,1,8,19
191110846,5,5,9,5,7,31
191110847,5,0,6,1,0,12
191110848,9,9,6,2,5,31
191110849,1,9,8,7,6,31
191110850,4,5,0,5,2,16
191110851,0,7,9,6,4,26
191110852,0,6,5,8,6,25
191110853,4,3,0,5,5,17
191110854,8,2,6,4,8,28
191110855,3,4,2,4,7,20
191110856,6,9,5,9,0,29
191110857,3,0,0,2,9,14
191110858,5,3,4,5,2,19
191110859,2,5,9,8,6,30
191110860,3,2,1,5,8,19
191110861,0,7,4,5,0,16
191110862,9,7,8,9,6,39
191110863,3,8,7,0,0,18
191110864,8,7,2,3,3,23
191110865,4,7,4,1,1,17
191110866,5,3,8,6,4,26
191110867,8,2,1,7,6,24
191110868,3,1,5,6,2,17
191110869,8,1,5,2,7,23
191110870,9,2,7,4,2,24
191110871,5,0,9,8,8,30
191110872,6,4,7,5,9,31
191110873,9,3,0,0,6,18
191110874,3,2,6,5,6,22
191110875,4,0,1,7,0,12
191110876,6,5,2,8,4,25
191110877,8,1,4,9,2,24
191110878,8,7,0,6,4,25
191110879,2,5,9,1,5,22
191110880,0,4,1,1,0,6
191110881,2,7,7,6,0,22
191110882,4,3,7,7,5,26
191110883,6,9,9,8,9,41
191110884,6,8,8,0,8,30
191110885,7,7,9,3,7,33
191110886,0,9,8,4,3,24
191110887,2,9,2,5,2,20
191110888,3,3,5,7,1,19
191110889,9,0,7,8,6,30
191110890,9,3,0,5,1,18
191110891,2,7,2,3,5,19
191110892,6,9,9,1,3,28
191110893,0,6,5,4,2,17
191110894,4,6,9,3,3,25
191110895,7,7,4,9,2,29
191110896,5,5,1,6,1,18
191110897,5,1,7,0,5,18
191110898,7,1,6,3,0,17
191110899,4,7,5,5,3,24
191110900,2,0,2,1,2,7
191110901,0,9,8,6,7,30
191110902,3,9,1,7,6,26
191110903,3,9,9,8,1,30
191110904,2,8,3,7,6,26
191110905,2,4,1,7,3,17
191110906,9,6,2,1,3,21
191110907,9,1,3,2,6,21
191110908,1,7,3,3,5,19
191110909,4,3,6,9,4,26
191110910,0,4,4,4,2,14
191110911,0,3,7,5,1,16
191110912,9,6,3,4,3,25
191110913,3,2,6,9,1,21
191110914,0,8,8,7,4,27
191110915,7,5,2,0,6,20
191110916,9,3,5,0,4,21
191110917,6,0,6,4,2,18
191110918,4,0,1,2,8,15
191110919,3,1,4,6,5,19
191110920,2,1,9,6,0,18
191110921,7,7,9,2,5,30
191110922,8,8,4,6,3,29
191110923,3,0,1,1,2,7
191110924,2,2,7,1,0,12
191110925,1,7,9,7,9,33
191110926,9,1,2,9,3,24
191110927,0,9,8,2,9,28
191110928,5,6,7,3,9,30
191110929,0,4,8,1,4,17
191110930,1,5,3,9,3,21
191110931,2,9,1,5,6,23
191110932,2,7,3,1,6,19
191110933,2,6,6,7,0,21
191110934,5,6,4,8,0,23
191110935,1,9,2,9,5,26
191110936,5,5,0,9,5,24
191110937,3,3,6,2,6,20
191110938,2,1,1,9,2,15
191110939,9,5,2,9,7,32
191110940,5,9,3,9,3,29
191110941,8,5,2,2,9,26
191110942,4,7,0,9,2,22
191110943,3,2,3,6,6,20
191110944,3,3,3,8,6,23
191110945,0,6,7,8,1,22
191110946,4,0,4,7,3,18
191110947,0,9,2,3,1,15
191110948,8,5,4,4,7,28
191110949,9,0,4,7,2,22
191110950,8,3,4,5,8,28
191110951,0,3,9,1,8,21
191110952,7,2,2,5,0,16
191110953,2,7,9,1,1,20
191110954,4,3,3,0,3,13
191110955,4,4,5,1,0,14
191110956,1,4,9,9,4,27
191110957,9,7,9,8,5,38
191110958,0,2,6,6,6,20
191110959,1,3,3,2,4,13
191110960,9,6,6,5,6,32
191110961,3,6,9,8,0,26
191110962,1,2,0,7,1,11
191110963,4,6,2,2,5,19
191110964,7,9,3,6,9,34
191110965,7,5,1,2,4,19
191110966,7,4,7,9,4,31
191110967,7,6,0,3,6,22
191110968,8,6,8,3,5,30
191110969,9,5,4,9,5,32
191110970,6,0,2,2,9,19
191110971,0,1,1,6,2,10
191110972,5,4,9,8,8,34
191110973,8,7,1,4,1,21
191110974,2,3,8,7,4,24
191110975,7,1,2,1,2,13
191110976,1,0,6,4,9,20
191110977,9,0,8,3,8,28
191110978,1,6,6,4,2,19
191110979,5,7,9,1,1,23
191110980,2,2,6,6,1,17
191110981,9,8,8,5,1,31
191110982,9,2,3,7,8,29
191110983,0,3,9,5,9,26
191110984,3,5,1,8,8,25
191110985,7,4,3,2,5,21
191110986,5,9,2,1,2,19
191110987,5,4,8,1,4,22
191110988,9,5,5,2,0,21
191110989,7,4,5,2,8,26
191110990,5,2,1,9,0,17
191110991,8,7,3,5,2,25
191110992,2,0,4,6,6,18
191110993,6,4,4,2,9,25
191110994,4,6,6,6,7,29
191110995,4,6,5,1,9,25
191110996,1,2,1,8,1,13
191110997,9,4,6,4,0,23
191110998,8,8,0,8,0,24
191110999,1,0,8,8,0,17
1911101000,6,3,9,6,5,29
1911101001,2,2,0,2,8,14
1911101002,5,9,9,4,1,28
1911101003,0,9,9,4,9,31
1911101004,6,7,6,7,3,29
1911101005,0,1,4,0,1,6
1911101006,6,9,2,5,5,27
1911101007,1,2,3,8,1,15
1911101008,5,3,7,8,5,28
1911101009,3,8,2,5,8,26
1911101010,0,6,8,4,1,19
1911101011,2,5,5,9,8,29
1911101012,6,8,1,2,8,25
1911101013,2,6,0,2,3,13
1911101014,7,4,7,0,6,24
1911101015,0,9,9,8,8,34
1911101016,5,5,5,9,9,33
1911101017,8,4,2,6,4,24
1911101018,8,9,4,6,5,32
1911101019,6,7,6,3,9,31
1911101020,5,2,6,9,7,29
1911101021,3,1,7,5,5,21
1911101022,7,2,7,4,9,29
1911101023,0,9,1,7,1,18
1911101024,8,2,3,0,4,17
1911101025,6,5,6,3,9,29
1911101026,2,9,9,8,1,29
1911101027,9,6,5,7,7,34
1911101028,9,3,6,3,2,23
1911101029,0,7,5,3,4,19
1911101030,5,4,5,0,0,14
1911101031,2,5,7,7,5,26
1911101032,6,1,8,5,0,20
1911101033,3,0,4,5,5,17
1911101034,2,7,3,3,0,15
1911101035,6,0,8,4,3,21
1911101036,4,1,0,5,7,17
1911101037,1,6,9,5,3,24
1911101038,5,0,1,2,3,11
1911101039,3,7,3,5,6,24
1911101040,4,8,2,9,2,25
1911101041,6,8,9,3,5,31
1911101042,1,9,7,6,6,29
1911101043,8,9,0,8,5,30
1911101044,5,7,8,4,5,29
1911101045,3,2,6,3,8,22
1911101046,6,3,1,8,7,25
1911101047,7,2,8,3,6,26
1911101048,0,6,8,7,0,21
1911101049,0,8,9,9,3,29
1911101050,5,8,4,8,3,28
1911101051,5,2,8,4,2,21
1911101052,7,4,3,7,9,30
1911101053,0,6,8,5,7,26
1911101054,3,2,9,4,9,27
1911101055,6,5,4,3,7,25
1911101056,6,9,9,2,6,32
1911101057,6,1,1,9,2,19
1911101058,3,3,2,6,8,22
1911101059,1,4,2,6,9,22
1911101060,7,7,2,1,9,26
1911101061,1,8,0,2,3,14
1911101062,8,0,3,3,9,23
1911101063,3,3,8,9,0,23
1911101064,7,2,4,4,4,21
1911101065,2,4,5,9,3,23
1911101066,7,4,1,0,0,12
1911101067,3,2,6,8,7,26
1911101068,7,2,1,4,8,22
1911101069,9,5,2,0,0,16
1911101070,5,0,7,0,0,12
1911101071,3,4,2,2,4,15
1911101072,0,4,8,4,5,21
1911101073,0,0,9,0,3,12
1911101074,8,8,6,4,4,30
1911101075,4,3,8,0,9,24
1911101076,4,8,0,2,1,15
1911101077,7,1,7,9,7,31
1911101078,7,8,9,7,4,35
1911101079,0,1,3,4,5,13
1911101080,8,5,8,4,5,30
1911101081,4,0,7,8,8,27
1911101082,6,5,1,0,2,14
1911101083,9,1,7,6,2,25
1911101084,8,5,5,8,3,29
1911101085,1,3,5,4,4,17
1911101086,0,9,8,4,1,22
1911101087,8,9,5,2,9,33
1911101088,7,8,9,5,2,31
1911101089,1,4,4,4,4,17
1911101090,0,2,4,8,4,18
1911101091,7,4,6,1,0,18
1911101092,5,2,0,1,2,10
1911101093,3,5,3,2,9,22
1911101094,8,1,6,2,5,22
1911101095,5,2,8,9,2,26
1911101096,4,2,0,5,9,20
1911101097,5,8,2,3,9,27
1911101098,9,5,3,7,2,26
1911101099,4,1,3,6,1,15
1911101100,0,4,4,9,8,25
1911101101,1,2,2,2,7,14
1911101102,9,2,2,4,3,20
1911101103,7,3,3,7,6,26
1911101104,8,5,3,9,9,34
1911101105,1,0,2,0,5,8
191111001,2,4,4,8,0,18
191111002,0,4,2,8,5,19
191111003,2,1,2,1,3,9
191111004,3,7,3,8,4,25
191111005,1,8,4,8,8,29
191111006,7,6,1,0,7,21
191111007,5,3,7,9,7,31
191111008,2,9,0,2,6,19
191111009,8,5,3,3,6,25
191111010,0,5,5,8,3,21
191111011,5,1,6,2,6,20
191111012,0,9,5,0,4,18
191111013,0,2,6,7,2,17
191111014,4,2,6,9,4,25
191111015,7,4,3,0,9,23
191111016,0,9,1,8,6,24
191111017,7,9,4,9,1,30
191111018,2,8,9,4,7,30
191111019,9,9,9,0,1,28
191111020,2,6,5,8,6,27
191111021,0,7,7,0,6,20
191111022,6,3,5,5,7,26
191111023,9,3,8,1,7,28
191111024,3,4,7,2,6,22
191111025,7,4,4,9,8,32
191111026,8,4,7,9,2,30
191111027,7,9,7,7,6,36
191111028,5,8,8,0,3,24
191111029,1,9,6,0,3,19
191111030,7,7,1,3,9,27
191111031,8,2,9,4,2,25
191111032,5,4,9,6,7,31
191111033,5,7,4,3,0,19
191111034,0,9,8,7,3,27
191111035,8,0,9,2,1,20
191111036,9,3,8,5,5,30
191111037,1,3,5,9,0,18
191111038,3,4,8,0,0,15
191111039,4,7,4,1,9,25
191111040,7,8,0,6,3,24
191111041,0,0,6,2,3,11
191111042,7,2,6,8,9,32
191111043,5,0,1,4,3,13
191111044,9,3,2,4,8,26
191111045,1,8,5,4,7,25
191111046,5,7,9,0,4,25
191111047,8,8,4,2,9,31
191111048,7,2,1,5,5,20
191111049,4,3,3,6,2,18
191111050,6,2,8,8,7,31
191111051,5,2,9,5,3,24
191111052,4,7,8,0,4,23
191111053,7,5,4,7,2,25
191111054,1,1,4,2,3,11
191111055,9,5,4,4,5,27
191111056,3,7,0,3,1,14
191111057,6,8,5,4,7,30
191111058,4,8,8,8,5,33
191111059,9,3,3,9,8,32
191111060,1,3,8,2,1,15
191111061,1,1,8,7,4,21
191111062,0,2,6,9,0,17
191111063,0,0,5,3,5,13
191111064,1,9,5,7,8,30
191111065,2,4,6,0,9,21
191111066,5,4,8,7,1,25
191111067,9,2,2,3,8,24
191111068,3,2,8,8,9,30
191111069,7,5,4,9,7,32
191111070,6,6,2,7,6,27
191111071,8,5,2,4,5,24
191111072,1,4,2,4,1,12
191111073,3,7,5,9,8,32
191111074,9,7,4,9,0,29
191111075,6,5,7,8,3,29
191111076,3,8,4,4,3,22
191111077,8,2,2,5,8,25
191111078,1,3,2,9,0,15
191111079,7,0,5,4,2,18
191111080,1,0,9,6,0,16
191111081,3,7,5,8,4,27
191111082,7,1,5,3,5,21
191111083,6,6,1,9,5,27
191111084,8,3,9,8,8,36
191111085,4,2,1,9,6,22
191111086,1,8,5,9,8,31
191111087,3,6,8,4,2,23
191111088,8,7,7,9,9,40
191111089,5,4,2,6,2,19
191111090,5,0,7,3,5,20
191111091,7,1,3,7,5,23
191111092,0,5,0,4,0,9
191111093,4,4,9,4,1,22
191111094,8,7,2,8,6,31
191111095,8,8,9,8,2,35
191111096,3,5,5,3,4,20
191111097,6,6,2,3,4,21
191111098,0,0,5,3,2,10
191111099,7,5,3,7,6,28
191111100,6,5,3,0,2,16
191111101,4,0,6,7,6,23
191111102,4,5,1,0,2,12
191111103,9,7,7,4,3,30
191111104,7,8,7,6,0,28
191111105,1,7,6,1,7,22
191111106,6,0,5,1,5,17
191111107,9,5,2,3,0,19
191111108,8,2,8,9,7,34
191111109,0,9,9,7,0,25
191111110,6,4,9,1,6,26
191111111,3,7,9,3,0,22
191111112,6,0,0,3,7,16
191111113,1,0,5,6,7,19
191111114,6,1,6,8,7,28
191111115,9,3,5,2,3,22
191111116,2,5,0,0,0,7
191111117,9,9,5,1,5,29
191111118,6,5,6,8,4,29
191111119,7,0,1,3,8,19
191111120,8,7,5,9,0,29
191111121,7,8,0,9,9,33
191111122,9,4,3,6,0,22
191111123,9,7,3,5,1,25
191111124,1,2,9,3,6,21
191111125,0,0,6,0,2,8
191111126,2,3,2,3,3,13
191111127,4,7,2,4,8,25
191111128,1,8,9,5,2,25
191111129,2,7,9,9,9,36
191111130,7,7,9,5,6,34
191111131,3,3,9,7,2,24
191111132,0,1,4,8,7,20
191111133,8,7,8,8,2,33
191111134,4,9,7,6,4,30
191111135,4,5,4,5,4,22
191111136,3,1,3,7,2,16
191111137,7,7,7,6,9,36
191111138,6,4,5,4,5,24
191111139,7,0,4,0,9,20
191111140,9,3,3,6,4,25
191111141,6,5,3,9,9,32
191111142,8,7,8,8,0,31
191111143,9,7,7,1,0,24
191111144,3,5,8,7,8,31
191111145,2,5,5,4,3,19
191111146,2,1,9,5,7,24
191111147,0,5,1,8,3,17
191111148,1,9,1,4,8,23
191111149,2,2,5,5,0,14
191111150,5,6,2,0,3,16
191111151,7,3,8,2,4,24
191111152,8,4,0,5,1,18
191111153,9,6,8,3,8,34
191111154,5,2,0,6,3,16
191111155,1,2,2,4,6,15
191111156,6,2,1,1,6,16
191111157,4,0,7,3,1,15
191111158,1,1,1,6,4,13
191111159,5,2,9,5,0,21
191111160,6,8,6,1,1,22
191111161,4,7,1,7,5,24
191111162,0,3,9,4,8,24
191111163,8,1,3,7,6,25
191111164,5,1,2,0,2,10
191111165,2,0,4,2,1,9
191111166,3,6,7,2,7,25
191111167,9,9,3,8,5,34
191111168,4,5,5,5,9,28
191111169,1,6,2,1,6,16
191111170,5,3,4,8,8,28
191111171,4,2,0,0,2,8
191111172,3,9,0,8,0,20
191111173,8,6,9,0,5,28
191111174,8,1,0,1,4,14
191111175,2,3,7,8,0,20
191111176,9,8,1,6,1,25
191111177,5,0,6,9,1,21
191111178,0,0,7,5,3,15
191111179,0,6,2,5,2,15
191111180,3,1,2,1,9,16
191111181,0,5,5,2,7,19
191111182,3,5,0,8,6,22
191111183,1,1,4,6,1,13
191111184,4,0,8,8,1,21
191111185,1,9,1,0,6,17
191111186,7,9,0,5,0,21
191111187,1,2,4,9,9,25
191111188,8,6,1,2,0,17
191111189,6,7,7,1,0,21
191111190,4,8,8,7,5,32
191111191,1,5,4,0,6,16
191111192,3,4,6,1,8,22
191111193,9,6,4,0,4,23
191111194,6,4,6,3,2,21
191111195,4,4,9,9,8,34
191111196,1,3,5,7,5,21
191111197,3,5,7,4,0,19
191111198,0,8,2,4,2,16
191111199,8,5,8,5,2,28
191111200,2,7,1,7,3,20
191111201,9,1,3,5,2,20
191111202,8,3,0,9,9,29
191111203,0,6,5,7,2,20
191111204,7,8,8,0,3,26
191111205,6,5,5,6,7,29
191111206,3,8,0,5,8,24
191111207,0,1,2,7,7,17
191111208,0,3,0,0,9,12
191111209,1,2,4,9,8,24
191111210,9,4,5,4,4,26
191111211,8,9,7,2,9,35
191111212,4,2,1,6,5,18
191111213,9,2,1,9,3,24
191111214,7,8,0,5,0,20
191111215,5,4,0,0,9,18
191111216,8,2,2,4,9,25
191111217,1,9,0,3,6,19
191111218,4,4,0,1,4,13
191111219,1,2,4,3,3,13
191111220,1,9,7,5,0,22
191111221,3,3,9,6,8,29
191111222,5,7,0,9,6,27
191111223,4,2,3,1,6,16
191111224,4,3,9,1,5,22
191111225,1,2,3,5,2,13
191111226,9,5,9,2,9,34
191111227,8,7,3,5,6,29
191111228,7,2,5,7,0,21
191111229,6,8,7,3,6,30
191111230,5,0,9,3,1,18
191111231,5,3,3,4,6,21
191111232,6,3,1,0,5,15
191111233,5,0,3,5,5,18
191111234,1,2,4,1,4,12
191111235,0,6,4,7,5,22
191111236,3,8,7,2,2,22
191111237,7,4,7,0,4,22
191111238,5,0,7,2,1,15
191111239,8,6,0,4,9,27
191111240,1,0,4,8,4,17
191111241,5,0,5,5,6,21
191111242,8,1,9,9,4,31
191111243,2,2,9,3,6,22
191111244,8,5,1,8,4,26
191111245,7,1,3,8,9,28
191111246,5,1,6,3,9,24
191111247,3,7,8,9,2,29
191111248,9,3,1,0,7,20
191111249,4,2,5,4,3,18
191111250,3,6,8,9,8,34
191111251,6,2,0,9,4,21
191111252,2,2,3,6,0,13
191111253,2,8,6,2,1,19
191111254,7,7,3,1,9,27
191111255,7,0,5,7,7,26
191111256,6,3,8,8,8,33
191111257,0,3,5,4,9,21
191111258,7,9,0,2,0,18
191111259,4,5,7,4,4,24
191111260,2,0,8,0,4,14
191111261,3,0,4,7,8,22
191111262,9,2,9,3,5,28
191111263,5,8,0,9,6,28
191111264,8,6,3,3,3,23
191111265,1,2,0,1,2,6
191111266,1,9,7,5,5,27
191111267,2,1,0,2,2,7
191111268,4,1,0,9,1,15
191111269,5,9,7,9,5,35
191111270,0,5,6,1,0,12
191111271,1,4,0,1,9,15
191111272,4,7,1,0,2,14
191111273,1,4,2,0,5,12
191111274,6,9,6,0,0,21
191111275,7,7,4,0,7,25
191111276,0,7,4,4,4,19
191111277,8,0,8,0,4,20
191111278,3,5,0,4,4,16
191111279,2,0,9,3,3,17
191111280,5,0,6,8,4,23
191111281,3,0,1,0,3,7
191111282,4,2,2,8,4,20
191111283,6,1,0,1,1,9
191111284,6,1,8,9,7,31
191111285,1,3,4,8,5,21
191111286,0,7,3,3,7,20
191111287,4,5,0,0,8,17
191111288,1,6,9,4,5,25
191111289,4,6,3,3,0,16
191111290,6,8,8,3,8,33
191111291,6,6,5,5,2,24
191111292,4,7,7,6,1,25
191111293,8,5,0,9,5,27
191111294,1,4,7,8,7,27
191111295,1,2,8,6,0,17
191111296,2,5,7,1,9,24
191111297,6,9,3,4,7,29
191111298,3,7,3,4,1,18
191111299,3,8,4,2,3,20
191111300,1,8,6,6,9,30
191111301,9,0,6,9,5,29
191111302,1,8,5,3,5,22
191111303,6,1,0,5,4,16
191111304,9,1,2,7,0,19
191111305,1,3,3,4,2,13
191111306,2,4,2,0,4,12
191111307,0,6,6,2,9,23
191111308,9,2,1,0,4,16
191111309,8,1,3,2,6,20
191111310,7,5,7,0,0,19
191111311,8,5,1,0,1,15
191111312,9,5,7,6,1,28
191111313,0,5,9,9,7,30
191111314,6,6,9,1,8,30
191111315,6,8,0,9,9,32
191111316,6,4,7,2,4,23
191111317,8,1,9,0,4,22
191111318,7,8,9,3,2,29
191111319,3,1,2,7,0,13
191111320,9,6,7,4,2,28
191111321,8,4,9,2,9,32
191111322,5,3,5,6,8,27
191111323,0,8,0,2,8,18
191111324,9,4,5,6,3,27
191111325,0,0,3,2,5,10
191111326,5,8,7,8,4,32
191111327,5,5,2,0,6,18
191111328,4,1,0,7,7,19
191111329,7,5,0,2,7,21
191111330,8,9,1,2,5,25
191111331,3,3,1,8,8,23
191111332,8,9,2,6,2,27
191111333,4,5,2,2,1,14
191111334,4,6,2,1,6,19
191111335,1,9,3,3,6,22
191111336,2,0,4,6,1,13
191111337,5,9,0,1,4,19
191111338,5,7,8,5,5,30
191111339,2,7,4,6,3,22
191111340,8,6,3,3,5,25
191111341,5,5,9,7,8,34
191111342,5,4,3,4,5,21
191111343,7,0,0,5,8,20
191111344,9,3,0,6,2,20
191111345,9,6,2,1,0,18
191111346,0,7,5,4,6,22
191111347,7,2,4,7,5,25
191111348,6,6,1,1,7,21
191111349,0,9,8,7,7,31
191111350,0,4,4,6,6,20
191111351,1,5,7,6,8,27
191111352,6,1,0,4,1,12
191111353,6,6,7,1,7,27
191111354,7,6,9,7,8,37
191111355,8,4,4,0,3,19
191111356,7,0,1,9,3,20
191111357,9,6,4,8,6,33
191111358,1,6,2,4,7,20
191111359,1,3,2,3,0,9
191111360,0,2,9,4,9,24
191111361,4,5,7,4,3,23
191111362,2,0,5,2,5,14
191111363,2,2,4,4,6,18
191111364,3,3,6,0,0,12
191111365,4,2,8,5,9,28
191111366,8,8,1,0,6,23
191111367,9,4,8,6,6,33
191111368,3,4,3,4,8,22
191111369,2,9,7,0,0,18
191111370,0,0,2,2,0,4
191111371,5,2,6,2,3,18
191111372,0,8,4,7,9,28
191111373,9,8,8,6,8,39
191111374,3,4,7,9,0,23
191111375,5,8,5,3,7,28
191111376,5,2,8,1,0,16
191111377,4,7,4,8,5,28
191111378,7,0,5,4,9,25
191111379,8,2,6,8,1,25
191111380,5,1,4,3,2,15
191111381,2,5,9,6,0,22
191111382,9,0,2,8,1,20
191111383,7,6,0,1,7,21
191111384,2,2,3,5,9,21
191111385,9,1,5,9,2,26
191111386,5,7,6,4,1,23
191111387,2,6,5,7,7,27
191111388,8,7,6,2,6,29
191111389,9,4,8,5,5,31
191111390,7,5,5,2,6,25
191111391,5,8,6,9,8,36
191111392,5,5,0,6,7,23
191111393,9,0,0,9,2,20
191111394,8,5,4,7,2,26
191111395,5,6,8,7,8,34
191111396,8,3,5,8,5,29
191111397,9,3,9,8,1,30
191111398,3,1,6,2,6,18
191111399,3,8,4,1,1,17
191111400,3,1,3,2,9,18
191111401,2,6,0,6,4,18
191111402,0,2,5,1,9,17
191111403,0,9,6,4,8,27
191111404,4,9,5,5,3,26
191111405,0,5,0,1,4,10
191111406,8,0,9,8,8,33
191111407,3,4,8,2,6,23
191111408,6,4,5,0,0,15
191111409,7,0,5,4,7,23
191111410,8,6,2,1,9,26
191111411,1,6,6,5,6,24
191111412,2,5,9,3,1,20
191111413,4,9,8,2,5,28
191111414,6,9,0,0,9,24
191111415,4,0,9,9,4,26
191111416,4,3,0,5,3,15
191111417,6,8,9,6,1,30
191111418,6,9,5,7,8,35
191111419,3,9,4,9,9,34
191111420,6,3,6,4,1,20
191111421,5,7,3,3,7,25
191111422,8,9,5,6,1,29
191111423,2,1,4,1,9,17
191111424,2,0,6,8,2,18
191111425,1,9,2,7,4,23
191111426,3,4,8,9,6,30
191111427,2,6,0,7,5,20
191111428,7,2,8,5,6,28
191111429,4,1,2,6,0,13
191111430,3,9,4,8,3,27
191111431,8,3,3,2,3,19
191111432,3,9,3,3,1,19
191111433,8,1,4,2,7,22
191111434,8,2,1,2,5,18
191111435,5,9,1,9,6,30
191111436,8,3,9,7,0,27
191111437,8,2,1,8,7,26
191111438,4,8,6,3,6,27
191111439,4,8,3,8,8,31
191111440,2,4,1,7,2,16
191111441,8,1,0,3,2,14
191111442,5,8,1,4,1,19
191111443,1,8,6,2,9,26
191111444,2,2,3,5,4,16
191111445,2,1,2,1,9,15
191111446,2,7,2,4,1,16
191111447,0,8,8,8,5,29
191111448,8,3,1,5,0,17
191111449,0,6,1,8,4,19
191111450,1,4,7,3,1,16
191111451,3,2,8,6,0,19
191111452,4,9,4,0,0,17
191111453,9,7,0,3,4,23
191111454,8,8,0,0,3,19
191111455,7,5,4,3,2,21
191111456,3,6,0,6,0,15
191111457,9,1,1,5,0,16
191111458,3,1,6,5,9,24
191111459,0,6,1,2,4,13
191111460,4,7,7,3,5,26
191111461,9,0,7,4,3,23
191111462,2,0,3,9,7,21
191111463,7,2,0,2,4,15
191111464,1,1,3,1,5,11
191111465,8,0,4,4,3,19
191111466,2,4,7,4,9,26
191111467,9,1,7,6,6,29
191111468,6,0,5,9,3,23
191111469,4,6,8,1,3,22
191111470,8,6,4,4,8,30
191111471,7,2,8,6,5,28
191111472,6,7,5,8,7,33
191111473,8,6,8,5,0,27
191111474,4,2,4,2,3,15
191111475,0,9,4,6,8,27
191111476,1,2,7,7,8,25
191111477,9,9,4,5,6,33
191111478,6,7,8,6,2,29
191111479,5,4,4,0,1,14
191111480,1,3,4,0,0,8
191111481,9,3,1,2,1,16
191111482,9,0,8,1,1,19
191111483,2,5,2,3,1,13
191111484,6,5,8,8,2,29
191111485,6,6,0,7,9,28
191111486,2,1,8,4,5,20
191111487,1,6,7,9,7,30
191111488,2,3,3,6,9,23
191111489,2,1,6,0,1,10
191111490,9,2,6,5,5,27
191111491,2,7,5,9,2,25
191111492,5,5,3,7,9,29
191111493,1,5,1,9,0,16
191111494,5,1,9,1,1,17
191111495,3,7,9,7,4,30
191111496,3,5,6,7,5,26
191111497,2,9,7,9,7,34
191111498,2,2,0,9,3,16
191111499,3,1,4,2,7,17
191111500,7,6,7,4,9,33
191111501,2,1,2,7,8,20
191111502,0,4,5,4,8,21
191111503,3,5,0,6,9,23
191111504,2,9,9,8,2,30
191111505,6,0,0,0,3,9
191111506,6,4,6,0,5,21
191111507,2,2,5,1,7,17
191111508,6,9,4,8,1,28
191111509,5,5,2,7,6,25
191111510,7,1,9,8,1,26
191111511,1,1,6,9,6,23
191111512,0,0,8,3,4,15
191111513,1,5,9,2,6,23
191111514,0,9,9,1,0,19
191111515,3,4,6,2,2,17
191111516,7,1,2,9,8,27
191111517,9,0,1,4,1,15
191111518,8,7,7,8,3,33
191111519,3,5,8,0,3,19
191111520,9,7,0,8,8,32
191111521,2,1,2,0,5,10
191111522,2,4,1,2,7,16
191111523,1,7,5,7,3,23
191111524,0,3,2,6,9,20
191111525,1,3,8,8,1,21
191111526,5,4,2,3,9,23
191111527,4,4,1,3,7,19
191111528,3,1,8,6,3,21
191111529,7,7,3,8,6,31
191111530,9,7,0,7,6,29
191111531,2,4,2,5,1,14
191111532,6,1,0,1,7,15
191111533,4,6,9,1,3,23
191111534,4,9,6,4,1,24
191111535,7,0,5,4,0,16
191111536,6,4,9,2,4,25
191111537,1,6,0,4,7,18
191111538,0,4,1,5,3,13
191111539,6,8,6,6,4,30
191111540,5,5,5,7,3,25
191111541,1,7,1,6,1,16
191111542,7,9,3,3,5,27
191111543,1,0,0,6,1,8
191111544,1,5,2,3,0,11
191111545,3,2,1,5,1,12
191111546,5,2,2,4,8,21
191111547,8,5,8,3,5,29
191111548,2,5,6,2,3,18
191111549,6,6,5,4,2,23
191111550,7,3,4,7,9,30
191111551,9,0,5,6,3,23
191111552,9,1,5,3,0,18
191111553,9,5,7,3,7,31
191111554,9,9,6,4,9,37
191111555,3,9,8,5,2,27
191111556,1,8,2,3,4,18
191111557,8,4,0,9,8,29
191111558,9,1,0,0,8,18
191111559,8,3,8,2,0,21
191111560,0,2,3,2,3,10
191111561,2,2,3,6,2,15
191111562,5,8,3,3,3,22
191111563,7,8,3,8,6,32
191111564,9,6,6,8,0,29
191111565,8,7,2,4,4,25
191111566,2,7,0,6,5,20
191111567,0,7,6,7,0,20
191111568,7,5,0,3,5,20
191111569,2,9,7,2,1,21
191111570,3,1,9,2,6,21
191111571,5,1,0,0,1,7
191111572,0,5,4,2,0,11
191111573,2,3,7,7,6,25
191111574,5,3,7,3,5,23
191111575,9,1,9,2,9,30
191111576,9,6,2,2,3,22
191111577,1,5,6,8,7,27
191111578,2,7,9,8,7,33
191111579,8,8,9,4,0,29
191111580,1,4,0,0,2,7
191111581,2,9,8,3,4,26
191111582,6,8,0,2,7,23
191111583,0,4,9,0,1,14
191111584,9,9,9,9,3,39
191111585,8,1,4,4,7,24
191111586,9,9,8,3,3,32
191111587,7,3,6,4,7,27
191111588,4,6,4,1,6,21
191111589,3,2,7,2,2,16
191111590,5,8,8,3,3,27
191111591,7,0,3,1,0,11
191111592,5,2,0,9,4,20
191111593,4,2,9,7,2,24
191111594,6,4,1,9,3,23
191111595,1,6,8,3,5,23
191111596,0,6,2,2,8,18
191111597,6,9,4,7,4,30
191111598,6,2,9,0,1,18
191111599,3,7,8,7,7,32
191111600,0,1,6,3,6,16
191111601,5,0,4,0,9,18
191111602,7,0,2,5,2,16
191111603,6,8,6,2,6,28
191111604,6,1,2,4,7,20
191111605,9,3,9,4,8,33
191111606,5,8,4,3,3,23
191111607,7,0,2,4,4,17
191111608,7,3,6,7,2,25
191111609,1,4,2,8,0,15
191111610,7,0,7,5,3,22
191111611,6,8,7,5,5,31
191111612,7,1,9,0,3,20
191111613,8,8,0,9,1,26
191111614,8,5,4,1,5,23
191111615,5,7,0,1,0,13
191111616,4,0,3,5,6,18
191111617,2,1,6,5,5,19
191111618,4,8,3,1,2,18
191111619,6,8,4,9,9,36
191111620,7,0,2,9,3,21
191111621,2,3,1,7,2,15
191111622,5,2,4,8,4,23
191111623,5,4,9,2,5,25
191111624,7,4,7,1,0,19
191111625,1,7,1,6,8,23
191111626,0,8,4,7,5,24
191111627,7,8,9,6,7,37
191111628,4,2,3,3,0,12
191111629,0,7,0,1,9,17
191111630,4,5,8,1,8,26
191111631,0,8,7,8,3,26
191111632,3,1,1,2,4,11
191111633,2,7,7,6,2,24
191111634,0,9,4,5,1,19
191111635,2,0,2,7,0,11
191111636,2,7,8,0,1,18
191111637,0,3,2,5,7,17
191111638,4,2,8,1,5,20
191111639,1,3,9,0,5,18
191111640,0,4,7,3,5,19
191111641,3,0,6,8,9,26
191111642,7,1,9,5,0,22
191111643,2,4,6,6,5,23
191111644,5,6,1,7,2,21
191111645,0,3,4,2,8,17
191111646,7,1,4,5,3,20
191111647,8,9,0,8,3,28
191111648,8,4,5,3,9,29
191111649,0,7,4,0,0,11
191111650,5,4,8,7,4,28
191111651,6,1,1,5,1,14
191111652,0,9,9,6,1,25
191111653,8,0,8,4,5,25
191111654,0,1,0,2,4,7
191111655,2,3,5,0,3,13
191111656,2,6,0,7,6,21
191111657,3,8,2,5,3,21
191111658,5,9,4,4,3,25
191111659,3,4,5,7,5,24
191111660,7,1,0,0,0,8
191111661,3,2,2,4,1,12
191111662,8,5,8,8,9,38
191111663,6,6,2,5,4,23
191111664,9,9,7,9,4,38
191111665,5,2,8,3,3,21
191111666,1,0,1,2,8,12
191111667,6,2,5,0,3,16
191111668,2,4,1,7,7,21
191111669,5,0,6,3,7,21
191111670,9,1,4,6,7,27
191111671,1,6,3,6,7,23
191111672,0,4,7,8,8,27
191111673,0,4,9,4,8,25
191111674,6,6,9,4,7,32
191111675,1,2,9,4,6,22
191111676,7,4,1,3,4,19
191111677,9,9,4,2,5,29
191111678,1,0,4,7,5,17
191111679,8,5,2,9,1,25
191111680,8,1,4,8,0,21
191111681,0,4,2,3,8,17
191111682,2,6,0,4,5,17
191111683,7,0,2,7,1,17
191111684,8,6,6,6,0,26
191111685,7,6,3,2,2,20
191111686,6,4,0,1,9,20
191111687,4,6,2,3,2,17
191111688,9,7,3,0,7,26
191111689,3,8,7,7,9,34
191111690,3,5,8,7,9,32
191111691,9,7,7,7,2,32
191111692,2,3,5,7,6,23
191111693,6,2,5,7,4,24
191111694,4,1,1,2,9,17
191111695,6,0,7,2,0,15
191111696,8,7,4,6,6,31
191111697,5,8,2,4,0,19
191111698,9,1,5,4,0,19
191111699,4,4,1,8,2,19
191111700,7,9,2,3,1,22
191111701,8,1,3,0,5,17
191111702,3,3,5,0,7,18
191111703,4,2,5,6,5,22
191111704,7,5,6,4,2,24
191111705,1,1,0,8,6,16
191111706,5,3,7,2,6,23
191111707,2,8,0,5,1,16
191111708,9,8,3,3,2,25
191111709,3,2,8,8,2,23
191111710,5,3,7,7,7,29
191111711,5,5,2,0,0,12
191111712,0,9,2,9,4,24
191111713,3,4,1,4,8,20
191111714,2,3,2,8,2,17
191111715,4,4,9,9,7,33
191111716,2,3,8,9,7,29
191111717,5,4,6,2,8,25
191111718,1,3,9,7,6,26
191111719,1,6,7,1,2,17
191111720,7,8,9,9,1,34
191111721,9,6,1,1,4,21
191111722,7,1,2,1,6,17
191111723,9,3,7,9,7,35
191111724,4,3,4,5,4,20
191111725,0,1,8,4,4,17
191111726,5,4,2,1,1,13
191111727,7,7,5,0,1,20
191111728,9,4,9,3,0,25
191111729,2,8,0,2,1,13
191111730,4,4,4,6,5,23
191111731,4,4,6,0,1,15
191111732,1,7,0,1,7,16
191111733,5,9,5,2,7,28
191111734,5,1,7,1,8,22
191111735,2,8,1,3,2,16
191111736,9,1,0,5,7,22
191111737,2,8,8,5,7,30
191111738,2,9,4,8,8,31
191111739,0,9,8,4,8,29
191111740,9,9,4,2,7,31
191111741,4,2,8,3,9,26
191111742,9,5,3,3,1,21
191111743,4,1,4,6,0,15
191111744,3,7,7,5,6,28
191111745,6,1,5,8,7,27
191111746,6,4,1,9,7,27
191111747,9,8,7,1,0,25
191111748,4,2,6,1,8,21
191111749,0,6,5,7,8,26
191111750,1,2,9,4,5,21
191111751,1,9,8,6,4,28
191111752,9,8,8,9,5,39
191111753,2,9,6,4,1,22
191111754,3,2,0,2,0,7
191111755,7,6,4,8,0,25
191111756,9,3,3,6,2,23
191111757,9,9,4,9,3,34
191111758,7,7,2,4,9,29
191111759,5,3,7,8,8,31
191111760,6,5,8,0,9,28
191111761,7,6,5,8,6,32
191111762,4,5,4,5,1,19
191111763,3,6,0,8,6,23
191111764,2,7,3,4,1,17
191111765,1,7,9,6,7,30
191111766,5,7,8,2,1,23
191111767,2,3,2,8,5,20
191111768,2,0,9,3,1,15
191111769,4,1,4,7,2,18
191111770,4,5,8,8,4,29
191111771,3,9,9,3,6,30
191111772,1,9,4,9,9,32
191111773,0,0,0,0,7,7
191111774,8,1,7,6,5,27
191111775,1,3,2,0,6,12
191111776,5,4,4,1,4,18
191111777,6,0,8,2,9,25
191111778,4,0,3,6,8,21
191111779,3,1,4,5,0,13
191111780,8,7,0,7,7,29
191111781,9,0,6,2,5,22
191111782,3,5,8,3,7,26
191111783,8,8,6,1,8,31
191111784,5,3,0,0,9,17
191111785,3,7,9,4,1,24
191111786,4,6,3,0,8,21
191111787,6,9,8,2,5,30
191111788,8,1,8,1,3,21
191111789,9,0,0,6,7,22
191111790,2,3,7,2,2,16
191111791,8,3,8,2,7,28
191111792,2,1,9,9,9,30
191111793,8,8,4,7,2,29
191111794,5,3,8,0,5,21
191111795,0,7,5,9,1,22
191111796,6,8,2,7,2,25
191111797,9,7,5,9,0,30
191111798,2,4,6,7,6,25
191111799,7,6,5,6,2,26
191111800,5,9,7,5,1,27
191111801,6,3,8,7,5,29
191111802,8,9,0,9,5,31
191111803,3,3,3,3,0,12
191111804,4,0,0,6,0,10
191111805,6,4,3,9,5,27
191111806,2,9,3,9,1,24
191111807,9,9,7,1,9,35
191111808,5,1,8,3,5,22
191111809,9,6,5,3,0,23
191111810,3,4,0,4,1,12
191111811,6,9,8,8,7,38
191111812,5,2,7,8,6,28
191111813,7,7,5,7,0,26
191111814,9,6,7,3,5,30
191111815,1,9,1,5,6,22
191111816,4,5,5,5,1,20
191111817,5,5,0,5,6,21
191111818,8,2,7,0,7,24
191111819,3,9,3,1,9,25
191111820,9,4,4,7,3,27
191111821,3,0,8,1,1,13
191111822,0,8,5,9,1,23
191111823,8,5,7,1,8,29
191111824,9,6,8,4,1,28
191111825,8,3,8,5,1,25
191111826,7,7,8,8,4,34
191111827,7,4,1,7,5,24
191111828,8,0,2,9,6,25
191111829,5,7,8,7,7,34
191111830,9,1,9,6,2,27
191111831,7,6,5,5,1,24
191111832,0,5,9,8,6,28
191111833,6,3,7,0,7,23
191111834,5,1,3,9,9,27
191111835,8,3,3,2,2,18
191111836,4,0,1,6,3,14
191111837,6,3,0,8,7,24
191111838,8,5,8,9,4,34
191111839,8,2,7,5,5,27
191111840,7,0,0,6,5,18
191111841,5,2,7,7,3,24
191111842,1,5,1,6,1,14
191111843,2,1,4,5,7,19
191111844,6,1,2,8,9,26
191111845,2,0,0,7,2,11
191111846,2,2,9,5,4,22
191111847,6,2,3,9,8,28
191111848,4,5,9,5,7,30
191111849,9,8,3,3,0,23
191111850,4,2,4,0,4,14
191111851,4,5,0,8,8,25
191111852,1,7,6,9,7,30
191111853,7,7,6,0,6,26
191111854,2,1,2,0,0,5
191111855,2,2,3,9,6,22
191111856,6,7,8,6,1,28
191111857,3,6,5,1,6,21
191111858,5,7,8,3,2,25
191111859,5,0,4,6,5,20
191111860,1,3,5,9,3,21
191111861,9,5,0,7,2,23
191111862,9,1,6,7,0,23
191111863,2,5,1,4,1,13
191111864,7,0,7,3,6,23
191111865,8,6,2,0,8,24
191111866,1,7,3,5,6,22
191111867,3,2,0,5,6,16
191111868,1,4,2,7,2,16
191111869,6,2,4,5,4,21
191111870,1,4,8,6,5,24
191111871,1,2,4,6,8,21
191111872,1,9,8,8,9,35
191111873,3,2,6,3,6,20
191111874,7,1,2,1,4,15
191111875,0,1,7,6,2,16
191111876,0,2,8,0,0,10
191111877,4,5,5,0,6,20
191111878,0,9,3,7,9,28
191111879,9,9,7,0,7,32
191111880,0,2,2,9,3,16
191111881,5,2,1,6,6,20
191111882,6,4,8,2,4,24
191111883,1,2,6,1,5,15
191111884,9,1,9,4,0,23
191111885,2,6,5,6,1,20
191111886,3,0,5,4,6,18
191111887,4,1,1,3,5,14
191111888,1,0,2,1,6,10
191111889,4,6,9,0,2,21
191111890,6,8,6,7,7,34
191111891,2,5,1,8,6,22
191111892,1,1,2,6,0,10
191111893,7,1,4,2,9,23
191111894,6,9,1,2,9,27
191111895,2,0,7,7,6,22
191111896,0,2,5,2,3,12
191111897,0,1,4,7,8,20
191111898,4,7,5,5,5,26
191111899,4,3,5,6,4,22
191111900,0,8,9,9,9,35
191111901,0,5,7,2,0,14
191111902,6,2,0,0,6,14
191111903,7,1,8,4,6,26
191111904,4,0,8,5,8,25
191111905,2,2,0,1,8,13
191111906,2,2,0,6,0,10
191111907,6,0,7,1,5,19
191111908,6,2,9,0,5,22
191111909,9,9,5,1,2,26
191111910,1,2,3,7,6,19
191111911,8,0,5,4,5,22
191111912,8,1,5,7,2,23
191111913,9,3,9,4,2,27
191111914,2,8,5,4,0,19
191111915,8,4,7,7,7,33
191111916,0,6,9,1,6,22
191111917,4,7,4,9,9,33
191111918,3,2,7,2,0,14
191111919,3,0,6,8,0,17
191111920,2,1,8,2,1,14
191111921,5,9,9,7,9,39
191111922,3,6,3,9,8,29
191111923,5,5,6,3,5,24
191111924,4,9,9,3,6,31
191111925,8,9,1,2,4,24
191111926,6,8,5,1,2,22
191111927,5,1,6,4,6,22
191111928,0,5,6,4,2,17
191111929,3,7,7,3,2,22
191111930,4,1,3,6,4,18
191111931,3,5,8,7,7,30
191111932,5,5,2,8,3,23
191111933,3,6,7,3,9,28
191111934,7,3,8,5,8,31
191111935,3,8,6,3,6,26
191111936,9,7,9,6,0,31
191111937,0,6,2,8,1,17
191111938,6,1,6,2,4,19
191111939,2,2,1,6,6,17
191111940,8,7,3,1,7,26
191111941,7,5,9,6,6,33
191111942,7,7,3,1,4,22
191111943,1,6,2,5,2,16
191111944,0,0,4,9,7,20
191111945,0,9,4,8,5,26
191111946,7,0,0,5,9,21
191111947,3,7,7,4,3,24
191111948,2,0,4,6,9,21
191111949,2,0,9,9,5,25
191111950,1,4,6,6,5,22
191111951,9,4,2,0,1,16
191111952,9,3,1,1,4,18
191111953,2,5,3,3,6,19
191111954,7,4,5,5,9,30
191111955,1,2,2,9,4,18
191111956,9,1,0,5,3,18
191111957,7,6,5,7,6,31
191111958,2,0,7,2,3,14
191111959,1,4,0,5,7,17
191111960,1,8,7,9,9,34
191111961,2,3,6,4,1,16
191111962,6,0,6,1,3,16
191111963,8,1,2,2,9,22
191111964,5,9,3,5,8,30
191111965,9,2,7,4,8,30
191111966,2,0,1,1,8,12
191111967,2,8,4,9,7,30
191111968,7,0,3,2,6,18
191111969,8,5,9,4,4,30
191111970,6,0,0,4,6,16
191111971,9,7,0,9,6,31
191111972,8,1,0,8,6,23
191111973,7,2,7,5,2,23
191111974,5,5,9,2,4,25
191111975,6,0,1,4,8,19
191111976,6,4,3,7,5,25
191111977,6,5,4,1,9,25
191111978,7,0,6,5,7,25
191111979,7,5,3,6,2,23
191111980,9,7,7,4,1,28
191111981,2,5,8,3,0,18
191111982,5,5,2,4,0,16
191111983,8,5,0,7,7,27
191111984,0,4,8,7,9,28
191111985,5,1,9,0,5,20
191111986,2,6,4,2,2,16
191111987,3,5,0,7,3,18
191111988,3,5,8,9,5,30
191111989,3,7,7,3,6,26
191111990,5,8,8,6,5,32
191111991,9,6,3,2,2,22
191111992,5,1,0,5,4,15
191111993,5,5,9,7,3,29
191111994,5,8,8,4,3,28
191111995,4,5,0,5,0,14
191111996,9,7,0,7,4,27
191111997,9,5,5,6,5,30
191111998,2,4,2,1,8,17
191111999,6,7,8,2,3,26
1911111000,8,2,6,3,4,23
1911111001,7,7,5,1,8,28
1911111002,0,4,9,2,9,24
1911111003,7,9,7,1,4,28
1911111004,6,1,1,0,0,8
1911111005,1,5,1,8,5,20
1911111006,6,5,8,8,6,33
1911111007,5,7,6,9,5,32
1911111008,2,3,6,3,1,15
1911111009,8,5,3,8,6,30
1911111010,8,6,8,9,2,33
1911111011,7,5,0,2,9,23
1911111012,2,0,4,9,2,17
1911111013,9,6,6,9,7,37
1911111014,3,6,5,5,3,22
1911111015,6,7,9,6,5,33
1911111016,3,5,3,6,9,26
1911111017,2,3,1,7,9,22
1911111018,8,4,4,8,6,30
1911111019,3,5,8,0,9,25
1911111020,1,1,4,0,6,12
1911111021,8,1,4,4,2,19
1911111022,2,2,4,3,9,20
1911111023,2,2,5,4,2,15
1911111024,1,7,8,0,7,23
1911111025,8,5,6,2,3,24
1911111026,5,2,1,0,6,14
1911111027,9,1,2,0,1,13
1911111028,1,7,2,3,7,20
1911111029,1,2,6,2,7,18
1911111030,3,5,8,9,3,28
1911111031,1,5,8,8,4,26
1911111032,6,1,4,6,7,24
1911111033,4,5,4,8,8,29
1911111034,6,6,7,8,9,36
1911111035,5,9,9,2,2,27
1911111036,2,2,1,3,7,15
1911111037,1,1,8,7,1,18
1911111038,7,5,4,0,5,21
1911111039,2,1,1,1,6,11
1911111040,4,1,2,6,4,17
1911111041,6,5,5,5,6,27
1911111042,8,8,7,5,2,30
1911111043,9,8,0,8,0,25
1911111044,2,4,1,7,9,23
1911111045,3,4,4,3,8,22
1911111046,4,2,2,5,4,17
1911111047,2,6,6,7,8,29
1911111048,8,0,7,3,3,21
1911111049,1,4,0,6,8,19
1911111050,7,0,4,8,3,22
1911111051,2,6,0,5,1,14
1911111052,1,2,6,5,3,17
1911111053,1,0,3,5,5,14
1911111054,9,5,1,2,7,24
1911111055,6,8,7,2,1,24
1911111056,4,1,8,6,4,23
1911111057,5,8,7,8,8,36
1911111058,6,7,0,0,6,19
1911111059,6,1,5,5,1,18
1911111060,1,2,3,8,3,17
1911111061,0,7,8,9,4,28
1911111062,6,3,6,2,8,25
1911111063,1,8,3,8,1,21
1911111064,9,2,0,9,3,23
1911111065,0,5,6,3,4,18
1911111066,0,2,6,7,5,20
1911111067,2,9,3,9,4,27
1911111068,2,2,9,0,8,21
1911111069,9,9,8,1,6,33
1911111070,7,0,2,2,7,18
1911111071,8,9,6,6,8,37
1911111072,7,1,4,6,1,19
1911111073,9,3,7,1,9,29
1911111074,9,3,3,2,4,21
1911111075,0,5,2,6,8,21
1911111076,3,0,5,2,2,12
1911111077,0,9,0,4,4,17
1911111078,4,0,3,1,8,16
1911111079,7,5,0,0,2,14
1911111080,6,9,7,0,3,25
1911111081,6,1,6,5,5,23
1911111082,4,6,0,5,6,21
1911111083,0,8,9,0,1,18
1911111084,2,1,0,5,6,14
1911111085,6,9,3,6,0,24
1911111086,5,3,6,6,0,20
1911111087,9,2,4,3,5,23
1911111088,9,3,7,6,6,31
1911111089,0,0,9,8,3,20
1911111090,1,4,6,8,4,23
1911111091,7,0,9,6,7,29
1911111092,1,0,7,6,1,15
1911111093,7,8,4,2,8,29
1911111094,9,6,7,1,2,25
1911111095,0,2,5,8,9,24
1911111096,6,0,0,8,3,17
1911111097,8,3,0,8,1,20
1911111098,9,7,3,3,9,31
1911111099,9,1,4,9,3,26
1911111100,5,9,1,3,0,18
1911111101,4,9,2,6,7,28
1911111102,8,8,9,6,7,38
1911111103,7,2,9,8,6,32
1911111104,6,4,0,2,1,13
1911111105,9,9,4,7,5,34
191112001,9,6,6,4,7,32
191112002,8,8,5,8,9,38
191112003,9,3,4,4,8,28
191112004,8,5,1,7,7,28
191112005,1,8,6,0,4,19
191112006,5,0,2,3,2,12
191112007,4,5,3,3,5,20
191112008,9,4,9,5,7,34
191112009,6,2,3,1,6,18
191112010,4,6,4,5,3,22
191112011,2,7,5,7,4,25
191112012,4,2,5,5,7,23
191112013,1,4,6,9,0,20
191112014,2,9,4,8,5,28
191112015,2,9,6,1,0,18
191112016,1,6,8,4,4,23
191112017,6,6,9,0,0,21
191112018,9,3,3,9,4,28
191112019,4,3,5,1,1,14
191112020,1,9,1,1,9,21
191112021,3,7,8,5,6,29
191112022,5,3,7,2,1,18
191112023,3,6,4,7,7,27
191112024,7,0,8,8,6,29
191112025,1,7,2,8,4,22
191112026,7,9,6,4,9,35
191112027,5,0,3,4,3,15
191112028,0,3,8,5,9,25
191112029,1,2,2,8,6,19
191112030,3,0,8,5,3,19
191112031,1,4,5,0,8,18
191112032,4,5,7,4,1,21
191112033,0,7,8,1,1,17
191112034,5,5,8,8,5,31
191112035,2,0,7,2,6,17
191112036,2,8,6,3,4,23
191112037,0,3,4,0,5,12
191112038,4,3,5,3,4,19
191112039,9,1,7,6,9,32
191112040,9,5,5,0,1,20
191112041,6,8,5,4,1,24
191112042,9,1,3,5,6,24
191112043,3,8,7,5,0,23
191112044,2,0,1,7,7,17
191112045,4,4,7,2,8,25
191112046,5,1,7,6,8,27
191112047,4,2,1,9,7,23
191112048,4,3,6,8,1,22
191112049,6,5,0,3,6,20
191112050,1,3,5,4,2,15
191112051,6,6,6,3,5,26
191112052,7,1,0,7,4,19
191112053,1,8,0,0,0,9
191112054,9,5,7,0,5,26
191112055,1,1,8,3,8,21
191112056,5,1,8,0,0,14
191112057,5,8,1,9,5,28
191112058,2,7,9,4,1,23
191112059,2,5,3,7,8,25
191112060,9,6,8,7,6,36
191112061,0,3,5,7,9,24
191112062,9,0,4,8,1,22
191112063,0,5,8,4,2,19
191112064,1,5,8,9,0,23
191112065,2,7,5,5,9,28
191112066,4,5,3,5,8,25
191112067,4,8,6,3,2,23
191112068,9,6,2,5,0,22
191112069,0,4,5,4,3,16
191112070,3,8,5,3,7,26
191112071,5,3,1,1,5,15
191112072,0,6,3,9,5,23
191112073,1,2,6,5,1,15
191112074,5,5,8,4,2,24
191112075,0,4,5,5,8,22
191112076,9,7,3,0,6,25
191112077,1,1,5,8,5,20
191112078,4,1,2,5,5,17
191112079,8,9,0,2,7,26
191112080,1,0,7,8,7,23
191112081,0,9,6,3,9,27
191112082,9,1,7,1,7,25
191112083,6,0,3,8,8,25
191112084,1,2,8,2,3,16
191112085,0,5,6,7,2,20
191112086,0,1,8,0,9,18
191112087,8,9,9,3,3,32
191112088,7,1,4,0,9,21
191112089,5,0,2,7,0,14
191112090,4,8,8,0,2,22
191112091,4,2,4,4,6,20
191112092,2,6,3,2,1,14
191112093,7,8,9,5,3,32
191112094,9,0,9,8,3,29
191112095,7,5,1,0,7,20
191112096,6,9,8,6,7,36
191112097,9,0,5,9,3,26
191112098,7,2,2,8,4,23
191112099,5,4,9,6,0,24
191112100,5,5,5,5,3,23
191112101,0,4,7,2,9,22
191112102,9,2,6,0,9,26
191112103,9,1,5,7,6,28
191112104,3,2,3,1,5,14
191112105,7,9,2,7,6,31
191112106,7,7,6,2,8,30
191112107,3,5,4,2,6,20
191112108,0,4,8,2,7,21
191112109,1,7,2,8,9,27
191112110,9,3,8,5,4,29
191112111,3,7,4,4,4,22
191112112,9,5,5,3,2,24
191112113,3,4,7,8,0,22
191112114,2,4,4,7,1,18
191112115,6,1,1,8,3,19
191112116,4,6,5,1,5,21
191112117,3,6,5,9,7,30
191112118,2,6,6,3,1,18
191112119,8,8,9,7,8,40
191112120,4,6,3,1,7,21
191112121,4,1,1,7,5,18
191112122,7,8,2,3,9,29
191112123,8,9,0,1,7,25
191112124,8,1,4,7,9,29
191112125,0,4,9,9,2,24
191112126,8,1,2,5,0,16
191112127,0,0,2,4,2,8
191112128,1,1,9,6,2,19
191112129,4,1,3,8,4,20
191112130,6,4,4,4,9,27
191112131,9,9,3,4,6,31
191112132,4,7,1,2,1,15
191112133,2,3,0,3,3,11
191112134,8,7,4,4,6,29
191112135,3,1,8,6,2,20
191112136,7,6,3,9,0,25
191112137,2,6,2,3,7,20
191112138,1,5,0,1,3,10
191112139,4,8,2,7,1,22
191112140,3,2,3,5,0,13
191112141,6,2,0,0,0,8
191112142,0,2,0,5,2,9
191112143,8,1,9,6,8,32
191112144,2,2,1,4,6,15
191112145,7,0,6,5,8,26
191112146,9,1,9,6,5,30
191112147,7,0,3,1,2,13
191112148,6,4,0,6,2,18
191112149,3,7,7,9,4,30
191112150,6,7,0,5,7,25
191112151,3,9,8,7,4,31
191112152,7,8,4,5,3,27
191112153,0,8,4,2,2,16
191112154,5,1,5,1,7,19
191112155,1,8,4,7,9,29
191112156,2,1,8,0,2,13
191112157,6,2,7,8,0,23
191112158,3,0,3,4,3,13
191112159,7,1,5,8,1,22
191112160,3,5,5,4,9,26
191112161,7,0,2,8,9,26
191112162,7,1,1,2,0,11
191112163,0,5,5,0,9,19
191112164,6,0,9,2,5,22
191112165,5,3,3,3,2,16
191112166,0,9,3,8,7,27
191112167,5,9,2,1,8,25
191112168,1,1,8,3,9,22
191112169,9,5,8,3,8,33
191112170,5,7,4,7,8,31
191112171,2,2,9,3,3,19
191112172,3,3,8,6,9,29
191112173,0,6,4,2,0,12
191112174,1,2,1,1,3,8
191112175,4,9,1,3,8,25
191112176,1,9,5,8,6,29
191112177,9,4,8,3,4,28
191112178,0,3,1,3,5,12
191112179,2,5,4,9,5,25
191112180,8,7,8,9,8,40
191112181,8,5,1,5,8,27
191112182,9,4,1,5,2,21
191112183,5,1,3,6,2,17
191112184,4,9,0,2,4,19
191112185,2,1,2,8,3,16
191112186,9,0,5,9,4,27
191112187,8,8,4,3,5,28
191112188,6,4,9,3,7,29
191112189,9,5,6,2,4,26
191112190,6,3,7,5,3,24
191112191,3,9,4,4,4,24
191112192,8,5,2,2,1,18
191112193,1,8,0,0,4,13
191112194,2,3,1,5,5,16
191112195,5,3,6,9,6,29
191112196,2,6,1,4,8,21
191112197,1,4,0,7,1,13
191112198,1,9,2,4,5,21
191112199,9,2,6,1,6,24
191112200,2,8,2,2,4,18
191112201,2,8,4,4,3,21
191112202,2,0,1,8,6,17
191112203,3,3,1,5,7,19
191112204,3,2,4,7,7,23
191112205,5,4,3,4,5,21
191112206,6,4,8,2,1,21
191112207,4,0,1,1,1,7
191112208,5,8,5,0,1,19
191112209,0,7,9,1,5,22
191112210,3,4,3,4,5,19
191112211,4,0,2,8,8,22
191112212,9,3,8,9,8,37
191112213,9,0,4,5,2,20
191112214,2,7,8,9,4,30
191112215,7,1,7,1,2,18
191112216,5,3,3,1,0,12
191112217,3,9,8,3,5,28
191112218,0,8,8,0,4,20
191112219,6,5,4,0,9,24
191112220,0,3,3,8,6,20
191112221,2,9,1,2,7,21
191112222,6,1,1,2,2,12
191112223,8,9,1,8,0,26
191112224,1,3,2,1,7,14
191112225,4,0,8,4,6,22
191112226,2,7,1,5,8,23
191112227,1,6,3,1,0,11
191112228,5,9,8,4,0,26
191112229,2,2,6,8,8,26
191112230,7,6,1,7,3,24
191112231,4,7,5,0,9,25
191112232,8,7,2,7,8,32
191112233,6,8,7,6,1,28
191112234,0,4,2,8,7,21
191112235,1,9,6,2,4,22
191112236,4,5,1,4,1,15
191112237,2,2,5,9,8,26
191112238,0,1,2,5,4,12
191112239,2,3,4,7,9,25
191112240,5,9,3,6,6,29
191112241,8,2,5,7,5,27
191112242,4,8,0,0,1,13
191112243,3,8,5,1,1,18
191112244,0,7,3,0,8,18
191112245,9,3,8,8,7,35
191112246,7,9,5,7,8,36
191112247,1,7,9,4,5,26
191112248,5,5,1,3,2,16
191112249,4,3,9,7,9,32
191112250,0,0,7,3,6,16
191112251,1,0,9,5,0,15
191112252,1,7,6,5,8,27
191112253,6,8,6,8,0,28
191112254,6,6,7,2,5,26
191112255,0,4,4,8,1,17
191112256,9,2,3,6,4,24
191112257,8,4,2,0,0,14
191112258,1,2,4,6,5,18
191112259,2,9,7,5,1,24
191112260,9,6,9,6,5,35
191112261,9,5,1,8,5,28
191112262,4,4,5,3,1,17
191112263,3,3,5,0,1,12
191112264,5,4,6,8,5,28
191112265,7,1,4,5,0,17
191112266,6,3,2,2,6,19
191112267,4,4,4,7,2,21
191112268,7,4,7,7,4,29
191112269,2,3,9,4,0,18
191112270,3,3,2,9,4,21
191112271,1,5,1,1,5,13
191112272,8,1,2,1,4,16
191112273,3,5,0,8,8,24
191112274,7,0,0,3,6,16
191112275,4,4,9,4,7,28
191112276,1,5,6,1,5,18
191112277,1,0,9,2,5,17
191112278,7,0,9,9,7,32
191112279,3,6,8,3,5,25
191112280,0,2,6,9,0,17
191112281,8,4,3,9,8,32
191112282,3,8,6,6,2,25
191112283,0,0,6,8,1,15
191112284,7,6,7,3,8,31
191112285,6,0,1,1,5,13
191112286,7,9,3,9,5,33
191112287,1,3,0,7,3,14
191112288,7,7,5,8,3,30
191112289,4,4,8,0,0,16
191112290,5,6,2,0,6,19
191112291,4,7,2,0,9,22
191112292,0,6,7,9,8,30
191112293,8,4,3,3,2,20
191112294,7,3,8,9,3,30
191112295,6,6,0,4,9,25
191112296,9,8,8,8,2,35
191112297,3,4,3,1,7,18
191112298,4,0,0,7,9,20
191112299,4,3,6,5,8,26
191112300,0,9,4,1,2,16
191112301,1,1,7,6,9,24
191112302,6,9,0,5,9,29
191112303,0,5,4,4,6,19
191112304,1,2,3,9,1,16
191112305,8,9,2,9,8,36
191112306,4,2,4,5,4,19
191112307,9,1,3,7,0,20
191112308,9,1,0,6,5,21
191112309,1,4,2,0,3,10
191112310,6,4,4,3,9,26
191112311,5,5,7,3,2,22
191112312,6,8,3,5,4,26
191112313,7,9,7,6,1,30
191112314,7,4,7,1,4,23
191112315,5,8,8,0,7,28
191112316,0,3,2,8,4,17
191112317,1,2,8,3,4,18
191112318,7,6,2,2,7,24
191112319,4,0,2,2,8,16
191112320,2,8,2,4,6,22
191112321,8,6,1,0,6,21
191112322,8,0,3,8,5,24
191112323,2,7,7,6,8,30
191112324,8,6,2,5,8,29
191112325,5,8,4,2,6,25
191112326,9,7,7,6,2,31
191112327,1,7,5,0,7,20
191112328,5,7,6,3,2,23
191112329,3,6,3,5,0,17
191112330,4,4,3,7,2,20
191112331,4,1,0,6,9,20
191112332,4,3,6,0,2,15
191112333,1,3,0,5,9,18
191112334,7,0,1,7,3,18
191112335,3,6,0,9,5,23
191112336,7,5,1,7,3,23
191112337,3,9,0,8,9,29
191112338,2,9,1,3,7,22
191112339,7,8,3,8,2,28
191112340,7,2,3,5,0,17
191112341,8,0,0,0,9,17
191112342,6,3,3,3,0,15
191112343,8,5,5,4,4,26
191112344,9,4,4,8,5,30
191112345,8,7,6,3,0,24
191112346,7,4,4,3,4,22
191112347,1,8,8,2,3,22
191112348,6,6,9,1,1,23
191112349,7,1,9,3,1,21
191112350,7,5,6,5,2,25
191112351,4,4,9,4,8,29
191112352,9,9,0,2,8,28
191112353,0,7,5,1,1,14
191112354,4,6,2,2,6,20
191112355,2,0,1,1,7,11
191112356,9,3,7,1,6,26
191112357,2,2,9,0,5,18
191112358,4,9,3,3,8,27
191112359,0,7,5,8,7,27
191112360,1,3,9,3,3,19
191112361,4,2,6,7,5,24
191112362,4,6,1,3,4,18
191112363,5,4,6,9,5,29
191112364,5,2,3,2,1,13
191112365,6,1,2,2,2,13
191112366,9,3,0,2,8,22
191112367,3,2,0,1,4,10
191112368,6,2,5,0,8,21
191112369,5,0,9,6,9,29
191112370,7,8,7,6,4,32
191112371,7,1,9,6,4,27
191112372,8,6,6,8,1,29
191112373,3,7,9,0,0,19
191112374,5,1,1,5,9,21
191112375,6,2,7,6,7,28
191112376,7,4,3,7,9,30
191112377,2,5,1,9,8,25
191112378,0,3,4,2,5,14
191112379,8,2,9,7,3,29
191112380,1,9,6,0,2,18
191112381,6,3,4,8,1,22
191112382,8,8,5,0,6,27
191112383,4,5,6,6,5,26
191112384,2,6,9,5,3,25
191112385,4,5,6,3,6,24
191112386,0,2,9,1,1,13
191112387,6,1,9,5,6,27
191112388,8,7,0,2,9,26
191112389,2,0,2,2,4,10
191112390,6,2,9,8,0,25
191112391,9,5,0,4,4,22
191112392,0,0,5,9,5,19
191112393,0,3,5,3,2,13
191112394,0,0,3,8,1,12
191112395,0,4,5,7,9,25
191112396,0,0,7,8,3,18
191112397,1,9,9,5,2,26
191112398,3,0,3,8,6,20
191112399,1,6,2,5,7,21
191112400,6,8,4,6,0,24
191112401,2,9,8,2,7,28
191112402,3,1,0,6,0,10
191112403,5,2,1,0,7,15
191112404,5,9,8,5,6,33
191112405,2,4,3,5,6,20
191112406,1,0,9,5,8,23
191112407,8,8,6,5,1,28
191112408,5,0,4,3,4,16
191112409,0,8,5,1,3,17
191112410,7,9,1,6,5,28
191112411,5,6,4,4,5,24
191112412,1,5,1,7,8,22
191112413,1,7,2,2,5,17
191112414,8,0,6,6,2,22
191112415,7,4,6,9,6,32
191112416,1,0,0,7,5,13
191112417,3,3,7,4,0,17
191112418,2,1,0,6,1,10
191112419,2,2,0,0,1,5
191112420,9,6,3,5,4,27
191112421,5,8,8,3,3,27
191112422,0,2,5,9,3,19
191112423,3,7,1,9,5,25
191112424,8,3,9,1,7,28
191112425,2,3,1,9,9,24
191112426,1,1,7,5,4,18
191112427,9,9,5,7,8,38
191112428,9,9,3,8,3,32
191112429,0,0,3,5,0,8
191112430,2,4,4,5,3,18
191112431,1,4,0,0,6,11
191112432,8,9,8,1,1,27
191112433,8,9,3,9,9,38
191112434,7,3,1,8,8,27
191112435,5,3,9,8,9,34
191112436,7,4,0,1,4,16
191112437,5,2,3,9,2,21
191112438,8,6,3,1,7,25
191112439,4,6,7,7,8,32
191112440,5,8,8,1,6,28
191112441,1,1,3,9,3,17
191112442,0,5,7,6,9,27
191112443,6,2,6,1,9,24
191112444,1,4,0,8,0,13
191112445,5,5,9,3,8,30
191112446,9,1,5,8,6,29
191112447,1,1,1,5,7,15
191112448,4,8,3,8,3,26
191112449,9,1,1,5,6,22
191112450,3,9,4,8,8,32
191112451,1,6,9,7,1,24
191112452,6,2,2,4,1,15
191112453,3,7,7,2,5,24
191112454,9,1,3,3,7,23
191112455,5,3,9,3,0,20
191112456,2,9,1,9,4,25
191112457,2,0,5,8,3,18
191112458,4,2,3,5,1,15
191112459,1,2,5,4,5,17
191112460,3,2,6,5,3,19
191112461,0,2,5,8,2,17
191112462,6,0,0,2,1,9
191112463,1,0,6,3,3,13
191112464,5,3,0,0,7,15
191112465,5,6,5,4,2,22
191112466,0,9,7,9,8,33
191112467,2,4,0,5,8,19
191112468,0,0,8,3,4,15
191112469,5,4,7,4,6,26
191112470,5,2,8,2,3,20
191112471,6,3,5,9,1,24
191112472,5,1,3,7,4,20
191112473,1,3,0,7,8,19
191112474,9,7,3,7,3,29
191112475,0,3,2,3,6,14
191112476,4,0,5,3,4,16
191112477,2,3,2,5,6,18
191112478,6,7,8,7,0,28
191112479,4,4,5,6,6,25
191112480,5,2,2,3,4,16
191112481,4,5,2,5,8,24
191112482,4,7,7,4,0,22
191112483,3,8,4,2,2,19
191112484,4,2,2,7,8,23
191112485,2,6,3,1,8,20
191112486,2,9,6,6,8,31
191112487,8,8,8,4,7,35
191112488,1,4,2,5,7,19
191112489,9,1,4,8,4,26
191112490,2,2,8,7,6,25
191112491,1,9,3,4,1,18
191112492,4,8,7,9,7,35
191112493,5,6,1,2,6,20
191112494,6,0,2,0,6,14
191112495,0,4,8,0,5,17
191112496,5,2,6,6,8,27
191112497,2,0,7,3,4,16
191112498,7,2,4,7,4,24
191112499,7,7,7,7,1,29
191112500,6,6,1,1,3,17
191112501,7,4,2,9,1,23
191112502,5,3,6,7,2,23
191112503,5,2,4,9,5,25
191112504,1,0,6,1,0,8
191112505,4,9,9,2,8,32
191112506,4,1,1,5,3,14
191112507,1,1,6,3,0,11
191112508,3,4,9,3,5,24
191112509,2,4,6,8,1,21
191112510,3,8,9,9,7,36
191112511,0,2,4,2,2,10
191112512,4,7,2,2,2,17
191112513,9,4,2,8,1,24
191112514,0,1,1,6,4,12
191112515,8,8,9,5,8,38
191112516,7,2,2,0,5,16
191112517,0,1,7,7,8,23
191112518,5,9,6,3,6,29
191112519,7,2,0,3,8,20
191112520,4,3,0,8,0,15
191112521,5,1,6,0,0,12
191112522,2,5,7,0,6,20
191112523,3,9,1,5,8,26
191112524,1,1,9,8,7,26
191112525,2,5,5,5,0,17
191112526,0,6,2,9,2,19
191112527,5,4,3,8,1,21
191112528,4,0,2,1,5,12
191112529,5,7,2,9,7,30
191112530,0,3,0,3,5,11
191112531,3,5,5,8,3,24
191112532,1,9,3,0,9,22
191112533,8,3,4,8,7,30
191112534,6,6,6,2,9,29
191112535,2,6,5,0,7,20
191112536,6,1,0,0,5,12
191112537,9,8,3,9,8,37
191112538,4,8,2,7,2,23
191112539,6,7,6,7,9,35
191112540,7,3,7,0,0,17
191112541,2,8,0,8,5,23
191112542,3,1,1,7,2,14
191112543,9,1,0,1,4,15
191112544,6,7,7,4,8,32
191112545,7,9,2,9,6,33
191112546,4,6,8,6,7,31
191112547,8,1,2,5,8,24
191112548,4,2,2,2,5,15
191112549,1,8,6,4,2,21
191112550,2,4,5,9,5,25
191112551,7,0,6,7,3,23
191112552,1,5,1,4,2,13
191112553,4,7,6,2,1,20
191112554,4,7,3,5,5,24
191112555,4,3,5,0,0,12
191112556,7,4,6,6,1,24
191112557,0,5,7,3,7,22
191112558,4,7,1,1,1,14
191112559,2,1,8,2,6,19
191112560,7,4,3,3,5,22
191112561,1,5,5,8,7,26
191112562,1,2,4,7,9,23
191112563,0,9,9,3,1,22
191112564,7,0,2,0,1,10
191112565,8,4,8,9,8,37
191112566,2,1,3,5,3,14
191112567,1,3,3,3,0,10
191112568,5,2,6,1,5,19
191112569,8,4,8,7,8,35
191112570,4,8,5,3,0,20
191112571,4,9,3,7,6,29
191112572,6,1,0,5,1,13
191112573,9,2,7,5,2,25
191112574,3,3,7,1,5,19
191112575,2,5,4,4,0,15
191112576,4,9,0,8,9,30
191112577,6,9,7,1,3,26
191112578,7,9,5,5,3,29
191112579,6,4,5,8,8,31
191112580,3,1,5,1,8,18
191112581,6,8,1,7,1,23
191112582,6,8,8,6,8,36
191112583,0,5,1,9,2,17
191112584,8,0,6,9,6,29
191112585,8,6,1,4,3,22
191112586,1,9,1,6,5,22
191112587,8,1,8,1,0,18
191112588,1,0,0,7,3,11
191112589,8,0,8,7,6,29
191112590,3,3,6,9,0,21
191112591,1,6,0,7,9,23
191112592,1,5,9,4,3,22
191112593,6,1,0,6,7,20
191112594,8,0,1,6,4,19
191112595,7,4,3,5,7,26
191112596,9,5,6,4,3,27
191112597,7,0,5,4,3,19
191112598,2,4,8,7,7,28
191112599,5,0,0,3,5,13
191112600,1,5,1,4,9,20
191112601,0,5,2,5,7,19
191112602,6,8,7,8,9,38
191112603,2,6,9,3,3,23
191112604,1,3,8,7,6,25
191112605,2,2,6,0,7,17
191112606,2,3,2,2,2,11
191112607,0,4,4,1,0,9
191112608,1,6,1,3,9,20
191112609,8,7,5,4,3,27
191112610,4,7,6,0,5,22
191112611,8,8,4,6,5,31
191112612,6,5,8,8,8,35
191112613,9,3,0,4,1,17
191112614,6,4,0,5,9,24
191112615,6,8,3,1,7,25
191112616,0,6,6,6,3,21
191112617,3,8,9,5,8,33
191112618,7,8,0,4,0,19
191112619,7,5,0,7,1,20
191112620,8,3,1,7,1,20
191112621,5,7,2,6,0,20
191112622,9,4,3,6,5,27
191112623,6,4,4,6,7,27
191112624,1,9,5,8,5,28
191112625,6,1,8,0,2,17
191112626,0,5,9,1,2,17
191112627,9,8,0,2,8,27
191112628,5,4,4,2,0,15
191112629,7,9,9,4,2,31
191112630,3,8,6,3,1,21
191112631,3,1,3,9,6,22
191112632,6,6,5,2,7,26
191112633,6,2,6,9,6,29
191112634,1,6,3,3,6,19
191112635,5,3,2,7,5,22
191112636,7,7,9,5,5,33
191112637,1,4,0,1,6,12
191112638,6,3,4,9,1,23
191112639,6,6,0,7,3,22
191112640,7,6,0,5,7,25
191112641,9,0,8,2,3,22
191112642,4,3,4,4,5,20
191112643,9,8,5,5,5,32
191112644,7,2,1,8,3,21
191112645,5,6,0,7,4,22
191112646,2,2,5,1,6,16
191112647,5,4,1,4,4,18
191112648,1,6,3,5,9,24
191112649,1,5,5,6,4,21
191112650,6,5,5,2,2,20
191112651,5,1,0,2,4,12
191112652,4,4,5,5,8,26
191112653,3,1,4,8,9,25
191112654,9,5,4,5,5,28
191112655,5,4,7,8,4,28
191112656,7,6,9,2,7,31
191112657,9,7,5,5,1,27
191112658,4,7,5,7,5,28
191112659,4,7,1,3,1,16
191112660,3,8,7,7,1,26
191112661,5,7,8,4,1,25
191112662,2,6,5,9,5,27
191112663,1,6,1,8,9,25
191112664,5,7,2,6,9,29
191112665,5,6,6,9,4,30
191112666,9,6,5,6,5,31
191112667,3,5,7,9,7,31
191112668,6,7,9,7,4,33
191112669,2,2,8,8,7,27
191112670,8,0,1,1,7,17
191112671,6,6,2,4,2,20
191112672,6,0,1,9,7,23
191112673,2,6,0,7,1,16
191112674,7,6,2,0,0,15
191112675,0,3,5,3,6,17
191112676,6,3,7,0,6,22
191112677,5,6,5,4,8,28
191112678,2,6,1,3,3,15
191112679,6,5,6,4,9,30
191112680,6,9,6,0,6,27
191112681,1,1,5,9,7,23
191112682,0,8,7,5,0,20
191112683,8,0,4,8,2,22
191112684,7,8,0,3,6,24
191112685,0,4,7,2,6,19
191112686,0,7,4,1,4,16
191112687,9,5,2,8,7,31
191112688,6,1,8,5,9,29
191112689,4,7,3,2,1,17
191112690,3,4,7,3,0,17
191112691,3,2,5,6,4,20
191112692,7,1,4,9,6,27
191112693,9,2,0,6,8,25
191112694,4,8,4,2,0,18
191112695,7,6,8,7,3,31
191112696,0,0,7,4,2,13
191112697,3,4,1,2,2,12
191112698,0,2,7,6,1,16
191112699,4,6,3,8,8,29
191112700,2,4,9,1,9,25
191112701,6,8,8,2,0,24
191112702,6,6,7,6,2,27
191112703,2,6,8,1,4,21
191112704,7,5,1,2,7,22
191112705,7,1,3,6,1,18
191112706,6,4,5,4,3,22
191112707,9,7,8,6,4,34
191112708,1,5,9,2,9,26
191112709,8,5,5,8,3,29
191112710,9,3,9,7,8,36
191112711,7,1,7,2,2,19
191112712,5,1,2,9,9,26
191112713,4,8,5,3,1,21
191112714,8,4,4,6,8,30
191112715,7,1,3,9,3,23
191112716,0,8,4,8,6,26
191112717,4,5,0,9,0,18
191112718,2,4,8,8,0,22
191112719,8,8,5,2,1,24
191112720,0,9,7,6,3,25
191112721,5,4,9,1,2,21
191112722,8,0,8,6,8,30
191112723,8,8,4,2,1,23
191112724,8,2,3,3,5,21
191112725,8,0,9,7,5,29
191112726,9,7,6,4,7,33
191112727,9,8,6,9,0,32
191112728,6,8,2,9,9,34
191112729,9,0,6,8,4,27
191112730,2,4,5,1,1,13
191112731,2,6,6,6,1,21
191112732,5,2,6,5,6,24
191112733,5,9,9,6,5,34
191112734,9,5,7,2,6,29
191112735,5,1,9,1,7,23
191112736,3,6,3,0,2,14
191112737,5,1,5,6,1,18
191112738,4,6,5,6,7,28
191112739,4,0,6,6,5,21
191112740,1,9,8,3,8,29
191112741,3,8,5,4,2,22
191112742,7,7,3,9,2,28
191112743,0,1,1,3,8,13
191112744,7,0,6,4,1,18
191112745,7,7,5,9,0,28
191112746,0,4,7,5,3,19
191112747,7,9,4,8,5,33
191112748,2,4,7,7,1,21
191112749,2,4,8,6,5,25
191112750,5,9,7,1,4,26
191112751,1,7,6,3,9,26
191112752,5,0,2,9,4,20
191112753,8,7,0,4,9,28
191112754,1,9,6,5,5,26
191112755,7,0,8,4,9,28
191112756,2,2,7,6,2,19
191112757,0,8,5,3,7,23
191112758,9,6,1,8,8,32
191112759,4,4,3,9,5,25
191112760,3,3,4,7,1,18
191112761,9,0,2,0,9,20
191112762,2,3,4,7,3,19
191112763,3,4,7,2,1,17
191112764,9,2,3,6,6,26
191112765,3,5,4,1,4,17
191112766,3,0,1,1,8,13
191112767,3,2,8,9,7,29
191112768,8,1,3,3,3,18
191112769,9,7,7,1,5,29
191112770,5,0,8,7,1,21
191112771,6,7,2,7,4,26
191112772,0,0,6,5,7,18
191112773,9,0,2,8,1,20
191112774,6,9,7,7,8,37
191112775,6,6,3,4,8,27
191112776,3,6,1,0,0,10
191112777,2,9,9,3,6,29
191112778,1,8,2,6,8,25
191112779,2,8,1,7,1,19
191112780,5,5,2,6,9,27
191112781,9,8,4,9,9,39
191112782,4,6,7,0,6,23
191112783,8,7,3,9,2,29
191112784,8,4,0,8,6,26
191112785,0,6,0,8,6,20
191112786,6,1,1,1,1,10
191112787,1,2,9,2,9,23
191112788,4,8,7,6,8,33
191112789,2,8,1,7,5,23
191112790,2,0,4,0,7,13
191112791,1,0,0,5,2,8
191112792,4,0,4,2,5,15
191112793,7,2,7,2,0,18
191112794,3,0,7,7,8,25
191112795,2,3,2,1,0,8
191112796,8,7,2,4,8,29
191112797,8,6,9,7,5,35
191112798,5,8,6,4,4,27
191112799,7,1,2,6,5,21
191112800,0,1,9,6,4,20
191112801,3,0,3,0,5,11
191112802,7,0,7,2,7,23
191112803,2,3,8,2,9,24
191112804,1,7,8,6,8,30
191112805,3,3,6,2,7,21
191112806,2,6,8,3,9,28
191112807,9,3,9,9,9,39
191112808,7,9,2,7,9,34
191112809,3,9,7,0,8,27
191112810,9,3,5,7,2,26
191112811,2,5,6,8,4,25
191112812,6,8,8,2,7,31
191112813,9,1,0,3,5,18
191112814,4,5,0,0,8,17
191112815,3,4,7,2,7,23
191112816,1,6,4,0,5,16
191112817,3,0,2,8,7,20
191112818,4,7,4,1,6,22
191112819,1,8,9,9,6,33
191112820,8,0,9,6,2,25
191112821,1,4,0,7,9,21
191112822,2,2,9,3,2,18
191112823,6,1,9,4,1,21
191112824,4,0,2,7,4,17
191112825,3,8,2,7,8,28
191112826,8,9,8,6,3,34
191112827,6,9,2,5,8,30
191112828,1,5,9,2,6,23
191112829,0,7,4,8,1,20
191112830,2,8,3,9,5,27
191112831,6,3,9,9,8,35
191112832,2,6,0,7,2,17
191112833,3,5,4,4,4,20
191112834,4,5,7,2,1,19
191112835,0,9,7,0,2,18
191112836,3,4,4,3,4,18
191112837,8,7,1,9,6,31
191112838,9,3,4,8,6,30
191112839,2,9,5,4,6,26
191112840,2,0,7,5,1,15
191112841,9,5,5,9,1,29
191112842,4,3,7,4,3,21
191112843,8,1,0,6,9,24
191112844,3,5,2,5,0,15
191112845,7,3,5,7,0,22
191112846,5,9,3,5,3,25
191112847,3,5,4,3,9,24
191112848,0,9,2,3,2,16
191112849,2,5,0,5,5,17
191112850,9,9,2,6,7,33
191112851,8,6,7,7,4,32
191112852,2,2,9,0,7,20
191112853,0,7,3,1,0,11
191112854,3,1,2,4,4,14
191112855,9,3,5,7,8,32
191112856,7,3,3,7,0,20
191112857,4,7,9,6,1,27
191112858,6,0,1,4,0,11
191112859,4,8,9,7,3,31
191112860,9,6,0,8,4,27
191112861,2,1,6,9,8,26
191112862,8,4,6,5,4,27
191112863,3,7,0,3,0,13
191112864,3,6,9,5,4,27
191112865,5,8,0,6,3,22
191112866,0,1,7,7,4,19
191112867,8,0,7,8,7,30
191112868,0,8,4,6,6,24
191112869,4,4,8,7,8,31
191112870,3,1,1,0,0,5
191112871,1,0,1,5,1,8
191112872,7,0,8,8,4,27
191112873,3,1,2,7,4,17
191112874,0,5,2,3,0,10
191112875,4,3,4,9,8,28
191112876,9,7,8,5,1,30
191112877,8,3,0,3,0,14
191112878,0,3,4,1,1,9
191112879,4,0,0,2,5,11
191112880,3,9,5,6,2,25
191112881,5,9,4,4,1,23
191112882,1,6,4,9,9,29
191112883,5,1,1,9,4,20
191112884,7,2,9,9,7,34
191112885,3,7,5,7,8,30
191112886,3,5,5,1,0,14
191112887,8,5,6,4,4,27
191112888,2,5,7,1,0,15
191112889,5,7,8,0,2,22
191112890,7,7,9,4,0,27
191112891,2,7,0,7,8,24
191112892,6,2,3,4,4,19
191112893,6,2,9,9,9,35
191112894,2,6,6,6,9,29
191112895,8,8,7,7,3,33
191112896,6,9,1,7,2,25
191112897,0,7,9,7,4,27
191112898,6,1,9,8,0,24
191112899,1,7,6,0,2,16
191112900,7,5,8,0,3,23
191112901,0,9,6,0,7,22
191112902,4,9,2,2,9,26
191112903,4,3,9,1,1,18
191112904,9,6,0,6,0,21
191112905,0,5,9,7,9,30
191112906,5,5,4,3,7,24
191112907,7,6,9,8,7,37
191112908,6,2,8,4,0,20
191112909,1,7,3,3,7,21
191112910,4,9,7,9,2,31
191112911,6,8,8,3,1,26
191112912,8,2,9,0,0,19
191112913,5,4,9,7,0,25
191112914,3,7,7,5,0,22
191112915,7,3,6,0,9,25
191112916,3,7,2,3,4,19
191112917,8,2,9,7,9,35
191112918,3,5,2,8,2,20
191112919,6,0,0,6,3,15
191112920,1,7,2,9,1,20
191112921,8,3,4,2,3,20
191112922,4,7,5,4,9,29
191112923,9,7,1,7,0,24
191112924,0,3,6,0,5,14
191112925,2,1,6,5,8,22
191112926,5,8,1,0,9,23
191112927,1,8,2,2,5,18
191112928,1,2,6,8,2,19
191112929,2,0,2,5,9,18
191112930,4,0,2,9,0,15
191112931,4,3,8,2,1,18
191112932,4,6,2,5,1,18
191112933,8,2,9,4,0,23
191112934,7,4,6,5,0,22
191112935,0,6,6,8,1,21
191112936,7,4,3,9,9,32
191112937,0,6,2,4,7,19
191112938,7,8,1,2,6,24
191112939,1,3,1,5,5,15
191112940,9,6,0,0,5,20
191112941,7,1,9,2,4,23
191112942,6,2,0,2,3,13
191112943,2,1,8,4,6,21
191112944,3,2,4,1,9,19
191112945,1,0,7,4,6,18
191112946,4,6,1,5,1,17
191112947,3,0,0,1,1,5
191112948,3,2,1,3,5,14
191112949,5,2,0,0,5,12
191112950,0,7,3,4,3,17
191112951,3,3,7,1,0,14
191112952,5,8,7,2,3,25
191112953,4,5,9,2,7,27
191112954,5,9,6,4,3,27
191112955,2,0,3,5,9,19
191112956,3,9,8,8,1,29
191112957,7,7,7,1,4,26
191112958,6,8,3,9,4,30
191112959,1,2,0,6,0,9
191112960,7,3,1,4,0,15
191112961,2,5,1,6,1,15
191112962,1,1,5,0,0,7
191112963,2,1,1,4,9,17
191112964,9,6,3,4,7,29
191112965,0,3,2,3,8,16
191112966,4,0,5,7,0,16
191112967,6,5,0,2,0,13
191112968,9,7,6,2,9,33
191112969,1,5,3,3,3,15
191112970,0,8,5,8,6,27
191112971,4,5,8,6,3,26
191112972,6,0,8,9,8,31
191112973,4,0,4,6,5,19
191112974,1,5,6,5,1,18
191112975,3,3,1,6,2,15
191112976,5,6,1,4,7,23
191112977,4,3,2,1,6,16
191112978,2,5,9,9,8,33
191112979,3,6,6,2,1,18
191112980,1,6,8,6,0,21
191112981,5,0,2,6,5,18
191112982,6,2,3,2,5,18
191112983,9,9,4,5,4,31
191112984,9,3,9,5,7,33
191112985,6,7,5,8,3,29
191112986,3,3,7,8,3,24
191112987,8,3,8,3,1,23
191112988,0,8,2,1,3,14
191112989,0,9,4,9,4,26
191112990,9,8,5,6,5,33
191112991,5,2,1,6,0,14
191112992,5,3,8,0,1,17
191112993,6,3,8,7,1,25
191112994,9,8,0,8,3,28
191112995,9,8,0,4,3,24
191112996,0,4,5,6,4,19
191112997,1,1,1,8,7,18
191112998,7,1,3,1,3,15
191112999,5,3,5,2,2,17
1911121000,1,7,6,2,5,21
1911121001,1,9,4,9,4,27
1911121002,7,9,0,5,9,30
1911121003,9,5,4,3,9,30
1911121004,4,4,3,6,4,21
1911121005,5,5,0,6,0,16
1911121006,8,1,5,0,1,15
1911121007,3,2,0,9,5,19
1911121008,6,5,7,8,5,31
1911121009,5,5,9,2,7,28
1911121010,9,5,8,6,5,33
1911121011,1,3,5,1,4,14
1911121012,7,3,7,0,3,20
1911121013,6,8,7,5,6,32
1911121014,2,0,9,7,4,22
1911121015,3,7,2,5,7,24
1911121016,0,9,9,3,9,30
1911121017,0,0,1,4,6,11
1911121018,1,3,6,9,0,19
1911121019,8,1,7,2,9,27
1911121020,6,4,1,3,7,21
1911121021,2,2,3,5,2,14
1911121022,2,7,5,2,0,16
1911121023,6,8,4,0,5,23
1911121024,7,3,0,0,9,19
1911121025,4,5,6,6,0,21
1911121026,2,4,8,2,5,21
1911121027,0,7,7,3,6,23
1911121028,7,5,9,5,5,31
1911121029,5,2,8,5,7,27
1911121030,4,2,6,4,6,22
1911121031,6,2,1,3,3,15
1911121032,1,8,4,2,2,17
1911121033,3,2,2,6,1,14
1911121034,2,1,3,7,0,13
1911121035,5,1,0,0,6,12
1911121036,2,0,4,4,8,18
1911121037,7,1,0,9,0,17
1911121038,6,6,7,0,6,25
1911121039,0,7,0,7,6,20
1911121040,7,2,4,2,2,17
1911121041,1,1,2,4,2,10
1911121042,2,1,8,9,5,25
1911121043,5,2,3,3,2,15
1911121044,2,3,9,7,7,28
1911121045,9,8,4,4,1,26
1911121046,7,7,2,2,4,22
1911121047,1,1,2,2,3,9
1911121048,8,9,5,4,6,32
1911121049,2,6,2,2,1,13
1911121050,7,3,0,9,5,24
1911121051,0,0,7,9,3,19
1911121052,0,2,5,9,2,18
1911121053,6,9,2,9,8,34
1911121054,7,1,1,0,4,13
1911121055,8,0,4,2,6,20
1911121056,1,4,9,2,4,20
1911121057,2,3,2,9,8,24
1911121058,8,4,5,1,9,27
1911121059,2,4,9,2,1,18
1911121060,9,4,9,9,7,38
1911121061,9,3,0,3,2,17
1911121062,5,7,2,7,0,21
1911121063,4,2,6,8,2,22
1911121064,3,7,3,3,4,20
1911121065,0,2,9,2,6,19
1911121066,8,5,3,5,1,22
1911121067,8,3,6,4,3,24
1911121068,7,0,0,8,0,15
1911121069,8,2,0,8,9,27
1911121070,1,1,3,1,3,9
1911121071,0,4,7,8,0,19
1911121072,2,1,5,8,6,22
1911121073,7,4,3,5,2,21
1911121074,0,9,6,1,7,23
1911121075,4,5,0,1,4,14
1911121076,9,9,5,6,5,34
1911121077,0,3,5,4,0,12
1911121078,8,9,0,6,7,30
1911121079,0,1,7,5,4,17
1911121080,3,1,5,9,6,24
1911121081,4,1,5,9,2,21
1911121082,3,7,7,2,2,21
1911121083,6,3,9,2,0,20
1911121084,8,2,8,5,2,25
1911121085,4,2,6,5,6,23
1911121086,5,3,1,0,8,17
1911121087,6,8,1,9,8,32
1911121088,6,6,2,0,6,20
1911121089,3,9,0,3,0,15
1911121090,3,7,5,6,8,29
1911121091,1,5,8,0,3,17
1911121092,9,5,2,4,0,20
1911121093,1,3,8,9,2,23
1911121094,3,2,1,1,0,7
1911121095,7,8,5,6,8,34
1911121096,7,0,0,0,8,15
1911121097,6,6,7,0,7,26
1911121098,0,6,8,5,9,28
1911121099,9,0,1,4,8,22
1911121100,2,1,5,1,4,13
1911121101,0,3,4,1,7,15
1911121102,2,6,9,6,1,24
1911121103,3,8,1,3,0,15
1911121104,3,7,3,7,9,29
1911121105,0,7,5,1,2,15
191113001,8,2,3,2,9,24
191113002,2,0,0,3,9,14
191113003,8,2,5,4,1,20
191113004,5,2,9,4,4,24
191113005,3,1,4,1,9,18
191113006,1,0,1,3,1,6
191113007,4,5,2,3,6,20
191113008,8,1,9,9,4,31
191113009,5,2,5,2,1,15
191113010,9,8,9,5,8,39
191113011,1,7,6,4,5,23
191113012,3,6,2,6,8,25
191113013,4,7,9,4,4,28
191113014,1,1,9,9,2,22
191113015,3,1,3,6,3,16
191113016,3,3,0,7,4,17
191113017,0,6,7,7,8,28
191113018,7,0,1,9,9,26
191113019,6,8,4,3,5,26
191113020,6,2,9,6,3,26
191113021,7,7,4,0,2,20
191113022,7,5,5,7,4,28
191113023,3,6,9,1,0,19
191113024,1,4,9,4,7,25
191113025,0,0,4,7,8,19
191113026,5,6,5,2,5,23
191113027,9,9,5,7,3,33
191113028,2,4,0,9,3,18
191113029,1,7,3,2,2,15
191113030,8,8,3,8,9,36
191113031,3,2,9,9,7,30
191113032,9,9,3,7,9,37
191113033,3,5,8,4,6,26
191113034,7,6,0,0,6,19
191113035,9,9,5,7,7,37
191113036,7,4,0,3,6,20
191113037,7,9,7,7,1,31
191113038,6,8,8,2,1,25
191113039,2,6,3,2,7,20
191113040,5,2,1,8,4,20
191113041,0,7,4,1,9,21
191113042,0,1,9,0,5,15
191113043,3,5,2,1,3,14
191113044,9,4,7,5,4,29
191113045,4,2,3,3,2,14
191113046,5,8,9,2,8,32
191113047,3,1,6,7,7,24
191113048,6,3,2,2,0,13
191113049,3,8,0,3,0,14
191113050,2,3,4,1,3,13
191113051,1,5,9,7,8,30
191113052,4,4,7,1,5,21
191113053,7,5,4,5,2,23
191113054,0,0,8,2,7,17
191113055,0,0,3,5,6,14
191113056,0,2,2,5,8,17
191113057,3,3,3,5,4,18
191113058,3,2,9,8,8,30
191113059,4,8,5,6,9,32
191113060,0,7,1,1,0,9
191113061,2,4,3,2,2,13
191113062,0,9,1,5,6,21
191113063,9,9,2,9,7,36
191113064,6,4,0,7,4,21
191113065,8,6,8,0,4,26
191113066,8,7,5,1,0,21
191113067,0,7,5,8,9,29
191113068,8,0,2,7,9,26
191113069,4,6,9,8,5,32
191113070,4,5,8,9,8,34
191113071,8,2,8,1,5,24
191113072,7,6,3,6,1,23
191113073,0,3,8,0,7,18
191113074,9,9,5,8,6,37
191113075,5,3,9,3,4,24
191113076,6,1,4,2,6,19
191113077,8,5,1,3,4,21
191113078,3,1,7,2,4,17
191113079,3,7,4,2,6,22
191113080,8,6,3,4,0,21
191113081,2,9,4,1,5,21
191113082,9,8,8,0,9,34
191113083,5,7,0,0,0,12
191113084,3,6,7,4,9,29
191113085,9,3,1,4,1,18
191113086,3,5,5,4,4,21
191113087,3,3,9,4,1,20
191113088,3,3,8,0,0,14
191113089,7,4,4,5,7,27
191113090,2,2,5,1,8,18
191113091,2,1,2,4,7,16
191113092,8,9,8,4,1,30
191113093,6,0,0,8,9,23
191113094,1,0,6,3,6,16
191113095,9,4,6,2,9,30
191113096,6,0,1,5,9,21
191113097,4,8,5,3,4,24
191113098,2,4,4,8,9,27
191113099,2,8,5,6,8,29
191113100,1,7,8,2,5,23
191113101,2,5,2,9,0,18
191113102,5,4,3,8,2,22
191113103,0,7,8,6,2,23
191113104,9,6,1,7,5,28
191113105,7,6,8,1,5,27
191113106,7,2,2,2,8,21
191113107,1,7,3,2,5,18
191113108,6,6,1,6,6,25
191113109,3,1,4,5,7,20
191113110,6,5,1,7,4,23
191113111,3,4,7,8,2,24
191113112,2,1,4,4,2,13
191113113,9,9,9,6,6,39
191113114,2,3,5,2,2,14
191113115,1,9,0,2,9,21
191113116,5,9,8,2,5,29
191113117,3,6,3,2,7,21
191113118,6,2,2,9,0,19
191113119,6,8,7,6,4,31
191113120,1,2,0,6,1,10
191113121,0,4,7,9,2,22
191113122,2,7,2,6,8,25
191113123,3,8,4,4,0,19
191113124,2,8,5,7,5,27
191113125,9,5,0,0,8,22
191113126,6,7,1,7,6,27
191113127,1,8,1,8,6,24
191113128,0,6,5,1,5,17
191113129,9,1,6,1,4,21
191113130,3,3,7,3,8,24
191113131,5,9,9,7,2,32
191113132,3,1,3,7,1,15
191113133,6,2,6,8,0,22
191113134,5,9,2,9,6,31
191113135,6,4,0,5,8,23
191113136,5,5,2,2,5,19
191113137,6,9,6,2,8,31
191113138,0,8,4,0,0,12
191113139,9,0,3,5,5,22
191113140,9,6,7,9,6,37
191113141,8,6,5,6,7,32
191113142,6,4,6,4,1,21
191113143,4,6,5,9,7,31
191113144,2,7,1,3,9,22
191113145,6,6,2,0,0,14
191113146,1,4,2,0,6,13
191113147,3,8,6,7,8,32
191113148,7,0,6,2,8,23
191113149,4,0,9,4,2,19
191113150,7,5,4,7,7,30
191113151,6,2,7,9,6,30
191113152,8,0,9,0,8,25
191113153,8,3,8,9,6,34
191113154,3,8,3,8,7,29
191113155,1,0,5,5,4,15
191113156,0,8,2,9,4,23
191113157,6,8,8,2,3,27
191113158,6,7,4,0,1,18
191113159,6,7,4,7,9,33
191113160,7,6,9,5,8,35
191113161,6,0,4,2,4,16
191113162,6,9,9,9,0,33
191113163,8,3,2,7,3,23
191113164,1,9,7,0,3,20
191113165,3,8,2,7,0,20
191113166,4,1,5,2,3,15
191113167,0,0,8,3,1,12
191113168,1,6,0,9,9,25
191113169,8,2,4,6,7,27
191113170,5,1,7,0,3,16
191113171,2,6,7,7,0,22
191113172,8,9,5,9,1,32
191113173,0,8,8,0,1,17
191113174,6,5,0,0,3,14
191113175,3,2,3,6,9,23
191113176,0,8,5,1,8,22
191113177,4,5,0,2,1,12
191113178,6,7,3,7,4,27
191113179,0,6,3,9,2,20
191113180,4,5,7,5,7,28
191113181,8,3,5,8,2,26
191113182,7,1,4,7,0,19
191113183,3,1,5,4,8,21
191113184,9,0,7,1,8,25
191113185,0,2,6,3,6,17
191113186,9,6,1,2,2,20
191113187,9,9,1,0,3,22
191113188,2,9,5,9,5,30
191113189,0,4,7,9,4,24
191113190,0,9,4,3,4,20
191113191,4,9,4,3,6,26
191113192,9,0,8,0,0,17
191113193,7,1,0,0,5,13
191113194,4,8,2,7,8,29
191113195,9,4,9,7,3,32
191113196,2,3,0,6,8,19
191113197,2,3,7,0,4,16
191113198,8,9,9,4,1,31
191113199,9,0,9,9,4,31
191113200,3,7,1,3,5,19
191113201,6,2,0,5,6,19
191113202,0,5,2,5,5,17
191113203,0,9,7,4,7,27
191113204,9,4,2,7,5,27
191113205,0,8,2,5,0,15
191113206,6,9,8,2,7,32
191113207,9,3,7,2,7,28
191113208,4,7,0,3,9,23
191113209,6,7,9,4,1,27
191113210,5,9,5,4,1,24
191113211,0,7,0,5,1,13
191113212,0,8,2,7,6,23
191113213,3,0,5,9,0,17
191113214,0,1,8,8,8,25
191113215,9,8,2,6,8,33
191113216,8,0,9,6,6,29
191113217,7,5,6,9,7,34
191113218,2,5,0,3,9,19
191113219,3,8,0,5,8,24
191113220,8,0,7,0,9,24
191113221,4,0,2,5,7,18
191113222,4,2,6,9,6,27
191113223,2,1,6,9,2,20
191113224,6,5,3,5,6,25
191113225,3,6,7,5,9,30
191113226,1,4,3,4,7,19
191113227,9,3,5,8,7,32
191113228,9,9,4,3,8,33
191113229,8,0,3,8,7,26
191113230,8,7,7,1,6,29
191113231,0,8,0,5,6,19
191113232,3,0,2,4,5,14
191113233,7,4,1,8,0,20
191113234,8,5,0,2,7,22
191113235,7,5,7,4,2,25
191113236,7,1,2,6,1,17
191113237,9,1,0,9,2,21
191113238,7,6,3,9,3,28
191113239,5,6,7,6,7,31
191113240,3,8,1,5,6,23
191113241,4,8,5,2,6,25
191113242,7,8,7,8,1,31
191113243,4,9,4,2,9,28
191113244,7,8,3,7,5,30
191113245,8,2,5,5,5,25
191113246,9,6,0,8,1,24
191113247,1,9,7,8,7,32
191113248,3,2,2,7,9,23
191113249,8,4,2,5,4,23
191113250,7,5,7,2,5,26
191113251,5,2,6,6,7,26
191113252,9,5,2,2,3,21
191113253,9,8,7,1,8,33
191113254,4,4,7,4,3,22
191113255,8,6,3,2,0,19
191113256,6,7,8,3,0,24
191113257,1,7,7,0,8,23
191113258,1,9,6,2,1,19
191113259,7,7,3,0,3,20
191113260,3,0,1,5,7,16
191113261,9,8,8,3,9,37
191113262,4,6,4,1,5,20
191113263,9,6,8,0,4,27
191113264,6,4,7,4,0,21
191113265,5,9,1,1,1,17
191113266,2,7,1,9,8,27
191113267,6,4,8,5,8,31
191113268,9,4,6,8,2,29
191113269,4,4,3,0,1,12
191113270,4,9,2,3,1,19
191113271,5,1,3,0,4,13
191113272,2,0,0,6,0,8
191113273,6,8,9,4,4,31
191113274,1,7,4,3,2,17
191113275,6,6,4,3,6,25
191113276,3,2,2,1,3,11
191113277,3,5,9,6,8,31
191113278,5,1,9,9,5,29
191113279,7,1,3,9,5,25
191113280,3,2,9,9,9,32
191113281,5,9,7,4,6,31
191113282,0,9,5,8,3,25
191113283,2,7,1,8,2,20
191113284,5,7,2,4,5,23
191113285,5,1,7,4,2,19
191113286,6,5,7,6,6,30
191113287,3,5,9,2,1,20
191113288,8,6,7,0,7,28
191113289,3,9,7,4,6,29
191113290,3,1,5,5,6,20
191113291,4,6,0,9,3,22
191113292,1,1,5,1,8,16
191113293,1,5,9,5,0,20
191113294,4,9,6,0,2,21
191113295,3,4,2,3,0,12
191113296,1,2,6,1,2,12
191113297,7,7,7,6,5,32
191113298,9,1,1,2,7,20
191113299,8,0,5,3,2,18
191113300,9,5,1,1,2,18
191113301,1,9,3,0,3,16
191113302,1,4,7,2,5,19
191113303,4,7,4,5,2,22
191113304,7,8,3,6,3,27
191113305,5,9,5,4,9,32
191113306,7,1,8,3,4,23
191113307,9,1,7,5,5,27
191113308,7,4,3,3,9,26
191113309,5,1,0,0,0,6
191113310,1,9,9,8,0,27
191113311,2,1,5,0,0,8
191113312,6,3,4,1,8,22
191113313,7,9,7,8,9,40
191113314,6,4,1,9,9,29
191113315,9,3,5,3,9,29
191113316,7,6,6,3,6,28
191113317,4,9,1,8,9,31
191113318,0,9,4,7,9,29
191113319,7,7,9,2,3,28
191113320,8,7,0,7,0,22
191113321,5,1,0,7,7,20
191113322,4,6,7,0,1,18
191113323,2,0,6,8,2,18
191113324,2,2,3,6,5,18
191113325,2,7,3,0,2,14
191113326,8,9,6,0,9,32
191113327,4,2,4,5,9,24
191113328,3,7,6,5,5,26
191113329,8,4,7,7,3,29
191113330,3,0,9,6,3,21
191113331,0,8,6,3,0,17
191113332,1,1,1,4,9,16
191113333,5,4,9,3,4,25
191113334,8,2,6,5,7,28
191113335,0,2,8,4,3,17
191113336,0,0,7,9,1,17
191113337,0,8,1,8,5,22
191113338,4,6,3,2,4,19
191113339,0,9,4,6,9,28
191113340,4,4,0,9,2,19
191113341,8,5,0,0,3,16
191113342,4,8,7,1,8,28
191113343,8,7,9,5,2,31
191113344,9,0,3,0,5,17
191113345,4,1,5,5,5,20
191113346,3,4,1,0,2,10
191113347,3,3,0,8,6,20
191113348,9,1,7,9,0,26
191113349,6,2,4,8,8,28
191113350,6,9,0,4,8,27
191113351,6,0,3,5,5,19
191113352,8,8,1,6,9,32
191113353,6,9,4,2,6,27
191113354,7,0,4,0,2,13
191113355,0,7,6,9,4,26
191113356,4,2,3,1,0,10
191113357,0,2,8,9,8,27
191113358,2,4,0,5,4,15
191113359,7,6,1,3,3,20
191113360,1,5,1,7,3,17
191113361,5,6,5,7,2,25
191113362,0,0,3,9,9,21
191113363,0,0,4,7,4,15
191113364,9,5,8,0,8,30
191113365,9,2,7,4,6,28
191113366,7,9,4,1,7,28
191113367,7,7,9,6,9,38
191113368,2,8,7,6,7,30
191113369,0,2,6,9,8,25
191113370,6,0,9,2,0,17
191113371,4,4,6,8,6,28
191113372,0,9,2,8,6,25
191113373,5,9,3,4,1,22
191113374,9,9,2,6,5,31
191113375,5,7,9,7,8,36
191113376,0,6,1,8,3,18
191113377,3,4,0,7,4,18
191113378,7,5,7,6,1,26
191113379,2,4,6,3,7,22
191113380,5,0,6,0,1,12
191113381,9,3,9,4,5,30
191113382,9,1,6,2,9,27
191113383,1,4,5,7,8,25
191113384,3,2,8,5,1,19
191113385,6,1,1,8,6,22
191113386,2,8,4,3,9,26
191113387,0,5,9,9,0,23
191113388,1,5,5,6,3,20
191113389,3,2,1,9,6,21
191113390,6,6,1,7,5,25
191113391,9,2,5,7,7,30
191113392,8,6,6,4,3,27
191113393,6,8,3,0,7,24
191113394,8,6,3,8,3,28
191113395,9,3,2,7,1,22
191113396,0,1,8,7,2,18
191113397,7,1,7,6,4,25
191113398,6,9,3,7,7,32
191113399,3,1,8,5,0,17
191113400,8,8,8,7,1,32
191113401,7,9,8,0,4,28
191113402,3,1,7,2,1,14
191113403,8,0,0,4,7,19
191113404,9,4,5,8,5,31
191113405,8,7,2,2,6,25
191113406,5,5,5,9,9,33
191113407,1,0,8,0,2,11
191113408,2,8,2,0,4,16
191113409,8,6,7,3,4,28
191113410,4,0,1,3,0,8
191113411,6,6,5,5,9,31
191113412,5,9,3,6,2,25
191113413,2,7,2,6,6,23
191113414,3,0,8,2,0,13
191113415,1,7,4,1,8,21
191113416,6,0,8,0,5,19
191113417,2,8,6,8,9,33
191113418,6,4,8,8,1,27
191113419,0,7,7,5,5,24
191113420,4,5,6,4,4,23
191113421,5,9,4,8,7,33
191113422,2,5,9,0,1,17
191113423,5,5,9,2,3,24
191113424,5,2,1,0,9,17
191113425,2,1,6,5,2,16
191113426,0,2,2,2,6,12
191113427,3,0,6,0,6,15
191113428,2,5,2,5,8,22
191113429,4,9,8,6,6,33
191113430,1,5,7,1,0,14
191113431,3,4,1,9,1,18
191113432,5,2,1,6,8,22
191113433,5,0,3,0,6,14
191113434,8,3,5,2,1,19
191113435,1,8,8,5,2,24
191113436,5,4,9,1,1,20
191113437,5,4,0,6,3,18
191113438,6,5,6,4,3,24
191113439,9,2,4,0,0,15
191113440,1,1,7,9,3,21
191113441,9,0,4,4,0,17
191113442,6,8,7,9,8,38
191113443,3,1,0,8,4,16
191113444,0,0,6,4,3,13
191113445,7,2,2,6,2,19
191113446,9,1,4,4,8,26
191113447,3,7,9,7,7,33
191113448,7,8,6,5,5,31
191113449,9,8,4,7,9,37
191113450,4,9,0,4,4,21
191113451,3,5,5,5,4,22
191113452,3,4,3,7,7,24
191113453,7,8,7,9,1,32
191113454,6,3,7,2,2,20
191113455,2,1,9,1,6,19
191113456,6,8,9,3,3,29
191113457,2,2,5,2,5,16
191113458,0,4,9,4,0,17
191113459,6,6,8,2,6,28
191113460,7,9,4,4,5,29
191113461,7,3,7,1,4,22
191113462,8,6,8,5,9,36
191113463,7,9,5,1,1,23
191113464,3,5,5,3,8,24
191113465,1,1,9,6,0,17
191113466,5,8,7,9,8,37
191113467,4,5,1,1,5,16
191113468,0,1,4,8,0,13
191113469,6,5,6,6,9,32
191113470,3,7,8,0,2,20
191113471,2,7,0,7,0,16
191113472,0,7,1,7,1,16
191113473,1,8,7,0,3,19
191113474,4,4,5,8,3,24
191113475,3,5,0,9,8,25
191113476,8,8,1,3,5,25
191113477,4,6,2,0,5,17
191113478,3,6,8,4,7,28
191113479,3,4,9,5,4,25
191113480,4,5,5,7,1,22
191113481,1,6,4,4,3,18
191113482,1,3,6,0,9,19
191113483,5,7,4,2,2,20
191113484,9,0,3,5,7,24
191113485,4,7,9,3,5,28
191113486,7,4,7,4,6,28
191113487,5,9,9,6,2,31
191113488,6,0,4,5,8,23
191113489,6,5,9,9,4,33
191113490,5,5,5,1,0,16
191113491,3,0,2,6,7,18
191113492,1,2,9,2,7,21
191113493,7,1,3,7,5,23
191113494,6,8,9,9,0,32
191113495,8,7,5,8,5,33
191113496,5,3,1,2,9,20
191113497,2,4,2,6,8,22
191113498,3,2,0,8,2,15
191113499,2,1,1,1,9,14
191113500,7,5,6,7,3,28
191113501,3,2,5,5,9,24
191113502,4,0,0,9,8,21
191113503,1,0,0,1,3,5
191113504,6,7,2,2,2,19
191113505,6,6,4,0,6,22
191113506,3,6,0,0,0,9
191113507,7,1,5,3,8,24
191113508,3,3,8,6,8,28
191113509,9,3,9,0,8,29
191113510,9,8,3,6,0,26
191113511,6,2,2,2,0,12
191113512,1,9,9,9,3,31
191113513,8,4,2,8,3,25
191113514,7,5,7,7,9,35
191113515,8,0,3,1,7,19
191113516,0,4,3,3,2,12
191113517,0,8,2,2,7,19
191113518,8,3,6,1,2,20
191113519,9,6,0,5,9,29
191113520,0,2,3,0,9,14
191113521,6,5,9,0,0,20
191113522,2,4,8,6,8,28
191113523,8,5,7,3,0,23
191113524,1,4,7,4,6,22
191113525,2,6,1,4,7,20
191113526,4,6,4,6,2,22
191113527,0,6,3,9,0,18
191113528,8,5,8,8,7,36
191113529,4,7,6,5,9,31
191113530,2,7,8,8,4,29
191113531,5,8,4,7,5,29
191113532,3,2,8,4,5,22
191113533,3,2,6,9,8,28
191113534,1,6,4,9,7,27
191113535,2,7,8,1,6,24
191113536,0,0,4,9,8,21
191113537,0,4,1,4,4,13
191113538,4,5,2,4,4,19
191113539,9,2,9,4,6,30
191113540,2,6,8,0,3,19
191113541,4,6,4,6,0,20
191113542,8,1,5,8,7,29
191113543,8,9,3,5,5,30
191113544,3,2,2,2,1,10
191113545,5,1,5,1,2,14
191113546,2,8,0,9,1,20
191113547,8,4,2,9,2,25
191113548,4,6,4,7,5,26
191113549,4,4,8,6,7,29
191113550,9,1,9,0,3,22
191113551,8,9,1,6,9,33
191113552,0,7,3,7,0,17
191113553,6,1,9,2,5,23
191113554,2,6,2,3,5,18
191113555,5,5,8,7,3,28
191113556,5,5,3,7,6,26
191113557,7,4,4,3,6,24
191113558,3,9,1,2,1,16
191113559,2,0,0,1,9,12
191113560,0,7,5,9,8,29
191113561,0,9,2,3,0,14
191113562,9,0,6,0,0,15
191113563,0,5,1,7,1,14
191113564,9,1,5,0,4,19
191113565,6,5,5,8,0,24
191113566,4,7,9,9,6,35
191113567,7,4,6,4,1,22
191113568,6,9,1,9,9,34
191113569,3,3,8,9,0,23
191113570,0,6,9,9,4,28
191113571,4,2,6,3,3,18
191113572,0,4,7,4,1,16
191113573,8,2,0,8,5,23
191113574,8,6,2,0,5,21
191113575,3,5,7,9,8,32
191113576,7,5,2,0,1,15
191113577,4,9,6,9,3,31
191113578,9,4,2,5,9,29
191113579,0,3,2,5,2,12
191113580,9,0,4,9,0,22
191113581,0,2,3,4,1,10
191113582,3,5,0,3,0,11
191113583,3,8,1,9,2,23
191113584,6,3,1,1,5,16
191113585,9,7,0,2,1,19
191113586,7,7,4,8,1,27
191113587,6,4,7,6,1,24
191113588,9,6,2,3,3,23
191113589,7,8,3,7,4,29
191113590,2,0,7,2,9,20
191113591,5,2,3,0,5,15
191113592,5,4,2,7,6,24
191113593,0,4,6,7,4,21
191113594,5,6,4,7,8,30
191113595,0,2,9,2,7,20
191113596,6,5,5,7,4,27
191113597,3,2,9,2,8,24
191113598,8,9,7,6,8,38
191113599,7,8,4,2,0,21
191113600,7,8,9,5,5,34
191113601,9,2,3,0,8,22
191113602,8,0,3,4,3,18
191113603,1,9,8,9,1,28
191113604,5,7,9,2,0,23
191113605,1,8,6,3,2,20
191113606,1,7,6,4,7,25
191113607,6,3,3,8,1,21
191113608,3,4,3,2,8,20
191113609,2,2,0,0,6,10
191113610,2,6,9,5,2,24
191113611,3,5,0,1,0,9
191113612,9,2,0,5,8,24
191113613,6,8,6,0,8,28
191113614,5,8,4,4,8,29
191113615,4,9,6,6,1,26
191113616,1,0,0,9,2,12
191113617,0,3,8,0,9,20
191113618,9,6,9,3,4,31
191113619,1,1,9,2,8,21
191113620,7,2,2,2,5,18
191113621,4,1,7,5,8,25
191113622,1,3,1,9,7,21
191113623,5,8,7,6,5,31
191113624,5,1,3,6,3,18
191113625,8,7,5,4,5,29
191113626,5,3,8,9,7,32
191113627,6,4,6,5,5,26
191113628,2,7,4,5,4,22
191113629,7,4,8,2,3,24
191113630,5,4,8,0,2,19
191113631,6,4,6,8,0,24
191113632,9,7,2,5,2,25
191113633,4,9,6,8,1,28
191113634,8,4,5,5,3,25
191113635,4,1,1,4,1,11
191113636,0,7,5,6,4,22
191113637,7,1,0,8,9,25
191113638,4,1,1,7,8,21
191113639,5,5,4,7,8,29
191113640,2,0,9,0,0,11
191113641,9,6,5,9,9,38
191113642,0,9,2,1,7,19
191113643,7,2,5,1,0,15
191113644,1,9,4,7,1,22
191113645,7,1,8,4,4,24
191113646,8,7,0,2,4,21
191113647,8,4,4,8,0,24
191113648,0,9,3,1,2,15
191113649,5,1,7,7,2,22
191113650,3,2,8,4,0,17
191113651,1,4,4,5,2,16
191113652,9,1,7,9,9,35
191113653,3,0,8,8,6,25
191113654,3,3,8,4,9,27
191113655,6,4,8,6,0,24
191113656,8,3,2,9,5,27
191113657,6,2,7,5,9,29
191113658,1,2,2,9,2,16
191113659,2,5,9,8,2,26
191113660,2,7,1,7,4,21
191113661,7,4,0,4,2,17
191113662,7,8,5,2,1,23
191113663,9,3,2,4,1,19
191113664,7,4,3,0,0,14
191113665,3,4,5,2,5,19
191113666,5,9,6,6,5,31
191113667,7,0,1,5,5,18
191113668,0,0,0,8,2,10
191113669,0,5,2,2,1,10
191113670,3,3,4,4,4,18
191113671,3,5,6,8,4,26
191113672,4,5,1,7,4,21
191113673,4,5,7,2,4,22
191113674,4,0,9,3,1,17
191113675,3,0,6,4,1,14
191113676,5,3,3,2,6,19
191113677,6,7,3,7,5,28
191113678,7,2,6,6,8,29
191113679,9,8,3,0,9,29
191113680,1,7,5,0,3,16
191113681,0,8,5,2,2,17
191113682,1,6,4,7,4,22
191113683,0,3,4,7,1,15
191113684,7,4,3,8,3,25
191113685,3,2,1,4,3,13
191113686,6,6,2,9,4,27
191113687,1,8,4,7,1,21
191113688,6,9,2,1,2,20
191113689,1,4,4,9,4,22
191113690,4,1,3,3,9,20
191113691,8,3,2,6,5,24
191113692,4,8,3,1,8,24
191113693,9,6,7,1,3,26
191113694,5,5,2,4,5,21
191113695,8,5,2,2,3,20
191113696,8,8,7,3,4,30
191113697,2,3,3,0,9,17
191113698,3,0,3,0,4,10
191113699,1,8,3,9,3,24
191113700,1,3,2,7,1,14
191113701,1,9,6,2,2,20
191113702,7,9,8,8,0,32
191113703,2,1,8,1,2,14
191113704,5,7,8,2,3,25
191113705,0,0,4,8,9,21
191113706,8,3,7,4,3,25
191113707,7,0,8,1,8,24
191113708,3,6,4,0,2,15
191113709,3,0,3,1,8,15
191113710,2,5,3,4,0,14
191113711,0,7,9,7,6,29
191113712,0,6,7,7,4,24
191113713,6,8,7,7,8,36
191113714,3,9,3,4,8,27
191113715,5,8,8,2,1,24
191113716,2,5,9,7,1,24
191113717,1,1,5,0,3,10
191113718,8,5,3,0,7,23
191113719,1,8,7,6,0,22
191113720,3,1,0,1,4,9
191113721,5,9,1,7,9,31
191113722,5,0,9,9,1,24
191113723,6,8,4,8,5,31
191113724,9,6,6,9,4,34
191113725,7,2,6,7,5,27
191113726,4,7,9,0,2,22
191113727,9,8,3,8,1,29
191113728,4,9,3,3,1,20
191113729,4,6,3,9,6,28
191113730,2,4,9,4,2,21
191113731,5,1,9,7,6,28
191113732,3,2,2,8,7,22
191113733,4,8,2,9,9,32
191113734,6,1,9,6,5,27
191113735,3,9,0,5,9,26
191113736,8,1,8,7,1,25
191113737,2,8,9,4,1,24
191113738,3,5,0,7,2,17
191113739,3,9,5,7,8,32
191113740,7,1,4,0,3,15
191113741,8,5,7,2,1,23
191113742,6,2,3,9,0,20
191113743,9,4,4,2,2,21
191113744,0,1,2,4,9,16
191113745,7,7,4,0,0,18
191113746,6,1,0,2,3,12
191113747,9,4,5,1,1,20
191113748,4,0,3,6,5,18
191113749,6,7,7,9,4,33
191113750,9,5,9,8,0,31
191113751,0,6,7,0,9,22
191113752,8,5,0,0,4,17
191113753,5,9,1,7,0,22
191113754,3,9,0,8,5,25
191113755,1,8,8,6,0,23
191113756,2,8,0,8,4,22
191113757,9,5,3,8,7,32
191113758,4,0,1,5,9,19
191113759,2,4,1,6,8,21
191113760,1,7,4,3,4,19
191113761,4,3,1,5,6,19
191113762,4,3,7,1,9,24
191113763,8,8,5,3,8,32
191113764,9,9,5,6,7,36
191113765,7,5,2,4,9,27
191113766,1,7,7,2,4,21
191113767,2,4,0,7,9,22
191113768,3,7,5,1,2,18
191113769,5,3,0,2,4,14
191113770,6,0,2,5,2,15
191113771,1,1,9,6,8,25
191113772,5,7,0,9,7,28
191113773,2,6,7,9,7,31
191113774,4,6,5,6,6,27
191113775,3,9,3,9,1,25
191113776,6,0,7,6,9,28
191113777,1,8,4,7,8,28
191113778,7,2,2,3,8,22
191113779,0,0,0,5,6,11
191113780,3,8,0,6,2,19
191113781,2,3,2,2,9,18
191113782,6,9,3,2,2,22
191113783,4,2,8,9,9,32
191113784,1,3,9,5,1,19
191113785,2,2,2,1,6,13
191113786,6,1,4,4,5,20
191113787,5,8,6,3,0,22
191113788,9,5,2,5,6,27
191113789,6,6,2,2,2,18
191113790,0,4,5,5,6,20
191113791,2,5,9,0,7,23
191113792,2,7,7,0,1,17
191113793,0,0,9,6,3,18
191113794,8,1,9,1,4,23
191113795,7,7,1,9,3,27
191113796,8,6,4,8,0,26
191113797,4,5,3,7,0,19
191113798,0,4,7,3,3,17
191113799,6,7,2,6,0,21
191113800,1,0,1,4,9,15
191113801,7,5,3,0,8,23
191113802,3,0,9,0,2,14
191113803,2,5,3,2,7,19
191113804,5,9,2,4,1,21
191113805,3,2,3,0,6,14
191113806,2,9,2,1,5,19
191113807,2,0,5,0,7,14
191113808,4,3,7,1,5,20
191113809,7,4,6,6,7,30
191113810,1,0,2,5,9,17
191113811,5,9,6,8,4,32
191113812,1,6,3,1,4,15
191113813,1,0,0,2,2,5
191113814,8,8,0,4,9,29
191113815,7,2,9,3,9,30
191113816,4,1,9,1,6,21
191113817,3,1,0,7,1,12
191113818,6,0,6,1,4,17
191113819,9,8,3,0,6,26
191113820,2,5,6,5,6,24
191113821,1,8,8,3,9,29
191113822,3,4,6,8,7,28
191113823,9,1,2,0,4,16
191113824,9,2,1,3,0,15
191113825,6,3,5,1,6,21
191113826,0,8,4,6,3,21
191113827,9,2,4,5,1,21
191113828,5,6,5,5,2,23
191113829,5,0,7,1,3,16
191113830,3,9,6,2,8,28
191113831,3,8,7,9,9,36
191113832,7,6,5,9,9,36
191113833,6,2,8,4,2,22
191113834,1,8,0,6,1,16
191113835,9,3,1,8,5,26
191113836,5,9,3,1,5,23
191113837,8,1,4,9,1,23
191113838,2,3,0,3,8,16
191113839,2,5,1,8,5,21
191113840,9,4,3,7,5,28
191113841,1,7,3,7,7,25
191113842,2,5,0,4,5,16
191113843,6,8,1,0,3,18
191113844,7,1,4,5,3,20
191113845,1,7,1,5,4,18
191113846,9,9,6,3,3,30
191113847,6,7,8,8,9,38
191113848,6,1,7,4,5,23
191113849,0,0,6,9,1,16
191113850,1,0,7,9,6,23
191113851,9,8,8,5,3,33
191113852,7,8,1,7,6,29
191113853,6,6,8,5,7,32
191113854,2,0,6,3,1,12
191113855,9,4,6,2,4,25
191113856,8,0,0,7,6,21
191113857,2,2,2,0,3,9
191113858,5,3,5,9,0,22
191113859,5,9,8,4,6,32
191113860,5,8,8,1,8,30
191113861,7,7,1,1,9,25
191113862,9,0,1,8,3,21
191113863,3,7,6,0,8,24
191113864,9,8,0,8,9,34
191113865,6,6,2,4,8,26
191113866,1,6,2,9,6,24
191113867,2,3,8,3,7,23
191113868,3,5,3,5,2,18
191113869,7,2,9,9,4,31
191113870,9,3,2,8,3,25
191113871,3,3,1,1,0,8
191113872,9,6,1,4,2,22
191113873,7,5,2,6,5,25
191113874,7,1,5,9,0,22
191113875,8,6,1,7,0,22
191113876,3,4,2,7,9,25
191113877,2,2,7,8,2,21
191113878,8,1,9,7,3,28
191113879,8,5,3,2,7,25
191113880,5,7,6,8,6,32
191113881,0,5,5,8,4,22
191113882,8,6,9,2,2,27
191113883,4,7,2,2,4,19
191113884,2,7,6,7,3,25
191113885,8,3,9,4,0,24
191113886,5,5,0,2,1,13
191113887,6,1,6,6,5,24
191113888,9,9,1,2,2,23
191113889,3,7,2,4,0,16
191113890,6,8,3,0,6,23
191113891,5,1,8,0,5,19
191113892,2,4,1,7,3,17
191113893,0,9,3,4,0,16
191113894,7,0,9,5,9,30
191113895,2,1,5,1,3,12
191113896,0,7,4,3,5,19
191113897,9,2,0,2,9,22
191113898,5,9,7,6,7,34
191113899,3,6,8,2,5,24
191113900,9,7,1,6,0,23
191113901,5,3,4,4,1,17
191113902,2,7,5,1,9,24
191113903,2,5,2,9,7,25
191113904,9,0,6,8,7,30
191113905,6,0,4,6,3,19
191113906,6,1,6,6,4,23
191113907,2,1,4,8,6,21
191113908,0,5,3,6,9,23
191113909,9,6,9,1,4,29
191113910,3,4,5,1,8,21
191113911,9,3,1,3,1,17
191113912,4,4,7,6,4,25
191113913,9,1,6,5,6,27
191113914,4,9,4,3,3,23
191113915,4,7,3,3,7,24
191113916,0,2,1,0,2,5
191113917,8,8,0,6,0,22
191113918,4,9,8,6,8,35
191113919,8,5,0,3,4,20
191113920,3,0,5,4,9,21
191113921,7,8,2,4,5,26
191113922,0,3,2,6,5,16
191113923,7,4,7,2,3,23
191113924,9,4,4,1,9,27
191113925,7,0,1,2,6,16
191113926,9,8,0,9,7,33
191113927,5,7,1,6,1,20
191113928,6,0,5,3,2,16
191113929,2,4,0,2,5,13
191113930,8,1,4,3,5,21
191113931,0,5,0,3,1,9
191113932,4,2,9,4,8,27
191113933,6,7,1,5,7,26
191113934,2,9,9,6,2,28
191113935,9,7,7,6,0,29
191113936,5,5,8,6,6,30
191113937,3,6,6,5,3,23
191113938,0,6,8,6,0,20
191113939,0,9,7,1,7,24
191113940,9,4,8,4,2,27
191113941,0,4,6,7,7,24
191113942,0,2,9,5,4,20
191113943,7,5,3,9,8,32
191113944,4,3,0,3,5,15
191113945,9,8,4,6,3,30
191113946,1,5,5,8,3,22
191113947,0,5,7,6,8,26
191113948,1,0,4,5,0,10
191113949,3,5,3,6,3,20
191113950,2,5,6,4,0,17
191113951,4,7,0,3,2,16
191113952,4,3,2,1,2,12
191113953,3,1,1,8,9,22
191113954,5,4,4,8,2,23
191113955,3,2,5,7,8,25
191113956,6,6,3,0,2,17
191113957,0,3,8,7,3,21
191113958,3,4,6,3,5,21
191113959,5,2,3,2,2,14
191113960,4,8,6,8,3,29
191113961,4,1,8,3,3,19
191113962,5,5,7,1,5,23
191113963,2,9,7,7,3,28
191113964,2,9,3,4,0,18
191113965,2,1,4,7,0,14
191113966,9,4,4,5,8,30
191113967,9,0,3,9,5,26
191113968,9,0,5,3,6,23
191113969,1,6,6,2,4,19
191113970,6,9,7,2,4,28
191113971,1,7,2,3,4,17
191113972,5,0,6,8,8,27
191113973,7,4,2,4,6,23
191113974,6,9,5,1,0,21
191113975,6,1,8,5,1,21
191113976,7,0,5,8,1,21
191113977,2,6,6,6,6,26
191113978,1,0,2,8,6,17
191113979,6,1,1,4,0,12
191113980,5,4,8,9,3,29
191113981,2,9,3,2,7,23
191113982,3,1,6,8,0,18
191113983,8,5,1,2,7,23
191113984,1,7,2,1,4,15
191113985,5,1,8,8,9,31
191113986,8,1,5,9,2,25
191113987,7,4,7,7,2,27
191113988,5,6,7,4,8,30
191113989,2,7,9,6,1,25
191113990,7,0,2,7,0,16
191113991,6,2,2,1,8,19
191113992,6,2,1,3,0,12
191113993,7,7,0,4,2,20
191113994,1,1,6,4,6,18
191113995,9,7,2,8,6,32
191113996,7,5,0,9,1,22
191113997,3,1,4,1,1,10
191113998,9,9,6,0,5,29
191113999,0,4,6,2,6,18
1911131000,6,8,3,7,9,33
1911131001,4,6,1,6,4,21
1911131002,1,5,1,3,6,16
1911131003,8,0,6,1,9,24
1911131004,4,6,2,4,4,20
1911131005,2,0,3,9,9,23
1911131006,7,3,7,4,3,24
1911131007,5,5,3,7,8,28
1911131008,6,9,0,6,9,30
1911131009,0,4,0,6,4,14
1911131010,1,1,2,8,5,17
1911131011,0,1,0,7,1,9
1911131012,5,0,9,4,0,18
1911131013,8,3,1,6,5,23
1911131014,9,1,8,9,1,28
1911131015,0,7,5,6,5,23
1911131016,2,3,2,1,3,11
1911131017,8,9,1,7,4,29
1911131018,2,8,9,7,3,29
1911131019,9,1,6,8,1,25
1911131020,7,2,6,3,9,27
1911131021,8,1,5,3,4,21
1911131022,3,9,4,9,7,32
1911131023,2,9,0,4,0,15
1911131024,8,2,8,1,8,27
1911131025,6,2,4,0,3,15
1911131026,8,2,7,5,7,29
1911131027,7,1,3,0,2,13
1911131028,2,6,1,5,2,16
1911131029,1,9,3,9,3,25
1911131030,4,1,0,7,7,19
1911131031,2,1,0,7,6,16
1911131032,3,7,9,4,4,27
1911131033,9,2,5,8,7,31
1911131034,0,5,2,3,9,19
1911131035,1,5,6,9,6,27
1911131036,2,3,2,7,0,14
1911131037,0,7,8,4,4,23
1911131038,0,8,5,4,2,19
1911131039,5,0,8,9,6,28
1911131040,7,6,4,7,9,33
1911131041,3,2,6,7,2,20
1911131042,6,0,6,5,7,24
1911131043,6,0,8,8,5,27
1911131044,8,5,7,8,3,31
1911131045,5,2,3,7,6,23
1911131046,5,7,1,5,4,22
1911131047,3,7,1,0,5,16
1911131048,3,6,5,1,7,22
1911131049,1,1,2,1,3,8
1911131050,0,3,9,1,7,20
1911131051,3,6,4,1,7,21
1911131052,5,5,7,0,7,24
1911131053,0,1,4,5,8,18
1911131054,7,0,0,3,5,15
1911131055,1,7,3,5,1,17
1911131056,9,8,2,3,2,24
1911131057,8,7,7,3,0,25
1911131058,0,7,3,7,9,26
1911131059,7,8,4,1,8,28
1911131060,7,7,2,9,7,32
1911131061,3,4,8,6,3,24
1911131062,9,9,6,7,9,40
1911131063,8,3,2,8,7,28
1911131064,6,9,8,0,6,29
1911131065,3,5,9,2,6,25
1911131066,8,2,5,1,5,21
1911131067,2,0,2,8,3,15
1911131068,5,6,8,3,1,23
1911131069,9,5,2,6,4,26
1911131070,2,8,3,9,9,31
1911131071,2,5,1,7,9,24
1911131072,5,6,6,9,6,32
1911131073,9,9,6,0,0,24
1911131074,9,8,3,4,2,26
1911131075,1,2,6,1,0,10
1911131076,0,2,0,1,4,7
1911131077,9,2,3,8,1,23
1911131078,8,1,4,4,3,20
1911131079,9,7,9,9,3,37
1911131080,3,7,2,9,8,29
1911131081,7,4,4,0,4,19
1911131082,0,1,9,8,1,19
1911131083,6,3,7,2,5,23
1911131084,3,4,7,5,5,24
1911131085,0,5,8,7,7,27
1911131086,5,5,6,2,6,24
1911131087,6,4,9,5,7,31
1911131088,5,1,8,2,3,19
1911131089,4,6,0,8,0,18
1911131090,1,7,6,0,7,21
1911131091,9,1,5,0,5,20
1911131092,0,9,8,8,8,33
1911131093,8,0,0,2,2,12
1911131094,2,6,0,5,0,13
1911131095,7,8,2,0,1,18
1911131096,0,6,3,9,8,26
1911131097,8,3,7,9,4,31
1911131098,8,6,2,8,6,30
1911131099,1,3,2,5,4,15
1911131100,3,3,4,7,4,21
1911131101,9,8,4,0,8,29
1911131102,0,5,2,3,8,18
1911131103,2,0,3,9,3,17
1911131104,9,4,4,8,7,32
1911131105,5,2,7,3,2,19
191114001,8,4,4,4,9,29
191114002,5,0,9,0,4,18
191114003,8,1,5,1,0,15
191114004,0,3,2,7,2,14
191114005,3,0,6,9,5,23
191114006,6,8,7,2,1,24
191114007,9,1,3,8,6,27
191114008,1,8,2,4,2,17
191114009,1,2,3,4,4,14
191114010,5,2,2,5,3,17
191114011,8,8,6,4,9,35
191114012,8,1,5,7,6,27
191114013,9,0,8,8,3,28
191114014,7,9,5,8,8,37
191114015,8,0,4,2,4,18
191114016,4,7,5,7,3,26
191114017,4,9,6,0,8,27
191114018,8,0,4,5,4,21
191114019,1,0,9,3,2,15
191114020,0,3,6,0,2,11
191114021,0,2,0,6,1,9
191114022,4,9,1,1,9,24
191114023,1,4,8,3,1,17
191114024,1,9,8,5,6,29
191114025,5,1,7,6,1,20
191114026,0,1,2,3,2,8
191114027,6,7,5,8,1,27
191114028,1,1,0,9,2,13
191114029,5,6,4,2,8,25
191114030,5,7,2,4,1,19
191114031,0,1,3,4,5,13
191114032,3,6,8,5,9,31
191114033,9,0,8,0,1,18
191114034,1,3,5,9,7,25
191114035,6,1,4,2,2,15
191114036,1,7,4,9,9,30
191114037,2,5,8,8,4,27
191114038,7,1,0,9,4,21
191114039,2,0,5,0,4,11
191114040,1,5,5,5,4,20
191114041,9,1,2,1,2,15
191114042,1,1,5,9,1,17
191114043,4,6,7,6,1,24
191114044,0,0,8,5,8,21
191114045,0,4,7,1,1,13
191114046,4,9,8,5,8,34
191114047,8,4,6,6,1,25
191114048,3,2,2,8,0,15
191114049,7,6,9,9,9,40
191114050,6,2,3,3,3,17
191114051,7,8,2,1,9,27
191114052,4,5,4,6,4,23
191114053,6,9,2,0,5,22
191114054,3,3,7,4,2,19
191114055,9,1,4,6,5,25
191114056,8,1,4,6,3,22
191114057,6,5,3,2,7,23
191114058,4,0,3,5,0,12
191114059,6,8,5,3,2,24
191114060,1,4,3,8,1,17
191114061,6,9,2,9,2,28
191114062,2,2,2,4,3,13
191114063,1,7,8,1,5,22
191114064,9,0,8,8,1,26
191114065,3,9,3,3,6,24
191114066,2,6,2,8,5,23
191114067,9,1,9,9,7,35
191114068,2,9,1,1,5,18
191114069,2,0,0,5,9,16
191114070,6,4,0,6,3,19
191114071,4,8,8,4,1,25
191114072,5,4,2,4,1,16
191114073,1,9,8,4,7,29
191114074,0,4,8,3,2,17
191114075,8,8,8,4,2,30
191114076,6,9,6,6,5,32
191114077,3,6,4,1,4,18
191114078,9,8,0,7,8,32
191114079,2,7,5,2,3,19
191114080,3,3,7,5,2,20
191114081,4,9,5,3,9,30
191114082,3,7,4,4,7,25
191114083,6,0,5,5,3,19
191114084,7,0,1,7,0,15
191114085,1,3,7,8,8,27
191114086,6,4,9,3,2,24
191114087,8,2,8,5,1,24
191114088,1,5,5,4,6,21
191114089,4,3,6,6,8,27
191114090,1,7,9,1,7,25
191114091,3,6,4,1,8,22
191114092,5,8,5,7,2,27
191114093,3,9,5,2,8,27
191114094,2,9,2,5,8,26
191114095,2,4,1,2,3,12
191114096,0,0,8,7,5,20
191114097,6,3,5,5,2,21
191114098,5,2,0,5,3,15
191114099,9,7,9,5,7,37
191114100,5,6,0,3,5,19
191114101,7,6,8,1,8,30
191114102,7,0,8,5,3,23
191114103,9,2,7,6,5,29
191114104,5,3,4,0,9,21
191114105,8,1,2,1,8,20
191114106,7,7,0,9,6,29
191114107,0,5,2,6,2,15
191114108,2,5,8,4,8,27
191114109,6,5,7,9,2,29
191114110,8,6,2,5,6,27
191114111,0,5,2,3,2,12
191114112,5,2,3,7,7,24
191114113,7,8,9,9,6,39
191114114,1,7,6,5,3,22
191114115,3,3,0,1,6,13
191114116,0,8,0,9,2,19
191114117,3,2,4,8,4,21
191114118,3,8,2,1,3,17
191114119,3,8,1,7,6,25
191114120,0,8,5,2,4,19
191114121,0,3,2,8,8,21
191114122,2,0,0,7,4,13
191114123,9,6,9,9,5,38
191114124,1,2,4,6,0,13
191114125,3,0,3,9,1,16
191114126,9,6,3,9,2,29
191114127,7,9,1,5,9,31
191114128,0,4,4,4,9,21
191114129,9,4,0,3,6,22
191114130,9,9,2,1,1,22
191114131,1,7,7,0,6,21
191114132,7,3,6,3,8,27
191114133,8,6,9,8,6,37
191114134,5,4,8,6,3,26
191114135,1,3,6,0,4,14
191114136,6,5,1,5,4,21
191114137,1,7,1,6,2,17
191114138,5,3,9,9,7,33
191114139,7,3,3,1,8,22
191114140,5,3,0,2,9,19
191114141,9,1,5,5,9,29
191114142,4,7,5,5,4,25
191114143,7,8,7,0,4,26
191114144,8,0,8,9,7,32
191114145,4,8,0,8,5,25
191114146,3,1,9,0,4,17
191114147,4,6,6,7,0,23
191114148,5,8,8,1,1,23
191114149,5,7,0,4,8,24
191114150,5,2,1,4,3,15
191114151,1,2,5,8,0,16
191114152,1,1,5,5,4,16
191114153,9,0,0,1,8,18
191114154,7,3,2,1,1,14
191114155,8,4,5,6,2,25
191114156,7,0,5,4,1,17
191114157,7,0,4,1,0,12
191114158,0,9,4,3,1,17
191114159,2,1,0,7,4,14
191114160,2,1,7,5,9,24
191114161,1,3,0,8,2,14
191114162,5,8,0,8,3,24
191114163,7,4,6,2,6,25
191114164,0,5,5,2,7,19
191114165,5,3,4,4,2,18
191114166,9,8,4,1,3,25
191114167,4,0,9,3,5,21
191114168,6,4,0,6,1,17
191114169,2,9,2,8,3,24
191114170,5,6,7,7,1,26
191114171,9,8,4,0,5,26
191114172,0,0,3,9,5,17
191114173,8,7,1,3,2,21
191114174,1,9,1,5,2,18
191114175,7,1,8,2,5,23
191114176,0,7,1,7,6,21
191114177,8,6,7,6,7,34
191114178,7,7,5,7,7,33
191114179,8,2,5,2,6,23
191114180,6,3,8,9,5,31
191114181,8,2,7,6,6,29
191114182,0,2,0,7,1,10
191114183,6,1,9,0,4,20
191114184,7,3,3,0,2,15
191114185,9,9,1,2,7,28
191114186,3,8,0,4,3,18
191114187,6,2,1,3,7,19
191114188,2,0,4,5,8,19
191114189,6,9,2,2,8,27
191114190,9,8,3,3,3,26
191114191,6,4,8,4,3,25
191114192,7,6,3,8,5,29
191114193,0,2,9,9,9,29
191114194,9,5,7,3,8,32
191114195,6,6,8,5,6,31
191114196,2,3,7,4,8,24
191114197,2,0,9,2,7,20
191114198,8,5,8,1,2,24
191114199,7,2,5,4,1,19
191114200,2,5,0,3,5,15
191114201,7,8,2,4,1,22
191114202,0,6,5,1,3,15
191114203,5,9,7,6,4,31
191114204,0,3,2,5,8,18
191114205,4,9,9,0,7,29
191114206,8,7,4,9,8,36
191114207,8,7,9,2,5,31
191114208,3,7,9,0,5,24
191114209,5,3,7,6,2,23
191114210,9,8,6,6,1,30
191114211,6,8,6,8,9,37
191114212,6,0,1,5,2,14
191114213,1,2,5,9,3,20
191114214,7,4,3,8,5,27
191114215,5,1,5,0,9,20
191114216,7,0,5,2,7,21
191114217,2,9,4,6,5,26
191114218,5,0,5,1,4,15
191114219,4,2,8,7,3,24
191114220,4,0,2,3,9,18
191114221,2,8,8,4,3,25
191114222,6,3,1,0,2,12
191114223,3,7,4,7,1,22
191114224,7,8,5,6,0,26
191114225,1,8,7,2,9,27
191114226,3,4,8,7,7,29
191114227,1,9,2,2,0,14
191114228,4,7,4,5,7,27
191114229,4,2,2,5,6,19
191114230,5,8,7,4,1,25
191114231,0,0,9,0,5,14
191114232,3,5,5,5,0,18
191114233,8,2,3,5,3,21
191114234,7,2,3,9,1,22
191114235,3,3,0,2,8,16
191114236,6,1,1,2,9,19
191114237,2,1,0,7,3,13
191114238,9,0,8,3,7,27
191114239,5,8,7,0,5,25
191114240,8,4,9,3,8,32
191114241,9,3,2,6,3,23
191114242,1,3,0,2,9,15
191114243,8,0,1,9,4,22
191114244,4,2,3,6,9,24
191114245,4,3,4,3,9,23
191114246,9,3,3,1,8,24
191114247,1,6,0,9,2,18
191114248,2,7,6,9,6,30
191114249,5,7,7,4,1,24
191114250,7,0,8,8,2,25
191114251,0,8,2,0,9,19
191114252,3,4,9,0,7,23
191114253,7,1,4,4,4,20
191114254,9,6,9,0,6,30
191114255,5,3,8,4,2,22
191114256,7,9,6,3,0,25
191114257,0,7,4,6,3,20
191114258,5,6,2,9,2,24
191114259,7,8,0,8,0,23
191114260,5,1,2,0,6,14
191114261,1,4,5,5,4,19
191114262,4,0,4,2,1,11
191114263,5,3,9,5,6,28
191114264,0,6,9,8,4,27
191114265,2,2,4,1,7,16
191114266,6,0,1,2,2,11
191114267,2,8,3,4,0,17
191114268,7,5,4,9,3,28
191114269,0,9,9,4,6,28
191114270,4,9,5,1,7,26
191114271,0,5,9,0,3,17
191114272,5,4,2,9,0,20
191114273,1,8,2,3,4,18
191114274,5,0,5,3,4,17
191114275,2,5,7,9,0,23
191114276,1,6,1,2,7,17
191114277,3,3,0,7,5,18
191114278,0,7,7,4,2,20
191114279,2,2,0,9,7,20
191114280,0,1,2,1,6,10
191114281,4,8,6,8,9,35
191114282,2,1,3,4,4,14
191114283,9,4,3,7,8,31
191114284,8,5,1,7,3,24
191114285,1,6,5,2,4,18
191114286,1,0,2,7,3,13
191114287,1,8,3,8,6,26
191114288,0,0,5,8,4,17
191114289,5,8,4,8,0,25
191114290,1,6,1,4,1,13
191114291,0,9,6,8,0,23
191114292,2,1,2,4,8,17
191114293,4,9,2,2,3,20
191114294,2,7,1,5,3,18
191114295,6,7,7,8,3,31
191114296,7,4,5,4,4,24
191114297,1,1,0,2,3,7
191114298,7,9,5,0,1,22
191114299,2,5,8,9,1,25
191114300,6,5,9,8,7,35
191114301,3,4,8,5,9,29
191114302,1,2,1,1,6,11
191114303,7,1,3,5,0,16
191114304,2,8,3,7,8,28
191114305,1,3,7,8,1,20
191114306,0,4,9,7,8,28
191114307,1,2,6,3,4,16
191114308,2,1,2,5,5,15
191114309,9,4,6,5,0,24
191114310,3,7,8,0,5,23
191114311,5,6,9,9,6,35
191114312,6,4,6,2,9,27
191114313,8,8,0,0,1,17
191114314,1,8,1,7,4,21
191114315,4,7,4,2,0,17
191114316,2,6,9,1,5,23
191114317,7,1,5,8,2,23
191114318,5,1,8,3,5,22
191114319,5,0,8,8,1,22
191114320,9,0,2,6,6,23
191114321,6,0,2,4,5,17
191114322,1,0,8,3,9,21
191114323,9,5,5,0,1,20
191114324,1,1,0,1,7,10
191114325,9,7,5,4,3,28
191114326,8,2,2,2,7,21
191114327,4,0,3,1,6,14
191114328,8,4,6,5,3,26
191114329,2,9,2,7,2,22
191114330,4,1,3,0,5,13
191114331,5,8,5,6,8,32
191114332,2,5,8,5,0,20
191114333,5,8,1,9,7,30
191114334,8,2,4,7,7,28
191114335,1,3,8,5,3,20
191114336,8,1,8,6,8,31
191114337,5,6,1,1,7,20
191114338,5,5,8,8,2,28
191114339,1,6,2,0,1,10
191114340,7,6,8,5,0,26
191114341,5,4,6,0,6,21
191114342,4,5,0,0,2,11
191114343,2,8,3,0,8,21
191114344,6,3,0,9,2,20
191114345,6,1,8,7,0,22
191114346,0,2,6,3,4,15
191114347,2,2,9,8,3,24
191114348,6,8,3,4,2,23
191114349,1,5,2,2,7,17
191114350,9,4,9,5,9,36
191114351,0,5,6,8,0,19
191114352,9,9,6,0,6,30
191114353,8,9,8,8,4,37
191114354,0,5,8,6,5,24
191114355,2,8,9,4,7,30
191114356,6,2,7,4,3,22
191114357,5,6,3,5,4,23
191114358,5,6,6,5,9,31
191114359,8,7,0,1,6,22
191114360,4,6,6,5,8,29
191114361,5,3,5,3,3,19
191114362,3,6,0,2,7,18
191114363,3,0,3,4,9,19
191114364,9,5,6,9,0,29
191114365,5,3,0,3,4,15
191114366,3,2,5,6,1,17
191114367,0,4,3,9,6,22
191114368,7,2,4,3,4,20
191114369,6,8,8,6,1,29
191114370,5,7,4,6,3,25
191114371,4,6,0,7,1,18
191114372,3,4,9,9,4,29
191114373,5,4,8,7,7,31
191114374,9,9,7,0,6,31
191114375,8,6,3,3,6,26
191114376,7,8,1,6,9,31
191114377,1,3,6,7,9,26
191114378,4,1,9,7,1,22
191114379,0,0,9,1,7,17
191114380,8,7,1,5,8,29
191114381,0,0,4,9,2,15
191114382,3,6,0,5,7,21
191114383,3,1,3,6,4,17
191114384,6,1,7,6,2,22
191114385,6,6,6,5,6,29
191114386,7,5,2,4,4,22
191114387,4,0,6,8,9,27
191114388,1,9,2,2,7,21
191114389,6,8,7,9,0,30
191114390,1,6,7,9,6,29
191114391,7,6,5,8,4,30
191114392,3,2,8,3,0,16
191114393,5,5,5,0,7,22
191114394,9,3,5,9,6,32
191114395,7,9,3,9,8,36
191114396,4,2,2,0,8,16
191114397,0,9,3,0,0,12
191114398,1,4,7,2,7,21
191114399,3,7,1,2,1,14
191114400,9,8,6,5,2,30
191114401,2,6,9,8,5,30
191114402,4,9,2,3,6,24
191114403,9,7,4,0,8,28
191114404,1,3,6,1,9,20
191114405,2,0,1,3,1,7
191114406,2,3,2,5,7,19
191114407,3,4,6,9,4,26
191114408,5,2,0,7,7,21
191114409,3,9,5,3,5,25
191114410,9,5,1,1,9,25
191114411,1,2,4,7,5,19
191114412,0,0,0,4,2,6
191114413,0,8,6,1,4,19
191114414,5,9,1,0,7,22
191114415,8,1,7,6,8,30
191114416,8,6,6,5,2,27
191114417,0,9,9,2,6,26
191114418,1,9,8,7,8,33
191114419,5,1,8,7,5,26
191114420,3,7,0,4,1,15
191114421,6,3,6,9,7,31
191114422,6,4,0,2,3,15
191114423,0,9,8,8,5,30
191114424,1,3,7,8,7,26
191114425,4,3,2,3,0,12
191114426,7,5,1,6,4,23
191114427,4,0,8,2,0,14
191114428,4,5,0,6,2,17
191114429,2,1,0,1,4,8
191114430,4,0,7,3,7,21
191114431,9,4,7,0,0,20
191114432,0,2,4,9,8,23
191114433,7,7,0,3,1,18
191114434,0,6,9,2,1,18
191114435,6,3,1,6,8,24
191114436,9,2,3,0,2,16
191114437,8,5,9,6,5,33
191114438,5,4,5,6,4,24
191114439,2,2,2,3,0,9
191114440,0,2,0,3,5,10
191114441,7,0,6,8,3,24
191114442,3,8,1,8,1,21
191114443,0,6,8,8,4,26
191114444,0,9,6,5,9,29
191114445,4,5,1,9,7,26
191114446,2,9,1,2,3,17
191114447,0,5,3,9,9,26
191114448,7,3,4,6,0,20
191114449,2,6,3,0,8,19
191114450,4,6,7,6,9,32
191114451,2,1,8,0,0,11
191114452,4,7,6,3,9,29
191114453,0,8,8,7,3,26
191114454,9,9,4,9,3,34
191114455,3,6,8,7,4,28
191114456,1,4,4,8,0,17
191114457,2,6,5,0,3,16
191114458,9,0,4,0,2,15
191114459,8,2,7,2,4,23
191114460,9,1,0,9,3,22
191114461,4,4,0,1,2,11
191114462,5,6,5,0,1,17
191114463,2,8,7,2,1,20
191114464,8,3,3,1,7,22
191114465,8,5,1,1,2,17
191114466,9,5,7,0,7,28
191114467,0,4,7,1,8,20
191114468,3,4,7,9,7,30
191114469,8,9,1,1,0,19
191114470,1,9,1,1,3,15
191114471,6,4,8,5,6,29
191114472,1,1,3,1,0,6
191114473,6,5,2,1,8,22
191114474,6,8,6,7,4,31
191114475,9,0,7,5,4,25
191114476,6,5,1,5,6,23
191114477,3,5,8,6,4,26
191114478,8,7,5,4,8,32
191114479,0,2,6,3,7,18
191114480,0,1,7,6,0,14
191114481,8,1,8,8,3,28
191114482,5,4,4,5,7,25
191114483,8,7,0,6,2,23
191114484,2,2,0,1,3,8
191114485,0,6,9,1,9,25
191114486,4,2,5,3,1,15
191114487,8,3,8,0,8,27
191114488,2,8,6,8,2,26
191114489,5,1,8,0,3,17
191114490,9,2,2,2,3,18
191114491,2,9,4,3,9,27
191114492,9,9,3,3,0,24
191114493,6,7,6,8,5,32
191114494,7,2,0,0,2,11
191114495,7,2,2,8,0,19
191114496,2,5,0,0,2,9
191114497,7,2,1,7,3,20
191114498,5,9,5,6,9,34
191114499,9,1,6,2,5,23
191114500,3,2,3,8,7,23
191114501,9,1,7,1,5,23
191114502,6,9,8,1,5,29
191114503,5,5,8,0,1,19
191114504,9,5,3,4,1,22
191114505,4,6,3,8,5,26
191114506,0,0,8,9,1,18
191114507,6,3,4,2,8,23
191114508,7,9,5,3,9,33
191114509,5,8,6,0,0,19
191114510,1,8,1,3,4,17
191114511,5,0,0,1,3,9
191114512,2,1,5,8,5,21
191114513,1,9,0,7,5,22
191114514,9,6,6,0,4,25
191114515,2,0,8,0,9,19
191114516,2,2,2,8,6,20
191114517,4,1,9,6,5,25
191114518,9,7,3,8,0,27
191114519,6,4,0,6,9,25
191114520,6,7,4,5,9,31
191114521,8,7,2,8,6,31
191114522,6,4,9,7,9,35
191114523,4,8,2,5,5,24
191114524,4,7,8,5,4,28
191114525,5,1,1,4,6,17
191114526,7,3,7,8,3,28
191114527,3,7,8,9,8,35
191114528,0,4,5,9,9,27
191114529,4,9,1,3,6,23
191114530,4,8,8,7,4,31
191114531,9,2,4,6,6,27
191114532,5,9,1,5,2,22
191114533,2,7,0,0,6,15
191114534,3,6,1,8,3,21
191114535,2,0,3,3,8,16
191114536,7,7,6,3,8,31
191114537,1,7,4,5,0,17
191114538,4,5,1,9,1,20
191114539,5,1,4,7,0,17
191114540,6,8,1,5,1,21
191114541,1,6,0,6,1,14
191114542,1,8,1,0,8,18
191114543,5,9,3,0,2,19
191114544,1,2,8,9,4,24
191114545,3,7,6,2,9,27
191114546,9,1,0,9,8,27
191114547,7,2,4,0,1,14
191114548,4,5,3,9,9,30
191114549,7,1,1,0,9,18
191114550,2,5,9,0,8,24
191114551,6,3,9,5,4,27
191114552,1,7,8,5,7,28
191114553,3,1,8,8,1,21
191114554,8,8,6,1,3,26
191114555,1,9,4,5,4,23
191114556,5,2,5,1,0,13
191114557,4,8,7,0,5,24
191114558,3,2,5,5,8,23
191114559,2,5,9,3,0,19
191114560,7,1,3,2,7,20
191114561,4,6,4,3,5,22
191114562,2,8,9,4,3,26
191114563,2,8,1,5,4,20
191114564,8,9,1,7,3,28
191114565,4,1,2,7,3,17
191114566,8,8,4,9,2,31
191114567,4,8,6,1,8,27
191114568,7,3,7,6,8,31
191114569,7,0,5,7,0,19
191114570,1,0,2,6,7,16
191114571,9,0,1,8,8,26
191114572,2,3,5,8,8,26
191114573,3,3,0,3,8,17
191114574,1,7,7,5,1,21
191114575,0,1,1,5,8,15
191114576,8,1,1,0,2,12
191114577,0,6,3,4,0,13
191114578,5,1,4,0,0,10
191114579,4,3,6,0,3,16
191114580,5,7,9,8,5,34
191114581,1,2,3,3,8,17
191114582,0,9,4,8,8,29
191114583,9,6,3,4,0,22
191114584,6,5,3,0,8,22
191114585,1,4,9,7,8,29
191114586,5,3,4,4,5,21
191114587,0,7,5,7,9,28
191114588,7,9,2,3,9,30
191114589,3,5,6,6,8,28
191114590,4,8,2,1,0,15
191114591,2,9,7,1,2,21
191114592,7,2,3,3,3,18
191114593,7,5,1,5,8,26
191114594,1,2,2,2,8,15
191114595,4,0,9,3,4,20
191114596,0,1,9,4,3,17
191114597,2,0,9,6,8,25
191114598,0,1,4,3,8,16
191114599,7,1,2,2,6,18
191114600,4,3,5,2,5,19
191114601,2,4,7,0,5,18
191114602,1,0,0,8,4,13
191114603,9,3,9,3,0,24
191114604,0,7,7,8,9,31
191114605,5,0,8,8,3,24
191114606,1,2,1,0,4,8
191114607,1,6,9,8,9,33
191114608,4,7,8,9,1,29
191114609,3,5,5,3,9,25
191114610,4,8,8,3,2,25
191114611,3,0,4,2,9,18
191114612,6,2,4,9,8,29
191114613,2,1,5,7,3,18
191114614,1,0,6,0,3,10
191114615,6,3,7,0,7,23
191114616,7,4,5,6,9,31
191114617,0,4,2,4,6,16
191114618,7,6,1,8,2,24
191114619,7,9,4,6,3,29
191114620,8,2,0,0,2,12
191114621,8,3,9,9,8,37
191114622,9,2,5,3,2,21
191114623,2,1,3,9,2,17
191114624,9,2,1,5,4,21
191114625,1,6,5,9,1,22
191114626,2,6,8,2,0,18
191114627,6,8,9,8,7,38
191114628,6,2,8,6,3,25
191114629,4,1,1,9,1,16
191114630,2,0,8,4,5,19
191114631,4,1,1,0,3,9
191114632,7,5,2,2,5,21
191114633,1,2,7,1,0,11
191114634,0,0,5,0,7,12
191114635,8,7,0,8,8,31
191114636,2,7,5,7,8,29
191114637,3,5,8,4,5,25
191114638,8,6,3,9,2,28
191114639,5,2,7,0,1,15
191114640,8,8,5,1,3,25
191114641,3,4,5,4,7,23
191114642,7,4,1,9,3,24
191114643,1,2,3,8,4,18
191114644,6,0,7,5,9,27
191114645,1,8,0,6,5,20
191114646,1,9,1,1,4,16
191114647,7,0,1,5,0,13
191114648,5,2,9,6,4,26
191114649,0,1,3,3,5,12
191114650,3,8,0,8,6,25
191114651,8,5,6,0,7,26
191114652,1,3,7,1,3,15
191114653,1,6,6,1,7,21
191114654,1,3,3,1,8,16
191114655,1,7,9,0,1,18
191114656,8,5,8,2,1,24
191114657,3,5,8,8,2,26
191114658,2,3,9,2,3,19
191114659,3,5,6,5,8,27
191114660,8,8,9,2,7,34
191114661,1,7,8,9,7,32
191114662,3,1,8,7,5,24
191114663,2,8,1,4,4,19
191114664,0,8,5,1,6,20
191114665,6,5,5,6,1,23
191114666,9,8,0,9,6,32
191114667,8,9,4,8,7,36
191114668,7,1,3,3,5,19
191114669,6,3,9,9,1,28
191114670,7,3,4,7,4,25
191114671,4,1,9,8,3,25
191114672,1,6,1,5,7,20
191114673,7,7,8,4,2,28
191114674,6,0,0,2,3,11
191114675,0,8,0,5,1,14
191114676,9,8,6,9,2,34
191114677,7,2,0,5,2,16
191114678,4,0,3,3,2,12
191114679,6,8,2,2,7,25
191114680,5,6,6,1,0,18
191114681,8,7,5,0,5,25
191114682,2,0,2,8,7,19
191114683,2,7,8,6,1,24
191114684,0,1,9,8,4,22
191114685,3,5,0,0,3,11
191114686,1,3,3,3,3,13
191114687,1,5,7,9,5,27
191114688,5,9,0,6,9,29
191114689,1,9,5,2,4,21
191114690,0,9,8,3,8,28
191114691,0,2,3,0,8,13
191114692,6,7,8,7,7,35
191114693,0,2,7,1,1,11
191114694,7,1,8,9,2,27
191114695,1,1,3,4,3,12
191114696,7,0,6,5,9,27
191114697,5,2,4,4,9,24
191114698,7,3,0,4,6,20
191114699,6,1,7,0,5,19
191114700,9,7,9,1,5,31
191114701,4,4,8,3,4,23
191114702,4,0,4,0,2,10
191114703,9,0,5,3,4,21
191114704,5,8,1,2,7,23
191114705,2,0,5,6,6,19
191114706,9,7,7,9,6,38
191114707,3,8,9,2,6,28
191114708,3,3,5,8,2,21
191114709,6,0,7,6,4,23
191114710,1,6,3,2,3,15
191114711,1,9,5,5,0,20
191114712,7,8,8,6,8,37
191114713,2,3,9,2,0,16
191114714,8,6,8,9,8,39
191114715,6,7,1,6,3,23
191114716,1,2,2,1,9,15
191114717,9,8,9,4,9,39
191114718,3,6,1,9,2,21
191114719,4,2,0,6,0,12
191114720,1,9,5,4,6,25
191114721,3,6,0,0,9,18
191114722,3,5,7,2,0,17
191114723,1,5,7,8,5,26
191114724,7,0,4,8,2,21
191114725,5,8,7,1,2,23
191114726,9,5,5,8,3,30
191114727,6,2,1,2,3,14
191114728,8,7,0,5,9,29
191114729,5,2,4,6,6,23
191114730,9,4,0,4,6,23
191114731,9,3,6,9,4,31
191114732,6,2,3,4,0,15
191114733,3,4,3,2,9,21
191114734,7,0,6,2,1,16
191114735,7,7,1,3,9,27
191114736,6,6,7,9,2,30
191114737,3,3,0,1,4,11
191114738,9,6,1,1,8,25
191114739,7,3,3,0,3,16
191114740,1,5,5,1,9,21
191114741,4,1,5,5,0,15
191114742,6,2,7,7,2,24
191114743,9,1,3,5,5,23
191114744,1,3,0,4,5,13
191114745,3,0,6,2,5,16
191114746,8,9,4,6,7,34
191114747,4,0,7,4,4,19
191114748,9,2,8,1,6,26
191114749,1,1,8,2,2,14
191114750,6,6,4,3,9,28
191114751,7,8,4,3,8,30
191114752,1,2,1,6,2,12
191114753,7,0,7,5,0,19
191114754,8,2,0,4,3,17
191114755,6,1,8,8,1,24
191114756,3,0,1,9,2,15
191114757,9,3,0,8,9,29
191114758,4,8,2,0,4,18
191114759,0,2,6,3,8,19
191114760,3,4,3,9,3,22
191114761,2,2,9,2,5,20
191114762,3,1,1,9,6,20
191114763,4,3,4,1,4,16
191114764,7,5,6,0,4,22
191114765,3,8,6,4,0,21
191114766,7,0,2,2,2,13
191114767,1,6,6,9,6,28
191114768,9,6,9,3,3,30
191114769,8,6,4,1,1,20
191114770,9,3,4,5,8,29
191114771,8,9,6,6,9,38
191114772,5,1,5,2,2,15
191114773,8,1,3,9,3,24
191114774,9,0,9,6,4,28
191114775,9,0,5,8,0,22
191114776,4,0,5,3,4,16
191114777,8,5,0,0,9,22
191114778,1,6,8,8,5,28
191114779,5,0,6,5,0,16
191114780,3,4,1,8,7,23
191114781,7,5,2,5,0,19
191114782,5,2,9,6,0,22
191114783,1,7,6,0,4,18
191114784,2,5,3,1,8,19
191114785,7,5,0,4,8,24
191114786,9,1,9,3,6,28
191114787,9,4,9,6,9,37
191114788,8,0,8,1,6,23
191114789,7,3,5,3,8,26
191114790,3,3,6,9,8,29
191114791,4,1,3,3,8,19
191114792,6,2,8,3,6,25
191114793,0,3,4,6,1,14
191114794,0,0,1,8,4,13
191114795,0,1,8,8,4,21
191114796,5,5,4,9,3,26
191114797,1,6,8,1,5,21
191114798,3,6,2,0,6,17
191114799,8,6,5,0,4,23
191114800,2,2,0,3,0,7
191114801,1,5,6,5,2,19
191114802,3,8,3,4,0,18
191114803,1,5,8,4,3,21
191114804,3,2,5,3,3,16
191114805,4,0,4,1,5,14
191114806,7,2,1,0,3,13
191114807,1,2,6,9,5,23
191114808,7,6,2,0,7,22
191114809,9,2,2,9,8,30
191114810,6,1,4,0,7,18
191114811,5,9,1,1,5,21
191114812,9,7,2,5,5,28
191114813,4,7,0,7,9,27
191114814,4,4,1,3,1,13
191114815,1,1,9,1,9,21
191114816,5,8,5,2,2,22
191114817,2,6,6,9,7,30
191114818,6,5,3,1,7,22
191114819,4,4,9,9,4,30
191114820,4,8,6,9,1,28
191114821,3,4,6,8,5,26
191114822,4,3,6,7,0,20
191114823,9,4,4,2,9,28
191114824,4,8,1,9,2,24
191114825,9,0,1,5,3,18
191114826,5,4,2,2,5,18
191114827,6,7,4,6,2,25
191114828,5,2,2,5,2,16
191114829,0,7,3,4,2,16
191114830,8,0,8,5,0,21
191114831,7,0,4,0,0,11
191114832,4,8,7,3,4,26
191114833,3,9,2,4,3,21
191114834,5,8,3,3,7,26
191114835,3,8,1,8,2,22
191114836,9,2,5,3,0,19
191114837,0,3,3,8,4,18
191114838,4,7,9,1,5,26
191114839,8,7,8,9,7,39
191114840,1,1,3,7,5,17
191114841,4,7,1,3,0,15
191114842,6,5,8,0,9,28
191114843,8,8,3,5,8,32
191114844,6,3,3,1,8,21
191114845,4,5,1,1,9,20
191114846,6,6,8,3,9,32
191114847,2,1,2,8,1,14
191114848,0,9,3,8,2,22
191114849,1,5,0,6,5,17
191114850,1,0,2,4,4,11
191114851,9,5,8,4,8,34
191114852,0,5,2,2,9,18
191114853,4,4,9,6,9,32
191114854,3,8,0,5,2,18
191114855,0,0,0,8,0,8
191114856,2,1,0,3,6,12
191114857,8,4,6,3,6,27
191114858,3,9,2,2,9,25
191114859,1,8,3,3,8,23
191114860,1,1,0,1,9,12
191114861,2,9,7,1,7,26
191114862,9,8,4,7,1,29
191114863,3,2,8,1,2,16
191114864,1,4,9,2,9,25
191114865,8,7,1,2,5,23
191114866,9,0,3,3,7,22
191114867,6,8,1,5,6,26
191114868,1,2,2,3,0,8
191114869,1,6,9,8,6,30
191114870,4,6,6,3,0,19
191114871,1,4,0,4,0,9
191114872,8,3,4,6,1,22
191114873,0,9,4,2,8,23
191114874,1,5,0,4,6,16
191114875,0,2,9,8,0,19
191114876,9,8,5,7,1,30
191114877,9,6,2,7,4,28
191114878,4,2,7,9,8,30
191114879,5,9,1,2,0,17
191114880,2,1,4,2,5,14
191114881,3,0,5,1,1,10
191114882,5,5,0,3,3,16
191114883,3,1,3,4,5,16
191114884,2,1,0,3,0,6
191114885,6,9,2,9,5,31
191114886,3,3,5,5,2,18
191114887,8,9,0,3,3,23
191114888,5,4,3,2,5,19
191114889,8,0,2,9,7,26
191114890,1,1,6,4,4,16
191114891,3,1,1,8,0,13
191114892,5,4,4,0,3,16
191114893,8,8,9,3,7,35
191114894,1,2,3,0,1,7
191114895,7,4,5,3,5,24
191114896,2,5,2,5,4,18
191114897,8,4,2,9,9,32
191114898,2,0,6,5,9,22
191114899,7,4,9,0,4,24
191114900,3,4,0,5,0,12
191114901,3,6,1,9,8,27
191114902,9,8,3,6,9,35
191114903,8,6,6,0,9,29
191114904,1,1,7,3,5,17
191114905,5,2,4,8,3,22
191114906,3,2,0,9,8,22
191114907,6,0,2,4,8,20
191114908,1,7,8,7,0,23
191114909,4,6,3,2,6,21
191114910,1,8,0,9,8,26
191114911,0,6,3,9,7,25
191114912,3,2,4,1,0,10
191114913,5,2,1,9,8,25
191114914,6,3,8,5,8,30
191114915,2,9,1,5,3,20
191114916,9,2,8,4,1,24
191114917,8,4,3,3,1,19
191114918,6,0,2,4,7,19
191114919,3,1,8,6,8,26
191114920,8,0,6,5,7,26
191114921,6,2,6,0,3,17
191114922,2,8,7,1,4,22
191114923,7,8,3,1,8,27
191114924,5,0,0,8,8,21
191114925,6,3,6,4,2,21
191114926,7,1,1,2,0,11
191114927,2,4,5,2,0,13
191114928,3,0,3,4,3,13
191114929,8,5,1,9,2,25
191114930,1,2,1,9,6,19
191114931,9,9,4,1,1,24
191114932,7,3,3,8,3,24
191114933,3,7,2,5,2,19
191114934,5,9,5,1,1,21
191114935,6,4,4,1,6,21
191114936,5,1,1,1,9,17
191114937,6,1,8,4,3,22
191114938,2,9,4,0,5,20
191114939,7,1,2,8,5,23
191114940,4,0,6,6,6,22
191114941,2,5,1,5,8,21
191114942,2,1,2,0,8,13
191114943,9,4,8,5,5,31
191114944,5,3,4,6,3,21
191114945,9,4,8,5,1,27
191114946,3,0,0,9,6,18
191114947,1,6,1,5,2,15
191114948,8,1,0,1,2,12
191114949,6,3,2,0,0,11
191114950,8,8,9,8,1,34
191114951,1,4,0,0,1,6
191114952,6,4,3,8,1,22
191114953,3,8,6,7,1,25
191114954,4,7,2,1,1,15
191114955,5,9,8,4,0,26
191114956,2,5,6,7,7,27
191114957,7,5,3,9,1,25
191114958,1,5,4,8,8,26
191114959,6,0,1,7,8,22
191114960,8,3,5,0,8,24
191114961,6,1,6,3,6,22
191114962,6,4,5,7,4,26
191114963,0,2,3,2,4,11
191114964,6,2,0,3,8,19
191114965,5,7,4,4,0,20
191114966,0,4,2,6,8,20
191114967,7,7,7,1,4,26
191114968,1,9,9,6,0,25
191114969,2,1,2,9,9,23
191114970,0,9,2,3,6,20
191114971,6,9,8,4,0,27
191114972,5,1,1,8,1,16
191114973,9,8,1,8,9,35
191114974,8,6,4,6,4,28
191114975,3,5,1,7,8,24
191114976,5,6,6,3,5,25
191114977,6,7,9,9,6,37
191114978,0,0,0,8,7,15
191114979,5,1,1,9,0,16
191114980,1,9,8,3,7,28
191114981,1,5,4,1,8,19
191114982,4,6,3,6,5,24
191114983,2,5,3,4,3,17
191114984,1,1,8,5,9,24
191114985,4,1,8,5,1,19
191114986,8,2,0,2,3,15
191114987,4,3,0,0,9,16
191114988,6,7,8,2,1,24
191114989,3,5,0,1,6,15
191114990,2,2,0,4,5,13
191114991,1,3,5,2,6,17
191114992,9,6,3,2,7,27
191114993,4,3,1,3,3,14
191114994,5,5,2,6,4,22
191114995,6,1,2,1,3,13
191114996,8,2,3,2,5,20
191114997,4,9,2,9,0,24
191114998,9,2,2,7,8,28
191114999,1,6,5,4,6,22
1911141000,1,0,1,0,6,8
1911141001,5,8,2,5,8,28
1911141002,2,2,0,8,4,16
1911141003,1,1,5,0,7,14
1911141004,7,6,1,7,5,26
1911141005,4,8,1,2,5,20
1911141006,1,9,5,0,2,17
1911141007,8,7,9,2,6,32
1911141008,6,9,8,6,7,36
1911141009,3,0,2,7,7,19
1911141010,3,4,7,8,0,22
1911141011,3,7,5,8,5,28
1911141012,0,2,7,7,6,22
1911141013,2,1,3,7,7,20
1911141014,7,4,8,4,5,28
1911141015,1,9,2,5,0,17
1911141016,9,1,8,9,0,27
1911141017,8,2,4,0,2,16
1911141018,6,9,8,1,9,33
1911141019,3,7,5,3,6,24
1911141020,1,4,9,3,9,26
1911141021,2,2,1,1,5,11
1911141022,1,5,8,7,4,25
1911141023,5,2,3,5,7,22
1911141024,6,6,9,7,8,36
1911141025,8,1,1,8,3,21
1911141026,8,1,8,1,9,27
1911141027,7,4,2,6,1,20
1911141028,5,7,7,7,2,28
1911141029,2,4,5,1,1,13
1911141030,8,7,2,6,3,26
1911141031,8,8,7,7,9,39
1911141032,6,7,1,6,7,27
1911141033,4,1,5,9,0,19
1911141034,7,2,1,5,1,16
1911141035,3,8,1,5,8,25
1911141036,2,7,9,1,5,24
1911141037,5,5,9,0,4,23
1911141038,0,3,5,7,3,18
1911141039,4,6,6,6,5,27
1911141040,8,8,8,3,5,32
1911141041,2,2,4,8,3,19
1911141042,4,9,2,5,7,27
1911141043,5,9,8,6,2,30
1911141044,0,8,1,0,6,15
1911141045,9,8,6,1,9,33
1911141046,9,8,8,7,0,32
1911141047,1,2,2,5,0,10
1911141048,1,8,0,7,8,24
1911141049,1,1,9,1,6,18
1911141050,4,9,3,4,9,29
1911141051,6,1,8,4,4,23
1911141052,0,0,3,7,6,16
1911141053,5,4,4,5,1,19
1911141054,6,4,6,0,5,21
1911141055,5,0,6,4,7,22
1911141056,0,2,1,7,7,17
1911141057,2,1,4,1,0,8
1911141058,2,6,2,5,0,15
1911141059,6,1,8,9,5,29
1911141060,7,2,1,4,5,19
1911141061,3,6,7,9,4,29
1911141062,2,5,6,0,4,17
1911141063,1,8,4,3,2,18
1911141064,6,5,9,4,5,29
1911141065,4,2,9,1,5,21
1911141066,7,4,3,8,2,24
1911141067,4,0,7,5,8,24
1911141068,6,0,2,0,7,15
1911141069,6,4,5,1,8,24
1911141070,2,2,7,8,0,19
1911141071,8,2,7,4,3,24
1911141072,6,2,6,5,7,26
1911141073,8,1,9,9,0,27
1911141074,2,7,2,7,1,19
1911141075,3,8,4,3,1,19
1911141076,4,7,6,7,2,26
1911141077,2,2,1,6,6,17
1911141078,9,8,6,2,3,28
1911141079,5,3,4,7,1,20
1911141080,3,0,0,6,6,15
1911141081,4,3,2,1,4,14
1911141082,3,4,2,1,1,11
1911141083,5,8,8,6,8,35
1911141084,4,5,4,2,6,21
1911141085,5,1,7,6,5,24
1911141086,2,8,2,4,2,18
1911141087,5,3,9,3,1,21
1911141088,8,0,3,8,9,28
1911141089,6,5,0,2,6,19
1911141090,0,9,4,4,2,19
1911141091,1,2,6,1,3,13
1911141092,3,5,9,0,4,21
1911141093,2,0,7,3,2,14
1911141094,0,2,5,3,0,10
1911141095,7,2,1,1,5,16
1911141096,0,2,6,3,5,16
1911141097,4,0,5,2,4,15
1911141098,1,9,2,8,1,21
1911141099,6,8,4,7,4,29
1911141100,2,8,9,6,9,34
1911141101,6,0,4,6,0,16
1911141102,5,6,3,8,6,28
1911141103,1,7,3,7,6,24
1911141104,6,5,1,8,7,27
1911141105,7,5,3,1,9,25
191115001,6,8,9,1,3,27
191115002,9,9,2,4,0,24
191115003,9,2,0,9,7,27
191115004,4,4,0,0,0,8
191115005,2,0,8,9,3,22
191115006,3,7,5,2,2,19
191115007,2,4,2,7,4,19
191115008,4,0,6,1,8,19
191115009,9,9,1,1,4,24
191115010,3,8,9,3,7,30
191115011,2,4,3,4,0,13
191115012,0,0,6,7,5,18
191115013,1,2,2,5,4,14
191115014,7,7,8,3,9,34
191115015,1,6,9,6,2,24
191115016,3,0,0,5,6,14
191115017,0,2,8,9,0,19
191115018,7,5,6,5,9,32
191115019,8,3,7,5,6,29
191115020,1,0,5,7,0,13
191115021,5,1,9,1,0,16
191115022,5,3,3,8,0,19
191115023,4,0,5,7,7,23
191115024,0,0,0,9,7,16
191115025,6,1,5,3,1,16
191115026,9,0,0,6,1,16
191115027,9,7,7,7,9,39
191115028,8,7,8,3,4,30
191115029,8,6,8,2,4,28
191115030,2,2,8,7,0,19
191115031,9,1,6,9,0,25
191115032,2,1,7,1,2,13
191115033,7,6,3,2,2,20
191115034,6,3,3,4,4,20
191115035,0,7,9,0,3,19
191115036,9,8,5,4,0,26
191115037,2,9,6,9,2,28
191115038,8,3,3,1,6,21
191115039,0,8,3,3,8,22
191115040,5,0,8,8,8,29
191115041,4,8,7,0,7,26
191115042,7,6,8,3,2,26
191115043,5,8,5,5,2,25
191115044,3,5,0,4,7,19
191115045,1,9,9,3,9,31
191115046,6,0,6,7,8,27
191115047,2,4,7,3,8,24
191115048,0,7,7,5,7,26
191115049,1,5,2,0,8,16
191115050,0,4,5,7,2,18
191115051,2,7,1,0,4,14
191115052,3,5,0,2,2,12
191115053,9,6,2,3,1,21
191115054,5,5,4,9,4,27
191115055,1,1,3,2,3,10
191115056,5,2,8,9,9,33
191115057,8,0,1,7,6,22
191115058,5,0,5,2,2,14
191115059,1,9,7,9,2,28
191115060,3,9,8,2,4,26
191115061,2,6,3,1,6,18
191115062,2,1,8,0,2,13
191115063,9,5,4,9,1,28
191115064,3,8,9,2,3,25
191115065,8,8,2,9,4,31
191115066,1,9,8,7,3,28
191115067,3,7,7,0,1,18
191115068,1,0,7,6,3,17
191115069,7,3,9,7,2,28
191115070,1,7,7,4,0,19
191115071,8,0,4,7,8,27
191115072,5,7,4,7,5,28
191115073,3,9,9,6,7,34
191115074,2,7,9,4,1,23
191115075,0,9,7,0,7,23
191115076,9,2,9,0,1,21
191115077,7,8,2,7,2,26
191115078,0,5,1,0,2,8
191115079,3,6,7,3,0,19
191115080,2,5,2,6,3,18
191115081,0,7,5,0,4,16
191115082,2,6,9,0,9,26
191115083,7,0,6,5,0,18
191115084,5,0,4,0,3,12
191115085,0,4,0,8,1,13
191115086,8,7,8,1,7,31
191115087,5,0,1,8,7,21
191115088,9,7,6,3,0,25
191115089,4,0,8,9,0,21
191115090,0,6,8,2,4,20
191115091,0,1,7,3,4,15
191115092,4,3,6,1,9,23
191115093,7,8,8,9,1,33
191115094,6,6,7,1,3,23
191115095,5,0,4,0,7,16
191115096,7,6,9,2,9,33
191115097,4,2,2,1,3,12
191115098,4,1,6,9,2,22
191115099,1,9,9,6,4,29
191115100,4,6,5,9,5,29
191115101,4,3,3,7,6,23
191115102,0,5,5,2,0,12
191115103,2,1,4,8,3,18
191115104,2,4,3,7,8,24
191115105,6,9,5,8,3,31
191115106,6,4,4,2,5,21
191115107,1,4,9,2,1,17
191115108,8,6,6,2,4,26
191115109,0,0,6,0,9,15
191115110,0,7,9,1,8,25
191115111,1,4,8,7,2,22
191115112,8,6,5,5,1,25
191115113,9,0,6,9,2,26
191115114,9,4,0,2,1,16
191115115,4,0,7,8,5,24
191115116,7,4,2,3,4,20
191115117,4,6,8,2,8,28
191115118,0,6,8,6,4,24
191115119,2,3,1,0,8,14
191115120,7,4,5,7,2,25
191115121,3,2,0,4,1,10
191115122,7,3,6,6,7,29
191115123,0,5,2,9,1,17
191115124,1,6,1,0,7,15
191115125,3,8,1,8,3,23
191115126,9,2,0,0,6,17
191115127,2,9,2,1,8,22
191115128,1,3,9,6,6,25
191115129,5,8,8,5,1,27
191115130,5,7,6,3,3,24
191115131,7,9,1,6,2,25
191115132,7,6,5,4,4,26
191115133,6,9,2,0,2,19
191115134,4,5,9,7,2,27
191115135,3,7,2,3,2,17
191115136,5,4,1,6,9,25
191115137,2,7,3,0,4,16
191115138,3,7,7,0,2,19
191115139,9,9,2,0,0,20
191115140,4,3,9,8,0,24
191115141,2,0,6,7,1,16
191115142,9,3,2,5,8,27
191115143,9,8,2,1,9,29
191115144,6,6,1,1,4,18
191115145,0,2,6,1,3,12
191115146,2,9,2,7,4,24
191115147,3,6,5,5,3,22
191115148,8,8,2,9,1,28
191115149,2,3,3,4,4,16
191115150,8,6,0,4,3,21
191115151,2,4,7,4,5,22
191115152,4,7,8,6,8,33
191115153,1,6,0,9,7,23
191115154,0,5,2,8,3,18
191115155,8,3,5,2,8,26
191115156,7,0,9,8,7,31
191115157,6,9,6,7,4,32
191115158,9,3,9,7,0,28
191115159,3,1,5,2,5,16
191115160,5,8,8,1,4,26
191115161,8,9,5,3,1,26
191115162,8,2,7,4,6,27
191115163,6,3,0,8,4,21
191115164,4,8,8,8,2,30
191115165,6,2,0,8,6,22
191115166,9,3,5,5,8,30
191115167,6,1,0,0,2,9
191115168,5,0,2,7,4,18
191115169,4,8,1,3,4,20
191115170,6,5,1,9,6,27
191115171,3,1,8,9,9,30
191115172,5,4,7,4,2,22
191115173,1,6,1,8,2,18
191115174,8,9,3,6,6,32
191115175,6,5,3,2,4,20
191115176,4,6,1,1,6,18
191115177,7,6,2,2,0,17
191115178,2,9,7,5,7,30
191115179,1,4,1,4,9,19
191115180,4,9,3,3,6,25
191115181,9,9,1,6,7,32
191115182,4,4,6,9,1,24
191115183,0,9,8,5,8,30
191115184,7,9,7,6,3,32
191115185,7,7,3,2,8,27
191115186,8,8,3,3,4,26
191115187,0,1,1,5,2,9
191115188,6,4,1,4,1,16
191115189,4,0,4,8,7,23
191115190,3,1,3,0,5,12
191115191,2,8,2,8,2,22
191115192,8,9,8,5,8,38
191115193,0,1,2,9,1,13
191115194,9,6,1,3,4,23
191115195,9,0,1,9,4,23
191115196,3,0,1,4,5,13
191115197,8,8,1,7,0,24
191115198,3,2,0,4,5,14
191115199,4,2,9,4,0,19
191115200,8,5,6,0,6,25
191115201,3,8,7,0,3,21
191115202,7,7,1,0,1,16
191115203,9,9,6,1,9,34
191115204,2,9,7,6,8,32
191115205,4,6,9,0,9,28
191115206,0,4,5,0,3,12
191115207,9,1,1,5,3,19
191115208,1,6,9,9,5,30
191115209,9,3,7,5,6,30
191115210,8,9,6,1,3,27
191115211,3,2,7,6,6,24
191115212,7,6,7,5,4,29
191115213,9,5,3,0,5,22
191115214,2,2,0,1,8,13
191115215,3,4,9,5,6,27
191115216,1,0,4,3,4,12
191115217,6,9,1,1,1,18
191115218,8,9,4,2,3,26
191115219,5,5,8,6,8,32
191115220,6,5,8,5,9,33
191115221,2,7,3,4,0,16
191115222,1,2,7,4,6,20
191115223,5,3,0,9,4,21
191115224,0,0,4,5,0,9
191115225,0,8,4,9,1,22
191115226,3,9,0,6,7,25
191115227,6,5,0,7,7,25
191115228,2,2,4,5,2,15
191115229,0,1,0,2,2,5
191115230,6,4,3,1,5,19
191115231,3,2,0,8,9,22
191115232,6,4,9,1,4,24
191115233,3,0,8,5,6,22
191115234,5,2,9,2,6,24
191115235,3,2,3,5,7,20
191115236,6,7,8,7,0,28
191115237,6,2,4,7,0,19
191115238,2,3,5,1,8,19
191115239,9,0,8,5,0,22
191115240,3,7,7,0,6,23
191115241,2,1,3,1,3,10
191115242,5,3,4,0,4,16
191115243,0,7,3,3,3,16
191115244,6,3,6,9,0,24
191115245,5,9,4,9,9,36
191115246,7,9,6,9,7,38
191115247,1,8,7,7,9,32
191115248,5,3,0,4,1,13
191115249,5,3,9,2,6,25
191115250,4,4,9,7,1,25
191115251,9,2,3,4,8,26
191115252,8,5,3,0,5,21
191115253,4,1,5,8,2,20
191115254,0,2,7,3,6,18
191115255,4,3,2,9,8,26
191115256,0,3,4,9,4,20
191115257,5,5,7,7,6,30
191115258,5,2,0,9,1,17
191115259,9,8,2,4,3,26
191115260,0,5,6,0,0,11
191115261,6,6,0,5,3,20
191115262,2,2,5,9,2,20
191115263,0,9,9,7,9,34
191115264,1,3,4,3,7,18
191115265,0,7,1,2,9,19
191115266,9,4,4,9,5,31
191115267,6,0,5,6,2,19
191115268,5,4,8,5,7,29
191115269,9,4,3,3,6,25
191115270,3,4,7,7,6,27
191115271,2,5,4,4,2,17
191115272,9,4,0,8,8,29
191115273,9,5,4,9,4,31
191115274,4,0,5,9,5,23
191115275,5,9,6,6,4,30
191115276,2,2,1,4,0,9
191115277,5,0,5,8,0,18
191115278,8,7,9,6,7,37
191115279,4,3,7,0,9,23
191115280,3,2,9,4,7,25
191115281,8,0,9,7,9,33
191115282,3,6,6,3,0,18
191115283,7,2,6,2,8,25
191115284,7,4,1,4,8,24
191115285,4,1,2,1,1,9
191115286,4,9,3,4,3,23
191115287,3,3,8,9,9,32
191115288,8,3,6,0,4,21
191115289,9,5,1,5,4,24
191115290,9,2,1,2,8,22
191115291,1,4,1,8,3,17
191115292,0,7,6,0,5,18
191115293,5,1,3,9,6,24
191115294,8,8,6,4,1,27
191115295,7,6,9,6,1,29
191115296,2,4,4,3,0,13
191115297,0,5,4,8,3,20
191115298,5,1,3,1,5,15
191115299,6,4,4,3,8,25
191115300,1,8,8,6,3,26
191115301,0,4,6,1,2,13
191115302,8,2,0,2,6,18
191115303,0,4,7,5,4,20
191115304,0,8,4,9,3,24
191115305,0,2,9,6,3,20
191115306,7,6,7,1,3,24
191115307,7,2,7,3,1,20
191115308,7,3,2,4,9,25
191115309,3,4,4,8,0,19
191115310,9,0,7,0,0,16
191115311,0,0,4,9,6,19
191115312,3,0,6,7,1,17
191115313,8,4,5,7,4,28
191115314,8,9,3,1,6,27
191115315,7,1,5,0,4,17
191115316,8,9,4,7,8,36
191115317,4,7,8,1,0,20
191115318,3,3,3,8,4,21
191115319,1,4,7,9,1,22
191115320,2,7,6,4,4,23
191115321,5,3,1,2,8,19
191115322,4,7,1,0,6,18
191115323,6,7,8,6,2,29
191115324,8,0,5,1,1,15
191115325,1,2,2,6,1,12
191115326,7,4,0,8,2,21
191115327,5,0,7,7,3,22
191115328,5,2,4,8,2,21
191115329,8,4,7,6,6,31
191115330,3,6,8,9,5,31
191115331,4,0,6,3,3,16
191115332,8,7,7,7,1,30
191115333,4,8,4,9,5,30
191115334,2,6,1,5,4,18
191115335,2,0,5,6,4,17
191115336,2,3,0,4,1,10
191115337,5,2,7,7,2,23
191115338,3,6,9,1,2,21
191115339,6,8,0,3,6,23
191115340,9,4,5,9,9,36
191115341,2,2,2,8,7,21
191115342,0,3,0,0,9,12
191115343,3,4,2,7,8,24
191115344,5,4,3,1,9,22
191115345,4,5,0,2,1,12
191115346,2,8,0,5,3,18
191115347,9,4,5,3,7,28
191115348,6,8,5,4,6,29
191115349,4,1,6,7,5,23
191115350,6,1,1,0,2,10
191115351,3,4,5,7,2,21
191115352,5,5,6,7,1,24
191115353,9,9,2,3,4,27
191115354,1,7,1,8,1,18
191115355,1,4,6,7,1,19
191115356,8,2,6,6,9,31
191115357,8,9,8,7,2,34
191115358,1,9,5,1,1,17
191115359,3,0,5,5,4,17
191115360,2,1,4,9,2,18
191115361,0,5,1,7,8,21
191115362,4,0,8,0,6,18
191115363,4,6,9,7,4,30
191115364,1,7,0,6,5,19
191115365,1,8,3,9,0,21
191115366,6,0,2,7,0,15
191115367,8,8,7,8,8,39
191115368,5,1,6,7,3,22
191115369,0,5,6,3,7,21
191115370,8,9,0,5,4,26
191115371,1,8,6,7,1,23
191115372,5,5,7,4,9,30
191115373,6,8,3,9,1,27
191115374,6,3,1,1,9,20
191115375,7,0,9,8,1,25
191115376,5,7,2,9,1,24
191115377,3,5,8,6,8,30
191115378,8,5,0,8,9,30
191115379,0,0,9,7,6,22
191115380,4,5,0,0,1,10
191115381,8,4,7,3,9,31
191115382,3,9,7,3,8,30
191115383,5,7,5,6,0,23
191115384,9,4,9,3,6,31
191115385,3,0,1,3,2,9
191115386,6,6,1,6,3,22
191115387,8,7,7,2,3,27
191115388,3,1,4,7,5,20
191115389,9,2,0,1,2,14
191115390,0,5,1,8,9,23
191115391,1,6,6,9,9,31
191115392,3,1,9,2,0,15
191115393,9,6,8,9,4,36
191115394,3,6,6,0,6,21
191115395,1,2,7,7,9,26
191115396,7,4,0,9,2,22
191115397,0,2,7,9,7,25
191115398,1,1,3,9,8,22
191115399,4,9,0,0,4,17
191115400,8,0,7,2,9,26
191115401,0,6,1,7,0,14
191115402,4,8,9,9,6,36
191115403,2,7,5,8,3,25
191115404,7,6,7,5,7,32
191115405,0,3,0,1,1,5
191115406,1,0,3,7,3,14
191115407,1,3,7,6,9,26
191115408,2,1,3,2,3,11
191115409,5,3,7,1,9,25
191115410,2,8,0,2,5,17
191115411,2,3,4,3,2,14
191115412,6,9,4,7,9,35
191115413,9,8,5,6,5,33
191115414,1,2,5,9,9,26
191115415,0,6,2,4,9,21
191115416,1,0,9,5,0,15
191115417,0,3,4,3,8,18
191115418,4,7,3,2,6,22
191115419,7,0,5,9,3,24
191115420,8,3,9,8,4,32
191115421,8,1,4,9,2,24
191115422,4,1,3,1,7,16
191115423,5,4,5,9,3,26
191115424,7,5,4,3,4,23
191115425,1,5,9,7,3,25
191115426,8,0,9,7,1,25
191115427,0,3,4,8,1,16
191115428,0,9,6,8,4,27
191115429,8,1,4,7,4,24
191115430,4,8,1,5,4,22
191115431,5,4,9,1,2,21
191115432,0,1,5,2,4,12
191115433,8,6,8,5,4,31
191115434,9,5,7,5,5,31
191115435,4,2,0,9,8,23
191115436,8,4,1,6,2,21
191115437,5,1,3,1,4,14
191115438,6,2,0,3,0,11
191115439,5,6,4,5,2,22
191115440,4,7,5,4,3,23
191115441,9,3,9,3,9,33
191115442,4,2,6,9,6,27
191115443,5,6,3,7,3,24
191115444,3,5,9,7,3,27
191115445,1,0,9,0,7,17
191115446,6,4,2,3,9,24
191115447,2,7,2,2,6,19
191115448,5,0,8,7,0,20
191115449,2,9,4,9,8,32
191115450,0,2,2,4,1,9
191115451,9,2,3,6,8,28
191115452,0,6,6,9,0,21
191115453,1,4,0,0,8,13
191115454,8,2,3,5,2,20
191115455,8,8,8,3,4,31
191115456,7,3,7,2,0,19
191115457,5,8,7,0,0,20
191115458,3,8,0,7,5,23
191115459,6,0,0,2,8,16
191115460,6,9,8,8,1,32
191115461,0,8,8,0,8,24
191115462,6,1,7,4,8,26
191115463,6,8,5,6,5,30
191115464,1,4,1,4,3,13
191115465,4,0,1,2,3,10
191115466,5,3,1,0,4,13
191115467,5,6,2,9,4,26
191115468,7,5,9,9,6,36
191115469,7,3,3,3,9,25
191115470,3,4,9,4,0,20
191115471,0,1,3,3,0,7
191115472,1,1,3,3,1,9
191115473,3,4,9,9,7,32
191115474,0,0,4,4,7,15
191115475,5,9,3,7,8,32
191115476,9,1,2,7,8,27
191115477,3,3,4,0,3,13
191115478,4,6,9,5,1,25
191115479,6,6,8,4,2,26
191115480,9,1,1,4,7,22
191115481,9,1,8,1,2,21
191115482,8,6,3,2,2,21
191115483,0,0,4,1,5,10
191115484,5,6,7,7,3,28
191115485,8,8,9,4,6,35
191115486,2,6,4,3,9,24
191115487,9,4,8,9,6,36
191115488,4,5,1,5,2,17
191115489,0,2,9,2,0,13
191115490,4,6,1,8,7,26
191115491,5,0,0,4,0,9
191115492,8,1,1,7,3,20
191115493,7,5,1,7,4,24
191115494,5,2,5,7,7,26
191115495,7,0,1,9,8,25
191115496,9,7,9,2,5,32
191115497,5,5,4,4,6,24
191115498,9,3,8,8,4,32
191115499,8,5,6,6,7,32
191115500,1,3,3,0,2,9
191115501,6,7,7,1,5,26
191115502,0,0,7,9,3,19
191115503,7,4,1,4,9,25
191115504,0,9,8,4,9,30
191115505,6,1,0,5,6,18
191115506,9,5,3,5,6,28
191115507,3,9,6,2,9,29
191115508,5,5,8,3,7,28
191115509,4,0,7,1,6,18
191115510,3,3,6,0,1,13
191115511,5,4,0,7,1,17
191115512,1,5,8,5,5,24
191115513,6,2,2,1,9,20
191115514,5,6,9,3,7,30
191115515,4,2,8,3,1,18
191115516,9,8,9,1,8,35
191115517,5,6,1,2,7,21
191115518,1,0,0,1,9,11
191115519,2,7,6,1,0,16
191115520,3,1,6,2,6,18
191115521,0,7,1,9,1,18
191115522,3,2,7,8,6,26
191115523,1,9,6,0,8,24
191115524,2,0,3,5,0,10
191115525,1,7,4,3,7,22
191115526,9,2,8,0,1,20
191115527,8,4,8,2,1,23
191115528,6,6,9,2,2,25
191115529,9,8,9,0,2,28
191115530,9,8,6,7,0,30
191115531,3,1,4,5,0,13
191115532,7,9,3,5,2,26
191115533,2,0,1,1,5,9
191115534,0,7,4,7,7,25
191115535,7,3,8,8,5,31
191115536,3,0,8,5,2,18
191115537,7,4,0,2,2,15
191115538,3,9,4,6,4,26
191115539,0,4,1,2,0,7
191115540,3,3,0,7,9,22
191115541,8,5,8,4,1,26
191115542,2,0,5,1,9,17
191115543,0,1,0,3,1,5
191115544,6,2,9,0,3,20
191115545,4,9,6,0,6,25
191115546,6,9,5,1,9,30
191115547,1,3,5,5,9,23
191115548,4,2,7,5,5,23
191115549,2,5,8,0,7,22
191115550,1,6,3,5,1,16
191115551,5,4,7,1,3,20
191115552,9,4,5,9,2,29
191115553,4,9,0,3,1,17
191115554,2,8,5,5,1,21
191115555,9,4,8,5,4,30
191115556,8,6,4,7,9,34
191115557,1,3,4,2,2,12
191115558,7,8,3,0,5,23
191115559,3,4,9,2,2,20
191115560,2,6,5,5,7,25
191115561,5,2,6,1,2,16
191115562,0,6,0,3,1,10
191115563,2,7,3,9,2,23
191115564,3,6,8,7,7,31
191115565,9,9,4,9,5,36
191115566,6,8,3,1,6,24
191115567,0,0,7,2,5,14
191115568,5,3,6,4,8,26
191115569,3,3,9,7,7,29
191115570,2,4,8,6,3,23
191115571,5,0,1,9,1,16
191115572,7,4,4,4,7,26
191115573,2,7,9,2,1,21
191115574,3,6,6,8,8,31
191115575,0,9,5,9,6,29
191115576,4,8,2,1,6,21
191115577,2,3,4,3,9,21
191115578,4,3,7,5,2,21
191115579,7,6,9,4,8,34
191115580,9,7,8,0,4,28
191115581,0,6,9,6,2,23
191115582,3,9,3,0,0,15
191115583,1,4,4,7,0,16
191115584,2,5,0,4,8,19
191115585,4,3,0,1,1,9
191115586,6,7,2,0,6,21
191115587,4,1,6,1,5,17
191115588,9,3,1,4,4,21
191115589,1,0,6,3,6,16
191115590,7,3,3,9,0,22
191115591,7,9,5,3,3,27
191115592,6,5,0,1,9,21
191115593,7,9,5,8,5,34
191115594,0,3,3,6,0,12
191115595,3,2,9,0,6,20
191115596,5,5,4,7,0,21
191115597,8,7,5,6,7,33
191115598,4,5,9,2,8,28
191115599,9,9,5,1,0,24
191115600,9,3,8,0,5,25
191115601,3,7,2,4,3,19
191115602,4,6,0,0,6,16
191115603,8,3,8,6,0,25
191115604,9,4,6,7,5,31
191115605,2,0,6,3,9,20
191115606,0,6,0,6,6,18
191115607,0,2,4,8,9,23
191115608,3,4,7,9,1,24
191115609,6,5,5,9,7,32
191115610,5,9,5,4,2,25
191115611,7,0,4,1,4,16
191115612,0,4,5,2,9,20
191115613,5,5,9,3,7,29
191115614,1,5,9,3,4,22
191115615,8,7,5,4,0,24
191115616,6,8,7,3,9,33
191115617,5,6,5,7,4,27
191115618,7,2,8,1,1,19
191115619,5,4,6,7,0,22
191115620,2,5,2,5,7,21
191115621,4,7,6,2,0,19
191115622,0,6,9,9,1,25
191115623,2,3,6,5,9,25
191115624,4,4,6,8,0,22
191115625,5,7,1,3,8,24
191115626,0,0,3,5,6,14
191115627,3,3,5,4,8,23
191115628,8,6,9,6,3,32
191115629,5,3,1,5,8,22
191115630,8,7,7,8,8,38
191115631,7,6,0,1,1,15
191115632,6,9,7,7,4,33
191115633,1,7,0,5,0,13
191115634,8,5,8,5,9,35
191115635,9,6,3,7,7,32
191115636,0,6,0,0,6,12
191115637,8,4,0,7,3,22
191115638,1,4,5,9,0,19
191115639,6,2,3,7,2,20
191115640,4,8,7,8,0,27
191115641,6,7,2,1,2,18
191115642,6,2,4,5,5,22
191115643,1,7,0,5,4,17
191115644,5,5,1,6,7,24
191115645,1,8,0,6,7,22
191115646,9,9,7,7,1,33
191115647,9,4,2,3,7,25
191115648,5,3,8,5,3,24
191115649,9,6,6,3,8,32
191115650,7,4,9,9,9,38
191115651,8,5,9,2,7,31
191115652,6,1,0,2,9,18
191115653,3,0,7,0,1,11
191115654,1,4,8,6,3,22
191115655,8,0,8,2,0,18
191115656,4,4,9,6,3,26
191115657,5,5,3,5,9,27
191115658,3,3,8,0,1,15
191115659,4,9,3,2,9,27
191115660,1,7,2,1,5,16
191115661,1,9,0,4,3,17
191115662,5,7,9,9,1,31
191115663,0,3,3,9,2,17
191115664,8,0,2,1,7,18
191115665,4,3,0,4,3,14
191115666,7,1,8,1,9,26
191115667,3,5,8,8,7,31
191115668,5,5,6,6,3,25
191115669,2,9,5,3,1,20
191115670,9,0,9,1,9,28
191115671,8,3,0,4,6,21
191115672,1,3,9,4,3,20
191115673,1,2,4,3,7,17
191115674,0,7,8,2,8,25
191115675,3,2,8,8,3,24
191115676,1,7,8,4,8,28
191115677,7,7,2,4,4,24
191115678,7,4,5,0,9,25
191115679,1,3,4,2,9,19
191115680,0,9,5,8,2,24
191115681,2,9,1,2,8,22
191115682,6,5,8,8,5,32
191115683,0,6,8,0,4,18
191115684,6,4,4,6,3,23
191115685,1,7,0,5,2,15
191115686,2,8,4,7,7,28
191115687,9,8,9,2,2,30
191115688,1,3,2,9,9,24
191115689,5,3,2,3,1,14
191115690,7,8,5,5,7,32
191115691,6,5,0,1,6,18
191115692,8,1,5,0,8,22
191115693,2,8,9,3,5,27
191115694,2,1,1,6,1,11
191115695,9,6,2,9,4,30
191115696,1,8,2,1,4,16
191115697,6,6,5,1,0,18
191115698,9,2,9,8,4,32
191115699,5,6,1,5,0,17
191115700,0,4,8,1,4,17
191115701,5,2,8,5,8,28
191115702,0,3,9,8,2,22
191115703,5,1,2,2,2,12
191115704,7,6,6,4,4,27
191115705,8,1,1,5,2,17
191115706,7,9,1,0,0,17
191115707,0,7,4,0,3,14
191115708,0,7,6,8,6,27
191115709,2,0,5,3,9,19
191115710,4,7,1,6,7,25
191115711,2,8,0,3,6,19
191115712,9,5,2,3,9,28
191115713,4,3,0,2,7,16
191115714,9,7,7,5,1,29
191115715,9,5,2,4,0,20
191115716,3,5,3,6,6,23
191115717,2,5,5,6,2,20
191115718,3,8,8,3,9,31
191115719,6,4,4,2,4,20
191115720,5,8,3,1,0,17
191115721,3,6,6,3,1,19
191115722,7,2,3,5,8,25
191115723,0,9,9,5,0,23
191115724,8,5,3,4,0,20
191115725,5,4,1,6,2,18
191115726,3,5,8,9,7,32
191115727,8,1,9,1,0,19
191115728,3,8,2,8,9,30
191115729,2,6,3,2,5,18
191115730,7,2,0,0,1,10
191115731,9,7,3,7,8,34
191115732,3,4,4,9,1,21
191115733,6,6,9,7,2,30
191115734,6,1,4,6,7,24
191115735,7,5,0,0,8,20
191115736,9,2,0,5,9,25
191115737,3,2,4,6,9,24
191115738,0,8,4,5,7,24
191115739,4,9,8,1,0,22
191115740,7,6,6,0,8,27
191115741,6,0,6,1,3,16
191115742,5,2,5,9,5,26
191115743,6,2,6,3,7,24
191115744,0,5,1,7,9,22
191115745,4,8,2,1,3,18
191115746,3,7,0,2,7,19
191115747,7,8,9,0,2,26
191115748,0,4,5,4,9,22
191115749,6,5,8,5,0,24
191115750,6,0,7,4,2,19
191115751,2,5,9,4,8,28
191115752,2,9,0,0,1,12
191115753,9,2,3,7,4,25
191115754,7,0,3,6,1,17
191115755,7,0,3,4,1,15
191115756,6,1,5,4,0,16
191115757,3,0,9,4,8,24
191115758,0,1,7,6,4,18
191115759,4,2,1,1,8,16
191115760,2,9,9,6,7,33
191115761,4,5,8,6,4,27
191115762,1,2,6,8,9,26
191115763,7,2,4,7,7,27
191115764,3,4,9,8,4,28
191115765,1,8,7,0,1,17
191115766,4,4,0,3,3,14
191115767,4,6,3,5,7,25
191115768,2,2,4,7,9,24
191115769,6,8,7,1,7,29
191115770,2,9,2,5,4,22
191115771,0,3,0,5,3,11
191115772,6,6,2,3,4,21
191115773,4,3,4,6,2,19
191115774,2,3,3,3,2,13
191115775,7,2,0,1,6,16
191115776,8,0,5,3,5,21
191115777,6,7,0,1,6,20
191115778,1,5,9,0,8,23
191115779,8,7,9,9,4,37
191115780,6,7,7,4,9,33
191115781,8,0,8,3,1,20
191115782,3,2,5,1,3,14
191115783,9,2,0,1,0,12
191115784,3,3,5,4,3,18
191115785,3,5,9,6,3,26
191115786,3,8,7,4,3,25
191115787,7,0,3,6,7,23
191115788,5,9,4,7,4,29
191115789,1,8,6,4,3,22
191115790,1,0,9,9,4,23
191115791,7,3,2,7,5,24
191115792,5,5,6,7,8,31
191115793,6,5,4,1,5,21
191115794,1,9,5,0,1,16
191115795,7,8,0,2,8,25
191115796,7,5,8,8,3,31
191115797,5,6,8,9,9,37
191115798,8,7,7,0,3,25
191115799,5,2,6,9,6,28
191115800,3,7,7,2,5,24
191115801,9,9,1,5,7,31
191115802,3,9,1,0,7,20
191115803,5,9,1,5,8,28
191115804,3,8,9,1,2,23
191115805,1,4,1,6,6,18
191115806,0,6,2,6,9,23
191115807,4,5,1,2,4,16
191115808,4,9,4,3,6,26
191115809,4,7,1,2,0,14
191115810,6,0,3,6,3,18
191115811,4,4,2,1,4,15
191115812,9,0,5,6,3,23
191115813,6,8,1,8,2,25
191115814,0,3,9,6,0,18
191115815,4,5,4,4,1,18
191115816,3,4,9,6,0,22
191115817,0,1,5,9,4,19
191115818,7,0,6,7,4,24
191115819,7,0,3,8,1,19
191115820,6,6,9,5,4,30
191115821,1,1,1,6,1,10
191115822,0,7,2,4,7,20
191115823,5,4,5,7,9,30
191115824,1,2,7,9,3,22
191115825,3,1,5,1,5,15
191115826,8,4,8,5,2,27
191115827,2,7,8,3,8,28
191115828,3,2,7,9,7,28
191115829,0,0,9,3,1,13
191115830,4,7,1,5,1,18
191115831,5,0,6,8,3,22
191115832,7,6,1,7,0,21
191115833,6,9,4,6,2,27
191115834,2,0,5,7,2,16
191115835,2,8,6,4,3,23
191115836,8,8,3,6,8,33
191115837,4,8,2,6,0,20
191115838,8,7,0,9,0,24
191115839,2,8,2,3,6,21
191115840,4,9,1,7,1,22
191115841,3,5,7,6,5,26
191115842,0,0,7,7,3,17
191115843,7,1,6,9,9,32
191115844,4,4,5,5,8,26
191115845,9,7,7,0,0,23
191115846,3,1,8,4,5,21
191115847,9,1,1,5,5,21
191115848,2,9,9,2,6,28
191115849,7,2,5,1,2,17
191115850,1,9,8,6,3,27
191115851,5,5,6,7,6,29
191115852,1,5,3,4,3,16
191115853,4,7,3,6,6,26
191115854,2,5,8,7,7,29
191115855,9,9,3,0,1,22
191115856,6,9,5,9,9,38
191115857,6,4,8,2,5,25
191115858,4,7,9,8,4,32
191115859,5,6,3,5,9,28
191115860,9,5,6,1,7,28
191115861,9,5,6,7,4,31
191115862,2,2,9,2,7,22
191115863,4,9,9,4,9,35
191115864,2,7,9,8,1,27
191115865,0,1,0,3,2,6
191115866,5,9,1,3,3,21
191115867,1,8,4,9,1,23
191115868,2,8,6,1,1,18
191115869,9,9,4,4,5,31
191115870,6,8,8,2,0,24
191115871,6,5,6,4,7,28
191115872,2,2,4,4,4,16
191115873,1,6,2,7,9,25
191115874,6,4,5,0,0,15
191115875,0,7,7,2,1,17
191115876,2,0,5,8,7,22
191115877,0,7,3,1,8,19
191115878,0,3,6,8,8,25
191115879,2,8,8,7,7,32
191115880,5,0,7,4,1,17
191115881,9,8,8,0,7,32
191115882,6,7,6,7,9,35
191115883,8,7,8,6,2,31
191115884,4,4,2,6,4,20
191115885,0,5,9,0,0,14
191115886,1,8,6,7,8,30
191115887,6,3,1,2,3,15
191115888,5,3,2,7,5,22
191115889,4,4,0,6,0,14
191115890,9,9,4,1,4,27
191115891,0,9,6,5,6,26
191115892,0,6,6,1,5,18
191115893,0,3,8,2,3,16
191115894,6,0,8,6,9,29
191115895,7,6,1,0,8,22
191115896,6,0,1,8,9,24
191115897,1,1,4,9,1,16
191115898,6,5,4,0,8,23
191115899,1,2,0,9,9,21
191115900,3,7,2,9,7,28
191115901,9,6,6,4,0,25
191115902,4,1,4,1,0,10
191115903,2,2,5,4,3,16
191115904,1,8,7,7,7,30
191115905,6,8,0,2,6,22
191115906,0,4,7,9,6,26
191115907,4,8,8,9,7,36
191115908,7,2,9,5,4,27
191115909,8,1,7,5,0,21
191115910,1,7,1,9,7,25
191115911,5,3,4,5,1,18
191115912,3,4,0,8,6,21
191115913,3,5,9,2,1,20
191115914,8,5,6,6,4,29
191115915,5,7,5,9,5,31
191115916,7,3,5,3,7,25
191115917,0,0,1,6,5,12
191115918,7,5,7,7,9,35
191115919,4,7,6,7,9,33
191115920,9,0,7,3,9,28
191115921,0,9,6,7,2,24
191115922,8,4,4,0,9,25
191115923,9,9,3,0,4,25
191115924,0,6,7,3,6,22
191115925,5,3,1,4,7,20
191115926,6,4,6,2,0,18
191115927,6,1,5,5,5,22
191115928,3,1,6,0,4,14
191115929,5,2,2,2,8,19
191115930,5,4,3,2,2,16
191115931,4,7,4,1,2,18
191115932,2,9,9,2,0,22
191115933,0,5,4,1,1,11
191115934,7,8,7,0,5,27
191115935,3,5,8,7,6,29
191115936,6,3,0,9,1,19
191115937,5,5,4,8,2,24
191115938,9,0,1,5,4,19
191115939,3,4,7,6,8,28
191115940,9,1,0,7,2,19
191115941,2,0,4,4,0,10
191115942,3,4,7,7,4,25
191115943,1,7,2,6,2,18
191115944,7,6,3,2,8,26
191115945,5,0,1,0,1,7
191115946,7,0,7,7,5,26
191115947,9,9,2,5,1,26
191115948,6,0,8,0,3,17
191115949,0,0,9,2,4,15
191115950,6,0,9,7,1,23
191115951,9,0,3,6,0,18
191115952,6,4,3,9,9,31
191115953,2,8,6,3,3,22
191115954,6,6,6,6,5,29
191115955,1,3,6,4,4,18
191115956,0,5,8,7,4,24
191115957,7,5,4,8,5,29
191115958,6,2,4,9,4,25
191115959,3,7,5,4,4,23
191115960,1,1,8,1,4,15
191115961,9,5,8,4,5,31
191115962,7,4,8,6,6,31
191115963,3,2,0,8,5,18
191115964,5,4,0,5,5,19
191115965,4,3,6,7,2,22
191115966,0,1,4,0,1,6
191115967,9,4,7,7,9,36
191115968,3,2,7,6,8,26
191115969,8,4,8,3,8,31
191115970,2,1,6,5,4,18
191115971,7,1,7,8,1,24
191115972,7,3,6,7,7,30
191115973,9,2,2,4,9,26
191115974,0,5,4,3,3,15
191115975,2,0,1,5,4,12
191115976,8,2,4,4,5,23
191115977,5,2,2,9,0,18
191115978,3,3,4,8,8,26
191115979,0,7,2,9,1,19
191115980,8,9,3,4,0,24
191115981,5,3,1,6,5,20
191115982,5,2,0,4,0,11
191115983,4,5,1,8,1,19
191115984,8,1,9,2,4,24
191115985,9,3,8,2,8,30
191115986,1,0,0,8,7,16
191115987,9,4,3,4,1,21
191115988,8,2,0,1,7,18
191115989,9,2,3,0,7,21
191115990,9,8,9,2,8,36
191115991,6,8,7,6,5,32
191115992,7,8,7,0,1,23
191115993,2,0,3,9,7,21
191115994,6,4,1,1,6,18
191115995,0,4,8,5,1,18
191115996,6,7,7,9,1,30
191115997,5,5,9,2,4,25
191115998,6,5,4,9,9,33
191115999,2,8,7,8,0,25
1911151000,5,2,0,8,3,18
1911151001,0,5,1,2,7,15
1911151002,2,9,7,5,2,25
1911151003,4,2,4,7,7,24
1911151004,6,4,1,4,3,18
1911151005,6,2,6,5,3,22
1911151006,1,7,4,3,1,16
1911151007,7,3,4,8,6,28
1911151008,7,7,7,0,7,28
1911151009,6,5,7,5,0,23
1911151010,3,5,6,0,1,15
1911151011,0,2,5,1,2,10
1911151012,0,3,4,6,9,22
1911151013,6,4,2,5,6,23
1911151014,1,8,6,3,8,26
1911151015,4,5,7,9,2,27
1911151016,8,8,2,6,0,24
1911151017,1,9,6,0,0,16
1911151018,2,0,6,5,3,16
1911151019,9,0,5,4,7,25
1911151020,7,1,8,6,9,31
1911151021,7,9,3,5,0,24
1911151022,0,0,4,6,4,14
1911151023,0,7,9,5,9,30
1911151024,0,0,1,4,8,13
1911151025,4,5,2,0,5,16
1911151026,9,8,1,2,8,28
1911151027,2,7,0,5,4,18
1911151028,2,0,3,8,1,14
1911151029,2,4,5,5,9,25
1911151030,8,6,8,9,0,31
1911151031,4,6,4,8,4,26
1911151032,2,5,3,8,9,27
1911151033,2,0,4,2,8,16
1911151034,4,9,9,6,6,34
1911151035,5,4,1,1,6,17
1911151036,9,5,4,7,7,32
1911151037,0,6,9,1,7,23
1911151038,7,8,4,2,3,24
1911151039,7,7,0,7,4,25
1911151040,7,9,9,3,8,36
1911151041,7,1,1,7,6,22
1911151042,4,5,8,8,7,32
1911151043,0,4,6,6,5,21
1911151044,1,0,1,4,1,7
1911151045,5,4,4,1,2,16
1911151046,8,3,9,3,4,27
1911151047,1,0,5,6,3,15
1911151048,2,8,7,7,2,26
1911151049,8,6,2,8,3,27
1911151050,5,8,4,4,6,27
1911151051,2,7,9,2,2,22
1911151052,7,8,8,8,2,33
1911151053,6,0,5,9,0,20
1911151054,0,1,9,0,6,16
1911151055,2,3,8,8,0,21
1911151056,8,2,7,4,5,26
1911151057,7,0,3,0,9,19
1911151058,8,8,1,8,9,34
1911151059,6,1,9,8,6,30
1911151060,9,9,2,8,0,28
1911151061,1,4,1,9,4,19
1911151062,6,6,9,6,9,36
1911151063,8,5,6,1,3,23
1911151064,3,6,2,2,8,21
1911151065,2,5,9,1,8,25
1911151066,9,2,1,0,5,17
1911151067,9,7,9,7,5,37
1911151068,0,8,8,7,6,29
1911151069,1,6,2,8,5,22
1911151070,8,3,4,4,1,20
1911151071,6,7,1,4,1,19
1911151072,6,7,7,1,7,28
1911151073,2,2,4,6,4,18
1911151074,9,4,7,2,5,27
1911151075,9,0,9,5,7,30
1911151076,4,4,8,2,3,21
1911151077,4,7,7,3,2,23
1911151078,5,3,8,0,1,17
1911151079,3,0,3,0,6,12
1911151080,8,7,6,6,9,36
1911151081,5,3,8,9,0,25
1911151082,5,6,2,4,5,22
1911151083,1,3,1,6,4,15
1911151084,5,9,7,4,9,34
1911151085,1,6,9,8,5,29
1911151086,5,9,4,8,3,29
1911151087,2,7,6,3,2,20
1911151088,4,9,5,3,0,21
1911151089,5,7,6,8,8,34
1911151090,1,8,8,2,4,23
1911151091,6,7,1,4,0,18
1911151092,5,3,2,1,1,12
1911151093,1,6,1,4,8,20
1911151094,3,8,7,9,0,27
1911151095,6,0,3,6,8,23
1911151096,7,4,7,2,2,22
1911151097,1,6,3,0,0,10
1911151098,6,2,2,3,6,19
1911151099,2,6,2,0,8,18
1911151100,7,9,2,7,5,30
1911151101,4,0,2,3,5,14
1911151102,0,7,9,1,3,20
1911151103,4,3,3,2,3,15
1911151104,6,7,9,0,0,22
1911151105,3,5,3,6,5,22
191116001,9,2,9,7,8,35
191116002,7,3,2,0,2,14
191116003,9,8,2,4,2,25
191116004,7,4,4,0,3,18
191116005,3,3,1,3,8,18
191116006,9,6,2,5,4,26
191116007,9,2,8,2,0,21
191116008,3,7,0,7,0,17
191116009,8,1,8,0,6,23
191116010,2,0,9,6,4,21
191116011,9,8,3,7,2,29
191116012,5,1,2,5,6,19
191116013,1,5,1,0,1,8
191116014,4,7,6,9,2,28
191116015,1,2,8,0,1,12
191116016,0,9,8,2,2,21
191116017,3,6,9,8,1,27
191116018,4,6,1,5,3,19
191116019,6,9,9,4,2,30
191116020,5,6,7,7,5,30
191116021,2,8,4,4,2,20
191116022,7,8,3,1,4,23
191116023,8,8,2,6,7,31
191116024,8,2,6,5,4,25
191116025,9,2,3,8,6,28
191116026,8,9,0,7,7,31
191116027,7,6,2,9,5,29
191116028,1,2,3,7,5,18
191116029,1,2,5,6,2,16
191116030,1,0,9,4,7,21
191116031,0,2,9,0,3,14
191116032,1,5,3,3,5,17
191116033,5,1,5,1,2,14
191116034,5,4,0,5,8,22
191116035,2,4,3,6,7,22
191116036,9,4,1,9,6,29
191116037,4,0,4,6,4,18
191116038,2,7,9,7,2,27
191116039,0,2,9,2,5,18
191116040,5,8,3,5,0,21
191116041,5,1,0,1,5,12
191116042,1,1,4,7,4,17
191116043,1,8,1,7,2,19
191116044,8,9,8,4,5,34
191116045,9,6,3,4,4,26
191116046,1,0,7,7,9,24
191116047,4,6,5,1,1,17
191116048,7,1,4,7,8,27
191116049,7,0,8,1,3,19
191116050,9,1,4,5,9,28
191116051,1,4,1,2,0,8
191116052,1,5,1,9,1,17
191116053,9,5,0,1,5,20
191116054,0,1,0,8,9,18
191116055,0,2,0,8,8,18
191116056,6,6,6,9,9,36
191116057,2,9,5,8,0,24
191116058,4,0,6,7,6,23
191116059,9,0,4,3,8,24
191116060,3,3,6,7,0,19
191116061,2,4,2,6,0,14
191116062,7,7,2,7,7,30
191116063,2,0,0,2,0,4
191116064,0,0,5,1,0,6
191116065,5,2,6,0,7,20
191116066,2,5,0,7,8,22
191116067,2,9,0,0,5,16
191116068,3,2,2,4,4,15
191116069,3,0,1,5,2,11
191116070,7,4,1,7,9,28
191116071,6,5,3,3,9,26
191116072,1,4,7,8,0,20
191116073,6,3,9,6,0,24
191116074,4,1,5,6,1,17
191116075,5,8,3,2,4,22
191116076,3,2,4,9,1,19
191116077,0,7,5,8,0,20
191116078,6,8,3,7,6,30
191116079,6,6,5,1,9,27
191116080,9,8,9,3,4,33
191116081,6,9,4,8,3,30
191116082,6,5,2,2,0,15
191116083,9,1,0,1,2,13
191116084,4,7,5,0,7,23
191116085,8,1,6,4,0,19
191116086,8,6,2,6,8,30
191116087,2,2,5,8,7,24
191116088,7,4,1,9,8,29
191116089,4,9,8,9,9,39
191116090,2,0,9,9,4,24
191116091,4,0,3,5,6,18
191116092,4,9,2,1,2,18
191116093,1,1,9,5,1,17
191116094,3,7,5,7,7,29
191116095,5,1,0,9,5,20
191116096,0,3,7,4,4,18
191116097,2,8,9,0,0,19
191116098,8,6,6,3,9,32
191116099,8,8,4,3,4,27
191116100,0,6,0,4,5,15
191116101,4,4,4,1,4,17
191116102,7,5,6,1,9,28
191116103,0,3,9,6,6,24
191116104,5,1,1,1,3,11
191116105,0,0,4,6,7,17
191116106,8,9,6,5,0,28
191116107,1,8,3,9,1,22
191116108,6,9,4,8,5,32
191116109,0,9,0,5,9,23
191116110,4,6,2,0,2,14
191116111,6,8,2,1,3,20
191116112,9,1,9,6,8,33
191116113,0,0,2,9,3,14
191116114,8,6,7,9,2,32
191116115,6,5,6,5,1,23
191116116,0,3,9,0,9,21
191116117,6,8,0,8,4,26
191116118,4,8,0,6,9,27
191116119,3,1,7,6,0,17
191116120,3,8,5,5,3,24
191116121,5,2,5,6,9,27
191116122,6,3,4,9,7,29
191116123,1,7,2,0,6,16
191116124,3,3,2,4,9,21
191116125,6,9,3,2,5,25
191116126,3,2,3,1,7,16
191116127,9,3,0,7,5,24
191116128,5,5,7,7,0,24
191116129,3,7,0,1,7,18
191116130,5,8,5,8,8,34
191116131,8,6,3,6,0,23
191116132,0,1,5,5,2,13
191116133,2,3,2,0,1,8
191116134,0,1,0,2,3,6
191116135,8,0,4,1,5,18
191116136,9,0,6,2,1,18
191116137,0,8,5,5,2,20
191116138,1,9,2,7,7,26
191116139,8,9,9,8,2,36
191116140,8,3,5,6,7,29
191116141,0,2,9,8,8,27
191116142,5,9,2,3,5,24
191116143,4,4,1,6,2,17
191116144,3,6,8,9,9,35
191116145,6,4,8,0,0,18
191116146,9,5,9,4,0,27
191116147,8,5,8,9,4,34
191116148,6,6,6,7,4,29
191116149,6,6,9,9,7,37
191116150,6,4,3,1,2,16
191116151,9,3,4,8,1,25
191116152,5,4,7,2,0,18
191116153,7,9,0,4,0,20
191116154,4,1,6,3,4,18
191116155,2,1,0,2,6,11
191116156,7,9,0,7,2,25
191116157,6,5,4,3,9,27
191116158,4,6,8,4,7,29
191116159,2,7,1,7,2,19
191116160,0,8,5,3,6,22
191116161,1,1,3,5,0,10
191116162,5,3,0,1,6,15
191116163,4,2,4,6,6,22
191116164,8,2,7,9,9,35
191116165,1,7,7,6,9,30
191116166,9,6,6,4,4,29
191116167,7,6,9,0,2,24
191116168,7,4,5,3,0,19
191116169,9,7,6,0,9,31
191116170,3,1,2,9,9,24
191116171,8,2,3,8,3,24
191116172,5,7,4,3,7,26
191116173,5,8,8,0,7,28
191116174,7,5,0,2,3,17
191116175,9,5,9,8,6,37
191116176,0,1,1,1,7,10
191116177,1,2,3,7,9,22
191116178,5,1,3,8,2,19
191116179,8,3,4,3,8,26
191116180,5,3,9,7,2,26
191116181,2,8,5,2,6,23
191116182,4,1,5,0,7,17
191116183,5,3,1,4,6,19
191116184,4,2,5,6,4,21
191116185,8,7,6,3,7,31
191116186,5,8,1,3,4,21
191116187,3,0,4,2,2,11
191116188,3,6,0,6,8,23
191116189,4,0,3,1,9,17
191116190,9,0,6,2,5,22
191116191,6,1,5,5,2,19
191116192,5,1,3,9,1,19
191116193,2,6,9,4,2,23
191116194,4,1,0,8,8,21
191116195,0,5,0,6,2,13
191116196,9,3,9,1,9,31
191116197,4,4,1,3,6,18
191116198,9,7,5,4,8,33
191116199,2,3,6,0,0,11
191116200,7,6,0,7,1,21
191116201,8,1,0,3,5,17
191116202,5,5,0,2,6,18
191116203,9,8,9,7,3,36
191116204,3,0,1,7,1,12
191116205,2,0,7,2,5,16
191116206,3,2,9,7,9,30
191116207,3,0,1,6,1,11
191116208,8,4,5,2,0,19
191116209,6,5,1,6,5,23
191116210,7,5,8,1,2,23
191116211,9,0,5,6,0,20
191116212,0,2,2,4,3,11
191116213,5,4,0,3,9,21
191116214,0,2,0,3,1,6
191116215,7,1,4,3,2,17
191116216,6,1,5,9,0,21
191116217,0,5,0,9,2,16
191116218,0,7,5,7,1,20
191116219,2,0,5,2,9,18
191116220,0,3,0,6,3,12
191116221,9,7,3,4,1,24
191116222,3,3,2,6,5,19
191116223,9,1,7,2,5,24
191116224,5,2,0,1,4,12
191116225,1,4,4,3,9,21
191116226,2,7,3,8,9,29
191116227,2,7,9,1,6,25
191116228,6,9,0,4,9,28
191116229,8,8,8,1,2,27
191116230,7,2,0,2,9,20
191116231,7,4,5,7,1,24
191116232,5,9,6,1,1,22
191116233,6,8,8,8,8,38
191116234,9,7,6,3,3,28
191116235,7,7,3,3,9,29
191116236,7,1,3,2,0,13
191116237,8,5,0,8,4,25
191116238,6,1,4,8,7,26
191116239,9,3,2,6,4,24
191116240,9,0,3,0,7,19
191116241,4,6,5,3,4,22
191116242,9,2,2,3,3,19
191116243,0,7,0,2,9,18
191116244,6,2,2,9,1,20
191116245,2,0,1,7,5,15
191116246,4,4,9,7,2,26
191116247,1,7,9,7,4,28
191116248,1,0,8,3,2,14
191116249,6,1,7,6,9,29
191116250,9,0,1,6,4,20
191116251,0,4,2,6,9,21
191116252,2,1,8,0,7,18
191116253,8,2,6,5,5,26
191116254,9,9,3,7,7,35
191116255,4,3,9,6,2,24
191116256,8,0,6,5,9,28
191116257,0,7,1,9,0,17
191116258,1,1,2,9,8,21
191116259,7,7,4,0,9,27
191116260,0,7,7,1,3,18
191116261,3,5,8,9,2,27
191116262,5,7,6,5,3,26
191116263,3,3,1,8,5,20
191116264,7,8,0,8,3,26
191116265,9,4,0,5,4,22
191116266,9,7,2,3,5,26
191116267,0,8,0,0,1,9
191116268,3,0,4,1,9,17
191116269,8,1,8,9,9,35
191116270,1,5,6,2,6,20
191116271,2,0,5,3,2,12
191116272,6,1,2,1,9,19
191116273,0,8,1,4,7,20
191116274,3,7,4,1,5,20
191116275,3,1,0,6,8,18
191116276,2,4,9,2,0,17
191116277,0,6,4,9,1,20
191116278,3,5,8,4,8,28
191116279,4,3,5,5,0,17
191116280,2,8,2,5,5,22
191116281,4,3,0,7,1,15
191116282,6,7,6,6,6,31
191116283,5,9,6,2,5,27
191116284,6,0,1,0,0,7
191116285,8,7,3,0,2,20
191116286,6,0,1,0,1,8
191116287,1,2,9,0,5,17
191116288,4,2,1,6,9,22
191116289,9,3,7,7,7,33
191116290,6,9,9,2,7,33
191116291,0,1,0,2,1,4
191116292,7,5,7,1,4,24
191116293,8,8,3,0,0,19
191116294,6,8,9,4,7,34
191116295,6,8,8,1,7,30
191116296,4,2,2,4,8,20
191116297,5,5,5,4,0,19
191116298,7,5,0,6,3,21
191116299,7,8,5,7,8,35
191116300,5,3,0,1,1,10
191116301,4,3,9,2,3,21
191116302,3,4,2,6,9,24
191116303,1,8,3,7,4,23
191116304,0,2,9,9,9,29
191116305,4,2,7,8,5,26
191116306,8,8,5,8,1,30
191116307,0,1,0,8,5,14
191116308,0,7,8,6,4,25
191116309,9,1,2,5,7,24
191116310,3,4,2,5,2,16
191116311,9,4,9,4,6,32
191116312,7,2,3,2,7,21
191116313,1,4,0,4,4,13
191116314,1,3,6,4,2,16
191116315,0,1,3,5,5,14
191116316,0,5,5,2,7,19
191116317,7,6,6,5,3,27
191116318,4,6,7,5,3,25
191116319,7,2,7,0,6,22
191116320,7,2,9,0,8,26
191116321,0,1,6,6,7,20
191116322,1,7,8,3,4,23
191116323,7,3,0,3,8,21
191116324,8,1,2,7,0,18
191116325,2,9,7,6,7,31
191116326,0,1,5,5,5,16
191116327,4,8,2,7,5,26
191116328,7,6,9,9,1,32
191116329,4,8,9,5,0,26
191116330,7,2,6,3,7,25
191116331,8,1,7,3,6,25
191116332,6,8,7,2,3,26
191116333,4,3,2,2,5,16
191116334,5,7,9,8,2,31
191116335,2,8,4,6,1,21
191116336,0,5,6,8,9,28
191116337,2,0,8,2,5,17
191116338,5,8,4,0,9,26
191116339,7,2,3,8,0,20
191116340,2,7,3,3,6,21
191116341,3,2,0,5,5,15
191116342,2,5,3,2,9,21
191116343,4,5,8,2,9,28
191116344,5,6,1,3,9,24
191116345,8,2,0,3,8,21
191116346,7,7,9,1,7,31
191116347,7,6,2,6,0,21
191116348,7,1,9,9,9,35
191116349,5,6,6,8,8,33
191116350,2,5,8,7,3,25
191116351,4,7,9,5,4,29
191116352,1,6,8,1,9,25
191116353,1,0,0,3,5,9
191116354,2,8,2,8,0,20
191116355,5,6,9,4,7,31
191116356,3,3,7,0,3,16
191116357,7,9,9,0,6,31
191116358,6,5,9,5,2,27
191116359,5,2,4,1,0,12
191116360,4,8,4,3,6,25
191116361,3,7,4,4,7,25
191116362,7,2,2,3,3,17
191116363,7,5,5,9,3,29
191116364,5,5,3,6,9,28
191116365,3,7,7,2,7,26
191116366,1,6,5,7,8,27
191116367,3,7,9,9,7,35
191116368,5,6,9,1,3,24
191116369,8,8,1,1,1,19
191116370,6,8,9,3,6,32
191116371,6,7,6,6,7,32
191116372,8,7,8,3,3,29
191116373,6,1,1,7,4,19
191116374,6,8,0,8,1,23
191116375,2,6,2,9,3,22
191116376,5,0,6,4,8,23
191116377,3,7,8,6,4,28
191116378,4,5,6,9,2,26
191116379,2,8,3,3,5,21
191116380,0,8,8,6,8,30
191116381,5,8,9,7,0,29
191116382,1,9,1,4,6,21
191116383,1,9,6,8,0,24
191116384,8,5,7,9,4,33
191116385,7,1,1,4,5,18
191116386,6,9,4,2,3,24
191116387,9,5,7,7,1,29
191116388,7,1,7,5,0,20
191116389,9,4,6,3,3,25
191116390,0,4,4,2,3,13
191116391,3,9,3,1,2,18
191116392,0,0,0,2,8,10
191116393,4,2,3,7,7,23
191116394,0,7,3,3,2,15
191116395,0,5,7,7,7,26
191116396,9,6,6,5,2,28
191116397,8,6,0,7,4,25
191116398,5,5,3,1,3,17
191116399,6,9,4,3,2,24
191116400,2,2,5,2,7,18
191116401,1,9,3,4,0,17
191116402,7,6,1,1,1,16
191116403,9,8,3,6,3,29
191116404,8,2,0,1,4,15
191116405,8,6,8,7,4,33
191116406,7,0,5,6,2,20
191116407,7,1,9,2,7,26
191116408,3,4,3,9,5,24
191116409,0,7,1,7,7,22
191116410,4,3,8,5,0,20
191116411,4,5,5,8,1,23
191116412,4,4,1,9,0,18
191116413,5,5,3,8,3,24
191116414,5,9,4,6,8,32
191116415,5,7,7,2,3,24
191116416,7,8,6,8,8,37
191116417,0,3,5,7,0,15
191116418,9,8,7,8,2,34
191116419,0,5,6,7,8,26
191116420,0,4,7,1,4,16
191116421,4,2,2,6,3,17
191116422,5,6,7,1,9,28
191116423,5,9,5,2,1,22
191116424,2,8,2,2,4,18
191116425,5,4,0,8,0,17
191116426,7,6,3,1,6,23
191116427,6,5,9,9,1,30
191116428,0,2,2,6,7,17
191116429,0,6,0,8,6,20
191116430,7,1,5,3,4,20
191116431,2,1,1,3,8,15
191116432,8,0,9,1,5,23
191116433,7,0,3,6,2,18
191116434,5,8,0,8,6,27
191116435,4,9,0,1,7,21
191116436,0,9,7,6,6,28
191116437,7,7,7,8,0,29
191116438,6,3,7,5,1,22
191116439,1,9,2,5,3,20
191116440,4,9,5,7,2,27
191116441,3,1,1,1,8,14
191116442,2,2,5,7,5,21
191116443,0,5,0,5,3,13
191116444,1,7,8,0,6,22
191116445,4,8,4,7,2,25
191116446,8,1,6,7,8,30
191116447,8,2,8,0,0,18
191116448,5,0,1,5,7,18
191116449,4,7,7,8,4,30
191116450,0,3,8,1,1,13
191116451,5,1,6,3,4,19
191116452,5,2,8,9,2,26
191116453,4,2,0,7,8,21
191116454,0,0,8,3,1,12
191116455,4,0,4,9,3,20
191116456,0,8,9,8,8,33
191116457,8,9,7,9,6,39
191116458,8,1,1,6,6,22
191116459,3,1,2,6,5,17
191116460,7,8,3,3,5,26
191116461,2,7,7,2,8,26
191116462,4,1,5,7,2,19
191116463,3,1,0,1,4,9
191116464,3,1,8,3,1,16
191116465,6,1,5,6,3,21
191116466,9,1,5,9,3,27
191116467,0,6,8,5,8,27
191116468,0,8,4,9,5,26
191116469,9,3,8,8,1,29
191116470,0,1,7,8,6,22
191116471,9,9,8,1,8,35
191116472,0,1,1,6,3,11
191116473,4,8,4,3,7,26
191116474,4,7,0,6,2,19
191116475,4,6,3,9,8,30
191116476,3,7,0,5,6,21
191116477,7,0,5,7,9,28
191116478,5,2,5,5,7,24
191116479,4,3,2,9,4,22
191116480,7,7,0,1,4,19
191116481,9,6,8,6,9,38
191116482,8,4,3,6,3,24
191116483,9,6,1,2,4,22
191116484,9,2,5,9,2,27
191116485,3,5,6,3,9,26
191116486,6,2,8,3,1,20
191116487,5,1,4,2,4,16
191116488,6,6,1,2,6,21
191116489,8,8,5,7,9,37
191116490,6,0,3,9,4,22
191116491,9,4,3,9,0,25
191116492,8,8,8,4,0,28
191116493,6,9,1,7,3,26
191116494,0,4,6,3,0,13
191116495,8,6,1,4,6,25
191116496,5,4,1,6,7,23
191116497,9,8,0,3,9,29
191116498,6,1,3,9,1,20
191116499,6,4,4,6,1,21
191116500,2,9,2,4,1,18
191116501,4,7,2,9,3,25
191116502,2,8,3,9,5,27
191116503,4,5,4,7,8,28
191116504,1,9,8,1,4,23
191116505,1,9,6,9,3,28
191116506,3,5,0,9,9,26
191116507,8,1,9,0,8,26
191116508,6,5,9,1,0,21
191116509,5,4,8,1,8,26
191116510,2,3,9,7,0,21
191116511,9,1,6,1,3,20
191116512,0,4,9,7,7,27
191116513,2,9,3,5,6,25
191116514,9,0,5,2,1,17
191116515,5,0,6,9,6,26
191116516,7,6,1,0,2,16
191116517,0,3,6,4,1,14
191116518,8,5,4,3,9,29
191116519,9,8,0,4,9,30
191116520,6,5,2,4,9,26
191116521,1,6,6,6,4,23
191116522,0,8,7,7,3,25
191116523,2,0,6,4,1,13
191116524,0,9,1,2,8,20
191116525,5,1,1,3,3,13
191116526,6,7,4,7,5,29
191116527,0,0,1,5,2,8
191116528,3,0,0,5,5,13
191116529,0,0,6,2,0,8
191116530,3,3,5,9,6,26
191116531,3,9,0,7,1,20
191116532,4,5,7,7,4,27
191116533,9,0,8,2,4,23
191116534,5,3,2,4,4,18
191116535,7,5,5,2,4,23
191116536,4,6,4,6,8,28
191116537,7,6,6,6,5,30
191116538,1,4,1,9,0,15
191116539,8,3,7,9,2,29
191116540,7,9,2,5,6,29
191116541,9,2,8,4,3,26
191116542,0,2,6,0,8,16
191116543,4,7,5,9,4,29
191116544,2,4,4,8,8,26
191116545,9,4,6,6,0,25
191116546,0,9,9,8,6,32
191116547,1,5,1,0,7,14
191116548,2,2,9,7,5,25
191116549,0,0,5,0,5,10
191116550,4,6,8,8,8,34
191116551,6,9,2,0,4,21
191116552,6,6,6,7,0,25
191116553,3,9,6,4,7,29
191116554,6,2,3,1,2,14
191116555,2,8,9,8,1,28
191116556,0,5,3,7,6,21
191116557,1,8,1,2,2,14
191116558,8,0,1,0,9,18
191116559,6,6,7,6,5,30
191116560,3,4,8,2,4,21
191116561,0,6,8,2,9,25
191116562,6,7,2,9,6,30
191116563,6,1,6,0,7,20
191116564,8,4,1,6,6,25
191116565,4,7,6,9,9,35
191116566,6,0,6,1,5,18
191116567,1,7,3,6,2,19
191116568,9,4,4,7,6,30
191116569,0,2,0,1,6,9
191116570,8,4,6,5,1,24
191116571,6,0,3,1,1,11
191116572,2,2,6,3,0,13
191116573,9,0,0,0,9,18
191116574,6,2,0,7,7,22
191116575,3,4,1,1,4,13
191116576,6,5,9,4,2,26
191116577,6,7,1,9,6,29
191116578,1,3,5,7,7,23
191116579,8,3,2,6,6,25
191116580,0,5,7,2,9,23
191116581,9,0,3,2,0,14
191116582,0,7,2,5,6,20
191116583,9,2,3,1,7,22
191116584,5,5,7,5,4,26
191116585,3,7,0,0,7,17
191116586,5,6,4,8,6,29
191116587,1,8,4,9,3,25
191116588,4,4,6,2,5,21
191116589,0,3,6,0,8,17
191116590,7,0,3,0,7,17
191116591,8,7,4,8,5,32
191116592,6,2,6,9,4,27
191116593,6,6,8,4,1,25
191116594,2,6,9,0,7,24
191116595,8,4,6,9,4,31
191116596,9,0,6,1,7,23
191116597,7,8,4,9,8,36
191116598,9,1,6,5,7,28
191116599,2,3,6,6,3,20
191116600,5,7,8,6,8,34
191116601,0,4,1,0,9,14
191116602,6,5,8,4,7,30
191116603,7,4,7,2,4,24
191116604,3,5,4,7,8,27
191116605,1,9,3,7,5,25
191116606,9,6,2,0,9,26
191116607,7,3,3,7,2,22
191116608,9,2,0,1,1,13
191116609,8,5,0,5,4,22
191116610,9,2,3,5,0,19
191116611,8,9,7,3,7,34
191116612,7,5,4,3,9,28
191116613,5,4,0,2,3,14
191116614,7,6,2,4,0,19
191116615,8,3,3,0,7,21
191116616,7,5,3,3,3,21
191116617,2,6,2,3,8,21
191116618,1,9,6,2,4,22
191116619,1,6,6,0,8,21
191116620,3,3,5,4,0,15
191116621,0,3,1,1,4,9
191116622,9,1,3,1,7,21
191116623,5,7,2,8,5,27
191116624,4,9,7,9,0,29
191116625,5,7,3,5,6,26
191116626,5,1,5,3,6,20
191116627,6,6,1,0,7,20
191116628,8,2,9,7,6,32
191116629,0,6,2,8,9,25
191116630,4,1,2,4,8,19
191116631,7,3,5,6,8,29
191116632,8,8,7,9,1,33
191116633,8,3,1,7,5,24
191116634,7,0,3,9,8,27
191116635,3,2,2,0,2,9
191116636,5,7,9,4,6,31
191116637,9,7,2,3,6,27
191116638,5,3,5,8,5,26
191116639,3,6,9,4,5,27
191116640,1,7,5,2,8,23
191116641,0,1,0,2,5,8
191116642,9,0,3,7,1,20
191116643,0,1,5,9,1,16
191116644,9,5,3,7,7,31
191116645,3,8,5,1,1,18
191116646,4,1,1,4,6,16
191116647,9,0,6,8,1,24
191116648,2,6,1,8,3,20
191116649,7,9,9,5,0,30
191116650,8,0,6,8,8,30
191116651,9,7,7,9,0,32
191116652,6,1,5,1,5,18
191116653,1,8,6,9,3,27
191116654,0,7,6,1,2,16
191116655,3,0,8,7,9,27
191116656,1,9,9,1,3,23
191116657,0,0,8,7,3,18
191116658,4,4,4,6,1,19
191116659,5,5,7,9,4,30
191116660,2,0,7,5,3,17
191116661,7,7,2,9,0,25
191116662,7,1,9,1,5,23
191116663,4,7,3,7,4,25
191116664,1,2,0,3,5,11
191116665,1,5,6,6,8,26
191116666,1,6,7,3,1,18
191116667,9,4,3,4,8,28
191116668,7,4,4,1,4,20
191116669,3,5,3,8,5,24
191116670,6,2,0,5,7,20
191116671,9,1,2,1,7,20
191116672,0,3,1,8,1,13
191116673,8,6,4,3,3,24
191116674,7,3,0,9,0,19
191116675,6,2,0,3,7,18
191116676,1,4,3,6,2,16
191116677,4,0,0,0,7,11
191116678,6,1,8,4,5,24
191116679,9,4,3,1,3,20
191116680,0,5,3,4,0,12
191116681,3,3,1,7,2,16
191116682,1,6,2,7,0,16
191116683,3,1,3,5,1,13
191116684,7,0,2,7,7,23
191116685,3,2,0,3,3,11
191116686,2,1,7,6,4,20
191116687,6,2,9,2,9,28
191116688,1,8,6,0,7,22
191116689,8,8,4,8,2,30
191116690,3,3,9,4,2,21
191116691,9,0,0,5,6,20
191116692,7,8,8,0,3,26
191116693,7,1,8,1,3,20
191116694,2,6,2,3,0,13
191116695,1,1,6,6,7,21
191116696,8,1,1,9,3,22
191116697,5,2,5,7,2,21
191116698,3,6,4,7,0,20
191116699,5,2,9,3,3,22
191116700,5,9,4,9,4,31
191116701,8,5,3,9,6,31
191116702,7,9,5,6,0,27
191116703,2,4,7,8,9,30
191116704,0,8,1,0,2,11
191116705,6,5,2,8,8,29
191116706,6,7,5,1,5,24
191116707,8,8,3,4,4,27
191116708,6,1,1,2,3,13
191116709,8,1,3,0,0,12
191116710,2,3,2,6,5,18
191116711,6,5,6,6,6,29
191116712,7,1,2,2,6,18
191116713,1,2,4,2,2,11
191116714,8,1,6,9,3,27
191116715,6,1,7,3,7,24
191116716,4,0,7,1,9,21
191116717,7,0,8,4,1,20
191116718,7,1,3,4,6,21
191116719,4,4,6,9,2,25
191116720,5,4,5,4,6,24
191116721,3,7,9,7,4,30
191116722,8,0,7,1,4,20
191116723,6,2,8,5,7,28
191116724,5,1,2,7,5,20
191116725,7,9,0,8,9,33
191116726,4,3,7,1,8,23
191116727,6,3,5,6,5,25
191116728,7,3,1,1,5,17
191116729,4,6,2,7,7,26
191116730,7,2,1,2,5,17
191116731,0,6,5,2,0,13
191116732,6,5,1,5,2,19
191116733,8,9,0,1,6,24
191116734,8,7,4,0,1,20
191116735,0,9,8,5,3,25
191116736,0,9,4,9,3,25
191116737,3,2,5,9,0,19
191116738,9,2,0,2,4,17
191116739,9,6,9,7,5,36
191116740,2,6,3,4,8,23
191116741,3,8,4,2,6,23
191116742,9,7,4,7,8,35
191116743,8,8,8,2,2,28
191116744,5,4,8,6,1,24
191116745,5,1,3,2,7,18
191116746,6,7,7,6,4,30
191116747,1,0,2,0,9,12
191116748,9,7,2,6,0,24
191116749,2,7,6,1,1,17
191116750,8,1,4,2,9,24
191116751,7,6,4,1,7,25
191116752,2,1,1,9,3,16
191116753,7,5,0,4,3,19
191116754,6,8,4,5,9,32
191116755,2,4,6,7,3,22
191116756,2,9,9,6,9,35
191116757,3,4,1,3,4,15
191116758,7,1,6,9,8,31
191116759,9,2,1,4,6,22
191116760,6,0,2,4,1,13
191116761,1,2,0,0,9,12
191116762,9,4,5,1,5,24
191116763,9,7,8,2,1,27
191116764,6,5,3,7,1,22
191116765,4,1,8,9,9,31
191116766,6,0,2,0,6,14
191116767,4,2,1,8,1,16
191116768,9,0,9,0,2,20
191116769,8,8,1,0,1,18
191116770,2,2,8,8,3,23
191116771,5,0,1,8,5,19
191116772,1,4,2,7,6,20
191116773,0,7,9,8,2,26
191116774,4,6,9,3,7,29
191116775,6,8,2,7,6,29
191116776,3,7,2,0,6,18
191116777,0,3,8,9,5,25
191116778,3,2,9,4,0,18
191116779,0,2,5,5,0,12
191116780,3,8,9,1,7,28
191116781,6,7,7,2,9,31
191116782,1,0,2,8,9,20
191116783,9,0,1,7,3,20
191116784,2,3,7,1,0,13
191116785,3,1,8,9,5,26
191116786,4,8,3,9,7,31
191116787,4,2,2,5,9,22
191116788,1,1,0,5,5,12
191116789,2,2,4,7,4,19
191116790,1,0,7,6,0,14
191116791,1,0,9,9,8,27
191116792,5,8,5,4,0,22
191116793,8,7,2,5,1,23
191116794,1,0,0,2,8,11
191116795,6,5,5,8,6,30
191116796,0,3,2,0,4,9
191116797,7,3,9,1,3,23
191116798,3,0,7,7,7,24
191116799,0,2,4,4,0,10
191116800,5,0,2,3,9,19
191116801,4,5,5,3,6,23
191116802,0,7,8,7,0,22
191116803,5,6,1,6,8,26
191116804,6,7,4,1,1,19
191116805,4,8,3,0,1,16
191116806,2,8,4,5,4,23
191116807,4,6,6,6,6,28
191116808,1,5,5,2,3,16
191116809,8,5,7,1,2,23
191116810,1,0,6,2,4,13
191116811,7,5,9,0,6,27
191116812,0,6,9,6,5,26
191116813,8,6,6,1,5,26
191116814,9,2,1,7,2,21
191116815,8,9,0,2,7,26
191116816,0,9,4,3,3,19
191116817,5,8,1,1,5,20
191116818,8,2,1,9,2,22
191116819,0,4,7,5,2,18
191116820,4,1,0,7,9,21
191116821,6,5,9,7,7,34
191116822,5,9,1,8,7,30
191116823,4,9,5,9,5,32
191116824,7,4,7,8,8,34
191116825,5,7,0,1,0,13
191116826,6,8,0,9,2,25
191116827,0,1,9,9,3,22
191116828,9,3,0,9,3,24
191116829,6,6,1,8,7,28
191116830,2,6,1,1,7,17
191116831,1,5,8,5,8,27
191116832,5,7,3,3,5,23
191116833,0,5,1,9,7,22
191116834,7,6,6,0,3,22
191116835,8,1,0,3,1,13
191116836,3,6,4,9,2,24
191116837,7,2,8,4,9,30
191116838,0,3,0,3,3,9
191116839,2,1,3,8,4,18
191116840,5,9,7,5,3,29
191116841,0,0,0,9,6,15
191116842,6,4,4,9,9,32
191116843,3,8,0,7,1,19
191116844,1,7,3,6,7,24
191116845,7,7,9,6,4,33
191116846,9,3,7,4,1,24
191116847,8,3,8,4,8,31
191116848,1,6,8,8,0,23
191116849,2,3,5,6,6,22
191116850,3,7,1,1,7,19
191116851,4,1,6,5,6,22
191116852,2,8,8,4,9,31
191116853,2,7,5,4,3,21
191116854,8,6,5,7,8,34
191116855,7,6,2,2,8,25
191116856,0,1,5,6,2,14
191116857,7,4,5,9,7,32
191116858,8,8,9,5,7,37
191116859,8,3,3,2,4,20
191116860,5,2,6,6,1,20
191116861,0,6,3,7,6,22
191116862,9,1,3,8,0,21
191116863,3,4,9,1,4,21
191116864,3,7,8,7,1,26
191116865,7,5,1,5,4,22
191116866,3,8,8,1,8,28
191116867,1,3,1,5,7,17
191116868,0,2,3,8,2,15
191116869,1,6,4,7,6,24
191116870,1,6,2,6,0,15
191116871,8,7,2,1,0,18
191116872,8,4,4,9,8,33
191116873,6,3,0,0,3,12
191116874,4,0,1,5,1,11
191116875,5,2,0,5,2,14
191116876,2,3,1,6,6,18
191116877,7,6,7,4,5,29
191116878,9,5,0,7,9,30
191116879,6,3,5,4,0,18
191116880,2,7,7,0,6,22
191116881,3,5,8,7,1,24
191116882,7,5,4,2,4,22
191116883,9,1,6,0,0,16
191116884,7,2,8,9,3,29
191116885,2,9,4,5,6,26
191116886,2,1,1,3,7,14
191116887,9,4,5,5,7,30
191116888,7,2,6,7,1,23
191116889,5,5,1,6,5,22
191116890,0,3,3,2,6,14
191116891,0,7,6,5,1,19
191116892,6,4,7,7,7,31
191116893,5,9,3,4,2,23
191116894,7,1,8,4,3,23
191116895,1,9,7,1,1,19
191116896,2,1,1,3,1,8
191116897,0,0,0,8,2,10
191116898,4,2,3,1,8,18
191116899,0,3,2,3,6,14
191116900,2,5,0,7,5,19
191116901,0,2,4,5,7,18
191116902,5,8,4,9,9,35
191116903,0,4,6,7,2,19
191116904,3,3,6,3,9,24
191116905,0,9,0,5,2,16
191116906,8,3,6,6,5,28
191116907,8,8,0,3,8,27
191116908,7,4,4,3,7,25
191116909,2,2,6,0,4,14
191116910,3,6,6,7,6,28
191116911,1,5,6,2,7,21
191116912,2,1,7,7,7,24
191116913,7,2,2,9,8,28
191116914,2,9,8,9,0,28
191116915,6,1,1,3,7,18
191116916,7,4,6,7,6,30
191116917,5,7,7,0,2,21
191116918,1,3,2,0,7,13
191116919,9,0,5,4,8,26
191116920,8,8,0,3,1,20
191116921,0,1,8,4,7,20
191116922,3,2,2,2,2,11
191116923,8,6,5,6,1,26
191116924,4,9,5,8,3,29
191116925,3,4,0,4,5,16
191116926,9,2,0,8,2,21
191116927,8,8,3,7,4,30
191116928,8,1,8,7,7,31
191116929,0,0,0,6,1,7
191116930,5,9,6,1,8,29
191116931,0,7,5,3,5,20
191116932,1,2,6,4,3,16
191116933,3,7,5,4,8,27
191116934,3,0,5,3,0,11
191116935,2,7,6,3,3,21
191116936,2,8,6,6,8,30
191116937,7,4,3,0,6,20
191116938,3,7,9,0,3,22
191116939,8,9,2,9,4,32
191116940,4,9,7,1,1,22
191116941,2,7,7,8,7,31
191116942,4,4,8,7,7,30
191116943,2,1,1,4,1,9
191116944,8,1,7,0,0,16
191116945,0,3,9,7,8,27
191116946,0,2,2,2,7,13
191116947,6,3,5,5,2,21
191116948,4,1,2,3,8,18
191116949,5,2,1,6,7,21
191116950,8,5,9,4,6,32
191116951,0,1,2,5,2,10
191116952,5,3,0,8,5,21
191116953,8,9,3,8,2,30
191116954,5,2,8,2,5,22
191116955,8,5,4,1,4,22
191116956,5,1,4,8,5,23
191116957,2,4,0,2,3,11
191116958,4,1,4,8,5,22
191116959,0,1,7,4,0,12
191116960,1,0,6,1,0,8
191116961,8,9,1,0,4,22
191116962,4,3,3,9,7,26
191116963,3,7,5,5,1,21
191116964,7,4,3,2,2,18
191116965,2,9,1,6,2,20
191116966,6,1,2,5,9,23
191116967,7,9,8,6,3,33
191116968,8,9,0,3,5,25
191116969,6,0,8,5,9,28
191116970,8,7,1,8,4,28
191116971,6,2,5,4,5,22
191116972,3,7,3,4,7,24
191116973,0,0,3,8,8,19
191116974,6,9,7,8,1,31
191116975,3,2,8,7,7,27
191116976,0,1,3,4,6,14
191116977,0,4,8,7,9,28
191116978,3,9,5,2,2,21
191116979,4,4,8,3,2,21
191116980,9,2,9,3,3,26
191116981,0,8,9,5,0,22
191116982,8,4,9,8,0,29
191116983,0,2,7,5,2,16
191116984,7,0,3,7,2,19
191116985,6,1,3,3,5,18
191116986,9,2,9,8,2,30
191116987,6,2,6,7,9,30
191116988,8,0,9,7,8,32
191116989,4,3,7,2,7,23
191116990,4,5,6,4,1,20
191116991,8,2,8,8,3,29
191116992,4,5,1,4,7,21
191116993,3,4,4,5,1,17
191116994,5,2,2,4,3,16
191116995,0,7,0,4,5,16
191116996,1,7,7,0,1,16
191116997,6,8,6,9,7,36
191116998,6,0,1,2,4,13
191116999,7,4,7,6,6,30
1911161000,5,0,8,3,3,19
1911161001,0,5,9,2,0,16
1911161002,9,9,8,6,7,39
1911161003,3,6,6,9,5,29
1911161004,7,8,7,8,5,35
1911161005,5,4,3,7,1,20
1911161006,1,8,4,5,2,20
1911161007,5,9,7,6,1,28
1911161008,9,7,2,5,7,30
1911161009,5,2,8,0,1,16
1911161010,3,9,3,1,0,16
1911161011,1,7,4,7,8,27
1911161012,7,0,4,5,3,19
1911161013,9,1,8,0,2,20
1911161014,5,6,7,5,6,29
1911161015,2,9,5,5,4,25
1911161016,4,2,4,2,2,14
1911161017,1,9,6,5,0,21
1911161018,1,9,0,8,9,27
1911161019,3,2,1,0,3,9
1911161020,5,1,4,4,9,23
1911161021,1,7,1,8,6,23
1911161022,2,9,3,6,9,29
1911161023,4,2,9,8,3,26
1911161024,1,4,9,4,4,22
1911161025,8,5,2,6,8,29
1911161026,3,9,6,5,1,24
1911161027,7,0,6,7,1,21
1911161028,0,6,6,7,5,24
1911161029,4,3,7,5,1,20
1911161030,0,1,4,2,2,9
1911161031,3,3,3,2,6,17
1911161032,7,1,6,4,6,24
1911161033,6,7,3,0,2,18
1911161034,0,3,8,0,0,11
1911161035,1,9,9,3,6,28
1911161036,8,3,4,0,4,19
1911161037,7,5,4,2,8,26
1911161038,4,2,6,3,4,19
1911161039,7,2,7,6,5,27
1911161040,7,1,3,4,8,23
1911161041,3,5,7,4,1,20
1911161042,1,6,2,4,0,13
1911161043,2,6,8,6,4,26
1911161044,3,3,2,3,0,11
1911161045,7,9,6,9,0,31
1911161046,2,0,6,9,4,21
1911161047,8,6,8,5,3,30
1911161048,1,3,1,5,1,11
1911161049,1,7,2,3,7,20
1911161050,4,9,0,7,1,21
1911161051,9,1,2,3,3,18
1911161052,0,2,1,5,3,11
1911161053,6,2,8,2,1,19
1911161054,9,8,3,0,7,27
1911161055,3,6,9,4,0,22
1911161056,5,3,5,3,5,21
1911161057,4,4,6,5,2,21
1911161058,1,0,6,5,6,18
1911161059,8,2,5,9,5,29
1911161060,9,8,7,2,3,29
1911161061,7,6,2,9,6,30
1911161062,5,0,3,1,6,15
1911161063,4,7,6,3,9,29
1911161064,2,7,7,3,1,20
1911161065,4,0,8,3,0,15
1911161066,0,7,6,5,8,26
1911161067,9,9,1,9,8,36
1911161068,7,7,4,2,2,22
1911161069,4,5,6,1,2,18
1911161070,4,6,2,9,9,30
1911161071,7,1,0,3,1,12
1911161072,5,9,7,8,6,35
1911161073,0,0,9,3,2,14
1911161074,7,3,0,3,5,18
1911161075,2,4,3,6,9,24
1911161076,6,9,4,8,6,33
1911161077,0,8,4,0,3,15
1911161078,4,0,6,6,4,20
1911161079,0,7,3,5,2,17
1911161080,3,6,7,4,5,25
1911161081,5,4,4,0,8,21
1911161082,8,2,6,0,3,19
1911161083,3,4,2,2,7,18
1911161084,6,8,1,0,3,18
1911161085,0,6,4,2,5,17
1911161086,5,1,6,3,7,22
1911161087,5,3,2,5,1,16
1911161088,4,1,2,6,2,15
1911161089,7,7,0,3,8,25
1911161090,2,7,8,6,3,26
1911161091,9,1,7,4,7,28
1911161092,7,7,0,0,0,14
1911161093,2,1,7,4,8,22
1911161094,7,6,3,7,0,23
1911161095,8,5,8,9,6,36
1911161096,3,5,4,8,5,25
1911161097,7,9,6,0,3,25
1911161098,8,1,5,5,6,25
1911161099,6,3,5,4,2,20
1911161100,5,1,1,3,2,12
1911161101,7,0,0,6,2,15
1911161102,5,4,7,4,3,23
1911161103,9,6,1,7,8,31
1911161104,8,0,2,1,1,12
1911161105,9,2,5,1,1,18
191117001,2,7,8,8,9,34
191117002,9,0,2,5,9,25
191117003,3,8,1,3,0,15
191117004,3,5,3,3,0,14
191117005,4,9,4,0,1,18
191117006,5,2,9,8,6,30
191117007,6,2,0,5,9,22
191117008,2,1,4,3,5,15
191117009,6,7,5,5,2,25
191117010,0,7,2,9,2,20
191117011,6,5,5,7,4,27
191117012,8,6,7,0,0,21
191117013,7,8,7,2,1,25
191117014,7,2,5,0,1,15
191117015,6,1,2,4,8,21
191117016,5,7,4,1,2,19
191117017,8,3,3,1,5,20
191117018,7,3,6,3,8,27
191117019,7,0,9,9,7,32
191117020,3,3,6,3,5,20
191117021,6,1,5,8,9,29
191117022,2,0,6,2,3,13
191117023,4,6,2,3,7,22
191117024,5,9,9,9,0,32
191117025,7,2,2,7,5,23
191117026,2,2,5,4,2,15
191117027,1,4,6,4,9,24
191117028,7,8,4,7,0,26
191117029,4,9,5,7,4,29
191117030,5,3,4,6,0,18
191117031,1,9,1,7,6,24
191117032,5,5,2,5,9,26
191117033,7,4,2,0,5,18
191117034,8,3,7,0,9,27
191117035,3,9,9,7,5,33
191117036,5,7,6,9,1,28
191117037,6,6,9,7,6,34
191117038,5,6,6,5,4,26
191117039,3,2,2,9,5,21
191117040,9,3,3,8,8,31
191117041,6,7,2,6,8,29
191117042,4,7,7,7,7,32
191117043,2,7,4,8,6,27
191117044,2,6,8,7,0,23
191117045,8,3,1,6,2,20
191117046,6,5,9,2,7,29
191117047,2,1,3,2,0,8
191117048,0,6,5,3,5,19
191117049,2,4,8,2,3,19
191117050,0,1,5,9,2,17
191117051,8,2,2,3,9,24
191117052,4,1,3,4,0,12
191117053,2,3,7,1,8,21
191117054,5,3,7,2,3,20
191117055,6,6,1,0,6,19
191117056,9,1,6,0,4,20
191117057,5,2,4,0,2,13
191117058,6,1,8,7,9,31
191117059,8,5,1,8,8,30
191117060,4,7,0,6,4,21
191117061,1,7,5,6,3,22
191117062,3,0,3,9,3,18
191117063,5,4,9,8,0,26
191117064,7,1,7,6,2,23
191117065,2,9,9,6,6,32
191117066,1,5,8,7,1,22
191117067,8,9,9,8,8,42
191117068,7,8,1,8,0,24
191117069,8,5,0,0,2,15
191117070,1,9,1,3,8,22
191117071,4,2,6,0,6,18
191117072,0,2,0,8,0,10
191117073,0,8,7,1,5,21
191117074,5,2,0,9,6,22
191117075,6,7,9,4,1,27
191117076,8,7,0,1,2,18
191117077,2,1,4,8,8,23
191117078,7,9,9,2,8,35
191117079,9,1,1,3,5,19
191117080,1,4,7,1,0,13
191117081,9,3,6,4,0,22
191117082,0,3,9,0,3,15
191117083,1,4,7,3,0,15
191117084,5,8,5,8,9,35
191117085,4,2,4,8,5,23
191117086,6,3,7,3,7,26
191117087,2,8,7,5,5,27
191117088,8,4,4,4,7,27
191117089,7,9,2,2,5,25
191117090,4,2,2,8,9,25
191117091,6,8,6,6,2,28
191117092,0,2,3,8,7,20
191117093,2,9,4,7,5,27
191117094,3,8,8,2,1,22
191117095,9,3,8,5,8,33
191117096,5,5,8,5,1,24
191117097,0,9,1,1,5,16
191117098,9,6,9,5,4,33
191117099,3,0,3,7,1,14
191117100,3,7,3,2,0,15
191117101,4,2,4,0,1,11
191117102,5,1,9,7,5,27
191117103,2,9,2,3,1,17
191117104,8,4,8,7,2,29
191117105,2,0,9,8,5,24
191117106,2,8,7,4,4,25
191117107,0,3,4,3,3,13
191117108,5,7,6,4,8,30
191117109,1,3,6,3,6,19
191117110,7,8,4,1,9,29
191117111,8,9,9,6,5,37
191117112,4,8,2,1,9,24
191117113,4,7,7,8,2,28
191117114,9,1,8,6,3,27
191117115,1,0,2,6,2,11
191117116,7,0,9,5,6,27
191117117,4,8,6,8,4,30
191117118,9,3,3,0,6,21
191117119,7,1,6,6,1,21
191117120,0,1,8,3,0,12
191117121,1,0,6,6,8,21
191117122,9,5,7,8,1,30
191117123,0,6,7,8,7,28
191117124,3,6,8,0,8,25
191117125,1,1,0,4,8,14
191117126,9,3,0,5,6,23
191117127,8,1,5,1,9,24
191117128,2,2,1,0,3,8
191117129,0,7,6,1,9,23
191117130,0,9,1,5,9,24
191117131,5,1,8,3,2,19
191117132,1,4,7,7,2,21
191117133,7,5,2,6,4,24
191117134,4,1,5,4,9,23
191117135,9,5,2,4,4,24
191117136,5,0,3,4,2,14
191117137,5,0,3,2,2,12
191117138,6,0,3,8,2,19
191117139,2,1,1,1,9,14
191117140,0,7,0,5,0,12
191117141,9,1,1,5,0,16
191117142,2,1,9,8,5,25
191117143,2,0,5,8,0,15
191117144,6,5,6,1,0,18
191117145,1,9,4,2,6,22
191117146,5,9,6,1,3,24
191117147,4,9,5,4,8,30
191117148,1,2,7,2,5,17
191117149,0,0,3,1,8,12
191117150,3,1,9,7,2,22
191117151,3,0,5,2,3,13
191117152,9,5,4,4,7,29
191117153,3,0,2,4,8,17
191117154,7,7,7,2,2,25
191117155,7,6,1,4,6,24
191117156,5,8,8,3,0,24
191117157,8,6,0,9,9,32
191117158,5,3,6,1,5,20
191117159,7,9,9,8,5,38
191117160,1,3,3,9,6,22
191117161,1,6,1,0,4,12
191117162,7,1,2,1,8,19
191117163,6,5,8,3,3,25
191117164,5,7,8,2,8,30
191117165,3,8,5,7,4,27
191117166,5,9,8,6,8,36
191117167,9,1,5,1,2,18
191117168,3,5,0,8,0,16
191117169,8,7,5,2,2,24
191117170,9,9,7,6,3,34
191117171,9,9,5,3,1,27
191117172,1,5,0,7,6,19
191117173,2,9,6,3,2,22
191117174,1,9,8,0,5,23
191117175,7,5,7,9,0,28
191117176,8,0,1,2,6,17
191117177,1,1,6,6,6,20
191117178,4,6,3,9,0,22
191117179,6,7,8,0,2,23
191117180,2,6,3,0,6,17
191117181,7,5,3,5,2,22
191117182,9,2,7,2,7,27
191117183,2,3,0,1,1,7
191117184,6,6,3,8,5,28
191117185,5,2,5,5,3,20
191117186,7,1,2,8,4,22
191117187,2,2,7,2,9,22
191117188,6,1,5,2,0,14
191117189,4,8,1,0,7,20
191117190,8,6,5,8,7,34
191117191,8,1,8,3,2,22
191117192,0,5,9,4,9,27
191117193,7,2,5,7,9,30
191117194,4,3,3,0,6,16
191117195,5,3,5,0,6,19
191117196,1,2,9,6,4,22
191117197,6,5,4,1,6,22
191117198,5,7,8,5,7,32
191117199,1,7,7,2,7,24
191117200,6,3,1,4,8,22
191117201,9,0,5,2,3,19
191117202,3,8,7,1,3,22
191117203,4,2,6,8,5,25
191117204,1,1,7,0,4,13
191117205,7,4,5,7,0,23
191117206,4,6,4,0,1,15
191117207,8,3,8,2,1,22
191117208,2,2,4,9,4,21
191117209,8,6,8,7,8,37
191117210,6,5,0,1,4,16
191117211,5,0,8,7,5,25
191117212,0,0,6,7,4,17
191117213,7,2,6,6,9,30
191117214,0,3,9,3,8,23
191117215,7,8,1,4,5,25
191117216,7,3,3,4,4,21
191117217,0,9,0,9,3,21
191117218,0,8,8,7,5,28
191117219,9,3,7,6,8,33
191117220,5,9,3,9,1,27
191117221,1,9,8,1,0,19
191117222,1,1,1,1,4,8
191117223,1,3,1,0,6,11
191117224,1,7,6,0,0,14
191117225,6,7,7,2,0,22
191117226,0,4,3,1,3,11
191117227,3,2,6,8,3,22
191117228,8,5,6,3,7,29
191117229,4,3,3,1,8,19
191117230,9,0,5,1,5,20
191117231,8,2,9,7,2,28
191117232,6,8,3,5,1,23
191117233,3,6,5,4,9,27
191117234,7,0,4,2,3,16
191117235,4,9,9,6,8,36
191117236,8,8,7,5,5,33
191117237,1,2,2,7,6,18
191117238,6,1,8,1,2,18
191117239,5,6,6,5,1,23
191117240,8,5,7,1,9,30
191117241,1,2,9,1,3,16
191117242,0,8,1,0,3,12
191117243,1,7,2,7,1,18
191117244,6,0,7,6,4,23
191117245,7,7,6,6,2,28
191117246,3,9,3,4,8,27
191117247,5,2,8,0,3,18
191117248,7,7,9,2,7,32
191117249,1,9,3,9,8,30
191117250,4,4,3,9,2,22
191117251,0,3,6,5,5,19
191117252,2,1,1,8,9,21
191117253,5,5,5,0,9,24
191117254,4,8,9,3,9,33
191117255,9,0,6,6,2,23
191117256,0,8,3,6,6,23
191117257,2,0,2,1,6,11
191117258,0,4,0,9,3,16
191117259,2,3,7,0,1,13
191117260,6,7,3,2,2,20
191117261,0,2,8,5,1,16
191117262,8,9,3,9,7,36
191117263,0,8,4,1,6,19
191117264,7,8,7,1,9,32
191117265,4,8,5,4,2,23
191117266,9,5,9,9,2,34
191117267,9,1,2,6,0,18
191117268,1,0,4,9,7,21
191117269,1,1,9,7,5,23
191117270,2,5,9,9,8,33
191117271,1,2,5,1,3,12
191117272,3,4,8,3,4,22
191117273,9,6,6,1,4,26
191117274,5,2,2,7,0,16
191117275,9,9,7,3,0,28
191117276,4,1,1,3,7,16
191117277,0,7,8,4,2,21
191117278,3,9,2,2,4,20
191117279,0,1,6,3,3,13
191117280,4,6,2,5,1,18
191117281,2,1,3,6,6,18
191117282,9,3,0,2,1,15
191117283,0,8,2,4,6,20
191117284,6,8,9,8,9,40
191117285,9,7,9,2,1,28
191117286,5,9,9,8,3,34
191117287,4,1,0,2,6,13
191117288,4,8,0,5,9,26
191117289,7,1,0,3,3,14
191117290,0,3,3,3,4,13
191117291,2,1,0,5,8,16
191117292,9,2,9,7,9,36
191117293,2,2,7,2,6,19
191117294,7,1,2,0,3,13
191117295,5,2,7,3,2,19
191117296,2,4,0,4,0,10
191117297,7,8,9,3,2,29
191117298,0,6,7,5,4,22
191117299,6,5,2,0,6,19
191117300,2,3,6,0,5,16
191117301,0,4,2,2,8,16
191117302,9,9,8,6,5,37
191117303,6,5,6,6,0,23
191117304,3,5,9,0,4,21
191117305,4,5,4,3,4,20
191117306,1,7,8,8,3,27
191117307,4,2,2,4,3,15
191117308,3,7,9,8,4,31
191117309,8,7,5,2,4,26
191117310,6,1,9,5,1,22
191117311,5,5,8,9,9,36
191117312,6,9,7,1,2,25
191117313,7,7,4,3,3,24
191117314,7,4,8,2,1,22
191117315,9,5,6,5,8,33
191117316,4,2,3,7,5,21
191117317,2,2,8,7,9,28
191117318,2,9,7,0,1,19
191117319,0,2,4,7,8,21
191117320,1,1,0,1,5,8
191117321,9,5,7,5,4,30
191117322,4,7,1,9,8,29
191117323,3,9,6,2,0,20
191117324,2,2,5,0,3,12
191117325,4,8,3,0,9,24
191117326,4,2,3,2,8,19
191117327,1,9,7,1,3,21
191117328,9,4,9,5,8,35
191117329,5,9,9,8,6,37
191117330,9,3,5,7,8,32
191117331,2,3,4,2,6,17
191117332,0,7,3,9,8,27
191117333,1,2,5,1,2,11
191117334,6,2,3,6,8,25
191117335,1,9,1,0,1,12
191117336,4,0,0,9,6,19
191117337,7,1,9,5,1,23
191117338,8,9,6,1,9,33
191117339,7,8,7,0,9,31
191117340,0,1,6,6,0,13
191117341,9,9,0,3,6,27
191117342,7,5,2,0,5,19
191117343,6,5,4,3,0,18
191117344,4,6,0,9,3,22
191117345,1,6,0,7,9,23
191117346,0,7,5,9,1,22
191117347,8,4,5,4,7,28
191117348,0,6,3,9,1,19
191117349,2,0,6,6,3,17
191117350,8,8,6,8,1,31
191117351,4,6,3,0,3,16
191117352,4,2,9,4,8,27
191117353,8,3,6,3,8,28
191117354,7,2,9,5,5,28
191117355,4,5,5,1,2,17
191117356,4,0,5,5,5,19
191117357,3,0,7,8,5,23
191117358,4,5,7,3,1,20
191117359,4,8,5,2,4,23
191117360,7,4,5,4,9,29
191117361,6,7,0,6,1,20
191117362,5,4,6,4,3,22
191117363,2,4,3,3,0,12
191117364,8,6,5,9,0,28
191117365,2,0,9,4,7,22
191117366,4,8,1,4,8,25
191117367,7,1,7,9,5,29
191117368,9,2,8,8,8,35
191117369,9,5,7,8,2,31
191117370,3,4,4,2,5,18
191117371,7,8,7,1,6,29
191117372,0,3,8,8,3,22
191117373,5,8,6,6,6,31
191117374,2,4,6,6,4,22
191117375,5,3,9,0,4,21
191117376,8,5,8,3,3,27
191117377,2,4,8,4,2,20
191117378,9,3,1,8,8,29
191117379,9,2,9,1,4,25
191117380,5,4,1,9,8,27
191117381,0,9,1,3,7,20
191117382,5,0,3,5,3,16
191117383,5,8,9,8,1,31
191117384,2,1,7,6,8,24
191117385,5,7,1,7,8,28
191117386,9,0,0,3,4,16
191117387,8,1,8,5,7,29
191117388,7,7,9,3,4,30
191117389,2,5,0,7,2,16
191117390,6,8,7,0,1,22
191117391,2,3,3,7,4,19
191117392,4,8,9,7,5,33
191117393,0,9,5,4,2,20
191117394,4,7,5,1,8,25
191117395,7,8,5,9,5,34
191117396,2,3,8,8,4,25
191117397,0,9,5,5,0,19
191117398,2,5,6,7,7,27
191117399,1,3,0,7,5,16
191117400,0,7,8,5,0,20
191117401,0,6,6,7,3,22
191117402,5,5,1,6,2,19
191117403,8,2,1,7,4,22
191117404,5,0,6,3,5,19
191117405,2,0,5,8,8,23
191117406,5,5,2,5,6,23
191117407,8,7,0,8,5,28
191117408,2,4,9,5,9,29
191117409,9,1,0,3,5,18
191117410,9,8,8,2,7,34
191117411,4,1,2,2,7,16
191117412,8,5,6,3,9,31
191117413,8,0,1,1,7,17
191117414,6,5,6,7,8,32
191117415,3,9,0,7,3,22
191117416,4,6,9,6,9,34
191117417,4,9,9,9,0,31
191117418,4,1,7,4,7,23
191117419,4,4,1,6,4,19
191117420,3,9,7,8,0,27
191117421,8,6,6,0,9,29
191117422,5,1,9,3,9,27
191117423,2,3,1,8,5,19
191117424,2,9,4,2,5,22
191117425,0,9,5,1,5,20
191117426,0,2,2,0,4,8
191117427,1,5,7,6,7,26
191117428,1,3,0,3,4,11
191117429,7,1,2,4,5,19
191117430,5,6,1,8,6,26
191117431,4,3,8,8,7,30
191117432,4,1,2,8,6,21
191117433,3,4,7,6,4,24
191117434,1,6,8,9,8,32
191117435,1,0,2,6,6,15
191117436,5,1,4,1,5,16
191117437,9,3,1,3,0,16
191117438,1,7,8,7,4,27
191117439,1,9,7,0,5,22
191117440,8,5,0,0,3,16
191117441,8,5,5,9,1,28
191117442,3,1,7,9,1,21
191117443,5,0,3,5,5,18
191117444,9,6,9,5,2,31
191117445,5,3,5,4,6,23
191117446,1,7,7,1,0,16
191117447,7,1,1,7,8,24
191117448,8,1,5,8,2,24
191117449,5,6,2,8,7,28
191117450,9,6,1,8,8,32
191117451,1,8,8,5,4,26
191117452,0,3,0,7,2,12
191117453,0,8,3,6,5,22
191117454,0,3,4,2,2,11
191117455,3,2,4,8,3,20
191117456,5,8,2,3,1,19
191117457,0,8,9,9,9,35
191117458,2,1,0,9,2,14
191117459,3,4,0,4,4,15
191117460,7,0,6,6,9,28
191117461,5,4,5,4,3,21
191117462,5,3,1,6,0,15
191117463,6,9,2,5,2,24
191117464,5,2,9,7,9,32
191117465,2,8,1,0,6,17
191117466,9,7,0,5,8,29
191117467,8,0,9,9,9,35
191117468,3,8,8,1,1,21
191117469,7,6,9,1,4,27
191117470,6,2,3,0,4,15
191117471,1,9,0,1,4,15
191117472,3,7,3,8,5,26
191117473,8,6,8,4,8,34
191117474,0,5,0,0,7,12
191117475,3,2,5,6,3,19
191117476,6,0,0,3,4,13
191117477,5,6,5,6,2,24
191117478,4,8,2,8,5,27
191117479,2,8,1,6,8,25
191117480,6,5,3,2,7,23
191117481,1,7,2,5,4,19
191117482,3,8,1,1,4,17
191117483,9,5,5,7,4,30
191117484,5,8,5,7,8,33
191117485,8,7,8,0,2,25
191117486,3,5,6,3,0,17
191117487,2,5,2,8,5,22
191117488,6,9,6,4,4,29
191117489,7,8,8,9,0,32
191117490,7,1,6,7,6,27
191117491,3,5,5,4,6,23
191117492,2,2,9,4,6,23
191117493,8,6,5,5,4,28
191117494,3,7,3,6,2,21
191117495,4,9,4,4,1,22
191117496,4,5,0,7,8,24
191117497,6,1,1,4,8,20
191117498,0,2,8,5,7,22
191117499,8,8,8,9,4,37
191117500,9,2,2,1,3,17
191117501,8,8,1,7,5,29
191117502,0,6,2,1,9,18
191117503,1,9,3,6,3,22
191117504,9,2,8,3,7,29
191117505,3,2,1,4,1,11
191117506,5,4,6,1,5,21
191117507,5,8,7,0,5,25
191117508,6,1,5,1,2,15
191117509,2,5,7,5,6,25
191117510,0,3,4,5,5,17
191117511,3,6,2,4,8,23
191117512,9,8,5,6,5,33
191117513,1,5,0,3,8,17
191117514,3,4,9,4,0,20
191117515,3,9,2,5,7,26
191117516,4,8,4,6,3,25
191117517,6,8,7,3,8,32
191117518,9,0,8,6,7,30
191117519,0,5,5,6,5,21
191117520,5,2,8,8,4,27
191117521,4,7,3,3,3,20
191117522,3,1,1,9,6,20
191117523,0,7,6,2,0,15
191117524,7,0,4,3,4,18
191117525,6,3,6,2,4,21
191117526,2,1,1,1,0,5
191117527,0,6,3,7,1,17
191117528,2,4,6,4,3,19
191117529,7,3,2,2,1,15
191117530,3,3,4,7,2,19
191117531,5,2,9,0,5,21
191117532,6,7,1,8,3,25
191117533,6,4,1,5,0,16
191117534,8,5,9,6,5,33
191117535,8,3,1,9,5,26
191117536,8,0,4,9,6,27
191117537,7,3,9,3,2,24
191117538,4,1,9,3,0,17
191117539,0,4,0,3,1,8
191117540,2,2,7,1,7,19
191117541,0,4,9,4,3,20
191117542,7,5,6,2,6,26
191117543,4,9,0,4,1,18
191117544,4,7,6,7,5,29
191117545,7,7,0,0,2,16
191117546,1,2,7,3,6,19
191117547,3,9,3,5,8,28
191117548,6,7,2,1,0,16
191117549,5,5,7,4,9,30
191117550,4,5,5,2,1,17
191117551,0,1,4,9,3,17
191117552,1,2,0,2,6,11
191117553,2,8,4,4,1,19
191117554,1,5,4,3,4,17
191117555,6,3,9,9,2,29
191117556,8,4,1,2,5,20
191117557,7,0,7,8,4,26
191117558,5,1,9,6,8,29
191117559,7,8,5,8,1,29
191117560,0,0,7,0,2,9
191117561,0,0,6,3,6,15
191117562,0,5,6,1,2,14
191117563,6,9,0,6,0,21
191117564,5,5,8,2,6,26
191117565,6,7,7,8,1,29
191117566,1,5,8,4,8,26
191117567,1,7,3,1,6,18
191117568,8,4,8,5,3,28
191117569,3,3,9,5,3,23
191117570,9,7,9,9,2,36
191117571,6,2,1,6,3,18
191117572,7,5,7,0,3,22
191117573,2,7,7,9,8,33
191117574,0,5,8,1,1,15
191117575,3,2,0,6,3,14
191117576,1,2,6,1,7,17
191117577,3,5,6,7,2,23
191117578,9,8,1,4,8,30
191117579,4,0,2,1,1,8
191117580,1,7,3,2,3,16
191117581,8,8,2,5,8,31
191117582,7,3,4,3,3,20
191117583,9,6,0,7,3,25
191117584,6,3,7,1,0,17
191117585,8,0,2,6,2,18
191117586,3,8,8,7,1,27
191117587,3,6,2,2,4,17
191117588,0,0,4,1,0,5
191117589,7,4,4,8,8,31
191117590,9,4,9,1,4,27
191117591,2,2,6,5,2,17
191117592,8,1,0,2,4,15
191117593,7,1,0,8,2,18
191117594,5,8,4,3,8,28
191117595,2,6,6,2,9,25
191117596,8,3,7,1,8,27
191117597,9,7,3,8,0,27
191117598,7,3,0,8,0,18
191117599,3,0,5,2,5,15
191117600,1,7,3,8,2,21
191117601,8,1,0,9,1,19
191117602,1,3,8,5,9,26
191117603,6,7,8,1,3,25
191117604,6,6,6,6,8,32
191117605,1,9,3,4,8,25
191117606,1,0,5,7,8,21
191117607,9,8,5,2,3,27
191117608,9,3,8,6,9,35
191117609,7,9,7,7,5,35
191117610,0,4,8,1,0,13
191117611,2,3,4,0,1,10
191117612,7,2,8,7,1,25
191117613,3,4,5,8,0,20
191117614,8,4,2,6,5,25
191117615,9,0,0,9,3,21
191117616,6,7,9,5,5,32
191117617,1,5,4,8,5,23
191117618,1,5,2,5,3,16
191117619,3,2,5,9,9,28
191117620,6,0,7,2,3,18
191117621,9,6,0,1,9,25
191117622,6,4,7,7,3,27
191117623,7,1,1,2,0,11
191117624,4,6,3,2,7,22
191117625,4,5,0,1,8,18
191117626,7,4,8,1,9,29
191117627,5,0,6,0,0,11
191117628,5,9,1,5,9,29
191117629,2,6,1,3,3,15
191117630,4,9,3,2,2,20
191117631,3,3,2,2,8,18
191117632,3,6,2,0,3,14
191117633,6,3,8,5,5,27
191117634,7,2,7,6,3,25
191117635,2,4,8,6,4,24
191117636,4,9,8,0,2,23
191117637,0,6,4,0,7,17
191117638,1,9,6,7,5,28
191117639,1,6,3,3,0,13
191117640,9,9,7,1,8,34
191117641,4,4,9,9,4,30
191117642,1,3,4,8,8,24
191117643,5,3,3,8,9,28
191117644,5,3,8,6,4,26
191117645,6,7,3,3,6,25
191117646,3,2,3,8,4,20
191117647,6,4,0,7,4,21
191117648,1,8,8,2,7,26
191117649,2,8,6,9,6,31
191117650,3,5,6,4,4,22
191117651,7,7,6,4,6,30
191117652,0,0,9,7,8,24
191117653,2,7,2,7,7,25
191117654,3,4,4,0,7,18
191117655,4,6,0,4,7,21
191117656,4,1,3,6,7,21
191117657,5,6,3,8,6,28
191117658,2,5,9,5,8,29
191117659,9,5,6,5,9,34
191117660,3,0,4,7,0,14
191117661,3,7,1,3,3,17
191117662,8,7,7,7,4,33
191117663,2,6,5,2,3,18
191117664,2,3,1,4,1,11
191117665,0,9,2,1,8,20
191117666,1,9,4,3,3,20
191117667,6,0,7,2,6,21
191117668,5,8,6,5,1,25
191117669,1,3,7,6,8,25
191117670,8,7,7,3,5,30
191117671,2,5,7,5,7,26
191117672,9,5,4,6,4,28
191117673,5,8,6,1,8,28
191117674,9,6,1,6,4,26
191117675,9,6,3,6,5,29
191117676,8,8,2,2,7,27
191117677,3,4,7,2,6,22
191117678,2,8,2,8,1,21
191117679,6,3,4,2,1,16
191117680,6,3,4,6,8,27
191117681,0,0,9,0,0,9
191117682,4,6,3,0,5,18
191117683,6,7,7,2,6,28
191117684,2,5,4,1,4,16
191117685,0,7,7,9,9,32
191117686,3,2,8,8,6,27
191117687,9,0,4,6,7,26
191117688,2,6,4,3,9,24
191117689,5,8,0,9,8,30
191117690,7,5,5,0,0,17
191117691,7,5,0,4,5,21
191117692,9,7,2,1,2,21
191117693,0,9,5,0,6,20
191117694,1,4,6,3,1,15
191117695,0,8,9,7,1,25
191117696,6,5,9,8,8,36
191117697,9,5,2,8,2,26
191117698,0,9,4,1,3,17
191117699,1,9,4,2,7,23
191117700,1,7,9,5,3,25
191117701,8,9,9,9,8,43
191117702,8,8,6,0,6,28
191117703,3,8,6,5,3,25
191117704,0,6,3,7,5,21
191117705,9,8,9,1,8,35
191117706,9,6,9,4,3,31
191117707,3,8,2,0,9,22
191117708,6,3,1,7,5,22
191117709,5,1,5,1,3,15
191117710,8,7,4,4,2,25
191117711,1,3,6,4,6,20
191117712,0,3,1,1,7,12
191117713,7,4,0,4,4,19
191117714,0,0,8,3,3,14
191117715,7,3,4,3,6,23
191117716,9,6,5,1,1,22
191117717,7,1,3,7,4,22
191117718,7,3,4,3,0,17
191117719,0,1,7,4,7,19
191117720,3,4,6,3,7,23
191117721,5,1,1,0,7,14
191117722,8,5,7,1,1,22
191117723,2,4,7,1,1,15
191117724,3,8,8,4,9,32
191117725,6,8,4,2,2,22
191117726,7,2,0,4,5,18
191117727,2,8,0,3,6,19
191117728,0,1,3,5,6,15
191117729,1,8,8,6,7,30
191117730,7,2,8,9,2,28
191117731,6,5,5,0,6,22
191117732,1,8,5,5,3,22
191117733,7,8,2,7,1,25
191117734,2,6,0,6,5,19
191117735,5,3,7,9,1,25
191117736,2,8,7,4,3,24
191117737,1,1,5,6,7,20
191117738,9,2,0,9,0,20
191117739,1,1,8,8,8,26
191117740,3,1,1,3,0,8
191117741,0,3,1,7,3,14
191117742,4,0,1,2,2,9
191117743,2,7,2,1,4,16
191117744,4,3,7,4,1,19
191117745,9,3,9,5,6,32
191117746,4,4,4,4,5,21
191117747,4,1,5,1,9,20
191117748,9,4,3,7,4,27
191117749,7,2,4,0,4,17
191117750,6,8,2,7,5,28
191117751,9,1,5,8,8,31
191117752,9,5,0,3,1,18
191117753,0,9,2,0,3,14
191117754,9,9,8,1,2,29
191117755,1,7,2,9,0,19
191117756,5,0,9,7,2,23
191117757,9,7,9,7,8,40
191117758,4,8,9,0,7,28
191117759,1,0,1,4,5,11
191117760,6,8,1,0,7,22
191117761,4,7,3,4,1,19
191117762,1,2,2,4,7,16
191117763,8,1,6,5,2,22
191117764,8,7,6,7,0,28
191117765,5,1,3,3,4,16
191117766,5,2,2,6,4,19
191117767,1,1,2,7,6,17
191117768,1,9,2,8,1,21
191117769,1,8,1,8,4,22
191117770,0,0,5,1,1,7
191117771,9,3,4,4,5,25
191117772,1,6,2,4,1,14
191117773,8,4,0,5,4,21
191117774,6,9,5,3,9,32
191117775,8,3,2,0,5,18
191117776,2,0,3,6,4,15
191117777,8,9,7,0,5,29
191117778,1,7,6,8,1,23
191117779,5,9,7,6,2,29
191117780,1,2,7,0,6,16
191117781,8,7,2,2,0,19
191117782,7,7,8,7,6,35
191117783,2,8,2,2,6,20
191117784,0,4,9,7,2,22
191117785,7,5,7,0,5,24
191117786,6,0,0,6,8,20
191117787,2,0,8,2,4,16
191117788,4,5,6,2,1,18
191117789,9,5,3,8,5,30
191117790,4,1,2,6,5,18
191117791,2,6,7,1,5,21
191117792,1,7,5,3,2,18
191117793,4,9,9,3,5,30
191117794,7,0,0,0,8,15
191117795,2,6,8,2,7,25
191117796,3,7,6,3,6,25
191117797,0,0,6,5,0,11
191117798,7,2,9,2,2,22
191117799,0,9,0,0,7,16
191117800,6,5,1,4,2,18
191117801,1,2,3,8,5,19
191117802,5,2,3,4,1,15
191117803,7,3,1,3,3,17
191117804,5,3,4,2,2,16
191117805,9,1,5,6,0,21
191117806,9,7,1,9,4,30
191117807,7,6,8,4,6,31
191117808,1,3,2,9,0,15
191117809,1,6,0,0,1,8
191117810,5,3,8,0,4,20
191117811,8,2,3,7,6,26
191117812,8,9,0,1,9,27
191117813,9,3,5,8,6,31
191117814,1,0,3,9,4,17
191117815,1,3,0,2,3,9
191117816,8,7,9,8,5,37
191117817,5,8,4,2,0,19
191117818,7,0,6,2,6,21
191117819,5,3,9,9,7,33
191117820,4,1,8,7,4,24
191117821,5,2,7,2,1,17
191117822,6,2,2,2,6,18
191117823,3,9,7,9,4,32
191117824,1,0,9,6,2,18
191117825,2,2,3,9,3,19
191117826,9,7,7,0,5,28
191117827,8,2,8,9,9,36
191117828,9,3,6,0,6,24
191117829,2,6,1,1,9,19
191117830,2,7,1,4,6,20
191117831,6,3,5,9,3,26
191117832,6,3,5,0,2,16
191117833,1,5,1,1,7,15
191117834,6,0,3,7,6,22
191117835,2,9,8,9,4,32
191117836,3,3,7,2,4,19
191117837,2,5,9,1,2,19
191117838,9,4,8,3,4,28
191117839,6,7,8,6,2,29
191117840,7,0,2,1,7,17
191117841,1,4,9,6,4,24
191117842,0,1,5,5,8,19
191117843,3,0,4,9,3,19
191117844,5,3,3,3,2,16
191117845,8,4,2,3,4,21
191117846,5,3,6,8,4,26
191117847,2,1,9,8,9,29
191117848,0,8,3,3,2,16
191117849,9,9,2,4,6,30
191117850,9,8,3,3,0,23
191117851,9,6,2,1,2,20
191117852,3,3,7,9,8,30
191117853,4,8,3,8,4,27
191117854,0,0,0,8,6,14
191117855,2,7,1,2,8,20
191117856,6,7,5,2,9,29
191117857,7,5,3,7,2,24
191117858,6,1,2,8,6,23
191117859,9,3,6,3,4,25
191117860,1,5,0,1,4,11
191117861,7,8,3,2,8,28
191117862,6,3,8,4,4,25
191117863,5,8,3,1,1,18
191117864,8,6,8,2,2,26
191117865,6,1,8,5,7,27
191117866,0,0,0,9,1,10
191117867,5,3,1,5,4,18
191117868,5,7,2,9,1,24
191117869,6,4,3,8,2,23
191117870,2,8,6,5,7,28
191117871,8,2,1,1,9,21
191117872,8,2,9,4,5,28
191117873,4,0,5,6,0,15
191117874,2,3,8,0,1,14
191117875,0,3,8,3,8,22
191117876,9,0,4,8,4,25
191117877,2,8,3,6,6,25
191117878,3,0,7,1,4,15
191117879,6,4,0,1,8,19
191117880,1,7,5,6,9,28
191117881,1,6,1,3,6,17
191117882,6,6,2,1,7,22
191117883,7,2,5,6,8,28
191117884,4,5,7,7,2,25
191117885,7,1,2,0,9,19
191117886,6,3,4,1,2,16
191117887,7,5,2,0,0,14
191117888,6,3,8,7,9,33
191117889,2,0,6,9,5,22
191117890,0,5,1,0,5,11
191117891,1,2,7,0,7,17
191117892,1,5,5,8,9,28
191117893,5,2,8,6,6,27
191117894,0,8,8,0,0,16
191117895,0,7,0,6,7,20
191117896,1,1,9,4,4,19
191117897,4,8,6,3,1,22
191117898,5,8,0,0,6,19
191117899,2,1,0,2,5,10
191117900,4,2,5,7,3,21
191117901,7,9,2,6,8,32
191117902,1,3,6,3,8,21
191117903,7,0,9,2,9,27
191117904,7,7,0,8,6,28
191117905,7,7,4,2,0,20
191117906,7,4,0,2,8,21
191117907,5,7,5,8,5,30
191117908,9,9,5,6,3,32
191117909,4,1,2,8,9,24
191117910,9,4,8,7,1,29
191117911,6,2,3,6,6,23
191117912,2,1,4,4,2,13
191117913,3,4,4,3,7,21
191117914,7,3,1,8,8,27
191117915,9,6,5,0,0,20
191117916,6,7,8,5,3,29
191117917,7,4,5,3,3,22
191117918,5,3,5,8,2,23
191117919,8,8,6,6,5,33
191117920,1,8,7,5,3,24
191117921,6,9,5,2,8,30
191117922,4,4,2,3,6,19
191117923,0,3,4,6,1,14
191117924,0,9,5,7,2,23
191117925,0,4,5,7,5,21
191117926,9,9,7,7,9,41
191117927,5,5,2,0,5,17
191117928,4,7,9,4,0,24
191117929,1,3,3,1,2,10
191117930,1,8,1,9,7,26
191117931,2,3,4,2,8,19
191117932,8,4,4,6,8,30
191117933,9,1,9,8,4,31
191117934,3,6,1,1,7,18
191117935,3,6,6,5,3,23
191117936,8,6,1,6,0,21
191117937,5,9,7,7,7,35
191117938,8,3,8,3,6,28
191117939,6,6,1,1,3,17
191117940,6,5,0,8,0,19
191117941,5,9,3,2,5,24
191117942,3,0,8,4,9,24
191117943,6,0,3,8,4,21
191117944,7,9,6,6,7,35
191117945,2,3,4,7,5,21
191117946,9,0,1,8,3,21
191117947,8,6,4,2,4,24
191117948,6,7,4,1,8,26
191117949,0,3,8,6,1,18
191117950,4,0,6,3,2,15
191117951,4,5,9,9,6,33
191117952,3,8,6,8,8,33
191117953,9,1,9,0,8,27
191117954,1,4,4,4,4,17
191117955,3,6,7,4,1,21
191117956,0,2,9,7,4,22
191117957,7,1,0,1,8,17
191117958,0,1,4,7,6,18
191117959,8,5,5,9,8,35
191117960,7,9,4,1,3,24
191117961,3,6,4,2,1,16
191117962,5,7,8,3,1,24
191117963,5,3,9,3,6,26
191117964,6,8,8,1,4,27
191117965,9,0,3,4,8,24
191117966,6,2,1,3,7,19
191117967,6,3,6,2,0,17
191117968,4,9,2,1,5,21
191117969,1,1,5,4,7,18
191117970,7,7,2,6,3,25
191117971,6,2,4,2,3,17
191117972,1,9,7,0,2,19
191117973,1,8,7,8,0,24
191117974,3,6,2,2,0,13
191117975,5,5,2,6,4,22
191117976,6,5,8,9,1,29
191117977,3,5,8,7,9,32
191117978,3,6,0,8,0,17
191117979,4,5,1,0,3,13
191117980,4,5,2,1,3,15
191117981,9,2,6,8,3,28
191117982,5,5,1,0,2,13
191117983,0,9,6,5,3,23
191117984,1,2,4,5,6,18
191117985,7,3,3,8,0,21
191117986,7,4,2,8,4,25
191117987,3,6,8,7,7,31
191117988,0,1,9,2,3,15
191117989,7,4,4,4,3,22
191117990,3,2,6,1,2,14
191117991,4,3,6,7,1,21
191117992,8,3,0,3,6,20
191117993,7,1,5,4,7,24
191117994,0,5,7,8,1,21
191117995,8,8,1,5,0,22
191117996,7,8,9,5,2,31
191117997,6,9,5,3,6,29
191117998,8,5,7,2,6,28
191117999,3,4,5,5,0,17
1911171000,2,5,1,0,4,12
1911171001,8,9,5,4,6,32
1911171002,8,7,6,1,2,24
1911171003,5,9,2,7,2,25
1911171004,3,3,0,2,3,11
1911171005,8,9,9,4,4,34
1911171006,3,4,9,6,5,27
1911171007,7,7,3,4,9,30
1911171008,6,2,1,4,8,21
1911171009,1,1,7,8,6,23
1911171010,3,3,4,1,6,17
1911171011,1,1,8,0,8,18
1911171012,0,0,6,5,1,12
1911171013,5,5,5,3,2,20
1911171014,8,4,9,3,9,33
1911171015,0,2,4,6,3,15
1911171016,1,1,1,0,0,3
1911171017,6,9,9,1,6,31
1911171018,3,3,8,2,6,22
1911171019,4,8,8,5,2,27
1911171020,5,7,7,8,0,27
1911171021,6,3,3,2,9,23
1911171022,7,4,5,7,5,28
1911171023,2,2,7,4,9,24
1911171024,2,1,2,6,9,20
1911171025,3,3,0,4,9,19
1911171026,0,2,6,2,8,18
1911171027,0,0,3,4,8,15
1911171028,8,3,4,8,9,32
1911171029,5,8,2,8,1,24
1911171030,9,5,9,2,9,34
1911171031,7,3,7,4,4,25
1911171032,7,7,3,0,6,23
1911171033,7,5,9,2,4,27
1911171034,8,5,9,5,8,35
1911171035,9,2,8,2,8,29
1911171036,6,9,0,8,0,23
1911171037,6,0,8,1,9,24
1911171038,4,7,9,5,6,31
1911171039,7,8,6,5,9,35
1911171040,8,4,4,2,8,26
1911171041,3,5,9,0,3,20
1911171042,7,8,4,3,1,23
1911171043,1,9,5,2,8,25
1911171044,7,4,2,9,5,27
1911171045,8,2,7,9,6,32
1911171046,0,6,7,6,8,27
1911171047,6,4,3,7,9,29
1911171048,0,5,0,1,7,13
1911171049,6,9,2,2,2,21
1911171050,8,1,8,9,4,30
1911171051,0,7,7,9,7,30
1911171052,1,4,3,9,0,17
1911171053,2,2,3,4,8,19
1911171054,2,7,0,3,2,14
1911171055,2,2,6,0,5,15
1911171056,0,6,1,7,0,14
1911171057,7,4,6,4,6,27
1911171058,9,9,9,7,6,40
1911171059,4,7,6,2,5,24
1911171060,0,6,5,0,6,17
1911171061,8,6,0,7,1,22
1911171062,5,1,1,5,5,17
1911171063,7,1,9,4,9,30
1911171064,1,7,8,1,4,21
1911171065,0,2,6,2,1,11
1911171066,2,1,9,4,3,19
1911171067,1,1,5,8,9,24
1911171068,7,7,5,3,7,29
1911171069,4,2,2,7,7,22
1911171070,8,4,2,9,9,32
1911171071,9,5,1,0,8,23
1911171072,0,2,8,2,3,15
1911171073,0,9,1,5,7,22
1911171074,0,0,7,3,2,12
1911171075,9,5,3,3,2,22
1911171076,5,9,6,5,9,34
1911171077,4,5,2,6,3,20
1911171078,8,3,3,6,1,21
1911171079,2,1,9,6,6,24
1911171080,4,8,2,7,7,28
1911171081,6,6,9,4,8,33
1911171082,9,8,4,6,0,27
1911171083,5,0,1,4,3,13
1911171084,7,0,1,4,1,13
1911171085,8,3,1,0,2,14
1911171086,7,7,1,5,1,21
1911171087,5,0,0,2,3,10
1911171088,8,4,9,0,8,29
1911171089,3,6,6,2,8,25
1911171090,2,7,1,8,8,26
1911171091,8,8,6,1,8,31
1911171092,6,2,5,3,9,25
1911171093,3,5,0,6,4,18
1911171094,6,3,8,2,9,28
1911171095,7,5,3,0,8,23
1911171096,0,1,2,7,9,19
1911171097,8,0,0,2,0,10
1911171098,6,8,3,7,0,24
1911171099,0,8,6,7,8,29
1911171100,0,4,8,5,4,21
1911171101,9,7,0,5,3,24
1911171102,1,4,7,0,4,16
1911171103,4,0,7,0,9,20
1911171104,7,1,9,7,4,28
1911171105,3,6,5,7,2,23
191118001,4,5,0,8,8,25
191118002,5,6,7,2,9,29
191118003,5,7,1,5,2,20
191118004,7,0,8,3,9,27
191118005,0,2,5,5,2,14
191118006,5,3,1,2,3,14
191118007,7,1,2,4,7,21
191118008,1,5,0,5,0,11
191118009,3,5,7,6,3,24
191118010,9,5,4,1,9,28
191118011,4,1,0,9,9,23
191118012,3,7,7,6,8,31
191118013,5,2,6,4,1,18
191118014,1,7,4,3,5,20
191118015,0,9,4,4,5,22
191118016,7,1,4,0,3,15
191118017,5,8,7,0,9,29
191118018,0,5,8,6,7,26
191118019,0,5,6,3,1,15
191118020,1,1,2,1,8,13
191118021,7,4,1,0,9,21
191118022,8,0,5,5,0,18
191118023,1,2,6,3,6,18
191118024,2,1,5,3,5,16
191118025,8,9,1,8,4,30
191118026,4,0,9,6,5,24
191118027,0,8,2,9,9,28
191118028,6,2,0,3,0,11
191118029,8,0,4,9,0,21
191118030,9,5,2,7,7,30
191118031,2,0,3,5,4,14
191118032,8,0,9,2,2,21
191118033,8,6,0,7,3,24
191118034,2,7,4,0,8,21
191118035,0,1,6,0,8,15
191118036,8,8,9,2,7,34
191118037,1,3,8,5,2,19
191118038,2,8,8,2,3,23
191118039,8,1,3,4,6,22
191118040,5,5,6,6,9,31
191118041,1,2,3,3,4,13
191118042,7,4,8,1,8,28
191118043,5,1,8,1,5,20
191118044,4,2,1,2,7,16
191118045,9,3,4,7,6,29
191118046,7,8,7,0,8,30
191118047,0,8,2,8,2,20
191118048,2,6,9,1,8,26
191118049,3,6,2,6,7,24
191118050,7,8,2,2,9,28
191118051,9,8,9,4,3,33
191118052,1,7,0,2,0,10
191118053,7,5,2,6,3,23
191118054,7,7,7,1,8,30
191118055,0,1,7,7,6,21
191118056,0,5,4,8,0,17
191118057,9,3,0,3,7,22
191118058,7,7,1,4,5,24
191118059,2,2,7,8,2,21
191118060,7,2,0,7,9,25
191118061,4,0,8,5,1,18
191118062,4,1,6,1,2,14
191118063,1,9,2,0,4,16
191118064,0,8,5,1,5,19
191118065,5,7,2,0,6,20
191118066,0,6,9,6,4,25
191118067,2,9,3,8,2,24
191118068,3,4,3,7,6,23
191118069,5,4,2,9,8,28
191118070,5,4,5,6,5,25
191118071,6,6,7,6,3,28
191118072,7,8,4,5,9,33
191118073,8,5,9,6,3,31
191118074,9,5,1,0,7,22
191118075,5,7,5,7,3,27
191118076,9,7,6,4,2,28
191118077,2,8,5,5,3,23
191118078,4,4,3,2,9,22
191118079,1,0,8,9,3,21
191118080,9,5,3,9,1,27
191118081,7,5,5,5,6,28
191118082,1,3,9,1,4,18
191118083,8,2,1,2,0,13
191118084,3,3,5,6,0,17
191118085,6,9,8,6,6,35
191118086,5,1,8,5,6,25
191118087,7,1,3,6,2,19
191118088,8,5,9,5,5,32
191118089,1,0,0,9,5,15
191118090,2,9,9,7,4,31
191118091,0,3,7,2,5,17
191118092,4,5,0,8,3,20
191118093,8,4,7,7,3,29
191118094,2,2,5,2,0,11
191118095,6,7,6,4,2,25
191118096,0,6,3,3,0,12
191118097,2,0,9,3,7,21
191118098,1,3,5,3,7,19
191118099,8,6,4,9,0,27
191118100,1,8,0,1,7,17
191118101,2,9,0,3,2,16
191118102,5,6,3,5,3,22
191118103,5,2,2,9,6,24
191118104,7,2,7,3,8,27
191118105,5,9,2,5,7,28
191118106,7,6,3,0,2,18
191118107,6,6,6,8,5,31
191118108,9,1,8,6,7,31
191118109,5,7,3,4,8,27
191118110,4,4,9,6,6,29
191118111,0,3,3,3,3,12
191118112,3,4,6,2,1,16
191118113,8,9,0,3,1,21
191118114,1,0,9,3,1,14
191118115,3,0,8,6,0,17
191118116,3,6,9,6,2,26
191118117,5,5,0,9,4,23
191118118,5,3,3,8,2,21
191118119,6,7,1,4,7,25
191118120,4,2,5,2,8,21
191118121,5,6,6,6,6,29
191118122,8,7,8,6,6,35
191118123,8,0,2,3,7,20
191118124,8,6,0,6,3,23
191118125,4,6,6,2,3,21
191118126,7,2,7,4,3,23
191118127,2,6,4,3,0,15
191118128,4,2,7,5,2,20
191118129,1,7,8,7,1,24
191118130,1,1,5,6,6,19
191118131,4,5,6,7,3,25
191118132,0,3,5,2,9,19
191118133,4,4,2,4,4,18
191118134,0,4,9,1,0,14
191118135,9,5,5,5,0,24
191118136,1,6,4,8,2,21
191118137,1,8,3,9,1,22
191118138,1,1,9,0,9,20
191118139,0,8,2,5,9,24
191118140,1,9,8,3,7,28
191118141,4,8,1,7,7,27
191118142,0,7,2,2,6,17
191118143,0,9,0,1,7,17
191118144,7,2,8,8,7,32
191118145,7,5,9,5,1,27
191118146,9,5,9,2,4,29
191118147,2,7,3,7,4,23
191118148,7,4,8,4,8,31
191118149,2,9,5,3,8,27
191118150,2,6,2,3,3,16
191118151,4,4,3,0,3,14
191118152,4,9,9,2,5,29
191118153,1,5,2,9,0,17
191118154,4,9,5,0,2,20
191118155,7,6,0,3,4,20
191118156,0,2,5,1,6,14
191118157,4,7,6,7,7,31
191118158,3,8,0,1,6,18
191118159,9,7,6,8,2,32
191118160,6,2,0,1,2,11
191118161,2,5,6,2,3,18
191118162,9,8,9,6,2,34
191118163,9,8,7,8,9,41
191118164,8,8,7,1,9,33
191118165,3,9,1,2,8,23
191118166,8,5,9,9,6,37
191118167,0,5,8,5,0,18
191118168,4,2,9,3,7,25
191118169,0,2,0,6,3,11
191118170,2,7,1,0,5,15
191118171,3,6,4,2,9,24
191118172,4,3,5,1,0,13
191118173,9,4,7,1,9,30
191118174,1,2,2,7,2,14
191118175,4,3,9,8,6,30
191118176,6,5,8,8,4,31
191118177,3,7,5,0,7,22
191118178,3,8,0,3,4,18
191118179,5,7,3,8,0,23
191118180,0,4,0,2,7,13
191118181,5,9,5,4,9,32
191118182,3,4,5,4,7,23
191118183,8,0,2,8,1,19
191118184,1,3,7,5,3,19
191118185,6,4,5,2,4,21
191118186,0,0,4,2,7,13
191118187,1,8,1,1,8,19
191118188,1,4,9,7,4,25
191118189,8,2,6,4,7,27
191118190,4,2,4,8,9,27
191118191,9,4,0,5,6,24
191118192,4,7,9,1,2,23
191118193,6,8,8,3,6,31
191118194,2,9,5,4,6,26
191118195,9,1,5,9,0,24
191118196,6,7,9,8,7,37
191118197,2,3,9,0,1,15
191118198,7,4,3,0,3,17
191118199,3,8,6,7,2,26
191118200,2,9,6,2,7,26
191118201,5,0,5,0,3,13
191118202,7,0,0,8,9,24
191118203,7,1,8,8,5,29
191118204,7,2,6,5,7,27
191118205,1,1,6,7,4,19
191118206,3,6,5,7,8,29
191118207,4,0,4,7,6,21
191118208,5,7,5,3,6,26
191118209,6,4,0,9,0,19
191118210,6,6,0,5,3,20
191118211,2,7,4,9,1,23
191118212,1,9,8,2,6,26
191118213,4,6,4,8,4,26
191118214,6,9,1,6,8,30
191118215,4,3,1,3,5,16
191118216,5,4,9,3,3,24
191118217,2,7,0,3,8,20
191118218,3,8,6,7,5,29
191118219,8,1,2,8,0,19
191118220,4,0,7,2,6,19
191118221,6,3,9,9,4,31
191118222,5,3,4,1,2,15
191118223,3,6,2,1,6,18
191118224,3,6,9,4,7,29
191118225,1,2,4,8,2,17
191118226,8,9,5,7,6,35
191118227,6,3,3,5,4,21
191118228,3,8,9,3,4,27
191118229,3,2,6,0,6,17
191118230,9,3,5,8,9,34
191118231,0,5,6,4,4,19
191118232,7,0,1,0,3,11
191118233,5,0,7,9,8,29
191118234,8,1,6,9,2,26
191118235,4,9,7,0,1,21
191118236,2,1,8,3,9,23
191118237,1,7,8,3,8,27
191118238,1,6,3,0,3,13
191118239,6,7,6,9,2,30
191118240,2,6,5,7,6,26
191118241,4,0,1,6,1,12
191118242,1,8,7,8,2,26
191118243,8,8,5,2,7,30
191118244,6,1,8,9,2,26
191118245,4,6,6,7,9,32
191118246,4,7,5,9,2,27
191118247,9,0,6,3,5,23
191118248,2,7,1,9,1,20
191118249,1,9,0,9,0,19
191118250,7,9,1,0,8,25
191118251,6,7,6,6,2,27
191118252,4,5,4,3,9,25
191118253,5,6,0,2,7,20
191118254,0,7,8,2,4,21
191118255,6,7,3,5,4,25
191118256,0,0,3,7,8,18
191118257,9,7,8,3,2,29
191118258,7,7,5,7,7,33
191118259,9,6,7,4,5,31
191118260,2,9,3,6,4,24
191118261,9,7,4,0,9,29
191118262,2,6,8,8,3,27
191118263,8,0,2,4,8,22
191118264,1,1,7,5,4,18
191118265,0,9,5,7,7,28
191118266,9,2,5,0,6,22
191118267,8,8,3,7,9,35
191118268,6,1,3,5,4,19
191118269,6,9,2,3,7,27
191118270,5,3,9,9,4,30
191118271,8,9,0,5,7,29
191118272,2,6,9,0,4,21
191118273,4,1,6,0,3,14
191118274,7,7,5,4,1,24
191118275,8,9,8,6,5,36
191118276,6,0,9,5,6,26
191118277,0,2,7,2,2,13
191118278,1,7,3,5,9,25
191118279,2,8,4,7,0,21
191118280,1,7,3,9,6,26
191118281,6,4,0,3,4,17
191118282,0,6,6,2,9,23
191118283,9,5,6,3,3,26
191118284,4,3,6,0,7,20
191118285,7,5,9,6,4,31
191118286,2,5,9,9,2,27
191118287,1,6,0,9,7,23
191118288,3,6,3,4,3,19
191118289,2,7,3,3,4,19
191118290,7,0,8,9,2,26
191118291,9,3,3,4,1,20
191118292,8,7,3,2,2,22
191118293,9,9,9,7,8,42
191118294,6,1,5,5,3,20
191118295,2,8,4,7,6,27
191118296,5,1,2,5,9,22
191118297,4,0,6,4,5,19
191118298,4,8,1,8,8,29
191118299,0,4,2,5,0,11
191118300,3,5,2,2,9,21
191118301,8,5,7,7,2,29
191118302,0,2,5,7,0,14
191118303,2,4,9,1,7,23
191118304,2,0,2,7,2,13
191118305,1,0,2,0,7,10
191118306,3,5,7,2,9,26
191118307,7,4,4,2,1,18
191118308,6,2,4,8,5,25
191118309,3,8,4,7,0,22
191118310,7,1,5,0,2,15
191118311,1,2,8,1,9,21
191118312,0,9,7,8,2,26
191118313,7,9,7,6,6,35
191118314,8,0,2,5,9,24
191118315,6,7,3,9,0,25
191118316,2,7,9,8,2,28
191118317,6,7,7,1,2,23
191118318,0,3,2,2,5,12
191118319,2,1,3,7,8,21
191118320,7,3,8,5,0,23
191118321,0,4,9,2,3,18
191118322,8,9,6,8,4,35
191118323,1,4,8,7,2,22
191118324,6,3,1,0,9,19
191118325,5,4,3,4,2,18
191118326,7,1,5,7,0,20
191118327,8,1,4,2,6,21
191118328,5,0,2,6,2,15
191118329,1,0,7,2,1,11
191118330,7,9,7,7,1,31
191118331,5,7,0,9,1,22
191118332,8,3,5,0,8,24
191118333,8,9,4,4,2,27
191118334,1,4,9,7,3,24
191118335,7,9,0,1,6,23
191118336,4,7,4,6,5,26
191118337,8,5,4,2,3,22
191118338,5,6,2,8,5,26
191118339,3,4,6,6,6,25
191118340,2,4,9,6,8,29
191118341,0,8,0,7,7,22
191118342,5,8,1,4,4,22
191118343,1,8,4,7,9,29
191118344,7,3,0,4,2,16
191118345,3,9,5,8,8,33
191118346,7,7,9,9,3,35
191118347,6,2,8,0,3,19
191118348,5,4,6,7,8,30
191118349,9,4,6,4,3,26
191118350,2,2,9,9,0,22
191118351,2,1,4,7,2,16
191118352,8,3,4,0,3,18
191118353,6,3,6,7,3,25
191118354,3,1,0,5,1,10
191118355,0,8,5,1,6,20
191118356,0,3,8,9,9,29
191118357,9,1,3,7,2,22
191118358,1,7,6,7,5,26
191118359,6,3,1,7,9,26
191118360,1,0,9,5,6,21
191118361,7,5,1,0,5,18
191118362,3,6,3,9,1,22
191118363,0,1,2,3,3,9
191118364,6,8,8,8,3,33
191118365,6,5,8,2,7,28
191118366,3,5,3,4,6,21
191118367,4,9,0,9,1,23
191118368,7,7,1,2,1,18
191118369,0,0,6,9,3,18
191118370,8,3,0,7,1,19
191118371,9,1,7,1,3,21
191118372,4,7,3,9,8,31
191118373,8,6,4,0,4,22
191118374,0,9,7,6,3,25
191118375,4,3,7,1,6,21
191118376,8,4,8,5,7,32
191118377,6,2,5,7,4,24
191118378,8,2,9,1,9,29
191118379,9,8,2,0,9,28
191118380,2,2,5,4,4,17
191118381,4,5,9,8,7,33
191118382,7,5,0,9,6,27
191118383,1,6,9,6,9,31
191118384,9,2,9,6,4,30
191118385,8,1,5,7,3,24
191118386,1,7,2,0,5,15
191118387,3,9,6,0,6,24
191118388,4,3,5,5,5,22
191118389,7,0,1,3,2,13
191118390,1,2,0,0,1,4
191118391,6,8,4,1,5,24
191118392,6,1,6,3,2,18
191118393,5,4,5,8,4,26
191118394,0,8,5,4,6,23
191118395,8,0,8,1,1,18
191118396,9,3,2,7,6,27
191118397,9,9,0,1,1,20
191118398,3,8,5,4,0,20
191118399,0,1,3,8,1,13
191118400,0,4,2,0,5,11
191118401,7,8,3,4,9,31
191118402,6,8,9,9,7,39
191118403,2,4,4,3,5,18
191118404,3,9,6,9,6,33
191118405,2,2,2,1,3,10
191118406,7,4,5,8,8,32
191118407,8,2,1,0,0,11
191118408,2,6,9,5,6,28
191118409,4,9,2,5,7,27
191118410,4,6,1,3,0,14
191118411,9,2,1,9,6,27
191118412,1,7,5,9,6,28
191118413,4,8,1,9,0,22
191118414,6,0,4,9,8,27
191118415,5,6,4,1,7,23
191118416,1,0,4,3,3,11
191118417,0,2,4,1,5,12
191118418,8,1,8,0,2,19
191118419,1,2,3,5,1,12
191118420,5,8,5,5,2,25
191118421,3,7,5,8,3,26
191118422,0,0,5,6,3,14
191118423,0,5,2,1,2,10
191118424,9,2,5,6,2,24
191118425,5,7,1,2,8,23
191118426,0,0,2,6,7,15
191118427,2,1,4,5,2,14
191118428,4,8,5,3,4,24
191118429,9,8,4,5,1,27
191118430,1,4,4,9,5,23
191118431,2,8,5,1,5,21
191118432,3,3,6,0,9,21
191118433,5,6,4,0,7,22
191118434,8,1,0,7,1,17
191118435,3,0,9,4,3,19
191118436,1,2,9,3,4,19
191118437,2,0,4,7,3,16
191118438,5,9,4,8,6,32
191118439,7,8,4,1,6,26
191118440,3,9,4,6,9,31
191118441,0,9,2,9,2,22
191118442,0,7,1,2,1,11
191118443,2,0,5,2,6,15
191118444,7,8,2,5,9,31
191118445,0,3,1,6,1,11
191118446,0,6,2,5,0,13
191118447,9,6,7,4,2,28
191118448,5,1,0,2,1,9
191118449,7,6,5,0,7,25
191118450,3,9,9,2,0,23
191118451,8,4,4,9,7,32
191118452,9,2,2,4,3,20
191118453,9,5,4,5,6,29
191118454,6,1,3,2,5,17
191118455,2,1,0,6,0,9
191118456,2,9,6,1,4,22
191118457,9,1,9,3,1,23
191118458,1,5,5,8,2,21
191118459,3,4,5,2,9,23
191118460,7,1,4,6,0,18
191118461,9,1,2,6,1,19
191118462,9,5,8,6,2,30
191118463,8,6,6,9,4,33
191118464,2,2,5,5,2,16
191118465,6,4,5,4,4,23
191118466,8,4,1,2,1,16
191118467,2,2,4,9,8,25
191118468,5,7,1,3,2,18
191118469,4,5,8,8,6,31
191118470,9,1,2,4,1,17
191118471,5,8,3,9,5,30
191118472,6,4,0,2,1,13
191118473,4,0,4,6,9,23
191118474,8,1,3,6,2,20
191118475,3,8,1,2,1,15
191118476,8,4,1,1,9,23
191118477,8,3,0,4,3,18
191118478,3,9,8,9,1,30
191118479,7,3,4,4,7,25
191118480,3,2,0,2,7,14
191118481,7,5,2,5,9,28
191118482,7,0,3,5,4,19
191118483,3,7,7,1,1,19
191118484,0,3,7,4,0,14
191118485,8,9,4,9,9,39
191118486,5,2,1,0,4,12
191118487,9,1,4,5,0,19
191118488,1,6,8,8,2,25
191118489,4,2,6,3,2,17
191118490,8,2,3,0,0,13
191118491,3,0,4,1,7,15
191118492,2,9,2,8,6,27
191118493,7,1,6,0,1,15
191118494,8,6,9,0,4,27
191118495,6,6,5,4,0,21
191118496,9,7,7,2,2,27
191118497,1,4,2,6,5,18
191118498,3,7,5,2,6,23
191118499,8,8,0,7,2,25
191118500,1,4,2,9,5,21
191118501,5,7,8,0,2,22
191118502,1,9,3,1,3,17
191118503,4,3,5,7,5,24
191118504,8,9,0,6,8,31
191118505,1,7,7,5,2,22
191118506,0,1,2,5,5,13
191118507,1,4,5,6,2,18
191118508,7,2,8,9,6,32
191118509,4,8,4,6,6,28
191118510,2,1,2,6,7,18
191118511,5,0,0,4,8,17
191118512,4,4,1,0,7,16
191118513,5,9,0,3,4,21
191118514,4,8,1,9,3,25
191118515,1,9,1,8,9,28
191118516,2,6,6,8,5,27
191118517,6,0,9,3,1,19
191118518,1,5,2,6,5,19
191118519,5,1,7,3,1,17
191118520,2,2,2,6,5,17
191118521,1,4,5,0,1,11
191118522,8,7,1,7,3,26
191118523,3,4,9,3,0,19
191118524,0,3,8,4,5,20
191118525,7,1,5,4,9,26
191118526,8,9,6,4,5,32
191118527,2,1,5,5,3,16
191118528,2,3,8,8,9,30
191118529,8,9,5,3,9,34
191118530,0,9,8,4,6,27
191118531,8,7,6,8,0,29
191118532,3,8,0,9,2,22
191118533,1,3,3,2,6,15
191118534,1,3,8,0,2,14
191118535,9,4,7,5,6,31
191118536,1,1,2,4,2,10
191118537,3,7,5,1,2,18
191118538,1,6,5,1,6,19
191118539,7,2,8,7,5,29
191118540,3,8,8,4,5,28
191118541,1,8,4,0,2,15
191118542,3,2,3,3,9,20
191118543,3,2,9,1,4,19
191118544,1,9,3,5,2,20
191118545,3,4,5,3,5,20
191118546,2,0,2,5,9,18
191118547,6,9,0,0,2,17
191118548,8,5,8,4,1,26
191118549,9,3,7,9,2,30
191118550,5,7,2,4,3,21
191118551,2,8,8,6,6,30
191118552,8,0,6,8,9,31
191118553,3,6,5,2,6,22
191118554,7,8,1,8,8,32
191118555,0,0,7,9,1,17
191118556,8,0,3,3,5,19
191118557,3,5,1,5,0,14
191118558,7,7,9,5,4,32
191118559,4,9,0,0,5,18
191118560,2,8,8,2,8,28
191118561,0,2,4,1,8,15
191118562,1,7,4,1,1,14
191118563,4,6,5,3,7,25
191118564,9,6,8,9,0,32
191118565,1,4,3,2,4,14
191118566,6,7,8,1,6,28
191118567,4,0,3,7,1,15
191118568,0,0,5,1,9,15
191118569,8,6,0,4,6,24
191118570,3,6,0,3,1,13
191118571,6,2,5,2,3,18
191118572,1,7,9,8,5,30
191118573,8,3,2,5,3,21
191118574,7,9,1,3,0,20
191118575,6,7,0,1,1,15
191118576,7,2,7,8,9,33
191118577,7,4,7,5,6,29
191118578,3,9,0,9,5,26
191118579,9,3,6,1,8,27
191118580,1,0,0,8,0,9
191118581,4,2,1,3,4,14
191118582,1,4,2,9,4,20
191118583,9,1,7,9,9,35
191118584,7,7,5,3,4,26
191118585,8,8,2,4,5,27
191118586,4,9,9,7,7,36
191118587,7,6,2,1,6,22
191118588,7,7,3,2,8,27
191118589,1,2,6,3,2,14
191118590,5,1,5,8,3,22
191118591,6,8,2,2,4,22
191118592,5,0,0,1,0,6
191118593,1,8,0,5,4,18
191118594,4,1,7,8,2,22
191118595,1,9,1,0,8,19
191118596,5,5,7,8,0,25
191118597,4,9,0,6,9,28
191118598,2,3,7,4,6,22
191118599,8,3,9,0,5,25
191118600,7,6,3,7,6,29
191118601,4,7,3,6,7,27
191118602,0,7,9,0,5,21
191118603,9,0,9,6,9,33
191118604,8,6,5,1,4,24
191118605,0,9,4,2,2,17
191118606,8,5,4,5,6,28
191118607,8,6,6,5,5,30
191118608,5,3,4,3,8,23
191118609,6,8,9,5,7,35
191118610,8,2,3,4,5,22
191118611,8,6,2,3,9,28
191118612,3,3,3,9,1,19
191118613,6,6,5,3,3,23
191118614,9,3,4,3,5,24
191118615,5,3,2,3,3,16
191118616,4,6,2,7,8,27
191118617,7,5,1,0,3,16
191118618,5,7,3,1,0,16
191118619,5,2,6,2,4,19
191118620,4,6,2,4,1,17
191118621,9,7,7,2,7,32
191118622,6,7,0,3,4,20
191118623,4,7,3,2,4,20
191118624,4,5,8,6,0,23
191118625,1,1,0,6,4,12
191118626,8,3,6,6,2,25
191118627,1,2,4,7,5,19
191118628,0,6,6,7,0,19
191118629,6,0,4,7,0,17
191118630,7,5,3,9,0,24
191118631,8,1,9,5,9,32
191118632,1,3,0,5,7,16
191118633,7,8,2,5,2,24
191118634,1,4,7,7,4,23
191118635,4,9,8,5,7,33
191118636,8,9,0,7,7,31
191118637,3,1,7,1,3,15
191118638,2,7,4,9,2,24
191118639,8,5,1,7,3,24
191118640,7,9,0,6,8,30
191118641,7,3,7,7,6,30
191118642,8,6,5,1,0,20
191118643,6,5,3,5,9,28
191118644,2,2,9,8,7,28
191118645,2,5,6,1,0,14
191118646,2,8,6,7,1,24
191118647,3,5,7,3,7,25
191118648,1,4,9,5,0,19
191118649,7,3,2,3,8,23
191118650,1,4,3,8,8,24
191118651,6,7,3,8,9,33
191118652,7,6,3,0,3,19
191118653,1,7,6,4,5,23
191118654,2,4,1,0,1,8
191118655,5,1,1,2,4,13
191118656,8,7,6,5,2,28
191118657,9,8,7,3,6,33
191118658,3,9,9,7,1,29
191118659,0,1,6,8,7,22
191118660,3,0,7,1,2,13
191118661,2,9,5,2,6,24
191118662,5,0,0,6,4,15
191118663,5,5,0,4,9,23
191118664,4,4,2,1,4,15
191118665,3,3,6,5,9,26
191118666,2,4,9,3,6,24
191118667,1,5,9,7,9,31
191118668,9,3,0,1,6,19
191118669,1,0,6,0,9,16
191118670,2,5,7,8,4,26
191118671,1,6,2,0,8,17
191118672,8,4,8,1,0,21
191118673,2,2,8,0,0,12
191118674,6,7,1,7,4,25
191118675,1,1,1,2,0,5
191118676,2,1,3,3,1,10
191118677,0,6,0,1,8,15
191118678,2,9,6,7,5,29
191118679,5,4,1,8,7,25
191118680,2,6,7,4,5,24
191118681,5,5,7,6,6,29
191118682,7,3,1,6,2,19
191118683,7,6,4,4,8,29
191118684,8,0,0,8,2,18
191118685,2,1,9,2,0,14
191118686,2,2,4,6,6,20
191118687,9,9,2,0,7,27
191118688,3,1,1,2,8,15
191118689,0,8,7,6,9,30
191118690,6,9,9,3,8,35
191118691,9,9,9,2,4,33
191118692,1,8,1,6,1,17
191118693,1,0,5,5,0,11
191118694,3,5,6,8,1,23
191118695,3,9,2,0,2,16
191118696,5,3,9,6,9,32
191118697,5,8,6,5,4,28
191118698,2,9,6,2,3,22
191118699,3,2,2,9,1,17
191118700,3,6,1,8,0,18
191118701,2,0,8,8,6,24
191118702,2,2,5,6,3,18
191118703,6,5,7,4,1,23
191118704,8,4,8,0,1,21
191118705,9,7,1,6,4,27
191118706,9,7,6,4,3,29
191118707,2,6,9,9,5,31
191118708,1,4,0,9,4,18
191118709,4,9,4,0,7,24
191118710,3,2,0,5,5,15
191118711,9,6,1,9,5,30
191118712,6,5,1,1,4,17
191118713,5,7,9,6,7,34
191118714,4,0,5,3,8,20
191118715,9,3,8,6,2,28
191118716,8,4,0,2,1,15
191118717,7,8,0,1,5,21
191118718,4,0,2,6,5,17
191118719,7,4,9,2,6,28
191118720,3,4,9,9,6,31
191118721,4,1,4,9,9,27
191118722,0,7,4,1,5,17
191118723,8,6,3,1,7,25
191118724,5,2,3,1,4,15
191118725,1,8,6,4,1,20
191118726,6,6,3,6,0,21
191118727,2,3,5,6,9,25
191118728,4,0,4,9,8,25
191118729,5,3,6,6,8,28
191118730,6,4,3,4,2,19
191118731,0,1,9,9,6,25
191118732,5,2,6,0,4,17
191118733,0,6,5,3,8,22
191118734,6,1,1,3,4,15
191118735,0,4,3,8,4,19
191118736,4,1,8,6,3,22
191118737,4,7,9,5,7,32
191118738,1,9,3,5,8,26
191118739,5,4,0,5,8,22
191118740,2,5,5,0,1,13
191118741,4,6,7,0,5,22
191118742,1,5,3,3,3,15
191118743,9,5,0,3,0,17
191118744,9,7,2,2,0,20
191118745,1,6,6,8,6,27
191118746,3,4,5,1,8,21
191118747,8,7,1,3,7,26
191118748,3,6,0,8,3,20
191118749,0,8,3,6,0,17
191118750,2,3,3,3,4,15
191118751,1,5,0,9,0,15
191118752,6,3,0,7,6,22
191118753,3,1,4,1,6,15
191118754,7,4,3,5,3,22
191118755,6,1,7,6,4,24
191118756,5,9,9,1,3,27
191118757,7,1,9,4,5,26
191118758,6,2,2,1,4,15
191118759,3,0,1,9,6,19
191118760,6,5,4,4,6,25
191118761,2,8,6,3,6,25
191118762,2,3,5,5,2,17
191118763,6,1,6,1,2,16
191118764,1,7,1,0,3,12
191118765,1,0,6,9,2,18
191118766,6,9,8,5,2,30
191118767,0,9,7,6,5,27
191118768,8,6,4,8,6,32
191118769,6,9,7,2,2,26
191118770,1,6,6,2,1,16
191118771,3,4,6,2,3,18
191118772,3,3,5,9,8,28
191118773,7,0,5,4,2,18
191118774,8,5,0,0,5,18
191118775,2,7,4,6,8,27
191118776,0,9,4,9,3,25
191118777,7,4,1,4,4,20
191118778,5,8,2,1,7,23
191118779,6,9,6,2,5,28
191118780,2,9,8,8,6,33
191118781,8,0,1,0,4,13
191118782,2,2,6,3,2,15
191118783,2,0,6,6,6,20
191118784,8,0,7,3,5,23
191118785,7,0,2,4,9,22
191118786,0,5,6,2,6,19
191118787,2,7,9,6,5,29
191118788,5,6,4,9,5,29
191118789,6,4,9,8,9,36
191118790,1,2,0,4,1,8
191118791,6,1,3,9,0,19
191118792,0,2,9,4,5,20
191118793,3,4,5,5,6,23
191118794,1,6,0,0,4,11
191118795,0,7,9,8,3,27
191118796,9,9,6,4,0,28
191118797,6,7,9,0,1,23
191118798,7,3,8,6,1,25
191118799,3,8,3,7,2,23
191118800,3,8,2,5,2,20
191118801,0,1,4,7,9,21
191118802,8,7,2,9,1,27
191118803,0,8,5,3,2,18
191118804,4,7,1,8,4,24
191118805,4,1,0,7,0,12
191118806,0,7,9,4,4,24
191118807,6,2,0,9,1,18
191118808,8,1,7,3,5,24
191118809,4,9,6,4,8,31
191118810,2,2,8,3,2,17
191118811,0,0,7,7,8,22
191118812,2,2,6,8,6,24
191118813,5,1,9,8,6,29
191118814,4,0,5,8,9,26
191118815,2,8,4,3,2,19
191118816,7,5,3,8,8,31
191118817,1,3,7,4,6,21
191118818,2,8,4,7,4,25
191118819,3,8,6,2,4,23
191118820,3,2,9,8,7,29
191118821,2,6,8,7,9,32
191118822,1,0,3,7,4,15
191118823,8,6,0,1,6,21
191118824,9,5,2,0,4,20
191118825,7,4,8,5,7,31
191118826,7,7,9,8,0,31
191118827,4,1,2,1,2,10
191118828,7,6,0,6,8,27
191118829,8,9,8,8,0,33
191118830,8,1,2,8,7,26
191118831,6,9,9,7,2,33
191118832,1,5,8,8,5,27
191118833,6,3,8,3,4,24
191118834,8,4,6,4,1,23
191118835,0,0,9,5,8,22
191118836,7,5,5,1,7,25
191118837,9,5,6,9,4,33
191118838,3,4,0,4,0,11
191118839,8,1,8,9,5,31
191118840,7,6,0,2,7,22
191118841,1,5,8,2,3,19
191118842,7,3,8,6,0,24
191118843,2,2,8,0,3,15
191118844,3,0,2,4,0,9
191118845,4,8,9,9,9,39
191118846,7,2,0,6,6,21
191118847,9,1,7,7,4,28
191118848,6,2,6,8,3,25
191118849,0,8,0,0,8,16
191118850,5,9,8,1,8,31
191118851,0,0,6,5,3,14
191118852,5,0,3,9,0,17
191118853,6,7,0,2,3,18
191118854,2,7,9,5,8,31
191118855,7,7,9,2,3,28
191118856,8,2,2,9,3,24
191118857,8,0,7,3,9,27
191118858,9,7,1,7,0,24
191118859,3,1,0,3,2,9
191118860,8,7,1,4,4,24
191118861,4,6,1,1,3,15
191118862,3,3,8,2,2,18
191118863,3,0,8,6,5,22
191118864,0,9,9,1,4,23
191118865,9,5,9,7,3,33
191118866,9,5,6,0,0,20
191118867,6,6,8,7,2,29
191118868,2,0,0,7,1,10
191118869,1,7,4,2,9,23
191118870,9,5,8,2,2,26
191118871,1,2,5,5,1,14
191118872,3,0,3,9,8,23
191118873,3,0,8,2,9,22
191118874,0,6,9,7,7,29
191118875,1,5,8,4,4,22
191118876,8,0,5,3,0,16
191118877,6,6,5,9,0,26
191118878,0,0,8,1,8,17
191118879,2,1,7,5,2,17
191118880,9,8,9,6,9,41
191118881,1,0,4,9,9,23
191118882,8,9,0,1,1,19
191118883,4,8,8,1,4,25
191118884,3,1,6,5,4,19
191118885,5,1,1,5,9,21
191118886,8,9,7,4,2,30
191118887,2,2,8,2,2,16
191118888,1,7,4,5,3,20
191118889,4,8,8,2,1,23
191118890,0,0,4,5,9,18
191118891,4,4,0,5,8,21
191118892,4,5,5,7,9,30
191118893,7,0,0,7,8,22
191118894,9,0,6,1,1,17
191118895,4,9,6,7,5,31
191118896,4,6,3,9,4,26
191118897,8,1,0,4,4,17
191118898,2,8,3,1,4,18
191118899,4,1,8,2,0,15
191118900,8,9,3,4,8,32
191118901,8,8,1,1,4,22
191118902,7,0,6,3,9,25
191118903,3,2,2,7,7,21
191118904,4,6,2,4,3,19
191118905,4,0,4,1,2,11
191118906,2,4,6,8,5,25
191118907,2,7,9,3,5,26
191118908,4,4,7,2,4,21
191118909,3,8,9,7,2,29
191118910,2,7,7,4,0,20
191118911,2,2,1,4,9,18
191118912,9,2,2,9,5,27
191118913,5,7,5,3,1,21
191118914,4,4,9,0,1,18
191118915,7,9,5,9,1,31
191118916,7,0,2,2,3,14
191118917,5,3,5,8,0,21
191118918,3,4,2,8,1,18
191118919,7,1,6,7,5,26
191118920,7,6,1,8,7,29
191118921,5,4,4,6,8,27
191118922,7,9,9,4,6,35
191118923,9,3,0,8,6,26
191118924,1,0,8,4,2,15
191118925,1,2,1,6,3,13
191118926,6,3,7,5,0,21
191118927,7,0,5,5,2,19
191118928,9,4,0,0,4,17
191118929,1,7,1,9,1,19
191118930,2,2,8,2,4,18
191118931,6,5,4,6,7,28
191118932,1,1,2,5,7,16
191118933,3,0,3,1,6,13
191118934,5,9,7,5,9,35
191118935,0,3,2,3,8,16
191118936,7,1,3,9,5,25
191118937,8,8,1,1,3,21
191118938,1,8,3,1,8,21
191118939,2,1,7,3,9,22
191118940,5,5,1,6,6,23
191118941,8,4,6,0,1,19
191118942,4,5,7,7,4,27
191118943,3,9,3,8,4,27
191118944,3,3,2,2,5,15
191118945,1,2,1,7,6,17
191118946,2,4,4,7,5,22
191118947,3,3,1,5,4,16
191118948,0,7,4,5,2,18
191118949,4,9,3,0,4,20
191118950,0,8,7,9,4,28
191118951,1,9,2,7,9,28
191118952,4,3,2,8,1,18
191118953,1,1,3,9,7,21
191118954,2,9,6,8,2,27
191118955,5,5,8,8,7,33
191118956,0,4,2,5,9,20
191118957,1,5,2,8,5,21
191118958,1,0,5,5,8,19
191118959,2,7,6,1,2,18
191118960,2,8,0,6,2,18
191118961,2,7,5,1,9,24
191118962,7,9,5,9,9,39
191118963,2,7,7,0,3,19
191118964,5,9,4,9,2,29
191118965,1,7,6,4,8,26
191118966,8,7,3,6,5,29
191118967,1,2,7,4,8,22
191118968,5,2,8,2,4,21
191118969,2,6,6,7,5,26
191118970,0,7,5,1,9,22
191118971,4,6,1,2,1,14
191118972,3,9,9,0,1,22
191118973,4,7,0,5,9,25
191118974,0,5,8,3,2,18
191118975,7,3,4,5,2,21
191118976,8,8,3,4,2,25
191118977,0,2,6,3,4,15
191118978,0,6,0,6,0,12
191118979,8,3,9,9,4,33
191118980,7,6,7,5,1,26
191118981,6,7,0,7,6,26
191118982,4,7,8,0,1,20
191118983,6,9,6,7,9,37
191118984,9,5,5,5,3,27
191118985,9,2,5,8,1,25
191118986,7,6,8,0,4,25
191118987,8,6,0,9,0,23
191118988,5,6,7,2,4,24
191118989,5,0,6,5,1,17
191118990,0,0,6,1,1,8
191118991,7,1,2,5,9,24
191118992,8,1,4,4,0,17
191118993,8,0,1,2,3,14
191118994,6,3,5,6,5,25
191118995,1,7,7,8,1,24
191118996,4,0,4,4,7,19
191118997,1,5,6,0,3,15
191118998,1,3,1,5,7,17
191118999,5,5,7,1,3,21
1911181000,4,8,3,1,9,25
1911181001,2,4,5,1,6,18
1911181002,3,8,3,8,1,23
1911181003,5,9,2,3,6,25
1911181004,0,0,8,1,7,16
1911181005,2,0,6,8,5,21
1911181006,0,1,0,2,4,7
1911181007,4,4,3,1,9,21
1911181008,8,9,0,4,1,22
1911181009,4,8,8,2,5,27
1911181010,6,8,4,2,6,26
1911181011,9,1,5,9,6,30
1911181012,7,3,7,9,0,26
1911181013,3,7,4,0,7,21
1911181014,8,2,0,9,9,28
1911181015,7,2,9,7,9,34
1911181016,6,7,3,8,2,26
1911181017,3,4,1,4,4,16
1911181018,9,2,3,7,6,27
1911181019,2,4,4,4,0,14
1911181020,1,7,2,3,4,17
1911181021,9,4,5,5,4,27
1911181022,5,3,6,6,4,24
1911181023,8,6,9,6,7,36
1911181024,7,5,5,3,6,26
1911181025,6,5,5,4,9,29
1911181026,7,4,0,4,3,18
1911181027,1,0,8,2,9,20
1911181028,3,1,0,2,5,11
1911181029,7,2,9,3,9,30
1911181030,2,7,6,0,3,18
1911181031,0,6,8,6,1,21
1911181032,0,4,6,6,7,23
1911181033,3,9,5,7,6,30
1911181034,0,7,4,9,0,20
1911181035,9,3,4,3,0,19
1911181036,7,8,7,6,3,31
1911181037,6,0,0,5,4,15
1911181038,8,1,7,1,9,26
1911181039,1,5,6,6,0,18
1911181040,0,3,3,3,7,16
1911181041,5,9,9,2,2,27
1911181042,8,4,7,6,3,28
1911181043,8,4,3,5,0,20
1911181044,7,2,2,9,6,26
1911181045,9,4,6,2,1,22
1911181046,5,2,9,4,6,26
1911181047,9,8,7,3,1,28
1911181048,1,4,4,7,5,21
1911181049,0,1,2,8,3,14
1911181050,7,4,4,9,2,26
1911181051,6,7,2,0,3,18
1911181052,7,9,9,5,5,35
1911181053,3,7,3,2,3,18
1911181054,2,0,5,8,7,22
1911181055,7,4,5,1,0,17
1911181056,5,1,5,8,4,23
1911181057,9,6,6,4,9,34
1911181058,9,7,3,4,7,30
1911181059,8,2,7,0,3,20
1911181060,4,9,2,8,8,31
1911181061,1,1,6,9,3,20
1911181062,2,9,9,4,6,30
1911181063,4,0,8,8,9,29
1911181064,6,9,6,1,4,26
1911181065,8,5,5,3,6,27
1911181066,1,0,2,2,8,13
1911181067,1,3,4,2,0,10
1911181068,1,3,5,9,5,23
1911181069,4,2,9,7,7,29
1911181070,5,7,5,1,7,25
1911181071,8,7,4,1,2,22
1911181072,4,1,1,2,7,15
1911181073,2,4,3,3,5,17
1911181074,4,3,1,7,7,22
1911181075,9,7,1,1,1,19
1911181076,5,8,1,7,3,24
1911181077,0,4,5,0,2,11
1911181078,0,3,4,9,0,16
1911181079,8,5,9,9,2,33
1911181080,1,7,8,8,8,32
1911181081,7,2,8,0,3,20
1911181082,1,5,6,9,4,25
1911181083,8,8,3,8,4,31
1911181084,7,9,5,6,6,33
1911181085,3,2,6,3,4,18
1911181086,6,1,5,7,2,21
1911181087,3,4,7,1,8,23
1911181088,6,4,5,5,7,27
1911181089,7,7,4,9,5,32
1911181090,4,3,6,5,5,23
1911181091,0,4,7,1,5,17
1911181092,2,5,3,8,8,26
1911181093,6,0,3,9,5,23
1911181094,1,7,8,7,2,25
1911181095,7,5,1,0,9,22
1911181096,8,4,5,6,7,30
1911181097,8,4,0,5,6,23
1911181098,7,3,7,4,9,30
1911181099,5,4,6,3,3,21
1911181100,7,9,1,8,8,33
1911181101,2,7,7,8,2,26
1911181102,2,5,7,1,7,22
1911181103,4,9,5,9,4,31
1911181104,8,8,2,3,1,22
1911181105,0,0,9,9,9,27
191119001,4,9,3,7,9,32
191119002,2,4,4,3,3,16
191119003,0,7,4,2,4,17
191119004,5,8,6,9,6,34
191119005,3,2,8,1,2,16
191119006,2,5,6,6,7,26
191119007,6,0,7,1,1,15
191119008,2,9,3,9,9,32
191119009,1,7,8,7,9,32
191119010,8,3,7,5,4,27
191119011,4,4,2,0,2,12
191119012,4,4,6,5,0,19
191119013,2,9,0,5,1,17
191119014,2,7,6,4,9,28
191119015,4,5,7,1,7,24
191119016,0,1,4,6,9,20
191119017,3,2,2,8,0,15
191119018,9,4,1,8,4,26
191119019,4,8,0,0,7,19
191119020,3,4,8,2,6,23
191119021,7,8,9,2,9,35
191119022,4,7,9,5,8,33
191119023,0,3,7,9,4,23
191119024,9,4,0,6,5,24
191119025,1,6,5,8,5,25
191119026,0,7,3,7,2,19
191119027,8,5,5,4,3,25
191119028,5,6,8,0,4,23
191119029,5,8,1,8,1,23
191119030,7,7,9,2,9,34
191119031,8,9,0,1,2,20
191119032,0,9,0,1,9,19
191119033,0,3,8,5,2,18
191119034,9,6,6,1,1,23
191119035,1,4,8,5,5,23
191119036,4,6,5,9,5,29
191119037,6,7,6,1,0,20
191119038,1,6,8,9,1,25
191119039,4,2,4,7,6,23
191119040,9,4,1,0,2,16
191119041,2,7,8,6,7,30
191119042,3,7,2,2,3,17
191119043,7,2,1,6,5,21
191119044,0,0,6,4,6,16
191119045,6,4,9,0,8,27
191119046,8,9,0,2,4,23
191119047,4,9,0,6,6,25
191119048,4,8,7,3,8,30
191119049,0,2,1,0,2,5
191119050,2,6,4,9,9,30
191119051,0,8,0,7,5,20
191119052,1,1,1,7,5,15
191119053,1,3,6,2,8,20
191119054,2,7,5,1,0,15
191119055,3,6,1,2,7,19
191119056,2,4,4,0,4,14
191119057,2,4,4,9,2,21
191119058,5,5,1,5,1,17
191119059,3,6,4,8,8,29
191119060,9,3,4,0,7,23
191119061,8,8,0,4,2,22
191119062,5,6,1,9,2,23
191119063,5,4,7,7,0,23
191119064,7,2,1,6,8,24
191119065,8,7,3,2,4,24
191119066,3,0,9,2,9,23
191119067,7,7,1,4,0,19
191119068,7,7,5,7,8,34
191119069,2,7,8,3,7,27
191119070,1,4,3,8,7,23
191119071,9,0,3,9,9,30
191119072,8,5,6,9,1,29
191119073,2,9,8,9,7,35
191119074,0,1,6,2,3,12
191119075,0,0,5,3,8,16
191119076,8,9,4,9,2,32
191119077,5,8,9,7,6,35
191119078,9,5,6,3,0,23
191119079,5,4,5,1,9,24
191119080,9,2,5,7,6,29
191119081,2,1,3,2,3,11
191119082,5,6,6,9,3,29
191119083,0,5,6,4,3,18
191119084,2,3,4,8,9,26
191119085,9,5,2,4,0,20
191119086,7,2,6,9,8,32
191119087,4,2,7,7,4,24
191119088,2,1,7,0,7,17
191119089,4,3,5,4,7,23
191119090,7,9,1,3,9,29
191119091,7,4,6,4,4,25
191119092,9,8,8,3,9,37
191119093,8,7,6,6,0,27
191119094,4,6,6,3,0,19
191119095,4,0,6,0,1,11
191119096,3,9,3,1,2,18
191119097,2,3,9,6,3,23
191119098,8,2,9,5,1,25
191119099,7,7,0,0,1,15
191119100,7,1,3,1,9,21
191119101,7,4,0,0,4,15
191119102,6,1,4,4,8,23
191119103,4,2,6,4,4,20
191119104,3,0,9,7,3,22
191119105,9,4,5,9,8,35
191119106,8,5,9,0,3,25
191119107,1,5,1,9,7,23
191119108,5,1,3,3,3,15
191119109,9,7,3,8,1,28
191119110,0,8,6,1,6,21
191119111,5,9,8,8,9,39
191119112,7,2,7,1,6,23
191119113,2,3,8,3,4,20
191119114,9,2,5,6,6,28
191119115,6,2,2,6,2,18
191119116,6,9,2,1,1,19
191119117,9,3,5,3,2,22
191119118,4,8,7,5,7,31
191119119,1,3,9,5,9,27
191119120,2,8,2,8,2,22
191119121,6,4,6,5,6,27
191119122,4,3,7,2,1,17
191119123,8,2,4,9,1,24
191119124,7,0,5,5,1,18
191119125,9,3,5,2,6,25
191119126,5,7,2,2,9,25
191119127,0,0,9,9,5,23
191119128,3,4,0,1,6,14
191119129,8,6,3,8,2,27
191119130,0,0,9,5,1,15
191119131,6,0,4,9,5,24
191119132,9,0,2,8,5,24
191119133,0,1,5,1,3,10
191119134,2,8,1,7,2,20
191119135,1,7,9,2,7,26
191119136,1,7,6,5,1,20
191119137,7,1,4,9,7,28
191119138,0,5,5,4,3,17
191119139,9,7,5,1,5,27
191119140,5,0,9,9,4,27
191119141,2,9,9,7,7,34
191119142,7,4,0,6,6,23
191119143,7,4,4,5,5,25
191119144,5,8,0,0,2,15
191119145,5,3,6,6,7,27
191119146,7,9,7,2,9,34
191119147,8,5,1,0,4,18
191119148,6,8,3,1,1,19
191119149,5,0,4,9,3,21
191119150,3,0,3,1,3,10
191119151,2,8,8,7,4,29
191119152,4,7,9,7,2,29
191119153,2,1,0,3,1,7
191119154,0,2,5,4,9,20
191119155,8,3,1,8,5,25
191119156,1,1,1,5,7,15
191119157,5,5,8,8,5,31
191119158,0,6,8,6,7,27
191119159,7,8,1,1,4,21
191119160,7,8,5,1,9,30
191119161,3,7,9,2,6,27
191119162,6,7,4,1,7,25
191119163,0,5,1,3,3,12
191119164,9,0,5,1,6,21
191119165,6,6,3,0,7,22
191119166,0,3,8,3,1,15
191119167,9,9,3,0,0,21
191119168,8,9,7,6,5,35
191119169,3,2,7,9,1,22
191119170,6,5,2,8,7,28
191119171,9,7,3,1,8,28
191119172,8,1,9,4,1,23
191119173,0,6,5,9,0,20
191119174,6,4,8,3,6,27
191119175,2,5,1,5,6,19
191119176,5,8,1,2,7,23
191119177,4,4,9,1,6,24
191119178,0,1,9,2,0,12
191119179,3,5,6,1,2,17
191119180,8,4,5,9,8,34
191119181,1,7,0,4,8,20
191119182,5,3,7,3,2,20
191119183,1,0,9,1,6,17
191119184,7,8,0,2,1,18
191119185,9,5,1,4,2,21
191119186,6,8,6,5,6,31
191119187,9,5,1,1,0,16
191119188,0,4,1,4,6,15
191119189,9,0,3,3,1,16
191119190,5,8,2,6,4,25
191119191,9,3,1,9,0,22
191119192,2,3,2,9,8,24
191119193,5,9,9,8,4,35
191119194,8,2,3,4,2,19
191119195,3,6,1,3,8,21
191119196,5,1,9,4,1,20
191119197,8,7,5,2,5,27
191119198,5,6,5,3,8,27
191119199,0,3,1,8,1,13
191119200,4,5,6,7,2,24
191119201,1,6,9,9,0,25
191119202,2,7,8,4,2,23
191119203,7,2,6,4,1,20
191119204,3,2,9,9,2,25
191119205,7,2,5,1,3,18
191119206,5,7,9,5,5,31
191119207,5,9,4,9,5,32
191119208,3,7,1,2,3,16
191119209,3,0,8,0,3,14
191119210,3,1,3,6,8,21
191119211,5,8,6,0,8,27
191119212,2,8,2,3,5,20
191119213,3,1,8,9,5,26
191119214,0,9,0,4,0,13
191119215,9,1,4,1,1,16
191119216,5,5,8,7,1,26
191119217,3,7,5,9,3,27
191119218,9,3,9,6,9,36
191119219,3,6,4,6,5,24
191119220,7,9,8,5,6,35
191119221,6,9,3,8,0,26
191119222,8,9,8,8,5,38
191119223,1,3,9,5,6,24
191119224,0,0,5,1,4,10
191119225,6,5,2,1,2,16
191119226,4,2,9,0,2,17
191119227,1,0,2,4,8,15
191119228,7,2,1,1,6,17
191119229,8,3,4,9,6,30
191119230,2,3,6,8,7,26
191119231,9,5,6,3,8,31
191119232,2,8,6,6,7,29
191119233,8,8,9,6,1,32
191119234,5,9,7,6,7,34
191119235,6,7,2,2,0,17
191119236,6,0,1,4,9,20
191119237,3,7,9,2,3,24
191119238,5,6,1,5,3,20
191119239,6,6,9,9,6,36
191119240,5,3,6,0,4,18
191119241,3,2,3,7,6,21
191119242,4,7,1,7,5,24
191119243,6,4,0,3,7,20
191119244,8,2,3,8,7,28
191119245,6,2,5,7,5,25
191119246,1,8,9,6,4,28
191119247,3,9,5,6,1,24
191119248,0,3,9,4,7,23
191119249,2,1,7,8,4,22
191119250,9,7,2,1,8,27
191119251,3,8,5,4,5,25
191119252,1,5,0,7,7,20
191119253,9,8,1,0,0,18
191119254,7,2,9,5,1,24
191119255,7,1,4,3,1,16
191119256,1,6,8,4,7,26
191119257,0,7,4,0,0,11
191119258,9,0,9,5,5,28
191119259,3,4,9,4,2,22
191119260,9,2,6,5,9,31
191119261,8,8,1,6,3,26
191119262,1,7,3,8,4,23
191119263,5,8,5,1,4,23
191119264,9,9,0,1,8,27
191119265,6,0,2,2,7,17
191119266,5,8,8,1,2,24
191119267,3,4,9,1,3,20
191119268,7,5,5,5,1,23
191119269,4,0,7,1,8,20
191119270,2,1,5,7,2,17
191119271,5,9,9,5,4,32
191119272,3,6,9,2,9,29
191119273,9,9,6,0,1,25
191119274,1,4,9,0,5,19
191119275,0,6,1,6,4,17
191119276,9,2,3,1,9,24
191119277,9,4,8,3,7,31
191119278,0,3,1,6,7,17
191119279,5,5,6,4,0,20
191119280,3,9,8,0,7,27
191119281,2,6,8,0,3,19
191119282,9,9,2,6,7,33
191119283,0,1,2,0,7,10
191119284,6,5,8,7,8,34
191119285,1,6,8,5,6,26
191119286,4,7,1,3,3,18
191119287,2,7,6,0,5,20
191119288,1,3,1,3,0,8
191119289,9,1,8,3,7,28
191119290,5,1,6,3,9,24
191119291,0,4,1,2,3,10
191119292,3,2,6,4,0,15
191119293,6,2,9,0,9,26
191119294,9,1,5,2,2,19
191119295,0,2,1,7,5,15
191119296,3,6,6,4,2,21
191119297,4,5,9,2,2,22
191119298,2,5,2,4,4,17
191119299,5,4,9,5,6,29
191119300,4,8,5,4,5,26
191119301,1,1,8,2,1,13
191119302,5,4,6,9,3,27
191119303,8,9,1,9,5,32
191119304,8,7,1,7,7,30
191119305,8,2,1,0,9,20
191119306,0,4,8,2,7,21
191119307,2,3,3,6,3,17
191119308,2,0,3,9,0,14
191119309,4,4,4,6,7,25
191119310,0,8,2,1,4,15
191119311,5,8,9,6,2,30
191119312,8,8,3,0,0,19
191119313,7,3,6,5,8,29
191119314,3,3,4,7,5,22
191119315,2,7,3,2,9,23
191119316,2,0,2,2,6,12
191119317,7,9,0,9,1,26
191119318,9,5,8,1,4,27
191119319,8,7,5,2,2,24
191119320,8,2,7,5,5,27
191119321,2,8,2,7,9,28
191119322,2,2,1,2,6,13
191119323,6,3,2,4,4,19
191119324,3,0,9,0,3,15
191119325,0,6,0,5,5,16
191119326,5,6,1,1,0,13
191119327,4,7,7,9,3,30
191119328,2,1,2,2,1,8
191119329,1,8,4,9,9,31
191119330,6,4,4,7,8,29
191119331,3,7,8,4,1,23
191119332,5,4,7,0,9,25
191119333,3,0,7,1,6,17
191119334,5,4,0,9,9,27
191119335,3,1,3,0,3,10
191119336,2,3,2,8,7,22
191119337,8,1,6,9,9,33
191119338,4,3,6,7,3,23
191119339,2,1,0,9,0,12
191119340,8,1,3,0,9,21
191119341,5,2,2,2,5,16
191119342,9,8,2,4,9,32
191119343,4,5,4,7,3,23
191119344,1,3,3,5,2,14
191119345,5,1,4,3,4,17
191119346,3,3,0,8,5,19
191119347,1,9,2,7,0,19
191119348,4,3,9,4,9,29
191119349,1,9,1,4,3,18
191119350,8,7,7,9,6,37
191119351,8,7,7,0,5,27
191119352,2,4,0,9,9,24
191119353,2,8,8,7,1,26
191119354,3,1,5,4,6,19
191119355,1,5,7,5,7,25
191119356,0,0,8,4,3,15
191119357,9,3,5,6,1,24
191119358,7,1,5,1,0,14
191119359,9,6,6,9,6,36
191119360,2,2,9,6,1,20
191119361,6,2,2,5,1,16
191119362,5,4,3,9,5,26
191119363,7,7,8,2,7,31
191119364,7,9,4,4,1,25
191119365,0,1,7,0,1,9
191119366,4,1,6,3,1,15
191119367,5,1,4,4,5,19
191119368,1,6,1,3,9,20
191119369,8,9,9,5,3,34
191119370,2,2,2,5,9,20
191119371,5,4,4,0,9,22
191119372,8,0,7,0,5,20
191119373,4,5,2,3,1,15
191119374,9,3,5,3,5,25
191119375,9,0,9,0,6,24
191119376,1,5,4,8,9,27
191119377,9,1,7,8,4,29
191119378,4,4,6,9,8,31
191119379,2,1,6,7,0,16
191119380,2,2,8,0,9,21
191119381,5,9,7,0,0,21
191119382,0,1,4,6,2,13
191119383,4,8,0,3,2,17
191119384,7,6,7,4,7,31
191119385,7,9,1,1,5,23
191119386,4,0,2,0,4,10
191119387,6,4,3,4,8,25
191119388,3,2,6,2,2,15
191119389,6,0,4,9,0,19
191119390,4,7,4,4,1,20
191119391,5,4,9,1,9,28
191119392,2,5,7,9,5,28
191119393,7,3,6,4,8,28
191119394,8,6,2,8,1,25
191119395,3,0,6,2,5,16
191119396,0,7,1,6,5,19
191119397,3,8,5,9,2,27
191119398,8,3,5,4,1,21
191119399,3,3,8,0,6,20
191119400,9,2,7,5,2,25
191119401,7,8,2,0,4,21
191119402,9,7,1,0,3,20
191119403,9,1,0,1,9,20
191119404,6,6,1,5,2,20
191119405,7,6,6,6,3,28
191119406,1,4,7,9,6,27
191119407,7,6,4,2,4,23
191119408,3,3,8,0,2,16
191119409,6,8,1,7,8,30
191119410,6,3,3,1,0,13
191119411,8,2,6,9,7,32
191119412,6,7,9,2,1,25
191119413,0,1,1,5,6,13
191119414,1,9,7,0,3,20
191119415,7,6,9,1,8,31
191119416,7,5,2,7,2,23
191119417,4,5,0,5,4,18
191119418,1,7,7,6,7,28
191119419,3,4,6,7,5,25
191119420,1,8,7,9,3,28
191119421,2,1,3,6,2,14
191119422,0,3,3,7,1,14
191119423,0,7,3,3,9,22
191119424,7,6,1,5,2,21
191119425,5,7,3,3,2,20
191119426,4,7,9,9,4,33
191119427,1,5,3,5,2,16
191119428,6,9,0,9,6,30
191119429,4,6,7,6,7,30
191119430,3,1,7,9,0,20
191119431,4,9,9,6,0,28
191119432,1,2,5,7,2,17
191119433,7,4,5,4,7,27
191119434,6,1,5,2,0,14
191119435,2,6,9,7,6,30
191119436,7,7,4,8,8,34
191119437,6,8,2,0,5,21
191119438,0,3,0,9,7,19
191119439,1,7,8,7,8,31
191119440,5,7,8,8,4,32
191119441,9,8,0,1,4,22
191119442,5,2,3,9,1,20
191119443,9,9,7,2,1,28
191119444,6,1,9,3,3,22
191119445,4,0,9,6,3,22
191119446,6,4,0,4,9,23
191119447,5,9,1,6,1,22
191119448,2,7,8,2,4,23
191119449,4,4,4,3,8,23
191119450,4,2,6,9,0,21
191119451,2,1,0,8,3,14
191119452,0,5,6,4,7,22
191119453,2,5,2,3,3,15
191119454,8,0,0,8,5,21
191119455,8,6,3,9,3,29
191119456,1,9,7,4,2,23
191119457,7,9,3,5,9,33
191119458,6,8,2,3,3,22
191119459,3,4,7,4,5,23
191119460,6,2,4,2,5,19
191119461,6,6,5,8,5,30
191119462,2,4,4,8,4,22
191119463,1,8,9,7,8,33
191119464,7,9,2,3,9,30
191119465,0,5,6,0,6,17
191119466,5,5,1,9,3,23
191119467,1,7,2,3,7,20
191119468,7,3,5,5,1,21
191119469,3,3,2,9,0,17
191119470,9,0,7,5,9,30
191119471,9,9,7,7,6,38
191119472,9,3,3,0,8,23
191119473,2,0,8,1,8,19
191119474,6,2,4,3,9,24
191119475,8,9,9,3,6,35
191119476,5,8,3,0,5,21
191119477,2,5,9,6,1,23
191119478,3,7,1,5,2,18
191119479,9,1,9,8,2,29
191119480,4,6,6,0,9,25
191119481,3,3,5,3,9,23
191119482,4,8,1,5,0,18
191119483,7,8,8,3,8,34
191119484,7,4,6,0,0,17
191119485,9,1,2,6,9,27
191119486,9,8,5,3,0,25
191119487,7,6,7,6,4,30
191119488,2,4,3,4,6,19
191119489,9,2,5,4,5,25
191119490,8,0,7,3,0,18
191119491,7,7,7,4,0,25
191119492,2,5,9,2,9,27
191119493,2,0,0,7,8,17
191119494,4,3,3,9,3,22
191119495,5,7,5,6,4,27
191119496,3,2,3,4,0,12
191119497,6,6,5,2,9,28
191119498,5,9,7,1,2,24
191119499,4,1,9,3,7,24
191119500,8,1,9,4,2,24
191119501,5,1,3,1,0,10
191119502,9,2,5,3,3,22
191119503,0,6,5,3,0,14
191119504,1,5,6,5,4,21
191119505,2,7,0,3,0,12
191119506,2,5,9,6,0,22
191119507,8,5,1,7,2,23
191119508,2,6,1,9,6,24
191119509,5,1,8,0,0,14
191119510,0,1,5,5,6,17
191119511,2,3,3,6,6,20
191119512,1,9,2,4,6,22
191119513,6,8,1,2,7,24
191119514,2,0,8,6,5,21
191119515,9,7,0,8,8,32
191119516,7,7,2,9,6,31
191119517,4,9,9,2,4,28
191119518,9,1,6,6,4,26
191119519,7,5,7,9,5,33
191119520,0,5,8,0,8,21
191119521,5,2,8,2,2,19
191119522,0,2,9,0,3,14
191119523,6,1,7,8,4,26
191119524,8,4,4,8,7,31
191119525,4,5,4,1,8,22
191119526,4,9,6,5,8,32
191119527,5,7,2,3,9,26
191119528,7,7,9,2,6,31
191119529,5,5,0,7,0,17
191119530,1,9,5,8,2,25
191119531,4,7,8,0,6,25
191119532,0,9,6,0,5,20
191119533,0,8,6,4,9,27
191119534,9,5,9,0,6,29
191119535,5,1,7,6,2,21
191119536,3,2,0,7,4,16
191119537,1,4,7,2,1,15
191119538,3,5,0,2,3,13
191119539,8,4,7,3,6,28
191119540,4,7,5,1,4,21
191119541,5,9,0,4,2,20
191119542,9,8,4,5,7,33
191119543,0,1,1,9,2,13
191119544,2,6,6,4,4,22
191119545,8,3,4,2,6,23
191119546,8,4,0,2,4,18
191119547,0,3,4,5,5,17
191119548,9,6,5,7,7,34
191119549,1,6,4,5,5,21
191119550,9,4,0,2,3,18
191119551,1,9,8,4,9,31
191119552,9,8,9,2,2,30
191119553,0,7,2,3,0,12
191119554,9,9,9,4,6,37
191119555,8,8,3,2,3,24
191119556,7,6,8,2,4,27
191119557,2,1,1,6,3,13
191119558,7,7,5,7,5,31
191119559,9,7,8,3,7,34
191119560,6,4,7,7,5,29
191119561,8,4,9,2,5,28
191119562,0,3,0,5,7,15
191119563,3,2,6,3,0,14
191119564,3,7,4,7,9,30
191119565,1,2,2,9,3,17
191119566,9,5,8,8,8,38
191119567,0,4,7,4,4,19
191119568,3,1,0,8,3,15
191119569,3,6,3,6,5,23
191119570,2,6,6,9,4,27
191119571,5,8,6,1,6,26
191119572,6,0,8,8,7,29
191119573,3,6,0,4,4,17
191119574,4,6,8,9,5,32
191119575,3,3,8,9,0,23
191119576,0,3,5,0,7,15
191119577,2,5,4,8,6,25
191119578,6,4,6,4,5,25
191119579,4,0,7,5,8,24
191119580,5,9,8,6,9,37
191119581,2,5,0,9,2,18
191119582,4,2,2,5,1,14
191119583,0,3,0,5,1,9
191119584,8,6,4,4,9,31
191119585,0,2,6,8,6,22
191119586,8,7,3,8,8,34
191119587,7,4,1,4,0,16
191119588,0,1,1,7,1,10
191119589,9,4,1,8,8,30
191119590,7,5,8,9,0,29
191119591,0,3,0,8,6,17
191119592,4,4,3,3,2,16
191119593,8,4,0,1,4,17
191119594,0,3,8,6,6,23
191119595,6,3,5,9,6,29
191119596,5,1,2,9,5,22
191119597,2,0,6,0,4,12
191119598,9,3,2,3,8,25
191119599,6,0,9,7,6,28
191119600,1,1,5,9,1,17
191119601,3,0,3,7,5,18
191119602,2,4,2,7,5,20
191119603,7,0,1,6,4,18
191119604,4,9,4,1,5,23
191119605,8,1,8,4,1,22
191119606,1,7,8,3,6,25
191119607,8,9,1,6,1,25
191119608,8,5,4,6,5,28
191119609,2,6,0,6,8,22
191119610,6,5,4,0,4,19
191119611,8,3,7,9,5,32
191119612,4,5,8,5,3,25
191119613,3,6,3,0,7,19
191119614,1,3,7,0,9,20
191119615,0,4,8,1,7,20
191119616,4,1,3,9,9,26
191119617,7,6,0,7,5,25
191119618,4,5,2,3,5,19
191119619,3,3,1,9,2,18
191119620,8,0,1,6,6,21
191119621,5,0,8,1,4,18
191119622,7,6,9,3,6,31
191119623,6,5,5,5,7,28
191119624,6,2,2,1,8,19
191119625,2,7,7,3,1,20
191119626,6,1,8,3,5,23
191119627,9,8,2,2,1,22
191119628,8,6,9,0,8,31
191119629,7,6,7,1,2,23
191119630,7,5,9,7,0,28
191119631,8,3,0,2,9,22
191119632,7,9,8,1,3,28
191119633,8,3,9,5,2,27
191119634,7,2,1,1,4,15
191119635,1,5,2,0,6,14
191119636,8,1,5,8,7,29
191119637,0,5,5,0,1,11
191119638,7,1,5,4,5,22
191119639,0,3,9,9,6,27
191119640,5,3,0,4,7,19
191119641,7,7,0,6,5,25
191119642,2,2,7,4,0,15
191119643,7,9,3,9,0,28
191119644,6,1,7,2,4,20
191119645,5,1,8,4,5,23
191119646,1,4,3,0,0,8
191119647,1,7,2,8,9,27
191119648,9,0,0,8,8,25
191119649,8,5,4,3,8,28
191119650,9,6,8,9,5,37
191119651,0,4,1,8,0,13
191119652,7,4,4,0,0,15
191119653,8,5,0,2,2,17
191119654,0,0,1,8,7,16
191119655,2,7,8,2,1,20
191119656,5,2,5,0,3,15
191119657,7,5,8,9,9,38
191119658,2,6,0,7,2,17
191119659,0,1,9,7,2,19
191119660,1,8,7,1,0,17
191119661,6,9,2,2,0,19
191119662,4,7,3,5,6,25
191119663,7,7,5,2,4,25
191119664,3,2,7,3,1,16
191119665,4,3,9,7,8,31
191119666,0,6,6,5,3,20
191119667,5,8,3,5,2,23
191119668,1,0,3,2,0,6
191119669,8,3,7,4,9,31
191119670,7,4,7,0,9,27
191119671,6,3,6,6,0,21
191119672,9,3,0,1,8,21
191119673,8,4,5,1,3,21
191119674,6,0,0,0,1,7
191119675,1,6,3,2,8,20
191119676,0,9,6,8,1,24
191119677,0,6,3,1,0,10
191119678,6,1,0,0,3,10
191119679,5,5,7,0,3,20
191119680,8,4,1,1,7,21
191119681,2,3,3,9,8,25
191119682,6,4,8,0,7,25
191119683,1,1,8,3,6,19
191119684,1,9,9,7,6,32
191119685,6,5,2,7,5,25
191119686,5,7,4,4,6,26
191119687,4,5,0,0,1,10
191119688,6,6,3,2,1,18
191119689,2,5,3,8,6,24
191119690,7,6,0,9,5,27
191119691,5,7,1,9,9,31
191119692,9,4,6,2,7,28
191119693,8,5,8,7,5,33
191119694,2,5,2,3,4,16
191119695,1,4,3,0,3,11
191119696,0,9,0,9,1,19
191119697,0,4,0,9,2,15
191119698,1,6,2,7,9,25
191119699,8,1,5,2,1,17
191119700,4,2,5,7,7,25
191119701,8,6,9,2,7,32
191119702,6,1,3,5,3,18
191119703,1,0,3,2,6,12
191119704,6,7,0,7,9,29
191119705,9,8,9,9,3,38
191119706,4,3,0,8,0,15
191119707,1,2,8,8,2,21
191119708,7,8,7,3,6,31
191119709,8,4,3,2,8,25
191119710,2,4,0,0,9,15
191119711,0,5,8,2,1,16
191119712,6,1,2,6,7,22
191119713,9,4,8,0,4,25
191119714,4,5,0,3,7,19
191119715,8,2,9,9,1,29
191119716,3,9,6,7,5,30
191119717,2,8,1,8,8,27
191119718,0,9,5,6,2,22
191119719,3,4,8,8,5,28
191119720,0,8,7,6,2,23
191119721,0,9,2,2,7,20
191119722,8,6,0,1,0,15
191119723,5,3,7,5,6,26
191119724,4,7,0,5,2,18
191119725,3,7,2,6,8,26
191119726,0,5,6,0,7,18
191119727,4,3,3,8,8,26
191119728,1,3,9,9,4,26
191119729,9,0,1,2,2,14
191119730,9,8,2,7,8,34
191119731,4,5,7,9,4,29
191119732,1,7,1,7,5,21
191119733,4,8,0,8,0,20
191119734,7,0,6,2,3,18
191119735,7,5,1,6,8,27
191119736,2,9,9,4,3,27
191119737,9,3,9,3,4,28
191119738,2,9,0,6,9,26
191119739,7,0,5,1,5,18
191119740,6,0,1,4,4,15
191119741,2,4,6,2,8,22
191119742,1,0,0,8,2,11
191119743,1,9,5,4,8,27
191119744,3,7,4,2,0,16
191119745,8,8,8,3,1,28
191119746,8,5,8,3,7,31
191119747,5,0,5,4,0,14
191119748,4,4,6,0,8,22
191119749,0,5,8,4,5,22
191119750,2,0,6,5,6,19
191119751,3,3,3,6,7,22
191119752,8,8,3,1,1,21
191119753,9,8,9,2,8,36
191119754,1,8,9,0,9,27
191119755,3,3,8,2,4,20
191119756,2,9,9,6,1,27
191119757,5,6,0,5,9,25
191119758,3,8,7,0,2,20
191119759,8,2,3,5,1,19
191119760,0,9,1,8,2,20
191119761,3,1,9,4,7,24
191119762,0,9,8,9,6,32
191119763,1,6,6,6,4,23
191119764,5,1,7,6,9,28
191119765,5,9,5,6,8,33
191119766,6,5,3,0,3,17
191119767,4,5,4,3,3,19
191119768,5,2,3,9,9,28
191119769,6,3,4,5,4,22
191119770,7,8,5,5,3,28
191119771,9,4,6,9,8,36
191119772,7,3,8,2,5,25
191119773,3,5,8,5,4,25
191119774,8,3,3,2,0,16
191119775,0,8,0,9,6,23
191119776,6,1,5,4,8,24
191119777,8,9,6,4,3,30
191119778,5,8,6,6,1,26
191119779,9,5,9,0,5,28
191119780,2,1,1,7,8,19
191119781,1,7,6,8,5,27
191119782,9,8,1,9,7,34
191119783,7,5,8,3,6,29
191119784,4,0,9,2,1,16
191119785,6,7,7,7,6,33
191119786,1,4,1,3,6,15
191119787,2,3,7,5,1,18
191119788,8,5,2,0,4,19
191119789,7,8,0,9,7,31
191119790,8,7,4,0,8,27
191119791,2,8,1,0,3,14
191119792,1,4,7,6,2,20
191119793,3,1,3,1,0,8
191119794,6,3,1,9,6,25
191119795,9,6,8,4,5,32
191119796,7,2,7,0,0,16
191119797,9,8,8,6,7,38
191119798,1,2,7,6,6,22
191119799,7,0,4,0,6,17
191119800,3,5,8,0,9,25
191119801,3,1,4,4,0,12
191119802,4,8,1,6,9,28
191119803,5,4,7,9,8,33
191119804,3,1,2,3,2,11
191119805,8,9,9,8,5,39
191119806,6,0,0,4,8,18
191119807,5,4,5,7,6,27
191119808,0,0,2,5,3,10
191119809,7,4,6,0,9,26
191119810,1,8,6,6,5,26
191119811,8,6,8,9,6,37
191119812,2,0,3,9,7,21
191119813,7,9,5,5,7,33
191119814,0,4,6,5,4,19
191119815,6,3,7,3,7,26
191119816,9,8,7,2,6,32
191119817,9,9,7,8,4,37
191119818,3,9,4,5,5,26
191119819,0,5,5,5,7,22
191119820,1,0,6,9,3,19
191119821,4,7,6,0,9,26
191119822,1,7,1,7,6,22
191119823,1,5,2,6,9,23
191119824,6,1,2,4,4,17
191119825,7,6,1,6,7,27
191119826,1,0,7,5,5,18
191119827,2,1,4,8,9,24
191119828,3,4,9,7,6,29
191119829,0,4,6,7,9,26
191119830,5,3,6,2,6,22
191119831,4,0,2,6,6,18
191119832,8,1,7,5,4,25
191119833,2,8,5,4,0,19
191119834,4,1,1,9,9,24
191119835,8,3,1,0,0,12
191119836,2,3,9,2,9,25
191119837,7,5,1,1,4,18
191119838,0,0,9,1,2,12
191119839,4,7,5,6,5,27
191119840,1,3,4,4,4,16
191119841,7,5,2,2,3,19
191119842,7,2,3,1,2,15
191119843,4,5,8,0,2,19
191119844,5,3,1,4,6,19
191119845,8,1,5,5,6,25
191119846,2,9,0,6,7,24
191119847,2,2,8,9,8,29
191119848,5,9,3,1,0,18
191119849,0,6,0,4,7,17
191119850,0,2,6,0,5,13
191119851,1,5,1,8,0,15
191119852,9,1,1,3,4,18
191119853,6,8,7,2,7,30
191119854,3,3,9,1,2,18
191119855,1,5,0,2,4,12
191119856,4,9,0,4,1,18
191119857,1,4,3,4,8,20
191119858,5,0,2,6,8,21
191119859,4,7,9,8,6,34
191119860,4,0,7,3,7,21
191119861,9,4,7,2,0,22
191119862,6,3,9,6,7,31
191119863,3,6,3,7,6,25
191119864,8,5,6,4,9,32
191119865,5,9,2,8,1,25
191119866,5,6,8,7,1,27
191119867,9,2,6,6,5,28
191119868,1,2,1,8,5,17
191119869,2,9,0,8,3,22
191119870,7,4,9,0,2,22
191119871,6,6,5,0,5,22
191119872,8,4,1,1,2,16
191119873,9,7,0,9,0,25
191119874,6,4,0,5,8,23
191119875,1,0,6,5,8,20
191119876,0,0,1,2,4,7
191119877,2,7,9,5,0,23
191119878,5,1,2,5,3,16
191119879,1,3,7,9,1,21
191119880,3,2,3,3,2,13
191119881,7,0,2,9,0,18
191119882,5,7,5,2,1,20
191119883,1,4,8,2,0,15
191119884,4,8,7,4,6,29
191119885,9,0,6,2,4,21
191119886,5,2,1,7,3,18
191119887,8,4,1,4,8,25
191119888,6,7,5,3,0,21
191119889,7,1,9,8,7,32
191119890,5,1,5,7,7,25
191119891,7,1,7,2,3,20
191119892,3,6,1,3,1,14
191119893,0,1,7,4,5,17
191119894,4,2,7,7,2,22
191119895,5,5,4,6,6,26
191119896,0,6,8,4,7,25
191119897,4,5,7,2,5,23
191119898,3,0,7,7,5,22
191119899,6,5,0,3,9,23
191119900,2,6,8,4,8,28
191119901,8,5,2,0,5,20
191119902,0,1,4,4,8,17
191119903,4,8,1,6,5,24
191119904,2,2,2,1,9,16
191119905,7,3,9,6,3,28
191119906,8,1,7,9,9,34
191119907,0,0,9,6,2,17
191119908,5,5,6,8,3,27
191119909,5,6,1,9,1,22
191119910,3,3,4,6,4,20
191119911,7,8,3,3,5,26
191119912,4,5,5,4,7,25
191119913,3,5,6,3,1,18
191119914,3,5,2,4,7,21
191119915,8,0,9,7,9,33
191119916,4,0,6,4,4,18
191119917,0,9,8,2,3,22
191119918,8,9,6,9,3,35
191119919,0,8,3,5,5,21
191119920,2,1,7,9,9,28
191119921,3,0,3,7,1,14
191119922,8,4,3,2,5,22
191119923,7,8,5,0,0,20
191119924,2,1,9,5,3,20
191119925,2,1,8,9,0,20
191119926,0,1,2,5,0,8
191119927,8,8,3,1,7,27
191119928,6,6,8,2,7,29
191119929,3,0,8,4,0,15
191119930,7,8,3,6,0,24
191119931,3,2,8,6,9,28
191119932,5,7,8,1,0,21
191119933,3,3,9,9,6,30
191119934,9,9,1,4,1,24
191119935,8,7,1,0,6,22
191119936,1,6,8,1,3,19
191119937,5,9,9,9,5,37
191119938,0,6,9,8,2,25
191119939,3,5,9,2,1,20
191119940,5,6,2,1,9,23
191119941,9,3,2,4,1,19
191119942,1,3,3,8,1,16
191119943,1,8,8,9,7,33
191119944,2,3,2,7,5,19
191119945,7,7,2,9,8,33
191119946,7,0,4,5,3,19
191119947,2,7,3,1,1,14
191119948,9,8,1,4,6,28
191119949,4,0,1,1,7,13
191119950,7,3,9,5,4,28
191119951,9,8,4,1,2,24
191119952,7,5,0,4,0,16
191119953,7,8,1,6,8,30
191119954,4,5,8,7,2,26
191119955,7,9,8,8,0,32
191119956,4,1,2,1,7,15
191119957,7,5,1,4,3,20
191119958,4,5,0,3,6,18
191119959,2,5,1,0,6,14
191119960,2,5,1,1,2,11
191119961,9,9,6,5,5,34
191119962,9,4,1,5,3,22
191119963,9,5,7,9,6,36
191119964,9,9,5,2,0,25
191119965,9,4,6,9,3,31
191119966,2,1,2,5,3,13
191119967,3,6,3,1,8,21
191119968,2,7,0,4,6,19
191119969,6,8,8,5,1,28
191119970,8,7,8,8,2,33
191119971,7,5,9,4,1,26
191119972,0,1,3,1,3,8
191119973,2,7,2,1,0,12
191119974,8,3,6,7,6,30
191119975,6,5,2,9,1,23
191119976,8,2,9,6,2,27
191119977,5,3,2,5,3,18
191119978,9,6,5,1,1,22
191119979,5,6,0,4,1,16
191119980,4,2,1,7,7,21
191119981,7,8,8,6,5,34
191119982,0,1,1,0,8,10
191119983,8,8,4,5,3,28
191119984,6,1,2,5,9,23
191119985,3,2,9,8,9,31
191119986,4,1,7,6,9,27
191119987,2,0,7,3,3,15
191119988,9,7,6,2,1,25
191119989,9,9,3,6,8,35
191119990,7,7,8,3,5,30
191119991,2,0,5,7,0,14
191119992,4,1,4,8,1,18
191119993,8,0,5,0,8,21
191119994,7,7,0,2,3,19
191119995,9,8,4,8,1,30
191119996,3,4,1,2,5,15
191119997,6,7,0,9,3,25
191119998,5,3,0,6,8,22
191119999,9,5,3,0,1,18
1911191000,1,6,2,8,7,24
1911191001,9,1,1,9,0,20
1911191002,2,2,4,4,8,20
1911191003,5,5,8,7,8,33
1911191004,0,0,3,8,0,11
1911191005,5,1,0,9,2,17
1911191006,3,3,2,9,8,25
1911191007,7,9,9,9,5,39
1911191008,5,7,3,6,5,26
1911191009,3,4,2,6,6,21
1911191010,0,5,5,8,9,27
1911191011,3,0,0,4,3,10
1911191012,1,0,7,8,2,18
1911191013,2,6,5,4,8,25
1911191014,1,5,5,9,9,29
1911191015,7,6,7,7,6,33
1911191016,6,2,7,2,4,21
1911191017,6,9,3,2,3,23
1911191018,8,6,3,7,5,29
1911191019,8,6,9,1,5,29
1911191020,4,6,4,8,3,25
1911191021,9,0,4,2,7,22
1911191022,7,9,8,1,9,34
1911191023,9,8,8,4,9,38
1911191024,5,0,7,7,3,22
1911191025,1,0,5,6,1,13
1911191026,9,8,3,0,1,21
1911191027,8,2,9,8,7,34
1911191028,3,7,7,9,9,35
1911191029,2,5,9,7,6,29
1911191030,9,7,2,5,5,28
1911191031,7,8,6,0,0,21
1911191032,2,2,7,9,4,24
1911191033,7,1,9,2,5,24
1911191034,2,9,3,7,2,23
1911191035,8,7,9,2,1,27
1911191036,2,6,4,7,4,23
1911191037,0,1,3,2,8,14
1911191038,4,5,8,2,4,23
1911191039,9,5,8,0,5,27
1911191040,1,4,2,6,6,19
1911191041,3,1,5,2,3,14
1911191042,2,4,7,1,5,19
1911191043,4,8,7,1,4,24
1911191044,1,1,8,2,8,20
1911191045,9,8,2,9,0,28
1911191046,5,1,6,0,8,20
1911191047,7,8,2,9,5,31
1911191048,3,2,7,5,3,20
1911191049,8,3,0,4,2,17
1911191050,0,7,8,0,6,21
1911191051,4,0,9,2,0,15
1911191052,1,1,0,0,3,5
1911191053,2,5,7,5,2,21
1911191054,4,0,2,8,3,17
1911191055,8,0,0,0,1,9
1911191056,0,4,5,3,5,17
1911191057,2,3,0,5,2,12
1911191058,2,0,7,9,6,24
1911191059,5,3,5,9,6,28
1911191060,8,2,2,4,1,17
1911191061,0,1,5,0,6,12
1911191062,3,5,2,5,7,22
1911191063,2,0,4,7,0,13
1911191064,0,4,1,3,5,13
1911191065,9,9,5,0,4,27
1911191066,4,3,7,0,1,15
1911191067,5,9,7,3,8,32
1911191068,0,9,7,7,4,27
1911191069,0,7,5,6,6,24
1911191070,6,4,9,9,2,30
1911191071,0,4,5,5,1,15
1911191072,3,9,0,7,2,21
1911191073,9,3,3,0,6,21
1911191074,7,6,7,9,3,32
1911191075,3,8,2,8,4,25
1911191076,1,4,8,9,6,28
1911191077,0,1,3,8,9,21
1911191078,5,2,4,2,9,22
1911191079,2,7,1,1,0,11
1911191080,5,7,3,1,1,17
1911191081,6,9,1,2,3,21
1911191082,3,4,3,8,1,19
1911191083,4,0,6,1,0,11
1911191084,8,7,3,3,1,22
1911191085,6,2,3,7,5,23
1911191086,7,9,4,1,1,22
1911191087,8,0,6,6,2,22
1911191088,3,7,6,2,6,24
1911191089,1,4,8,3,9,25
1911191090,9,6,5,7,5,32
1911191091,5,0,7,4,4,20
1911191092,3,4,7,4,4,22
1911191093,9,7,6,3,7,32
1911191094,3,7,7,1,9,27
1911191095,4,5,6,4,5,24
1911191096,0,5,0,1,3,9
1911191097,4,0,9,0,6,19
1911191098,0,5,5,3,2,15
1911191099,9,4,5,0,1,19
1911191100,7,6,9,2,9,33
1911191101,5,9,9,3,3,29
1911191102,1,3,3,3,9,19
1911191103,1,9,7,8,0,25
1911191104,8,7,9,1,8,33
1911191105,4,7,6,4,9,30
191120001,6,5,8,5,4,28
191120002,2,2,1,3,3,11
191120003,5,6,7,0,0,18
191120004,6,2,7,8,7,30
191120005,9,8,4,2,6,29
191120006,5,9,2,1,4,21
191120007,5,1,3,5,9,23
191120008,7,8,6,9,7,37
191120009,7,1,8,1,9,26
191120010,6,5,6,9,3,29
191120011,0,1,7,5,2,15
191120012,9,5,1,9,0,24
191120013,8,9,1,3,8,29
191120014,7,7,2,7,9,32
191120015,9,1,1,1,4,16
191120016,0,4,7,2,3,16
191120017,3,6,0,7,9,25
191120018,0,6,4,6,8,24
191120019,4,8,3,4,0,19
191120020,0,7,5,1,5,18
191120021,1,7,3,7,9,27
191120022,1,2,8,8,3,22
191120023,4,3,1,8,5,21
191120024,6,0,1,0,7,14
191120025,0,9,8,7,9,33
191120026,3,4,5,9,9,30
191120027,9,2,7,3,2,23
191120028,6,9,4,3,7,29
191120029,7,5,7,4,7,30
191120030,7,7,5,5,8,32
191120031,7,1,9,0,7,24
191120032,0,9,4,2,7,22
191120033,8,3,5,4,5,25
191120034,2,1,7,1,2,13
191120035,9,1,7,8,1,26
191120036,3,9,7,5,4,28
191120037,2,3,9,0,5,19
191120038,6,8,4,0,7,25
191120039,7,3,5,4,0,19
191120040,3,8,6,7,6,30
191120041,2,6,0,7,5,20
191120042,5,4,1,6,8,24
191120043,8,7,3,6,8,32
191120044,2,4,1,6,2,15
191120045,1,2,7,5,6,21
191120046,2,1,9,0,0,12
191120047,5,5,6,1,2,19
191120048,3,7,9,1,7,27
191120049,8,7,6,9,5,35
191120050,6,8,9,4,7,34
191120051,9,1,5,9,3,27
191120052,9,2,1,1,9,22
191120053,8,7,7,5,3,30
191120054,8,8,5,1,5,27
191120055,5,3,2,3,6,19
191120056,8,7,7,1,0,23
191120057,2,0,3,4,0,9
191120058,9,5,7,3,3,27
191120059,1,4,1,4,2,12
191120060,9,0,9,3,8,29
191120061,8,8,4,3,8,31
191120062,6,8,5,7,8,34
191120063,5,5,4,8,7,29
191120064,0,3,4,3,2,12
191120065,4,4,9,5,4,26
191120066,5,6,6,8,5,30
191120067,7,7,4,4,1,23
191120068,0,9,4,5,8,26
191120069,9,6,2,7,0,24
191120070,0,8,1,3,0,12
191120071,6,5,4,0,6,21
191120072,4,8,6,3,9,30
191120073,1,8,2,8,6,25
191120074,9,7,6,7,0,29
191120075,6,8,4,4,2,24
191120076,7,1,7,7,0,22
191120077,9,0,6,4,8,27
191120078,9,9,0,5,5,28
191120079,4,9,3,4,3,23
191120080,0,7,2,4,3,16
191120081,0,2,4,5,6,17
191120082,1,9,7,8,5,30
191120083,8,8,3,3,5,27
191120084,5,5,5,5,4,24
191120085,5,1,1,7,5,19
191120086,5,1,7,5,4,22
191120087,3,1,3,9,6,22
191120088,9,4,3,6,1,23
191120089,1,3,7,8,4,23
191120090,9,9,2,7,9,36
191120091,2,7,8,5,7,29
191120092,0,3,3,0,7,13
191120093,5,7,7,4,6,29
191120094,4,1,2,9,7,23
191120095,3,3,8,4,0,18
191120096,0,7,9,6,2,24
191120097,1,6,7,8,8,30
191120098,5,0,5,0,1,11
191120099,3,2,2,3,8,18
191120100,0,4,7,9,8,28
191120101,2,3,9,0,3,17
191120102,8,8,6,4,8,34
191120103,9,3,4,2,1,19
191120104,7,2,3,3,4,19
191120105,9,6,0,6,7,28
191120106,3,5,2,9,6,25
191120107,1,6,0,0,3,10
191120108,8,9,9,3,5,34
191120109,5,1,5,6,7,24
191120110,8,2,0,0,4,14
191120111,4,8,2,8,0,22
191120112,3,4,9,6,8,30
191120113,3,8,2,5,1,19
191120114,0,2,1,1,8,12
191120115,0,1,8,2,6,17
191120116,6,2,7,1,6,22
191120117,8,6,6,3,7,30
191120118,9,2,6,5,2,24
191120119,0,1,1,5,3,10
191120120,9,2,2,6,0,19
191120121,3,2,0,7,2,14
191120122,2,9,1,8,6,26
191120123,3,0,1,1,1,6
191120124,5,3,5,4,8,25
191120125,1,9,2,4,7,23
191120126,7,2,6,0,4,19
191120127,9,1,8,5,9,32
191120128,2,5,9,2,3,21
191120129,5,8,4,7,7,31
191120130,6,0,8,6,5,25
191120131,3,8,9,9,1,30
191120132,6,4,7,5,0,22
191120133,7,0,7,0,9,23
191120134,2,6,6,5,1,20
191120135,7,4,6,7,6,30
191120136,6,6,4,8,3,27
191120137,7,3,3,2,4,19
191120138,0,3,8,8,3,22
191120139,7,3,7,1,6,24
191120140,0,4,7,6,3,20
191120141,0,2,0,8,5,15
191120142,7,8,7,0,8,30
191120143,6,8,8,8,9,39
191120144,5,3,1,0,9,18
191120145,8,1,4,6,9,28
191120146,8,5,5,0,6,24
191120147,0,7,1,4,4,16
191120148,6,1,5,1,9,22
191120149,9,1,7,9,8,34
191120150,2,1,5,0,2,10
191120151,7,3,3,2,3,18
191120152,8,6,3,3,7,27
191120153,9,4,3,8,5,29
191120154,4,2,5,0,8,19
191120155,7,6,7,0,9,29
191120156,2,9,1,2,2,16
191120157,1,1,9,5,6,22
191120158,5,3,2,1,2,13
191120159,2,1,1,2,6,12
191120160,0,8,9,8,0,25
191120161,5,2,1,3,2,13
191120162,3,7,2,8,9,29
191120163,9,9,1,6,0,25
191120164,0,5,3,0,4,12
191120165,4,4,7,7,4,26
191120166,0,0,9,5,4,18
191120167,4,4,7,8,1,24
191120168,9,8,2,6,3,28
191120169,8,0,7,7,7,29
191120170,9,0,3,7,0,19
191120171,9,9,4,9,8,39
191120172,8,6,1,6,2,23
191120173,4,2,6,2,1,15
191120174,3,4,2,0,2,11
191120175,9,3,5,7,0,24
191120176,1,8,1,7,9,26
191120177,4,4,9,5,8,30
191120178,8,2,4,4,1,19
191120179,1,9,0,3,1,14
191120180,2,5,6,9,9,31
191120181,5,6,9,6,9,35
191120182,4,2,2,4,1,13
191120183,5,7,6,7,2,27
191120184,6,8,1,2,1,18
191120185,5,5,5,6,8,29
191120186,4,6,0,0,8,18
191120187,7,4,8,8,2,29
191120188,2,5,1,3,0,11
191120189,5,6,7,7,5,30
191120190,5,8,7,4,5,29
191120191,8,8,9,7,8,40
191120192,2,9,1,6,9,27
191120193,7,0,9,7,1,24
191120194,3,8,2,2,6,21
191120195,7,4,4,3,1,19
191120196,5,4,6,6,9,30
191120197,4,3,6,5,1,19
191120198,0,1,9,9,1,20
191120199,9,6,5,8,4,32
191120200,5,9,1,3,6,24
191120201,6,1,0,9,2,18
191120202,4,7,9,5,6,31
191120203,3,6,0,6,8,23
191120204,4,3,1,2,7,17
191120205,1,9,4,0,4,18
191120206,5,9,2,5,7,28
191120207,6,5,9,8,7,35
191120208,0,0,8,4,7,19
191120209,3,6,9,1,6,25
191120210,4,1,3,3,5,16
191120211,3,9,6,7,0,25
191120212,2,9,0,7,0,18
191120213,5,4,4,9,1,23
191120214,1,2,2,9,9,23
191120215,9,7,0,0,2,18
191120216,1,8,1,8,4,22
191120217,3,9,8,7,7,34
191120218,5,6,2,1,8,22
191120219,1,8,2,7,5,23
191120220,3,6,7,5,2,23
191120221,7,3,2,1,2,15
191120222,9,4,2,9,5,29
191120223,3,6,0,9,5,23
191120224,5,1,6,4,7,23
191120225,6,8,1,9,1,25
191120226,0,5,7,1,6,19
191120227,3,2,7,2,4,18
191120228,4,0,6,3,3,16
191120229,2,4,3,5,9,23
191120230,7,1,5,7,6,26
191120231,4,4,8,2,6,24
191120232,2,7,0,9,8,26
191120233,6,2,9,3,1,21
191120234,7,9,6,8,3,33
191120235,0,5,8,5,8,26
191120236,0,7,5,2,1,15
191120237,1,4,0,9,7,21
191120238,0,3,7,5,5,20
191120239,5,0,9,2,6,22
191120240,9,5,8,3,6,31
191120241,7,0,0,6,1,14
191120242,4,1,9,9,7,30
191120243,8,0,1,5,1,15
191120244,7,0,5,1,4,17
191120245,9,1,7,0,1,18
191120246,7,7,6,7,1,28
191120247,8,9,6,1,9,33
191120248,9,8,9,3,7,36
191120249,5,6,8,2,2,23
191120250,8,1,4,7,6,26
191120251,2,1,9,9,7,28
191120252,9,2,2,9,2,24
191120253,6,6,8,2,0,22
191120254,5,1,4,2,7,19
191120255,4,0,5,4,3,16
191120256,9,1,0,1,2,13
191120257,1,3,6,6,9,25
191120258,4,8,0,7,2,21
191120259,5,2,0,0,8,15
191120260,2,5,2,7,6,22
191120261,4,5,6,3,1,19
191120262,1,9,2,7,4,23
191120263,4,4,5,8,8,29
191120264,1,7,0,0,9,17
191120265,4,2,0,3,9,18
191120266,7,8,5,0,9,29
191120267,4,5,6,9,7,31
191120268,5,5,1,4,2,17
191120269,2,0,1,1,5,9
191120270,0,5,6,4,1,16
191120271,5,8,2,3,8,26
191120272,3,2,1,0,6,12
191120273,9,5,3,4,2,23
191120274,9,4,1,5,9,28
191120275,6,7,4,4,6,27
191120276,8,0,8,7,0,23
191120277,6,5,1,5,2,19
191120278,2,1,8,4,4,19
191120279,8,3,4,7,9,31
191120280,5,3,3,0,4,15
191120281,6,2,7,0,9,24
191120282,0,0,2,8,9,19
191120283,9,3,1,5,0,18
191120284,4,7,2,1,6,20
191120285,9,2,0,4,6,21
191120286,6,3,1,1,2,13
191120287,3,3,8,1,9,24
191120288,9,3,3,0,4,19
191120289,0,2,2,6,4,14
191120290,0,6,1,2,0,9
191120291,4,0,6,7,7,24
191120292,6,3,8,3,9,29
191120293,2,1,0,8,6,17
191120294,2,4,9,8,5,28
191120295,5,4,3,7,2,21
191120296,5,2,9,2,2,20
191120297,3,0,1,4,4,12
191120298,3,5,1,2,7,18
191120299,2,6,4,6,5,23
191120300,1,7,1,9,4,22
191120301,5,6,1,6,4,22
191120302,6,0,2,8,1,17
191120303,4,4,2,9,4,23
191120304,1,9,4,2,8,24
191120305,9,9,9,3,3,33
191120306,0,9,7,1,0,17
191120307,9,5,1,1,7,23
191120308,2,6,5,7,4,24
191120309,9,4,3,9,4,29
191120310,8,8,6,2,4,28
191120311,1,8,6,9,0,24
191120312,9,3,8,0,6,26
191120313,8,2,1,8,1,20
191120314,5,1,6,6,3,21
191120315,2,2,0,3,7,14
191120316,4,4,4,7,0,19
191120317,8,8,4,5,4,29
191120318,3,0,6,5,4,18
191120319,2,8,4,4,8,26
191120320,1,3,5,2,3,14
191120321,9,0,8,8,4,29
191120322,1,0,9,4,9,23
191120323,5,1,3,0,3,12
191120324,6,4,6,9,0,25
191120325,1,2,2,8,2,15
191120326,1,4,5,4,9,23
191120327,8,4,4,8,0,24
191120328,6,6,3,0,8,23
191120329,3,1,9,7,8,28
191120330,9,3,9,5,5,31
191120331,3,1,0,7,2,13
191120332,1,5,5,1,4,16
191120333,5,5,5,2,3,20
191120334,2,9,8,5,2,26
191120335,7,8,8,2,7,32
191120336,1,1,8,7,2,19
191120337,6,6,5,7,4,28
191120338,4,8,1,3,1,17
191120339,5,2,7,2,6,22
191120340,8,1,0,3,7,19
191120341,1,6,2,1,6,16
191120342,1,3,0,5,3,12
191120343,7,7,3,5,3,25
191120344,9,4,9,0,8,30
191120345,3,3,4,9,3,22
191120346,5,0,3,3,0,11
191120347,9,1,3,0,2,15
191120348,0,1,2,9,1,13
191120349,6,9,5,9,4,33
191120350,9,4,8,5,8,34
191120351,3,2,0,0,6,11
191120352,5,4,1,0,9,19
191120353,9,7,6,6,7,35
191120354,0,0,9,7,2,18
191120355,0,1,8,2,8,19
191120356,7,5,0,2,4,18
191120357,9,0,0,2,9,20
191120358,4,4,3,8,4,23
191120359,3,5,1,2,0,11
191120360,6,4,3,8,9,30
191120361,3,3,7,8,1,22
191120362,5,0,3,4,0,12
191120363,1,4,5,3,3,16
191120364,8,7,6,1,4,26
191120365,1,9,3,2,0,15
191120366,2,2,2,9,5,20
191120367,1,5,7,7,5,25
191120368,1,1,4,5,4,15
191120369,2,7,7,6,2,24
191120370,0,2,8,0,0,10
191120371,7,8,4,1,5,25
191120372,1,0,3,6,6,16
191120373,5,0,9,2,5,21
191120374,5,6,8,2,9,30
191120375,7,1,2,9,3,22
191120376,6,8,9,8,1,32
191120377,7,2,2,8,5,24
191120378,7,6,7,2,6,28
191120379,7,4,4,9,9,33
191120380,5,6,8,9,1,29
191120381,1,0,1,1,9,12
191120382,9,3,6,5,0,23
191120383,7,0,4,3,0,14
191120384,5,4,9,2,1,21
191120385,5,2,1,9,9,26
191120386,1,0,1,7,6,15
191120387,8,8,4,3,7,30
191120388,3,7,2,0,2,14
191120389,1,5,7,5,3,21
191120390,0,2,4,9,0,15
191120391,1,7,0,1,3,12
191120392,5,0,0,1,1,7
191120393,2,6,9,6,8,31
191120394,5,4,9,8,4,30
191120395,3,2,4,1,5,15
191120396,6,5,5,2,0,18
191120397,8,2,3,4,8,25
191120398,4,3,2,6,1,16
191120399,0,0,7,4,4,15
191120400,7,0,1,8,0,16
191120401,1,5,9,0,4,19
191120402,9,5,7,6,3,30
191120403,1,5,1,7,1,15
191120404,0,9,9,5,9,32
191120405,4,5,0,4,4,17
191120406,9,4,1,8,0,22
191120407,8,7,8,5,2,30
191120408,4,1,5,5,8,23
191120409,0,7,1,0,3,11
191120410,4,5,4,6,6,25
191120411,3,7,6,5,9,30
191120412,5,3,3,3,7,21
191120413,9,5,3,2,5,24
191120414,1,3,9,9,1,23
191120415,3,7,9,8,0,27
191120416,2,8,3,4,2,19
191120417,4,9,9,5,0,27
191120418,9,5,4,6,2,26
191120419,1,8,0,7,7,23
191120420,6,6,1,0,3,16
191120421,1,9,9,8,2,29
191120422,8,6,1,9,4,28
191120423,6,3,5,4,3,21
191120424,7,4,3,8,1,23
191120425,5,4,7,9,1,26
191120426,6,7,6,5,6,30
191120427,5,4,7,2,0,18
191120428,7,7,4,7,3,28
191120429,4,3,6,3,2,18
191120430,2,2,6,2,5,17
191120431,6,1,0,4,0,11
191120432,9,6,0,7,8,30
191120433,9,3,8,3,6,29
191120434,3,7,7,4,7,28
191120435,3,0,5,3,9,20
191120436,4,6,5,3,6,24
191120437,0,4,9,6,2,21
191120438,5,3,4,0,3,15
191120439,0,0,3,8,1,12
191120440,0,4,9,1,7,21
191120441,1,1,6,2,0,10
191120442,1,5,9,9,0,24
191120443,0,2,7,2,4,15
191120444,9,0,5,7,8,29
191120445,9,2,0,1,8,20
191120446,6,8,9,7,1,31
191120447,2,5,9,4,5,25
191120448,6,5,6,1,7,25
191120449,6,1,0,4,1,12
191120450,9,6,4,0,4,23
191120451,0,9,0,7,9,25
191120452,3,3,3,2,5,16
191120453,0,7,0,4,4,15
191120454,3,5,4,6,8,26
191120455,8,9,5,7,1,30
191120456,5,6,3,5,9,28
191120457,0,4,1,4,8,17
191120458,3,1,5,6,8,23
191120459,4,2,1,4,1,12
191120460,2,8,9,8,9,36
191120461,2,3,9,2,7,23
191120462,1,7,9,0,9,26
191120463,0,0,1,2,5,8
191120464,6,8,3,8,4,29
191120465,6,0,9,2,7,24
191120466,0,5,3,3,7,18
191120467,1,4,2,2,0,9
191120468,2,3,1,5,5,16
191120469,2,0,2,4,4,12
191120470,1,2,6,6,1,16
191120471,1,5,9,0,8,23
191120472,8,9,6,0,5,28
191120473,5,5,5,7,7,29
191120474,2,3,4,1,1,11
191120475,8,4,7,7,1,27
191120476,4,6,4,9,1,24
191120477,0,4,4,9,1,18
191120478,0,9,5,0,2,16
191120479,4,2,1,2,2,11
191120480,3,8,7,3,2,23
191120481,5,9,2,3,8,27
191120482,2,9,5,8,8,32
191120483,0,9,6,8,9,32
191120484,1,8,2,4,5,20
191120485,2,9,5,3,7,26
191120486,0,9,2,7,7,25
191120487,4,1,5,6,5,21
191120488,4,3,1,9,2,19
191120489,2,7,8,3,4,24
191120490,5,8,3,6,0,22
191120491,6,5,7,3,2,23
191120492,1,5,8,6,1,21
191120493,0,4,3,3,9,19
191120494,1,9,6,7,3,26
191120495,1,0,7,8,9,25
191120496,2,6,2,2,2,14
191120497,1,1,4,5,5,16
191120498,7,3,2,6,9,27
191120499,5,0,7,5,8,25
191120500,3,9,4,7,0,23
191120501,1,2,5,9,7,24
191120502,9,4,4,5,4,26
191120503,8,7,8,0,1,24
191120504,0,2,7,7,6,22
191120505,3,1,1,1,1,7
191120506,9,9,7,5,8,38
191120507,3,3,2,1,6,15
191120508,1,9,2,4,1,17
191120509,9,0,9,6,6,30
191120510,1,7,1,9,6,24
191120511,8,9,5,8,3,33
191120512,2,5,8,8,4,27
191120513,0,7,5,9,1,22
191120514,8,9,9,6,2,34
191120515,5,2,4,4,9,24
191120516,8,2,2,3,7,22
191120517,8,1,3,8,0,20
191120518,9,6,3,1,7,26
191120519,2,9,8,4,0,23
191120520,3,1,3,1,4,12
191120521,2,2,3,9,3,19
191120522,3,0,7,9,6,25
191120523,8,8,5,2,0,23
191120524,9,7,9,9,0,34
191120525,4,7,8,7,8,34
191120526,3,1,4,1,9,18
191120527,4,6,6,5,9,30
191120528,4,9,5,7,3,28
191120529,0,1,3,1,6,11
191120530,4,3,1,1,0,9
191120531,9,5,4,2,2,22
191120532,3,2,8,7,1,21
191120533,7,3,7,9,9,35
191120534,8,0,9,7,6,30
191120535,4,4,3,8,7,26
191120536,9,2,8,1,9,29
191120537,0,8,7,1,9,25
191120538,2,0,5,4,8,19
191120539,2,8,0,8,8,26
191120540,8,1,3,7,6,25
191120541,6,1,5,8,3,23
191120542,5,0,3,7,4,19
191120543,2,9,9,0,6,26
191120544,0,6,2,9,7,24
191120545,8,6,9,5,7,35
191120546,0,5,4,5,9,23
191120547,1,0,6,7,9,23
191120548,9,3,6,4,3,25
191120549,7,8,4,6,3,28
191120550,3,5,4,5,0,17
191120551,4,4,8,6,8,30
191120552,5,2,3,3,7,20
191120553,8,8,7,9,1,33
191120554,4,4,7,5,7,27
191120555,0,0,9,9,2,20
191120556,5,1,8,4,9,27
191120557,9,5,4,0,1,19
191120558,5,1,3,9,5,23
191120559,7,3,3,3,3,19
191120560,9,4,6,0,9,28
191120561,8,2,6,6,2,24
191120562,9,7,2,6,9,33
191120563,1,2,6,9,7,25
191120564,2,5,1,5,0,13
191120565,8,6,1,1,0,16
191120566,9,3,0,9,5,26
191120567,5,0,1,3,3,12
191120568,1,3,4,1,9,18
191120569,0,5,0,8,2,15
191120570,8,0,6,4,3,21
191120571,0,7,1,9,0,17
191120572,1,1,6,6,7,21
191120573,1,3,9,0,8,21
191120574,3,9,9,9,2,32
191120575,5,9,6,5,7,32
191120576,0,8,1,9,3,21
191120577,1,4,3,6,6,20
191120578,1,8,8,1,0,18
191120579,6,1,1,0,3,11
191120580,6,5,3,8,2,24
191120581,8,6,7,5,5,31
191120582,0,5,6,9,6,26
191120583,8,7,1,0,8,24
191120584,0,0,9,9,6,24
191120585,0,9,3,8,0,20
191120586,4,8,4,6,3,25
191120587,9,6,1,1,6,23
191120588,2,6,0,8,3,19
191120589,5,4,9,9,7,34
191120590,9,7,6,2,6,30
191120591,4,9,0,2,6,21
191120592,0,9,8,1,6,24
191120593,2,1,0,7,8,18
191120594,2,7,0,4,8,21
191120595,7,6,0,5,2,20
191120596,1,0,8,2,4,15
191120597,8,4,7,6,7,32
191120598,3,1,5,8,6,23
191120599,2,3,0,0,4,9
191120600,0,9,6,0,8,23
191120601,6,2,0,5,7,20
191120602,3,0,0,8,8,19
191120603,4,7,2,8,7,28
191120604,1,0,3,8,4,16
191120605,2,1,7,8,3,21
191120606,1,1,5,4,3,14
191120607,3,5,4,7,5,24
191120608,0,2,8,2,2,14
191120609,6,8,7,6,5,32
191120610,1,0,7,5,3,16
191120611,2,9,7,5,0,23
191120612,8,2,2,7,3,22
191120613,5,6,2,0,0,13
191120614,1,5,5,5,2,18
191120615,5,6,5,0,1,17
191120616,1,8,8,0,4,21
191120617,0,7,2,3,4,16
191120618,9,1,1,2,3,16
191120619,0,4,4,3,8,19
191120620,1,9,9,7,3,29
191120621,7,1,4,2,1,15
191120622,6,3,6,4,8,27
191120623,8,6,4,1,5,24
191120624,7,1,3,2,5,18
191120625,6,2,0,8,0,16
191120626,5,2,1,0,2,10
191120627,9,1,3,2,1,16
191120628,0,4,4,8,4,20
191120629,1,6,3,8,2,20
191120630,0,9,3,6,4,22
191120631,8,2,5,1,0,16
191120632,4,7,0,6,3,20
191120633,8,4,2,0,0,14
191120634,0,7,9,4,8,28
191120635,1,3,5,9,0,18
191120636,0,2,5,0,8,15
191120637,0,5,4,0,8,17
191120638,6,8,5,4,5,28
191120639,2,0,7,9,3,21
191120640,2,6,3,4,2,17
191120641,1,1,1,9,0,12
191120642,0,1,7,8,5,21
191120643,1,0,1,0,2,4
191120644,0,7,9,1,7,24
191120645,5,7,3,7,7,29
191120646,7,3,4,3,7,24
191120647,9,4,8,6,7,34
191120648,1,7,7,7,9,31
191120649,5,0,7,6,0,18
191120650,5,6,7,9,4,31
191120651,1,9,6,5,2,23
191120652,0,9,5,2,1,17
191120653,5,5,8,7,7,32
191120654,6,8,1,9,2,26
191120655,2,8,7,5,0,22
191120656,2,7,9,8,5,31
191120657,7,3,3,2,0,15
191120658,1,6,3,7,1,18
191120659,9,6,2,4,0,21
191120660,1,1,6,6,0,14
191120661,4,8,1,6,2,21
191120662,9,2,2,1,0,14
191120663,4,1,1,8,2,16
191120664,9,4,2,8,0,23
191120665,2,1,9,9,9,30
191120666,3,3,2,8,3,19
191120667,4,0,8,2,7,21
191120668,4,5,9,2,5,25
191120669,6,5,9,8,1,29
191120670,9,4,0,9,7,29
191120671,2,6,3,7,1,19
191120672,7,0,0,2,4,13
191120673,0,8,2,3,5,18
191120674,1,8,8,4,9,30
191120675,0,7,6,7,9,29
191120676,0,3,5,2,6,16
191120677,8,1,0,8,1,18
191120678,0,1,4,1,6,12
191120679,8,6,9,4,7,34
191120680,1,0,0,7,2,10
191120681,0,4,9,7,0,20
191120682,7,0,5,7,5,24
191120683,4,3,9,7,9,32
191120684,9,8,8,7,6,38
191120685,9,8,6,1,4,28
191120686,7,0,7,8,7,29
191120687,4,6,0,6,2,18
191120688,0,1,6,2,5,14
191120689,1,0,6,7,0,14
191120690,1,1,7,6,0,15
191120691,3,7,1,9,0,20
191120692,1,4,7,6,1,19
191120693,1,0,4,5,5,15
191120694,8,3,5,7,8,31
191120695,3,8,0,4,2,17
191120696,3,7,3,4,2,19
191120697,8,1,0,7,6,22
191120698,3,6,6,5,5,25
191120699,1,6,3,2,9,21
191120700,6,4,1,3,1,15
191120701,1,9,7,3,6,26
191120702,2,8,8,0,9,27
191120703,2,3,0,9,6,20
191120704,2,2,5,8,8,25
191120705,3,5,9,5,3,25
191120706,5,6,1,5,0,17
191120707,1,7,7,4,2,21
191120708,7,1,6,9,1,24
191120709,4,7,9,3,0,23
191120710,2,5,0,4,3,14
191120711,2,1,0,5,2,10
191120712,1,9,5,3,4,22
191120713,8,7,8,6,6,35
191120714,6,5,6,8,7,32
191120715,4,0,5,8,7,24
191120716,4,4,0,4,9,21
191120717,3,8,9,9,5,34
191120718,9,2,4,8,8,31
191120719,5,2,5,2,2,16
191120720,9,2,3,6,2,22
191120721,2,0,8,7,1,18
191120722,5,7,2,8,0,22
191120723,3,5,5,0,5,18
191120724,0,8,7,2,9,26
191120725,6,3,5,6,9,29
191120726,8,7,8,9,8,40
191120727,5,3,2,5,1,16
191120728,6,2,1,8,4,21
191120729,2,1,3,8,2,16
191120730,0,9,7,9,4,29
191120731,7,1,1,5,9,23
191120732,8,7,2,4,4,25
191120733,9,3,7,7,8,34
191120734,8,7,7,1,1,24
191120735,7,5,0,5,0,17
191120736,9,6,1,9,0,25
191120737,4,7,3,6,7,27
191120738,0,3,6,3,8,20
191120739,9,0,9,9,1,28
191120740,0,6,8,0,3,17
191120741,6,6,6,7,3,28
191120742,1,2,6,8,5,22
191120743,2,3,9,5,8,27
191120744,3,0,5,9,4,21
191120745,5,9,7,5,3,29
191120746,2,6,9,6,3,26
191120747,3,8,5,1,1,18
191120748,8,4,0,6,3,21
191120749,3,9,7,2,9,30
191120750,0,8,2,2,0,12
191120751,6,2,1,8,1,18
191120752,0,4,5,6,9,24
191120753,4,0,0,5,9,18
191120754,3,2,8,9,7,29
191120755,9,6,4,4,2,25
191120756,6,0,5,3,8,22
191120757,3,7,6,0,4,20
191120758,4,4,8,7,2,25
191120759,2,4,5,5,0,16
191120760,6,4,3,6,9,28
191120761,2,5,0,8,1,16
191120762,9,7,7,0,1,24
191120763,2,0,3,0,8,13
191120764,2,3,3,4,0,12
191120765,0,1,9,3,3,16
191120766,6,9,2,4,7,28
191120767,8,7,0,2,3,20
191120768,3,2,3,9,0,17
191120769,8,7,8,1,2,26
191120770,5,8,5,4,4,26
191120771,9,4,8,3,8,32
191120772,8,2,9,5,7,31
191120773,3,0,3,2,5,13
191120774,8,0,4,2,9,23
191120775,1,5,5,9,1,21
191120776,7,4,6,7,3,27
191120777,5,2,5,6,1,19
191120778,0,2,7,1,6,16
191120779,3,0,0,7,2,12
191120780,4,8,9,8,8,37
191120781,4,1,4,4,0,13
191120782,5,7,6,6,2,26
191120783,4,6,4,1,9,24
191120784,4,1,1,2,9,17
191120785,9,4,6,2,2,23
191120786,5,9,3,8,2,27
191120787,8,6,8,2,2,26
191120788,9,9,4,6,4,32
191120789,5,7,1,2,4,19
191120790,2,6,2,1,0,11
191120791,3,4,5,6,0,18
191120792,7,1,0,6,3,17
191120793,6,6,9,5,5,31
191120794,4,1,0,5,7,17
191120795,5,0,9,4,6,24
191120796,9,5,8,7,8,37
191120797,1,1,6,9,4,21
191120798,4,0,1,1,8,14
191120799,9,2,1,2,5,19
191120800,4,6,2,2,9,23
191120801,4,6,7,7,5,29
191120802,8,9,2,4,8,31
191120803,3,5,7,4,4,23
191120804,3,2,8,3,5,21
191120805,7,6,0,1,7,21
191120806,9,5,0,0,7,21
191120807,6,2,4,9,7,28
191120808,2,7,7,8,0,24
191120809,3,0,6,4,2,15
191120810,1,0,3,3,4,11
191120811,9,0,2,1,4,16
191120812,0,0,8,4,5,17
191120813,1,1,4,4,9,19
191120814,1,1,9,3,4,18
191120815,1,5,5,5,1,17
191120816,4,9,9,7,8,37
191120817,9,7,6,1,7,30
191120818,3,4,4,9,4,24
191120819,9,9,5,8,8,39
191120820,3,2,1,2,9,17
191120821,3,4,6,2,7,22
191120822,9,4,3,5,9,30
191120823,2,1,7,3,2,15
191120824,3,6,5,8,6,28
191120825,4,3,7,9,3,26
191120826,6,1,3,8,7,25
191120827,6,6,6,9,3,30
191120828,1,4,1,4,0,10
191120829,2,4,3,6,0,15
191120830,7,5,1,5,7,25
191120831,9,9,7,8,2,35
191120832,1,4,3,6,9,23
191120833,2,9,7,6,7,31
191120834,7,3,6,3,4,23
191120835,4,5,7,7,9,32
191120836,3,2,7,5,8,25
191120837,5,8,8,9,7,37
191120838,6,3,8,3,3,23
191120839,9,9,8,1,4,31
191120840,2,2,4,7,8,23
191120841,2,6,4,1,3,16
191120842,8,5,7,2,8,30
191120843,9,4,4,1,9,27
191120844,8,4,4,5,5,26
191120845,6,5,7,9,4,31
191120846,5,1,2,0,2,10
191120847,9,1,9,6,7,32
191120848,3,3,0,1,4,11
191120849,1,1,1,0,1,4
191120850,2,8,3,8,2,23
191120851,7,8,4,6,2,27
191120852,3,7,1,3,5,19
191120853,6,2,7,1,5,21
191120854,8,0,6,1,7,22
191120855,2,0,6,5,7,20
191120856,9,5,8,8,4,34
191120857,4,0,8,5,9,26
191120858,7,4,9,1,1,22
191120859,8,3,7,3,0,21
191120860,0,1,1,7,0,9
191120861,3,2,5,7,4,21
191120862,2,5,4,3,8,22
191120863,5,3,3,6,3,20
191120864,9,5,4,4,5,27
191120865,2,3,9,6,5,25
191120866,5,7,3,0,2,17
191120867,1,9,8,7,6,31
191120868,2,4,1,2,7,16
191120869,3,7,9,6,8,33
191120870,2,4,0,0,0,6
191120871,4,6,1,5,2,18
191120872,3,2,9,9,3,26
191120873,0,7,5,1,3,16
191120874,8,0,7,9,0,24
191120875,5,9,5,4,6,29
191120876,9,1,8,9,3,30
191120877,2,4,4,8,2,20
191120878,5,9,3,0,5,22
191120879,9,6,5,3,4,27
191120880,7,1,5,0,8,21
191120881,2,2,9,1,2,16
191120882,2,2,0,1,5,10
191120883,7,7,3,5,7,29
191120884,2,7,5,6,5,25
191120885,5,0,9,3,5,22
191120886,4,5,9,5,3,26
191120887,4,3,8,2,3,20
191120888,8,0,8,0,9,25
191120889,4,7,5,8,5,29
191120890,2,0,1,2,8,13
191120891,8,3,2,7,8,28
191120892,0,7,5,2,6,20
191120893,1,7,7,6,8,29
191120894,5,0,0,4,7,16
191120895,1,0,9,8,1,19
191120896,7,8,4,4,0,23
191120897,4,7,0,2,8,21
191120898,5,2,5,6,5,23
191120899,7,9,9,6,9,40
191120900,0,1,8,8,2,19
191120901,8,3,9,3,9,32
191120902,5,5,6,4,5,25
191120903,8,7,6,4,7,32
191120904,1,7,7,2,5,22
191120905,5,9,2,7,3,26
191120906,0,0,3,3,0,6
191120907,0,1,0,1,1,3
191120908,0,1,0,3,2,6
191120909,2,2,1,9,8,22
191120910,8,6,6,9,6,35
191120911,0,0,0,9,2,11
191120912,4,2,3,3,6,18
191120913,0,5,5,7,1,18
191120914,1,5,5,6,3,20
191120915,8,1,9,2,7,27
191120916,3,5,0,6,1,15
191120917,4,0,7,9,0,20
191120918,0,9,4,9,8,30
191120919,5,5,3,5,5,23
191120920,0,2,5,9,9,25
191120921,4,9,0,2,4,19
191120922,7,0,0,8,6,21
191120923,9,8,8,5,8,38
191120924,9,3,3,1,3,19
191120925,1,4,5,1,3,14
191120926,5,4,2,3,0,14
191120927,3,3,0,6,4,16
191120928,2,0,6,9,0,17
191120929,7,8,7,6,6,34
191120930,0,5,1,0,5,11
191120931,3,7,0,8,6,24
191120932,9,8,2,2,6,27
191120933,1,6,2,9,6,24
191120934,2,6,9,2,6,25
191120935,2,7,7,9,6,31
191120936,8,4,5,5,5,27
191120937,8,5,0,6,8,27
191120938,2,9,3,0,1,15
191120939,0,2,1,0,5,8
191120940,2,6,6,5,7,26
191120941,4,1,2,9,4,20
191120942,2,2,6,4,0,14
191120943,7,1,9,6,5,28
191120944,9,8,4,8,2,31
191120945,9,4,4,9,5,31
191120946,8,5,5,1,4,23
191120947,2,2,7,6,3,20
191120948,8,3,5,7,5,28
191120949,7,8,2,5,6,28
191120950,5,5,8,5,9,32
191120951,4,3,8,2,9,26
191120952,0,9,0,1,2,12
191120953,8,5,8,3,4,28
191120954,1,5,4,0,8,18
191120955,6,7,2,4,0,19
191120956,0,7,7,6,6,26
191120957,4,0,0,8,0,12
191120958,5,2,5,3,4,19
191120959,9,9,5,8,7,38
191120960,5,5,2,4,2,18
191120961,7,4,1,4,7,23
191120962,7,9,5,1,0,22
191120963,1,3,7,7,9,27
191120964,1,1,8,5,5,20
191120965,0,4,5,7,6,22
191120966,1,7,4,6,2,20
191120967,7,8,3,6,9,33
191120968,2,0,0,3,6,11
191120969,9,5,2,2,6,24
191120970,8,2,8,9,9,36
191120971,6,9,0,0,9,24
191120972,0,3,7,3,6,19
191120973,7,3,1,3,7,21
191120974,2,4,7,4,5,22
191120975,3,0,7,7,3,20
191120976,2,1,5,2,8,18
191120977,1,4,9,0,8,22
191120978,4,8,5,9,8,34
191120979,9,5,9,6,3,32
191120980,6,6,8,8,2,30
191120981,0,0,1,1,4,6
191120982,6,7,2,3,9,27
191120983,8,1,8,8,7,32
191120984,0,7,9,1,8,25
191120985,8,3,5,9,3,28
191120986,9,2,1,4,1,17
191120987,3,0,2,1,7,13
191120988,0,0,5,5,3,13
191120989,3,1,8,1,3,16
191120990,7,7,1,6,7,28
191120991,3,6,7,8,1,25
191120992,2,8,3,9,3,25
191120993,6,9,9,7,0,31
191120994,3,0,2,7,3,15
191120995,8,4,3,3,1,19
191120996,4,0,9,4,8,25
191120997,3,1,7,2,4,17
191120998,0,4,7,5,3,19
191120999,1,1,2,4,3,11
1911201000,0,4,5,5,2,16
1911201001,0,6,9,8,0,23
1911201002,1,6,7,6,2,22
1911201003,7,2,6,8,1,24
1911201004,1,0,0,6,5,12
1911201005,4,2,9,6,3,24
1911201006,2,3,5,5,4,19
1911201007,0,9,3,8,4,24
1911201008,7,2,2,7,1,19
1911201009,1,0,4,0,7,12
1911201010,8,5,9,8,1,31
1911201011,1,4,6,0,0,11
1911201012,6,7,7,2,5,27
1911201013,8,9,7,5,7,36
1911201014,2,3,9,7,0,21
1911201015,2,0,3,3,4,12
1911201016,5,0,2,3,8,18
1911201017,6,6,4,3,3,22
1911201018,6,4,1,0,4,15
1911201019,5,2,5,5,0,17
1911201020,2,9,0,8,5,24
1911201021,2,2,2,4,2,12
1911201022,2,4,9,2,7,24
1911201023,1,1,7,2,9,20
1911201024,6,3,2,1,8,20
1911201025,7,4,2,7,5,25
1911201026,1,9,0,8,2,20
1911201027,0,9,8,0,6,23
1911201028,6,8,0,2,9,25
1911201029,7,5,8,4,5,29
1911201030,7,1,9,5,7,29
1911201031,1,9,9,6,5,30
1911201032,0,4,5,2,8,19
1911201033,1,9,3,4,3,20
1911201034,4,1,1,0,6,12
1911201035,1,3,7,2,5,18
1911201036,2,4,3,6,5,20
1911201037,0,0,8,0,4,12
1911201038,0,4,6,1,9,20
1911201039,4,8,9,6,1,28
1911201040,9,8,2,9,9,37
1911201041,8,9,4,8,6,35
1911201042,4,5,6,1,9,25
1911201043,9,6,2,6,4,27
1911201044,9,4,5,7,0,25
1911201045,0,1,2,0,4,7
1911201046,2,4,9,7,7,29
1911201047,9,0,2,8,4,23
1911201048,0,5,4,4,7,20
1911201049,8,3,5,8,3,27
1911201050,1,6,5,2,0,14
1911201051,9,3,3,6,2,23
1911201052,0,7,6,4,6,23
1911201053,6,3,4,1,9,23
1911201054,1,2,4,6,8,21
1911201055,6,1,1,5,8,21
1911201056,1,0,9,0,5,15
1911201057,5,1,0,7,2,15
1911201058,8,0,2,4,4,18
1911201059,1,9,4,6,3,23
1911201060,3,5,4,7,1,20
1911201061,9,6,7,3,4,29
1911201062,3,3,3,4,7,20
1911201063,2,8,7,0,2,19
1911201064,3,8,2,9,9,31
1911201065,5,3,6,8,8,30
1911201066,8,5,0,5,5,23
1911201067,0,0,0,3,9,12
1911201068,5,6,6,9,2,28
1911201069,7,2,2,3,1,15
1911201070,9,5,8,6,7,35
1911201071,3,7,3,0,1,14
1911201072,9,3,5,0,6,23
1911201073,1,3,6,8,0,18
1911201074,9,3,4,2,9,27
1911201075,8,8,8,0,6,30
1911201076,9,7,1,8,8,33
1911201077,7,3,2,0,6,18
1911201078,5,1,2,7,9,24
1911201079,0,5,1,0,1,7
1911201080,1,7,3,1,5,17
1911201081,0,0,4,9,4,17
1911201082,8,4,8,5,4,29
1911201083,8,4,1,8,7,28
1911201084,3,4,3,1,3,14
1911201085,5,9,3,0,1,18
1911201086,5,2,2,8,1,18
1911201087,0,2,1,3,4,10
1911201088,1,0,6,4,2,13
1911201089,0,0,1,4,3,8
1911201090,6,5,4,8,1,24
1911201091,5,0,3,3,2,13
1911201092,9,2,7,0,5,23
1911201093,0,0,6,9,4,19
1911201094,0,2,7,4,0,13
1911201095,5,4,9,1,5,24
1911201096,7,6,5,9,4,31
1911201097,7,5,9,8,6,35
1911201098,6,0,5,5,4,20
1911201099,9,1,2,7,9,28
1911201100,5,3,4,8,0,20
1911201101,8,9,7,9,5,38
1911201102,2,2,1,8,1,14
1911201103,5,9,4,1,1,20
1911201104,3,2,1,4,9,19
1911201105,7,3,0,4,9,23
191121001,3,3,6,9,8,29
191121002,0,1,5,6,9,21
191121003,7,7,6,0,9,29
191121004,3,3,2,5,6,19
191121005,4,9,2,2,0,17
191121006,0,8,3,9,4,24
191121007,6,5,8,3,8,30
191121008,7,4,6,6,3,26
191121009,1,5,8,1,7,22
191121010,6,6,2,9,9,32
191121011,8,6,9,4,3,30
191121012,8,7,7,1,9,32
191121013,1,9,8,0,7,25
191121014,3,1,0,6,7,17
191121015,2,7,4,7,4,24
191121016,1,6,2,8,3,20
191121017,9,6,7,8,4,34
191121018,4,9,1,0,7,21
191121019,4,5,7,3,9,28
191121020,1,9,7,3,5,25
191121021,0,5,7,6,5,23
191121022,6,9,9,0,4,28
191121023,8,2,4,6,0,20
191121024,3,5,7,7,8,30
191121025,5,4,7,8,3,27
191121026,9,5,4,3,2,23
191121027,9,4,7,2,6,28
191121028,0,6,9,3,3,21
191121029,9,8,4,9,6,36
191121030,0,9,7,6,7,29
191121031,5,6,5,0,5,21
191121032,7,1,0,4,3,15
191121033,6,5,6,2,4,23
191121034,0,4,9,9,8,30
191121035,3,7,5,2,6,23
191121036,0,9,2,6,8,25
191121037,0,8,6,6,5,25
191121038,9,9,1,7,8,34
191121039,4,8,0,2,8,22
191121040,5,0,5,0,6,16
191121041,1,1,7,2,8,19
191121042,1,6,7,1,8,23
191121043,1,8,6,9,2,26
191121044,8,6,1,9,3,27
191121045,0,0,3,3,1,7
191121046,9,9,1,0,9,28
191121047,6,4,0,4,3,17
191121048,6,4,0,1,9,20
191121049,1,1,3,7,1,13
191121050,4,7,6,2,3,22
191121051,7,3,8,5,2,25
191121052,9,6,0,4,6,25
191121053,8,7,2,4,6,27
191121054,2,1,3,5,7,18
191121055,3,2,0,5,1,11
191121056,0,0,6,5,2,13
191121057,0,4,3,9,2,18
191121058,7,1,7,5,2,22
191121059,5,9,9,7,5,35
191121060,6,2,1,3,8,20
191121061,6,3,2,9,2,22
191121062,4,7,0,2,9,22
191121063,0,4,1,0,8,13
191121064,5,9,4,7,6,31
191121065,3,9,5,0,3,20
191121066,4,8,4,3,4,23
191121067,2,2,8,1,7,20
191121068,7,1,7,7,2,24
191121069,8,3,9,1,6,27
191121070,5,2,7,2,5,21
191121071,2,6,3,7,4,22
191121072,2,5,9,3,4,23
191121073,3,8,2,0,3,16
191121074,6,5,2,8,5,26
191121075,0,9,1,6,8,24
191121076,7,6,4,7,4,28
191121077,4,0,8,1,7,20
191121078,6,1,7,7,2,23
191121079,0,5,2,2,0,9
191121080,0,9,3,8,7,27
191121081,5,6,2,9,4,26
191121082,4,6,5,8,6,29
191121083,9,2,0,8,9,28
191121084,2,6,8,4,6,26
191121085,1,0,2,7,9,19
191121086,7,2,4,1,4,18
191121087,9,6,9,2,0,26
191121088,7,3,0,2,3,15
191121089,7,6,9,7,9,38
191121090,5,6,0,6,2,19
191121091,4,1,1,1,4,11
191121092,3,9,7,6,6,31
191121093,5,0,5,2,2,14
191121094,0,9,3,3,8,23
191121095,7,5,0,4,3,19
191121096,7,4,8,2,5,26
191121097,2,4,7,2,4,19
191121098,1,4,9,9,8,31
191121099,1,8,7,1,4,21
191121100,5,4,9,0,1,19
191121101,1,6,6,1,7,21
191121102,8,5,3,8,2,26
191121103,7,9,5,0,6,27
191121104,3,5,9,8,3,28
191121105,7,8,6,9,4,34
191121106,5,6,1,9,4,25
191121107,9,3,9,8,2,31
191121108,7,2,3,0,9,21
191121109,3,6,1,0,0,10
191121110,6,6,4,5,0,21
191121111,7,9,5,9,7,37
191121112,4,0,1,1,2,8
191121113,0,0,3,5,4,12
191121114,1,1,9,5,0,16
191121115,5,8,8,6,2,29
191121116,0,4,9,6,8,27
191121117,7,4,7,2,6,26
191121118,2,1,0,2,4,9
191121119,2,0,4,1,5,12
191121120,3,8,8,1,4,24
191121121,1,8,8,9,5,31
191121122,9,7,1,5,4,26
191121123,0,1,9,0,2,12
191121124,8,9,0,7,2,26
191121125,1,3,9,2,4,19
191121126,2,8,2,2,7,21
191121127,2,1,6,1,5,15
191121128,1,0,6,7,4,18
191121129,1,8,4,3,1,17
191121130,1,8,7,2,2,20
191121131,9,5,0,6,3,23
191121132,6,1,4,5,3,19
191121133,1,1,2,6,9,19
191121134,6,1,4,6,6,23
191121135,8,9,2,7,9,35
191121136,9,0,2,4,0,15
191121137,8,2,9,9,7,35
191121138,5,6,7,3,1,22
191121139,3,2,8,6,1,20
191121140,1,1,0,9,4,15
191121141,8,1,5,2,2,18
191121142,6,2,6,8,2,24
191121143,3,8,9,9,0,29
191121144,2,6,7,8,7,30
191121145,4,0,8,2,0,14
191121146,6,4,0,2,7,19
191121147,0,2,9,2,2,15
191121148,9,1,3,3,7,23
191121149,3,3,9,2,0,17
191121150,2,2,0,6,0,10
191121151,6,0,3,7,1,17
191121152,7,7,7,4,5,30
191121153,1,5,3,2,7,18
191121154,1,4,9,0,1,15
191121155,6,7,7,8,7,35
191121156,5,9,3,7,2,26
191121157,8,3,1,9,8,29
191121158,3,5,9,8,8,33
191121159,7,9,1,3,0,20
191121160,0,6,5,5,1,17
191121161,4,0,4,8,7,23
191121162,0,6,0,4,4,14
191121163,5,1,4,7,0,17
191121164,3,9,4,4,4,24
191121165,3,6,6,7,0,22
191121166,0,9,0,4,6,19
191121167,3,2,6,3,2,16
191121168,0,0,4,7,7,18
191121169,0,4,8,6,9,27
191121170,4,5,9,8,1,27
191121171,1,3,8,4,3,19
191121172,4,1,6,6,4,21
191121173,3,0,4,5,8,20
191121174,7,9,1,6,3,26
191121175,5,1,0,2,8,16
191121176,8,3,8,6,4,29
191121177,3,3,1,9,5,21
191121178,6,1,1,3,5,16
191121179,5,2,7,2,0,16
191121180,0,1,8,2,2,13
191121181,4,2,4,0,3,13
191121182,5,5,8,7,3,28
191121183,1,9,8,6,2,26
191121184,8,5,1,5,2,21
191121185,6,4,6,4,3,23
191121186,7,0,8,9,5,29
191121187,8,9,0,6,8,31
191121188,1,5,8,5,4,23
191121189,5,1,4,8,6,24
191121190,0,5,0,0,6,11
191121191,6,7,2,3,4,22
191121192,8,7,4,0,1,20
191121193,7,1,6,7,2,23
191121194,4,6,6,3,4,23
191121195,8,3,9,2,4,26
191121196,5,8,1,2,4,20
191121197,5,0,9,8,3,25
191121198,9,4,8,2,4,27
191121199,0,9,7,6,8,30
191121200,2,0,2,3,6,13
191121201,2,3,9,4,4,22
191121202,5,5,2,0,7,19
191121203,2,5,6,0,1,14
191121204,7,2,3,8,3,23
191121205,4,6,5,6,2,23
191121206,4,5,1,0,5,15
191121207,4,2,3,5,0,14
191121208,0,7,0,8,6,21
191121209,0,8,5,0,5,18
191121210,7,4,0,8,6,25
191121211,7,0,1,6,7,21
191121212,4,1,9,9,6,29
191121213,2,6,0,1,0,9
191121214,1,5,6,9,3,24
191121215,4,8,4,7,8,31
191121216,9,3,8,3,2,25
191121217,7,3,6,7,4,27
191121218,5,5,1,2,1,14
191121219,1,2,1,7,3,14
191121220,4,2,0,3,3,12
191121221,6,4,6,7,1,24
191121222,5,0,3,0,4,12
191121223,5,2,2,6,8,23
191121224,9,5,4,5,6,29
191121225,0,5,3,2,4,14
191121226,4,6,4,7,0,21
191121227,9,2,6,9,3,29
191121228,5,6,6,4,0,21
191121229,7,6,0,0,0,13
191121230,0,1,9,4,8,22
191121231,1,1,9,8,7,26
191121232,0,1,0,1,2,4
191121233,7,2,4,9,6,28
191121234,2,6,7,5,7,27
191121235,4,0,2,9,0,15
191121236,4,7,5,3,7,26
191121237,7,4,8,7,2,28
191121238,4,6,4,8,5,27
191121239,5,4,2,4,1,16
191121240,0,5,8,4,1,18
191121241,4,6,8,7,4,29
191121242,7,6,0,7,3,23
191121243,5,2,3,2,2,14
191121244,4,8,2,6,0,20
191121245,4,3,2,0,2,11
191121246,4,8,5,5,3,25
191121247,4,0,6,6,0,16
191121248,3,1,1,3,8,16
191121249,6,3,2,6,5,22
191121250,3,3,8,2,0,16
191121251,0,2,0,3,9,14
191121252,2,2,5,5,6,20
191121253,9,6,2,1,7,25
191121254,4,3,6,2,9,24
191121255,8,0,8,4,6,26
191121256,9,0,2,3,8,22
191121257,4,5,5,9,5,28
191121258,5,4,2,2,3,16
191121259,2,8,3,7,1,21
191121260,0,5,2,9,1,17
191121261,9,2,8,0,1,20
191121262,0,5,8,5,4,22
191121263,0,0,9,3,6,18
191121264,5,5,6,5,9,30
191121265,1,1,8,0,2,12
191121266,5,1,9,9,4,28
191121267,1,1,4,9,0,15
191121268,9,3,4,7,1,24
191121269,3,6,6,2,6,23
191121270,7,3,5,0,0,15
191121271,9,7,5,3,5,29
191121272,2,8,6,9,9,34
191121273,7,9,7,8,7,38
191121274,6,1,3,2,3,15
191121275,5,5,3,7,8,28
191121276,1,2,1,8,8,20
191121277,8,1,5,0,6,20
191121278,5,8,5,6,1,25
191121279,7,2,3,2,1,15
191121280,6,3,1,4,9,23
191121281,9,2,3,1,8,23
191121282,3,9,4,3,5,24
191121283,3,1,7,9,5,25
191121284,4,3,8,2,0,17
191121285,6,8,5,0,5,24
191121286,9,5,4,4,6,28
191121287,8,2,1,3,6,20
191121288,2,3,0,2,6,13
191121289,1,9,9,5,9,33
191121290,9,3,0,9,8,29
191121291,0,2,7,5,5,19
191121292,1,4,5,9,4,23
191121293,2,8,6,8,4,28
191121294,0,2,6,6,3,17
191121295,7,2,4,7,1,21
191121296,4,4,3,3,9,23
191121297,5,4,0,1,8,18
191121298,1,6,1,2,9,19
191121299,7,3,2,6,2,20
191121300,8,2,2,7,7,26
191121301,3,3,2,3,9,20
191121302,0,3,3,7,5,18
191121303,8,7,8,3,4,30
191121304,1,4,8,4,0,17
191121305,5,7,8,6,5,31
191121306,6,3,4,0,9,22
191121307,4,7,6,8,7,32
191121308,6,7,6,0,6,25
191121309,7,0,0,7,7,21
191121310,9,6,5,0,1,21
191121311,7,3,5,3,0,18
191121312,3,5,0,5,4,17
191121313,7,3,0,0,7,17
191121314,0,2,2,7,9,20
191121315,4,8,0,4,1,17
191121316,2,4,6,8,1,21
191121317,3,2,7,6,4,22
191121318,3,8,0,6,1,18
191121319,7,6,4,3,1,21
191121320,3,6,3,6,3,21
191121321,4,1,0,0,4,9
191121322,1,8,7,7,9,32
191121323,0,9,6,7,4,26
191121324,7,3,7,5,5,27
191121325,0,3,4,6,1,14
191121326,7,4,3,2,9,25
191121327,5,8,7,0,8,28
191121328,5,0,6,4,7,22
191121329,9,7,4,0,3,23
191121330,3,8,5,6,1,23
191121331,4,8,6,6,6,30
191121332,8,5,7,8,8,36
191121333,2,0,1,9,7,19
191121334,0,1,9,5,1,16
191121335,4,7,4,7,6,28
191121336,1,7,1,2,9,20
191121337,8,8,4,5,0,25
191121338,1,6,3,3,5,18
191121339,5,2,8,6,5,26
191121340,2,5,7,4,8,26
191121341,0,2,4,7,7,20
191121342,2,9,9,2,4,26
191121343,4,1,0,7,1,13
191121344,1,2,4,5,7,19
191121345,0,6,1,1,1,9
191121346,1,4,5,0,6,16
191121347,6,9,1,9,2,27
191121348,1,5,1,9,7,23
191121349,4,4,0,0,0,8
191121350,9,4,3,0,8,24
191121351,0,0,7,2,1,10
191121352,4,1,0,0,6,11
191121353,8,9,8,9,3,37
191121354,5,1,3,1,1,11
191121355,0,9,2,5,8,24
191121356,6,5,6,6,4,27
191121357,3,1,9,4,8,25
191121358,4,1,0,2,3,10
191121359,9,6,9,9,6,39
191121360,4,2,7,6,5,24
191121361,2,4,0,3,9,18
191121362,3,1,3,9,1,17
191121363,1,3,4,9,3,20
191121364,6,6,6,3,6,27
191121365,5,4,7,1,2,19
191121366,7,6,6,5,8,32
191121367,1,5,3,0,4,13
191121368,0,9,0,4,7,20
191121369,7,0,9,1,7,24
191121370,7,2,3,0,7,19
191121371,3,5,5,8,5,26
191121372,9,7,2,5,6,29
191121373,9,0,0,9,9,27
191121374,3,7,7,3,7,27
191121375,6,3,6,2,0,17
191121376,8,5,6,9,2,30
191121377,3,3,0,3,7,16
191121378,2,4,8,5,6,25
191121379,2,5,9,7,1,24
191121380,0,7,8,0,5,20
191121381,8,3,7,9,3,30
191121382,1,3,0,0,9,13
191121383,1,3,6,5,4,19
191121384,5,8,0,9,5,27
191121385,4,4,6,0,2,16
191121386,7,5,8,0,7,27
191121387,0,5,7,7,9,28
191121388,1,9,3,2,1,16
191121389,6,0,0,9,8,23
191121390,0,6,7,1,7,21
191121391,1,2,0,7,2,12
191121392,0,4,6,5,3,18
191121393,0,4,6,0,0,10
191121394,4,2,7,8,4,25
191121395,0,1,0,5,0,6
191121396,0,8,7,5,3,23
191121397,7,1,7,2,5,22
191121398,5,3,2,3,5,18
191121399,8,4,4,7,4,27
191121400,0,8,8,6,2,24
191121401,5,0,6,2,6,19
191121402,1,4,3,2,5,15
191121403,0,5,0,3,5,13
191121404,5,6,7,0,2,20
191121405,1,2,8,4,4,19
191121406,9,4,2,1,6,22
191121407,8,6,4,9,3,30
191121408,1,1,7,2,2,13
191121409,9,1,7,0,0,17
191121410,6,3,3,3,0,15
191121411,9,9,8,6,4,36
191121412,7,4,9,4,6,30
191121413,2,8,1,7,1,19
191121414,4,2,1,6,4,17
191121415,8,7,3,9,6,33
191121416,3,6,2,8,0,19
191121417,6,8,1,6,5,26
191121418,1,0,0,7,0,8
191121419,8,7,2,2,1,20
191121420,4,4,5,2,6,21
191121421,6,2,0,9,1,18
191121422,6,5,5,7,8,31
191121423,5,5,3,8,2,23
191121424,9,7,8,4,7,35
191121425,1,1,2,3,5,12
191121426,6,0,4,0,8,18
191121427,5,7,0,5,6,23
191121428,9,5,3,7,6,30
191121429,9,6,8,4,3,30
191121430,6,3,2,3,6,20
191121431,6,7,3,9,2,27
191121432,8,3,7,2,5,25
191121433,7,3,1,6,9,26
191121434,3,2,8,6,3,22
191121435,6,0,5,6,4,21
191121436,2,6,7,2,0,17
191121437,9,5,2,5,5,26
191121438,4,2,9,4,9,28
191121439,4,5,7,2,2,20
191121440,9,0,6,1,5,21
191121441,8,6,4,2,9,29
191121442,5,8,1,3,6,23
191121443,7,7,8,3,4,29
191121444,7,9,8,1,5,30
191121445,6,7,0,5,1,19
191121446,1,9,7,2,9,28
191121447,8,0,1,3,9,21
191121448,0,3,2,6,4,15
191121449,8,2,5,4,3,22
191121450,2,1,8,3,3,17
191121451,5,3,2,1,5,16
191121452,2,8,5,4,3,22
191121453,4,6,7,5,1,23
191121454,3,5,6,6,5,25
191121455,0,6,9,1,8,24
191121456,2,9,0,5,0,16
191121457,1,1,7,7,5,21
191121458,1,1,1,2,1,6
191121459,4,8,7,1,6,26
191121460,1,9,1,3,7,21
191121461,5,7,6,5,4,27
191121462,0,3,6,9,6,24
191121463,9,2,0,8,2,21
191121464,9,7,4,2,1,23
191121465,3,7,0,3,7,20
191121466,5,6,8,6,3,28
191121467,4,2,9,3,7,25
191121468,3,9,4,6,3,25
191121469,7,5,6,0,1,19
191121470,1,6,2,8,0,17
191121471,0,4,4,7,6,21
191121472,7,4,4,4,1,20
191121473,7,6,9,5,9,36
191121474,9,4,9,3,8,33
191121475,7,0,8,8,1,24
191121476,7,2,3,6,7,25
191121477,4,8,6,4,0,22
191121478,9,1,9,2,4,25
191121479,5,8,0,5,6,24
191121480,7,7,3,3,1,21
191121481,1,2,8,6,3,20
191121482,2,3,0,8,3,16
191121483,1,1,4,5,7,18
191121484,0,8,6,5,7,26
191121485,3,9,8,8,6,34
191121486,1,8,7,8,1,25
191121487,0,8,2,1,2,13
191121488,7,0,8,0,5,20
191121489,5,9,6,0,9,29
191121490,7,5,5,2,8,27
191121491,1,3,7,8,3,22
191121492,8,3,8,7,5,31
191121493,5,0,0,2,9,16
191121494,6,1,3,0,1,11
191121495,0,4,3,0,5,12
191121496,0,2,6,4,7,19
191121497,6,1,1,1,6,15
191121498,0,5,8,9,4,26
191121499,1,9,5,9,4,28
191121500,0,4,1,1,3,9
191121501,9,2,8,8,3,30
191121502,8,8,6,6,7,35
191121503,9,5,2,5,0,21
191121504,2,1,8,5,6,22
191121505,2,1,6,4,2,15
191121506,7,9,8,2,6,32
191121507,1,2,1,9,0,13
191121508,1,9,3,6,5,24
191121509,3,3,1,6,5,18
191121510,4,7,1,7,1,20
191121511,0,6,2,8,2,18
191121512,9,9,0,4,6,28
191121513,4,3,5,7,9,28
191121514,3,3,0,0,5,11
191121515,0,0,1,8,5,14
191121516,4,9,9,0,7,29
191121517,8,0,9,0,5,22
191121518,0,5,5,7,8,25
191121519,1,1,0,9,9,20
191121520,4,0,8,6,6,24
191121521,3,3,4,2,2,14
191121522,3,6,4,8,8,29
191121523,7,7,8,7,1,30
191121524,7,7,9,0,4,27
191121525,5,3,9,7,9,33
191121526,6,1,2,2,2,13
191121527,5,5,6,4,8,28
191121528,3,2,7,1,0,13
191121529,3,6,6,5,9,29
191121530,2,8,7,6,1,24
191121531,3,8,0,2,1,14
191121532,8,0,6,5,5,24
191121533,9,3,4,2,2,20
191121534,3,2,3,4,7,19
191121535,0,2,8,8,1,19
191121536,4,2,5,3,5,19
191121537,6,4,5,7,2,24
191121538,5,6,3,9,2,25
191121539,2,7,7,7,1,24
191121540,7,2,6,5,4,24
191121541,5,0,0,7,1,13
191121542,1,9,9,3,6,28
191121543,4,7,2,5,2,20
191121544,2,8,1,3,3,17
191121545,3,8,2,3,8,24
191121546,7,5,2,7,6,27
191121547,3,3,5,8,7,26
191121548,4,0,1,6,2,13
191121549,7,4,4,9,4,28
191121550,1,2,5,1,3,12
191121551,5,7,8,7,9,36
191121552,2,7,9,4,9,31
191121553,0,0,5,8,9,22
191121554,4,6,3,9,3,25
191121555,4,3,5,1,3,16
191121556,3,5,1,6,2,17
191121557,5,4,9,0,7,25
191121558,7,8,0,0,9,24
191121559,2,4,1,5,1,13
191121560,1,7,5,5,6,24
191121561,9,1,2,9,9,30
191121562,3,8,6,6,2,25
191121563,9,6,2,0,0,17
191121564,8,2,0,5,4,19
191121565,0,7,6,5,8,26
191121566,6,3,4,9,9,31
191121567,3,5,4,1,4,17
191121568,2,3,7,4,0,16
191121569,8,6,5,3,7,29
191121570,2,6,4,5,3,20
191121571,3,0,8,0,8,19
191121572,5,9,7,0,6,27
191121573,0,7,7,6,0,20
191121574,3,7,6,4,1,21
191121575,4,0,7,7,1,19
191121576,8,0,1,5,8,22
191121577,2,4,4,7,3,20
191121578,9,6,0,0,6,21
191121579,5,6,9,0,2,22
191121580,0,5,6,9,1,21
191121581,6,9,0,6,1,22
191121582,2,9,6,1,4,22
191121583,9,0,1,2,0,12
191121584,2,0,0,8,2,12
191121585,5,3,5,3,4,20
191121586,4,0,7,0,3,14
191121587,3,2,5,2,8,20
191121588,9,2,4,3,4,22
191121589,5,4,8,3,0,20
191121590,2,4,8,2,0,16
191121591,5,4,9,9,4,31
191121592,8,5,2,0,3,18
191121593,7,3,8,3,5,26
191121594,0,4,5,7,8,24
191121595,9,9,4,1,9,32
191121596,5,2,6,7,7,27
191121597,0,8,2,2,8,20
191121598,0,4,8,2,9,23
191121599,9,1,7,8,5,30
191121600,7,5,9,9,7,37
191121601,1,0,6,1,1,9
191121602,8,6,4,0,2,20
191121603,7,1,1,6,2,17
191121604,9,1,9,4,9,32
191121605,4,2,2,3,1,12
191121606,6,4,6,7,3,26
191121607,2,4,2,7,1,16
191121608,3,6,9,3,7,28
191121609,5,7,3,3,8,26
191121610,1,6,7,1,0,15
191121611,2,0,5,2,4,13
191121612,6,8,4,1,9,28
191121613,7,5,6,1,4,23
191121614,6,9,9,2,7,33
191121615,0,2,2,8,3,15
191121616,6,5,9,5,0,25
191121617,7,8,6,3,5,29
191121618,1,9,3,7,5,25
191121619,2,7,6,4,2,21
191121620,7,7,0,4,7,25
191121621,3,6,6,6,4,25
191121622,2,5,9,7,9,32
191121623,1,7,3,5,0,16
191121624,1,9,8,9,1,28
191121625,8,7,7,6,1,29
191121626,9,4,5,1,2,21
191121627,5,3,5,4,1,18
191121628,8,8,7,6,6,35
191121629,1,7,4,1,2,15
191121630,0,2,9,2,8,21
191121631,7,6,6,3,0,22
191121632,8,1,9,1,9,28
191121633,2,5,0,0,7,14
191121634,5,6,0,9,3,23
191121635,8,7,4,6,8,33
191121636,4,1,9,3,4,21
191121637,5,2,4,4,1,16
191121638,7,1,7,5,3,23
191121639,7,4,0,1,8,20
191121640,5,9,5,7,7,33
191121641,1,8,9,4,7,29
191121642,0,3,3,3,1,10
191121643,7,5,1,7,4,24
191121644,9,7,7,2,9,34
191121645,3,6,9,3,5,26
191121646,9,1,5,5,1,21
191121647,3,1,6,7,9,26
191121648,5,6,7,8,5,31
191121649,0,1,2,6,7,16
191121650,9,6,2,6,5,28
191121651,3,2,6,9,1,21
191121652,5,8,8,0,7,28
191121653,3,5,3,1,0,12
191121654,8,7,2,2,5,24
191121655,9,7,1,6,8,31
191121656,8,9,7,4,8,36
191121657,8,8,1,4,5,26
191121658,9,7,0,2,9,27
191121659,8,9,5,1,2,25
191121660,1,9,1,1,8,20
191121661,2,6,3,8,6,25
191121662,5,9,7,6,0,27
191121663,8,6,7,3,6,30
191121664,3,8,1,0,7,19
191121665,6,1,6,2,2,17
191121666,3,0,8,3,9,23
191121667,1,6,9,9,9,34
191121668,9,1,1,0,5,16
191121669,3,9,8,3,1,24
191121670,7,7,3,6,7,30
191121671,1,1,4,7,7,20
191121672,5,2,3,3,4,17
191121673,9,1,0,4,4,18
191121674,9,9,6,0,4,28
191121675,5,8,4,0,3,20
191121676,0,1,1,8,3,13
191121677,6,5,9,3,9,32
191121678,1,7,6,7,7,28
191121679,5,7,4,1,1,18
191121680,2,1,0,3,4,10
191121681,2,5,6,0,0,13
191121682,4,3,4,7,8,26
191121683,1,1,6,9,6,23
191121684,3,9,4,2,9,27
191121685,9,0,7,9,4,29
191121686,3,2,2,4,6,17
191121687,8,7,2,4,0,21
191121688,1,7,3,2,2,15
191121689,3,3,2,1,7,16
191121690,6,0,5,5,5,21
191121691,2,1,6,6,9,24
191121692,1,1,2,0,0,4
191121693,9,0,1,9,4,23
191121694,7,2,6,3,3,21
191121695,4,7,5,1,4,21
191121696,9,6,8,6,2,31
191121697,3,9,9,0,5,26
191121698,2,9,4,3,2,20
191121699,3,5,8,6,1,23
191121700,9,4,7,5,0,25
191121701,2,3,5,7,9,26
191121702,9,3,5,1,1,19
191121703,9,8,3,0,8,28
191121704,3,8,4,6,1,22
191121705,9,2,5,9,3,28
191121706,8,0,4,3,6,21
191121707,1,8,8,5,8,30
191121708,4,1,7,3,6,21
191121709,5,4,3,4,2,18
191121710,6,6,7,0,4,23
191121711,1,4,8,7,2,22
191121712,9,2,8,1,4,24
191121713,4,8,9,3,2,26
191121714,5,5,8,5,1,24
191121715,8,9,0,9,8,34
191121716,3,4,8,5,3,23
191121717,5,7,5,5,6,28
191121718,4,3,8,6,7,28
191121719,5,5,1,1,2,14
191121720,2,8,6,1,4,21
191121721,4,0,3,7,8,22
191121722,9,7,3,7,1,27
191121723,1,4,5,5,2,17
191121724,9,0,0,0,2,11
191121725,7,8,8,3,8,34
191121726,1,8,4,7,2,22
191121727,9,4,3,2,5,23
191121728,7,2,4,5,5,23
191121729,7,1,2,4,5,19
191121730,4,9,8,5,6,32
191121731,1,5,3,0,0,9
191121732,1,6,8,3,2,20
191121733,9,4,3,7,2,25
191121734,5,9,2,0,4,20
191121735,0,4,2,8,3,17
191121736,6,3,2,8,1,20
191121737,4,9,4,4,4,25
191121738,7,8,3,5,9,32
191121739,1,6,6,7,2,22
191121740,3,8,4,2,6,23
191121741,1,9,8,3,2,23
191121742,1,5,5,7,7,25
191121743,8,9,4,1,6,28
191121744,8,0,4,7,9,28
191121745,1,0,3,0,3,7
191121746,5,2,2,5,9,23
191121747,9,5,4,9,1,28
191121748,5,0,2,5,2,14
191121749,0,8,8,9,4,29
191121750,6,2,6,7,8,29
191121751,6,3,8,6,7,30
191121752,1,5,6,3,1,16
191121753,3,3,2,2,5,15
191121754,6,9,5,0,1,21
191121755,4,9,2,5,6,26
191121756,3,4,7,2,4,20
191121757,0,8,9,6,8,31
191121758,8,4,6,6,4,28
191121759,1,0,8,3,8,20
191121760,0,4,3,1,0,8
191121761,2,3,6,2,0,13
191121762,1,4,6,9,4,24
191121763,9,2,6,1,8,26
191121764,5,2,6,7,5,25
191121765,3,3,7,0,2,15
191121766,0,4,1,1,9,15
191121767,9,1,0,2,6,18
191121768,8,1,3,4,2,18
191121769,3,3,3,9,5,23
191121770,9,1,1,4,4,19
191121771,9,6,1,2,2,20
191121772,2,6,4,2,3,17
191121773,3,0,4,0,2,9
191121774,5,4,2,0,5,16
191121775,4,4,0,1,6,15
191121776,3,6,0,6,4,19
191121777,1,6,5,6,6,24
191121778,0,4,0,5,0,9
191121779,1,6,4,9,3,23
191121780,0,1,6,7,6,20
191121781,1,1,8,5,4,19
191121782,9,5,3,2,7,26
191121783,5,5,6,4,1,21
191121784,9,0,3,6,6,24
191121785,7,0,0,2,6,15
191121786,1,2,2,9,2,16
191121787,9,9,4,3,7,32
191121788,4,1,1,0,1,7
191121789,5,4,3,3,0,15
191121790,7,8,5,2,0,22
191121791,9,0,9,0,0,18
191121792,7,3,2,9,7,28
191121793,7,2,4,2,2,17
191121794,8,8,1,5,6,28
191121795,4,2,9,8,0,23
191121796,8,6,9,2,7,32
191121797,7,5,0,8,9,29
191121798,4,0,4,2,0,10
191121799,9,8,3,2,4,26
191121800,2,0,7,3,2,14
191121801,4,3,8,6,2,23
191121802,5,8,6,3,2,24
191121803,9,6,7,1,8,31
191121804,3,0,0,7,5,15
191121805,1,2,2,3,4,12
191121806,7,2,9,6,7,31
191121807,3,5,6,0,4,18
191121808,3,4,1,9,0,17
191121809,6,7,5,0,5,23
191121810,3,5,5,5,3,21
191121811,4,1,6,1,3,15
191121812,1,8,2,2,5,18
191121813,5,4,9,8,3,29
191121814,6,8,2,3,9,28
191121815,5,8,9,7,6,35
191121816,1,4,0,1,1,7
191121817,3,6,9,9,4,31
191121818,1,0,3,5,9,18
191121819,3,2,0,3,4,12
191121820,6,5,7,0,8,26
191121821,9,6,2,9,6,32
191121822,2,1,2,3,5,13
191121823,6,8,2,1,3,20
191121824,4,3,3,4,8,22
191121825,7,3,6,1,6,23
191121826,6,8,2,4,1,21
191121827,0,6,8,8,5,27
191121828,0,6,0,8,3,17
191121829,5,5,0,3,6,19
191121830,9,9,9,1,9,37
191121831,4,2,1,3,6,16
191121832,5,2,6,2,3,18
191121833,4,2,6,1,3,16
191121834,2,6,7,6,0,21
191121835,4,8,3,0,8,23
191121836,1,2,5,1,4,13
191121837,4,5,8,1,6,24
191121838,5,1,7,8,7,28
191121839,1,3,3,1,5,13
191121840,0,1,6,0,0,7
191121841,5,5,3,2,5,20
191121842,0,2,0,9,0,11
191121843,1,1,7,6,2,17
191121844,6,5,1,9,6,27
191121845,2,9,4,7,5,27
191121846,0,5,4,7,5,21
191121847,7,6,6,8,0,27
191121848,5,5,4,7,7,28
191121849,8,0,4,9,1,22
191121850,4,8,3,2,9,26
191121851,3,9,5,5,9,31
191121852,9,2,8,4,4,27
191121853,1,7,7,6,1,22
191121854,4,9,1,1,6,21
191121855,6,2,7,1,7,23
191121856,5,3,2,8,7,25
191121857,6,9,1,2,1,19
191121858,9,6,6,3,2,26
191121859,1,4,6,4,9,24
191121860,2,5,9,5,4,25
191121861,6,4,6,1,2,19
191121862,1,4,8,0,6,19
191121863,6,3,6,0,7,22
191121864,5,0,2,2,8,17
191121865,5,8,4,3,6,26
191121866,1,7,4,0,7,19
191121867,4,7,8,1,7,27
191121868,8,5,6,8,4,31
191121869,2,0,6,8,2,18
191121870,6,8,4,5,2,25
191121871,0,8,0,5,6,19
191121872,3,5,6,8,2,24
191121873,8,7,2,7,0,24
191121874,0,9,0,2,7,18
191121875,2,5,9,6,5,27
191121876,3,8,0,8,5,24
191121877,4,5,8,8,6,31
191121878,3,5,6,5,1,20
191121879,9,5,1,4,0,19
191121880,7,9,4,1,3,24
191121881,6,9,7,7,4,33
191121882,7,2,3,3,2,17
191121883,2,0,9,1,7,19
191121884,1,8,9,3,3,24
191121885,2,4,9,2,6,23
191121886,6,0,9,2,1,18
191121887,2,0,5,0,6,13
191121888,4,6,1,2,7,20
191121889,4,3,4,1,8,20
191121890,3,6,2,7,0,18
191121891,4,2,8,0,2,16
191121892,3,7,0,1,6,17
191121893,7,3,2,4,9,25
191121894,9,3,7,3,0,22
191121895,4,7,4,4,6,25
191121896,7,4,0,0,1,12
191121897,6,4,8,0,6,24
191121898,3,8,5,2,2,20
191121899,0,2,1,0,7,10
191121900,4,0,7,4,8,23
191121901,7,6,4,8,8,33
191121902,7,0,8,0,3,18
191121903,8,3,7,6,1,25
191121904,9,2,3,5,1,20
191121905,7,4,2,2,0,15
191121906,3,5,0,2,0,10
191121907,7,6,4,7,9,33
191121908,1,6,7,2,1,17
191121909,3,4,9,5,7,28
191121910,2,6,7,5,1,21
191121911,1,2,2,7,4,16
191121912,2,5,8,7,1,23
191121913,4,0,4,4,5,17
191121914,3,8,2,2,8,23
191121915,6,7,8,1,1,23
191121916,0,4,8,5,6,23
191121917,9,1,5,4,9,28
191121918,0,9,9,2,1,21
191121919,2,1,2,1,7,13
191121920,0,6,0,9,9,24
191121921,3,4,5,8,9,29
191121922,8,3,7,2,9,29
191121923,2,8,7,1,3,21
191121924,2,9,3,9,2,25
191121925,0,4,8,8,8,28
191121926,3,4,6,0,2,15
191121927,2,5,2,2,4,15
191121928,3,4,1,6,6,20
191121929,0,0,6,2,4,12
191121930,8,5,3,6,7,29
191121931,1,3,9,4,0,17
191121932,9,6,4,7,6,32
191121933,4,8,0,5,3,20
191121934,0,6,7,1,6,20
191121935,9,1,9,6,0,25
191121936,7,6,3,7,3,26
191121937,6,5,5,4,9,29
191121938,4,6,9,4,0,23
191121939,7,3,4,4,4,22
191121940,3,5,5,7,6,26
191121941,7,2,6,3,4,22
191121942,9,1,5,4,8,27
191121943,4,4,7,6,8,29
191121944,9,6,6,6,1,28
191121945,8,4,0,2,8,22
191121946,7,9,6,5,6,33
191121947,1,7,9,7,0,24
191121948,3,6,0,7,1,17
191121949,8,6,2,2,0,18
191121950,9,5,6,0,0,20
191121951,0,0,0,1,0,1
191121952,4,1,2,2,0,9
191121953,9,4,1,4,1,19
191121954,1,1,1,1,8,12
191121955,1,0,4,1,2,8
191121956,1,1,4,0,8,14
191121957,1,4,5,6,1,17
191121958,5,8,1,3,8,25
191121959,9,6,8,1,6,30
191121960,3,1,9,0,4,17
191121961,8,6,3,7,6,30
191121962,7,7,6,1,7,28
191121963,0,3,4,3,7,17
191121964,0,4,0,3,2,9
191121965,4,1,9,3,0,17
191121966,7,3,0,1,3,14
191121967,3,9,9,1,3,25
191121968,1,3,2,6,5,17
191121969,9,1,6,2,7,25
191121970,7,6,0,9,9,31
191121971,9,4,6,4,0,23
191121972,1,1,6,7,7,22
191121973,0,6,7,5,6,24
191121974,4,4,8,7,1,24
191121975,5,7,2,6,9,29
191121976,1,0,6,1,2,10
191121977,5,5,4,0,8,22
191121978,9,9,5,3,7,33
191121979,8,7,6,4,8,33
191121980,2,3,4,3,9,21
191121981,3,7,4,1,7,22
191121982,8,8,8,2,1,27
191121983,2,7,1,5,3,18
191121984,0,0,9,4,9,22
191121985,6,0,4,0,9,19
191121986,7,2,7,6,1,23
191121987,2,5,7,1,8,23
191121988,7,6,9,6,6,34
191121989,1,9,5,5,2,22
191121990,6,2,8,7,8,31
191121991,8,0,2,5,0,15
191121992,8,0,2,6,5,21
191121993,2,1,2,0,3,8
191121994,0,4,3,4,1,12
191121995,3,4,3,7,7,24
191121996,3,6,3,1,4,17
191121997,4,4,2,0,1,11
191121998,6,4,1,3,6,20
191121999,8,9,2,2,5,26
1911211000,3,7,8,6,8,32
1911211001,9,5,8,7,5,34
1911211002,5,7,9,6,1,28
1911211003,6,7,4,2,5,24
1911211004,9,5,9,0,6,29
1911211005,5,0,0,2,5,12
1911211006,1,8,4,2,6,21
1911211007,8,0,7,6,7,28
1911211008,0,3,3,1,1,8
1911211009,9,7,5,8,2,31
1911211010,8,5,8,0,6,27
1911211011,2,7,3,5,8,25
1911211012,5,2,2,0,5,14
1911211013,1,6,9,1,4,21
1911211014,8,8,6,3,6,31
1911211015,6,0,2,5,0,13
1911211016,0,4,9,7,4,24
1911211017,5,1,1,4,8,19
1911211018,2,0,1,7,2,12
1911211019,5,0,3,0,0,8
1911211020,2,7,5,7,8,29
1911211021,4,0,9,9,8,30
1911211022,4,3,7,5,3,22
1911211023,5,8,7,9,8,37
1911211024,6,4,1,1,3,15
1911211025,4,6,3,3,6,22
1911211026,2,9,3,0,2,16
1911211027,9,7,1,0,4,21
1911211028,1,8,3,4,4,20
1911211029,6,1,7,0,5,19
1911211030,5,9,0,6,3,23
1911211031,2,1,0,7,6,16
1911211032,0,7,6,8,1,22
1911211033,8,2,0,5,2,17
1911211034,5,4,9,1,9,28
1911211035,5,1,7,6,0,19
1911211036,9,7,2,2,9,29
1911211037,2,4,4,1,8,19
1911211038,7,1,2,3,9,22
1911211039,3,8,3,6,3,23
1911211040,7,8,9,0,2,26
1911211041,0,0,5,6,0,11
1911211042,5,8,1,6,9,29
1911211043,8,4,2,5,0,19
1911211044,8,5,9,8,7,37
1911211045,0,2,2,5,7,16
1911211046,8,8,1,8,9,34
1911211047,2,7,2,1,8,20
1911211048,2,1,1,2,5,11
1911211049,7,6,1,1,3,18
1911211050,9,0,1,3,2,15
1911211051,6,5,1,1,2,15
1911211052,9,9,1,8,8,35
1911211053,1,8,6,9,6,30
1911211054,4,4,8,1,8,25
1911211055,6,3,7,1,6,23
1911211056,5,2,6,5,7,25
1911211057,2,0,3,6,8,19
1911211058,2,4,4,6,2,18
1911211059,8,9,9,9,5,40
1911211060,8,0,4,4,3,19
1911211061,3,1,7,2,1,14
1911211062,6,5,1,0,6,18
1911211063,1,4,1,1,8,15
1911211064,4,6,1,2,1,14
1911211065,6,3,4,2,8,23
1911211066,9,5,7,4,3,28
1911211067,7,5,6,0,9,27
1911211068,7,8,9,8,9,41
1911211069,5,6,5,3,9,28
1911211070,3,3,8,0,2,16
1911211071,7,1,4,8,0,20
1911211072,8,3,2,2,8,23
1911211073,7,0,7,8,4,26
1911211074,3,9,9,6,5,32
1911211075,5,7,3,7,5,27
1911211076,2,3,0,0,5,10
1911211077,3,5,3,5,6,22
1911211078,6,5,1,3,5,20
1911211079,6,1,6,1,1,15
1911211080,5,3,1,9,4,22
1911211081,3,8,0,0,0,11
1911211082,9,1,4,7,6,27
1911211083,2,9,8,5,8,32
1911211084,5,8,3,0,2,18
1911211085,5,5,7,5,8,30
1911211086,3,2,3,6,7,21
1911211087,8,7,0,0,2,17
1911211088,7,7,0,6,3,23
1911211089,9,1,4,8,2,24
1911211090,0,1,9,6,1,17
1911211091,2,1,8,9,3,23
1911211092,6,3,0,6,0,15
1911211093,0,3,0,7,2,12
1911211094,2,5,2,7,8,24
1911211095,9,1,7,6,3,26
1911211096,8,1,6,5,4,24
1911211097,1,9,3,7,9,29
1911211098,7,1,6,8,9,31
1911211099,2,8,6,5,3,24
1911211100,8,2,1,4,9,24
1911211101,3,1,2,9,3,18
1911211102,9,5,6,5,9,34
1911211103,4,3,9,8,3,27
1911211104,1,1,3,5,1,11
1911211105,0,0,2,4,5,11
191122001,2,4,9,1,4,20
191122002,3,3,6,8,5,25
191122003,8,8,0,7,1,24
191122004,2,2,8,3,4,19
191122005,0,0,0,6,5,11
191122006,8,6,7,6,8,35
191122007,6,8,8,0,1,23
191122008,0,7,1,6,5,19
191122009,4,2,7,8,3,24
191122010,9,6,8,9,2,34
191122011,3,6,8,0,4,21
191122012,9,1,8,3,5,26
191122013,4,6,9,6,3,28
191122014,8,2,9,9,3,31
191122015,4,7,3,8,3,25
191122016,9,6,7,6,9,37
191122017,0,2,8,5,2,17
191122018,1,8,8,2,0,19
191122019,8,7,5,7,4,31
191122020,8,9,4,6,1,28
191122021,9,7,7,5,0,28
191122022,0,9,6,3,5,23
191122023,3,6,9,3,1,22
191122024,6,0,1,1,6,14
191122025,1,9,9,3,8,30
191122026,8,8,3,2,2,23
191122027,1,4,9,4,0,18
191122028,1,7,1,7,9,25
191122029,9,8,6,4,1,28
191122030,5,5,2,0,9,21
191122031,0,4,3,5,5,17
191122032,8,6,1,0,1,16
191122033,8,0,6,0,1,15
191122034,8,2,7,5,7,29
191122035,7,7,8,8,1,31
191122036,7,5,9,9,9,39
191122037,6,6,6,2,7,27
191122038,9,3,0,1,7,20
191122039,4,6,4,3,7,24
191122040,4,0,4,1,3,12
191122041,4,5,2,1,4,16
191122042,4,7,2,6,3,22
191122043,4,2,9,3,9,27
191122044,8,6,8,4,3,29
191122045,3,9,0,3,1,16
191122046,4,4,7,8,6,29
191122047,6,2,9,2,2,21
191122048,5,3,9,9,6,32
191122049,7,7,8,2,7,31
191122050,8,4,9,0,4,25
191122051,8,8,0,0,3,19
191122052,2,0,2,8,6,18
191122053,4,2,7,9,0,22
191122054,0,1,6,6,4,17
191122055,6,1,1,8,1,17
191122056,4,6,3,3,1,17
191122057,0,7,6,5,0,18
191122058,8,1,0,8,4,21
191122059,2,2,0,2,3,9
191122060,1,1,5,3,2,12
191122061,1,2,3,3,0,9
191122062,3,1,0,5,3,12
191122063,2,0,2,1,6,11
191122064,9,2,4,4,9,28
191122065,7,8,8,3,6,32
191122066,0,4,6,6,9,25
191122067,9,8,9,9,5,40
191122068,4,0,0,2,1,7
191122069,1,5,8,0,1,15
191122070,4,7,8,9,6,34
191122071,9,2,1,5,2,19
191122072,9,6,4,9,3,31
191122073,7,8,0,1,3,19
191122074,9,1,2,9,4,25
191122075,5,9,8,8,4,34
191122076,3,9,1,6,4,23
191122077,6,8,5,0,7,26
191122078,8,6,7,4,0,25
191122079,2,0,9,1,1,13
191122080,4,0,2,5,0,11
191122081,5,1,7,1,8,22
191122082,6,8,1,5,0,20
191122083,2,2,5,7,4,20
191122084,2,6,9,6,5,28
191122085,4,9,0,7,1,21
191122086,6,4,7,4,2,23
191122087,5,0,2,9,3,19
191122088,2,6,7,3,1,19
191122089,0,9,9,5,8,31
191122090,5,5,0,3,4,17
191122091,6,0,3,5,6,20
191122092,3,1,5,4,4,17
191122093,7,7,5,0,8,27
191122094,0,1,9,1,3,14
191122095,5,1,6,6,0,18
191122096,9,8,3,8,8,36
191122097,3,1,5,3,2,14
191122098,4,8,4,2,9,27
191122099,6,3,2,9,5,25
191122100,6,3,0,3,9,21
191122101,2,8,4,9,7,30
191122102,5,0,1,0,9,15
191122103,1,0,9,6,8,24
191122104,6,3,9,6,1,25
191122105,5,4,1,3,4,17
191122106,5,2,7,2,9,25
191122107,7,8,0,1,7,23
191122108,8,6,1,3,5,23
191122109,1,1,0,5,6,13
191122110,6,3,8,9,9,35
191122111,8,3,8,8,9,36
191122112,9,4,5,5,6,29
191122113,8,8,0,9,1,26
191122114,5,7,6,8,4,30
191122115,1,5,5,2,1,14
191122116,0,5,7,9,1,22
191122117,3,5,2,0,9,19
191122118,6,6,1,8,6,27
191122119,0,6,5,6,2,19
191122120,3,5,9,0,3,20
191122121,3,4,1,1,4,13
191122122,4,0,1,4,6,15
191122123,3,4,3,8,3,21
191122124,7,8,7,7,8,37
191122125,6,5,9,8,2,30
191122126,7,1,4,8,3,23
191122127,0,2,1,3,6,12
191122128,0,5,9,7,4,25
191122129,3,0,0,7,9,19
191122130,3,4,5,6,5,23
191122131,6,9,2,9,7,33
191122132,6,6,0,0,5,17
191122133,3,5,4,9,3,24
191122134,5,7,7,3,5,27
191122135,8,0,6,2,8,24
191122136,1,9,0,1,4,15
191122137,2,2,2,2,3,11
191122138,8,3,2,6,7,26
191122139,1,1,1,7,6,16
191122140,9,4,9,2,3,27
191122141,8,0,4,9,3,24
191122142,1,2,1,7,0,11
191122143,0,2,2,9,3,16
191122144,6,2,4,6,0,18
191122145,9,0,2,7,8,26
191122146,2,2,4,6,9,23
191122147,1,3,1,9,6,20
191122148,9,4,6,0,4,23
191122149,5,1,6,4,3,19
191122150,6,0,7,9,6,28
191122151,7,0,9,5,3,24
191122152,4,6,6,9,4,29
191122153,7,0,0,5,2,14
191122154,0,7,1,5,5,18
191122155,1,8,3,8,7,27
191122156,9,7,3,7,5,31
191122157,6,3,3,4,7,23
191122158,3,0,1,4,6,14
191122159,9,9,3,5,0,26
191122160,1,3,7,0,4,15
191122161,4,7,3,6,0,20
191122162,3,8,7,2,2,22
191122163,2,3,2,2,9,18
191122164,8,9,7,8,0,32
191122165,8,5,2,4,5,24
191122166,9,6,8,5,4,32
191122167,8,1,0,1,6,16
191122168,3,3,9,8,8,31
191122169,5,0,0,9,9,23
191122170,9,5,8,1,6,29
191122171,1,1,0,7,2,11
191122172,6,1,8,1,7,23
191122173,3,5,4,7,7,26
191122174,9,2,1,6,2,20
191122175,4,2,9,7,9,31
191122176,2,4,6,2,0,14
191122177,0,1,3,9,1,14
191122178,1,2,5,8,0,16
191122179,2,6,4,8,7,27
191122180,0,1,2,4,6,13
191122181,8,8,3,9,8,36
191122182,4,8,6,9,4,31
191122183,8,0,9,7,0,24
191122184,1,9,8,6,5,29
191122185,3,5,3,2,5,18
191122186,8,2,7,0,1,18
191122187,9,4,0,3,6,22
191122188,9,1,2,8,0,20
191122189,3,0,6,2,4,15
191122190,7,7,6,1,1,22
191122191,8,4,1,6,0,19
191122192,6,7,4,1,3,21
191122193,6,0,1,9,6,22
191122194,9,6,0,6,3,24
191122195,4,7,5,4,4,24
191122196,9,4,3,4,5,25
191122197,9,3,3,7,5,27
191122198,7,8,0,3,0,18
191122199,0,8,5,9,1,23
191122200,7,3,4,7,6,27
191122201,8,7,2,1,1,19
191122202,9,5,3,9,4,30
191122203,9,7,4,2,3,25
191122204,9,9,4,1,5,28
191122205,8,7,6,9,4,34
191122206,5,8,5,7,3,28
191122207,7,6,4,4,0,21
191122208,8,9,4,9,0,30
191122209,3,2,9,1,9,24
191122210,1,9,8,1,6,25
191122211,4,5,7,0,4,20
191122212,8,3,5,1,2,19
191122213,9,8,0,9,0,26
191122214,7,1,1,0,9,18
191122215,8,7,5,9,5,34
191122216,6,6,0,9,7,28
191122217,6,1,8,1,3,19
191122218,8,9,0,3,8,28
191122219,6,9,0,4,5,24
191122220,8,9,1,6,4,28
191122221,2,7,6,2,0,17
191122222,8,2,5,3,6,24
191122223,4,6,6,9,9,34
191122224,8,1,4,1,2,16
191122225,0,9,4,9,1,23
191122226,9,6,9,1,2,27
191122227,3,6,8,2,6,25
191122228,4,5,9,8,3,29
191122229,5,6,5,6,6,28
191122230,2,1,8,1,9,21
191122231,0,6,9,3,4,22
191122232,7,9,3,5,4,28
191122233,9,1,4,8,3,25
191122234,3,9,6,7,7,32
191122235,4,3,5,3,9,24
191122236,4,6,0,3,6,19
191122237,3,6,4,7,2,22
191122238,4,8,2,1,7,22
191122239,5,2,9,1,3,20
191122240,5,0,2,0,4,11
191122241,1,1,0,3,4,9
191122242,3,7,1,4,3,18
191122243,2,9,7,2,5,25
191122244,3,6,9,5,1,24
191122245,2,7,5,7,2,23
191122246,9,4,4,9,4,30
191122247,7,5,1,0,5,18
191122248,6,7,4,8,1,26
191122249,4,5,3,6,9,27
191122250,5,4,8,5,9,31
191122251,8,5,4,7,0,24
191122252,7,4,7,5,7,30
191122253,7,5,1,1,9,23
191122254,3,2,8,7,2,22
191122255,5,4,9,5,6,29
191122256,9,4,9,5,8,35
191122257,8,0,3,0,7,18
191122258,4,5,5,9,9,32
191122259,7,3,5,5,1,21
191122260,6,5,8,3,1,23
191122261,7,2,4,1,9,23
191122262,4,5,3,3,4,19
191122263,2,4,9,9,4,28
191122264,2,5,5,1,7,20
191122265,4,8,8,1,9,30
191122266,2,8,6,9,5,30
191122267,0,7,9,7,3,26
191122268,0,1,1,5,8,15
191122269,9,7,5,9,9,39
191122270,3,1,1,4,3,12
191122271,3,7,2,5,6,23
191122272,9,5,0,4,4,22
191122273,0,4,4,2,4,14
191122274,0,8,2,9,8,27
191122275,1,1,8,5,3,18
191122276,1,9,1,6,9,26
191122277,7,0,3,5,6,21
191122278,1,9,7,2,2,21
191122279,0,4,8,8,9,29
191122280,7,3,5,2,0,17
191122281,5,8,0,0,8,21
191122282,3,8,2,5,8,26
191122283,5,2,8,8,4,27
191122284,8,7,7,3,7,32
191122285,8,1,5,0,1,15
191122286,9,4,6,7,8,34
191122287,3,3,7,2,4,19
191122288,6,8,0,4,3,21
191122289,7,5,4,5,1,22
191122290,7,5,6,0,4,22
191122291,5,6,8,4,8,31
191122292,0,0,2,2,5,9
191122293,5,2,5,8,5,25
191122294,5,0,4,0,6,15
191122295,4,1,1,7,0,13
191122296,6,1,6,7,3,23
191122297,1,1,0,1,6,9
191122298,6,7,2,7,7,29
191122299,0,3,7,0,8,18
191122300,0,6,2,8,4,20
191122301,1,3,9,0,6,19
191122302,5,5,8,0,1,19
191122303,7,6,9,1,7,30
191122304,2,6,3,5,9,25
191122305,7,7,8,9,0,31
191122306,8,0,7,8,5,28
191122307,6,1,4,2,8,21
191122308,6,0,1,8,6,21
191122309,4,9,9,6,9,37
191122310,7,4,1,1,2,15
191122311,4,5,4,4,5,22
191122312,8,5,2,9,2,26
191122313,3,3,4,4,7,21
191122314,7,2,7,7,1,24
191122315,5,3,6,5,2,21
191122316,7,9,0,9,3,28
191122317,5,2,6,1,8,22
191122318,0,5,8,0,5,18
191122319,3,2,3,3,1,12
191122320,2,9,0,1,4,16
191122321,3,9,8,2,9,31
191122322,0,6,5,1,7,19
191122323,7,4,0,2,2,15
191122324,6,2,8,5,2,23
191122325,5,8,5,1,7,26
191122326,2,1,0,9,7,19
191122327,2,4,6,0,9,21
191122328,4,3,0,2,7,16
191122329,4,6,6,7,0,23
191122330,0,9,4,4,0,17
191122331,2,9,1,9,6,27
191122332,2,0,6,7,1,16
191122333,2,4,2,4,1,13
191122334,8,7,8,3,9,35
191122335,3,3,5,0,2,13
191122336,9,9,7,4,4,33
191122337,1,6,8,9,9,33
191122338,7,6,0,6,4,23
191122339,9,3,0,9,7,28
191122340,2,7,0,5,6,20
191122341,8,8,7,4,8,35
191122342,1,4,8,4,4,21
191122343,1,7,0,0,2,10
191122344,6,0,3,6,4,19
191122345,0,0,1,6,9,16
191122346,4,7,5,8,2,26
191122347,6,9,4,6,6,31
191122348,9,0,0,5,4,18
191122349,4,1,8,6,3,22
191122350,0,2,0,1,8,11
191122351,3,1,9,4,7,24
191122352,0,6,4,4,2,16
191122353,5,5,1,0,1,12
191122354,0,7,3,8,8,26
191122355,5,0,3,6,9,23
191122356,9,7,5,7,7,35
191122357,9,0,9,6,3,27
191122358,0,0,2,4,3,9
191122359,2,1,7,9,0,19
191122360,3,0,3,7,3,16
191122361,5,8,7,4,8,32
191122362,6,1,2,9,6,24
191122363,6,7,6,3,7,29
191122364,1,1,9,3,3,17
191122365,4,7,2,9,7,29
191122366,6,0,3,6,7,22
191122367,0,2,8,2,1,13
191122368,9,9,4,4,0,26
191122369,4,1,5,1,1,12
191122370,9,3,1,6,5,24
191122371,2,8,5,1,2,18
191122372,3,3,0,1,3,10
191122373,7,0,6,1,4,18
191122374,6,9,4,4,5,28
191122375,0,4,9,0,0,13
191122376,4,5,5,8,2,24
191122377,6,1,2,8,0,17
191122378,5,5,6,8,4,28
191122379,2,9,9,1,1,22
191122380,8,5,3,6,2,24
191122381,5,8,3,1,6,23
191122382,8,6,2,6,2,24
191122383,1,1,7,3,4,16
191122384,1,5,6,8,4,24
191122385,4,4,1,4,2,15
191122386,4,5,8,5,2,24
191122387,0,4,6,8,4,22
191122388,5,9,3,6,8,31
191122389,4,2,4,8,2,20
191122390,8,7,9,9,7,40
191122391,6,1,2,7,4,20
191122392,0,0,3,9,6,18
191122393,9,7,2,3,8,29
191122394,3,4,3,7,3,20
191122395,4,8,4,5,8,29
191122396,3,1,7,0,4,15
191122397,3,3,8,7,7,28
191122398,0,4,5,2,9,20
191122399,8,5,1,0,0,14
191122400,9,0,2,8,6,25
191122401,9,5,7,5,3,29
191122402,8,1,9,5,8,31
191122403,7,2,6,8,7,30
191122404,1,4,0,0,0,5
191122405,5,1,1,9,9,25
191122406,0,4,4,5,1,14
191122407,0,4,6,0,9,19
191122408,7,2,9,3,9,30
191122409,5,8,7,7,0,27
191122410,7,3,7,6,8,31
191122411,0,0,3,2,3,8
191122412,7,0,5,8,8,28
191122413,7,4,8,0,2,21
191122414,3,6,2,1,1,13
191122415,2,6,6,8,3,25
191122416,1,3,6,9,7,26
191122417,6,2,0,1,9,18
191122418,0,3,3,3,5,14
191122419,3,1,0,7,5,16
191122420,7,4,0,8,4,23
191122421,9,6,0,5,5,25
191122422,2,9,0,6,1,18
191122423,5,6,5,8,4,28
191122424,2,2,3,6,1,14
191122425,8,2,8,4,9,31
191122426,0,3,9,8,5,25
191122427,7,3,9,8,1,28
191122428,1,2,7,2,6,18
191122429,5,2,7,5,2,21
191122430,9,7,3,9,8,36
191122431,1,0,7,0,1,9
191122432,3,5,7,7,5,27
191122433,2,7,6,7,5,27
191122434,6,3,1,9,3,22
191122435,6,1,6,7,7,27
191122436,9,3,3,9,0,24
191122437,2,8,8,1,8,27
191122438,5,7,4,0,9,25
191122439,1,0,4,5,2,12
191122440,9,0,1,5,2,17
191122441,9,7,3,2,8,29
191122442,5,7,0,1,9,22
191122443,0,0,7,9,7,23
191122444,0,9,6,2,2,19
191122445,7,4,3,6,6,26
191122446,9,5,7,7,4,32
191122447,2,5,0,6,4,17
191122448,1,7,8,3,4,23
191122449,7,6,3,8,7,31
191122450,8,7,4,5,6,30
191122451,4,1,4,2,0,11
191122452,6,3,6,6,2,23
191122453,1,4,4,2,0,11
191122454,6,1,0,3,8,18
191122455,6,0,6,8,2,22
191122456,8,0,7,6,5,26
191122457,4,2,0,4,1,11
191122458,7,8,4,7,1,27
191122459,9,9,6,5,2,31
191122460,0,6,4,0,3,13
191122461,3,9,5,2,6,25
191122462,1,8,9,0,7,25
191122463,9,0,8,4,4,25
191122464,9,8,9,1,2,29
191122465,9,4,4,1,6,24
191122466,3,1,8,0,8,20
191122467,6,2,9,2,1,20
191122468,7,1,5,4,7,24
191122469,0,9,1,1,5,16
191122470,6,3,6,9,1,25
191122471,1,3,4,3,0,11
191122472,8,7,1,4,5,25
191122473,2,0,3,7,0,12
191122474,2,5,4,3,1,15
191122475,5,5,0,5,7,22
191122476,7,0,6,9,5,27
191122477,4,5,0,0,4,13
191122478,6,4,7,6,0,23
191122479,7,7,7,7,7,35
191122480,2,4,3,7,8,24
191122481,0,4,4,9,4,21
191122482,6,5,8,2,7,28
191122483,4,4,9,7,8,32
191122484,9,1,9,9,9,37
191122485,8,8,7,7,4,34
191122486,8,3,2,0,2,15
191122487,6,5,7,7,4,29
191122488,8,0,5,6,2,21
191122489,9,8,0,8,3,28
191122490,9,8,5,2,0,24
191122491,6,8,7,5,6,32
191122492,0,9,8,9,5,31
191122493,3,9,2,7,2,23
191122494,0,7,4,4,1,16
191122495,8,6,7,6,6,33
191122496,7,4,0,5,9,25
191122497,1,7,0,2,1,11
191122498,8,2,4,0,2,16
191122499,7,6,1,9,7,30
191122500,9,2,7,8,6,32
191122501,5,3,8,9,5,30
191122502,2,3,0,3,4,12
191122503,4,7,8,7,9,35
191122504,3,9,2,1,9,24
191122505,5,8,9,4,4,30
191122506,3,4,2,8,8,25
191122507,1,2,7,8,4,22
191122508,2,6,9,2,3,22
191122509,5,0,8,2,7,22
191122510,6,0,0,8,8,22
191122511,1,0,9,2,6,18
191122512,4,9,1,7,5,26
191122513,7,5,7,4,5,28
191122514,3,6,3,7,6,25
191122515,5,1,2,4,2,14
191122516,1,9,9,3,5,27
191122517,1,2,5,0,8,16
191122518,9,5,6,8,2,30
191122519,8,5,9,5,0,27
191122520,3,6,8,6,7,30
191122521,4,6,3,0,8,21
191122522,9,4,4,8,8,33
191122523,6,6,1,2,8,23
191122524,2,9,7,0,1,19
191122525,0,8,3,0,7,18
191122526,6,0,8,8,6,28
191122527,0,0,4,4,6,14
191122528,6,3,4,3,5,21
191122529,4,0,8,3,9,24
191122530,0,9,5,3,9,26
191122531,1,9,3,9,1,23
191122532,6,0,5,4,6,21
191122533,0,3,4,0,3,10
191122534,6,4,6,4,2,22
191122535,1,4,9,2,9,25
191122536,7,4,8,6,5,30
191122537,7,4,9,3,9,32
191122538,6,4,1,7,5,23
191122539,8,2,6,3,3,22
191122540,1,5,7,5,9,27
191122541,6,2,7,8,6,29
191122542,8,2,0,1,8,19
191122543,5,2,2,5,7,21
191122544,9,3,6,9,7,34
191122545,4,1,1,0,4,10
191122546,3,5,7,5,6,26
191122547,8,4,9,8,6,35
191122548,5,8,6,0,8,27
191122549,4,1,5,9,2,21
191122550,4,0,9,6,0,19
191122551,1,5,5,0,6,17
191122552,2,4,6,6,4,22
191122553,1,4,4,3,1,13
191122554,0,7,0,1,0,8
191122555,5,7,1,7,5,25
191122556,9,9,9,0,4,31
191122557,0,2,7,9,2,20
191122558,9,9,2,8,0,28
191122559,8,6,6,8,9,37
191122560,9,7,7,7,8,38
191122561,6,2,2,8,5,23
191122562,7,2,8,9,9,35
191122563,5,2,7,4,7,25
191122564,2,9,8,4,1,24
191122565,5,7,3,5,5,25
191122566,9,4,9,5,0,27
191122567,9,7,0,7,0,23
191122568,3,5,8,2,9,27
191122569,0,8,0,5,4,17
191122570,4,3,2,6,4,19
191122571,7,9,4,9,2,31
191122572,9,3,9,7,0,28
191122573,4,3,2,1,2,12
191122574,2,7,4,4,6,23
191122575,9,3,6,1,3,22
191122576,5,4,3,7,9,28
191122577,6,2,8,6,1,23
191122578,3,9,5,2,1,20
191122579,0,9,0,2,6,17
191122580,2,5,5,7,2,21
191122581,4,0,7,7,8,26
191122582,8,6,9,4,1,28
191122583,4,8,1,2,0,15
191122584,3,7,7,6,3,26
191122585,2,0,6,4,4,16
191122586,5,7,1,5,1,19
191122587,6,4,7,6,3,26
191122588,6,3,3,5,5,22
191122589,3,2,5,4,5,19
191122590,6,1,9,9,8,33
191122591,2,6,7,4,6,25
191122592,2,8,5,4,8,27
191122593,0,0,5,7,5,17
191122594,4,3,3,1,6,17
191122595,8,5,6,1,9,29
191122596,4,6,0,5,3,18
191122597,0,7,5,8,1,21
191122598,6,9,5,7,4,31
191122599,9,8,5,1,5,28
191122600,9,4,9,7,2,31
191122601,3,9,4,4,8,28
191122602,5,1,9,9,5,29
191122603,8,0,3,4,0,15
191122604,9,1,1,0,0,11
191122605,7,6,8,6,5,32
191122606,7,3,3,1,5,19
191122607,2,9,5,7,1,24
191122608,4,7,7,9,1,28
191122609,0,0,9,1,4,14
191122610,5,1,1,5,7,19
191122611,1,4,5,4,4,18
191122612,8,6,5,2,8,29
191122613,0,3,3,8,8,22
191122614,4,5,3,8,0,20
191122615,1,7,7,8,1,24
191122616,9,7,7,0,2,25
191122617,7,8,1,9,3,28
191122618,6,2,0,4,2,14
191122619,9,0,5,9,6,29
191122620,8,2,6,4,8,28
191122621,1,1,2,5,2,11
191122622,5,5,3,7,2,22
191122623,7,5,9,2,2,25
191122624,5,8,7,8,7,35
191122625,6,1,7,2,6,22
191122626,2,3,1,2,7,15
191122627,3,4,2,0,8,17
191122628,5,7,0,0,6,18
191122629,0,1,1,0,1,3
191122630,8,0,2,3,0,13
191122631,3,3,5,2,7,20
191122632,3,1,9,6,5,24
191122633,6,6,7,2,8,29
191122634,3,4,3,9,3,22
191122635,9,5,0,2,8,24
191122636,4,3,4,1,6,18
191122637,0,4,7,9,5,25
191122638,3,9,1,8,2,23
191122639,5,2,8,7,4,26
191122640,4,3,4,5,2,18
191122641,0,9,0,1,0,10
191122642,4,7,7,6,4,28
191122643,1,6,2,4,1,14
191122644,8,1,4,7,4,24
191122645,0,6,5,2,8,21
191122646,7,7,9,0,5,28
191122647,5,3,9,9,4,30
191122648,1,6,0,9,3,19
191122649,6,1,6,6,3,22
191122650,1,0,6,1,8,16
191122651,9,6,2,6,2,25
191122652,6,6,2,6,5,25
191122653,2,9,6,1,2,20
191122654,9,1,9,7,1,27
191122655,0,9,1,3,3,16
191122656,8,3,9,8,0,28
191122657,1,8,3,5,9,26
191122658,7,0,1,9,0,17
191122659,7,1,4,8,5,25
191122660,6,6,4,5,7,28
191122661,7,8,5,9,0,29
191122662,0,8,9,1,7,25
191122663,5,2,1,8,1,17
191122664,1,3,2,3,7,16
191122665,1,4,3,8,2,18
191122666,8,7,2,1,4,22
191122667,6,7,8,9,7,37
191122668,1,3,4,7,9,24
191122669,0,1,2,2,7,12
191122670,5,5,1,5,5,21
191122671,2,2,7,0,5,16
191122672,6,2,6,3,4,21
191122673,8,0,3,3,4,18
191122674,6,6,1,6,9,28
191122675,3,7,4,1,5,20
191122676,9,5,8,2,4,28
191122677,9,4,4,1,4,22
191122678,2,7,5,9,0,23
191122679,5,8,1,8,7,29
191122680,6,7,8,3,5,29
191122681,8,7,1,7,1,24
191122682,5,7,0,9,8,29
191122683,1,7,6,4,6,24
191122684,9,2,5,7,1,24
191122685,9,8,7,1,9,34
191122686,8,6,5,2,0,21
191122687,3,0,8,6,7,24
191122688,0,3,2,6,6,17
191122689,9,1,5,9,1,25
191122690,5,3,5,9,4,26
191122691,7,9,4,9,0,29
191122692,9,0,4,5,3,21
191122693,6,6,3,8,0,23
191122694,9,5,3,5,2,24
191122695,5,1,2,5,4,17
191122696,5,4,6,9,1,25
191122697,4,5,6,1,7,23
191122698,2,0,6,9,9,26
191122699,9,7,4,6,6,32
191122700,2,7,2,6,3,20
191122701,3,7,8,2,6,26
191122702,5,2,1,6,5,19
191122703,3,8,1,4,3,19
191122704,4,3,7,7,1,22
191122705,0,8,9,2,0,19
191122706,3,6,5,3,9,26
191122707,9,9,1,5,8,32
191122708,0,0,9,0,1,10
191122709,3,1,7,9,3,23
191122710,5,1,8,0,5,19
191122711,2,5,3,5,6,21
191122712,5,8,9,6,1,29
191122713,2,3,8,5,7,25
191122714,4,8,0,1,2,15
191122715,3,2,3,1,0,9
191122716,6,7,8,4,3,28
191122717,0,8,3,7,4,22
191122718,6,8,7,5,5,31
191122719,2,1,1,3,6,13
191122720,3,3,8,0,4,18
191122721,9,7,6,9,2,33
191122722,2,1,6,5,6,20
191122723,0,1,2,2,1,6
191122724,3,8,1,1,4,17
191122725,7,6,6,8,4,31
191122726,4,3,8,3,6,24
191122727,8,3,4,1,8,24
191122728,6,6,4,4,4,24
191122729,0,4,2,4,3,13
191122730,0,4,0,7,5,16
191122731,9,8,9,4,9,39
191122732,6,3,6,2,2,19
191122733,8,2,6,4,5,25
191122734,1,3,2,7,0,13
191122735,6,5,8,0,2,21
191122736,9,8,7,6,8,38
191122737,1,1,0,9,6,17
191122738,7,8,6,4,1,26
191122739,4,0,4,6,3,17
191122740,5,7,7,9,5,33
191122741,9,9,8,8,2,36
191122742,9,5,5,2,7,28
191122743,9,2,3,8,3,25
191122744,3,2,3,0,5,13
191122745,0,7,4,9,7,27
191122746,3,3,6,5,5,22
191122747,0,4,5,1,6,16
191122748,7,7,4,2,7,27
191122749,9,0,2,4,4,19
191122750,9,9,7,2,5,32
191122751,2,7,3,6,1,19
191122752,2,3,1,8,4,18
191122753,3,4,7,0,0,14
191122754,2,8,0,1,2,13
191122755,5,7,5,2,6,25
191122756,3,3,4,9,2,21
191122757,5,5,0,0,0,10
191122758,4,3,9,5,6,27
191122759,9,4,6,7,4,30
191122760,5,9,7,2,6,29
191122761,9,1,9,6,2,27
191122762,9,3,9,6,1,28
191122763,4,9,5,5,0,23
191122764,0,1,5,9,4,19
191122765,8,7,1,1,5,22
191122766,9,9,4,5,0,27
191122767,9,2,0,2,8,21
191122768,8,5,9,9,8,39
191122769,7,3,2,1,2,15
191122770,3,4,6,2,9,24
191122771,0,7,0,9,4,20
191122772,6,5,5,0,3,19
191122773,3,6,6,3,9,27
191122774,0,8,8,9,8,33
191122775,5,8,9,1,3,26
191122776,0,0,4,3,1,8
191122777,4,4,0,4,9,21
191122778,6,0,6,5,7,24
191122779,6,4,0,4,9,23
191122780,0,4,4,7,5,20
191122781,4,2,4,4,9,23
191122782,0,4,3,8,9,24
191122783,8,0,4,9,2,23
191122784,9,3,9,3,4,28
191122785,1,2,8,4,6,21
191122786,6,0,9,4,5,24
191122787,0,8,2,3,5,18
191122788,6,5,5,6,8,30
191122789,3,0,5,0,2,10
191122790,3,7,1,9,7,27
191122791,1,6,9,4,3,23
191122792,0,7,5,0,3,15
191122793,1,6,0,6,9,22
191122794,6,7,7,2,0,22
191122795,5,8,3,4,3,23
191122796,1,6,9,6,0,22
191122797,2,9,2,5,6,24
191122798,8,6,1,3,4,22
191122799,2,0,9,6,3,20
191122800,0,2,7,5,0,14
191122801,5,0,0,3,9,17
191122802,6,3,6,8,8,31
191122803,2,3,4,3,8,20
191122804,2,0,5,8,5,20
191122805,7,6,8,1,4,26
191122806,7,4,5,6,9,31
191122807,1,9,9,5,2,26
191122808,3,3,7,5,4,22
191122809,8,1,0,7,4,20
191122810,7,5,1,1,0,14
191122811,5,4,8,6,9,32
191122812,4,3,2,3,2,14
191122813,0,9,6,5,4,24
191122814,6,4,9,2,4,25
191122815,4,9,4,7,3,27
191122816,9,0,6,5,4,24
191122817,1,5,0,3,9,18
191122818,3,6,1,5,0,15
191122819,3,5,7,9,8,32
191122820,3,0,3,5,0,11
191122821,2,4,3,8,0,17
191122822,7,1,5,7,6,26
191122823,4,3,4,9,1,21
191122824,9,1,1,8,5,24
191122825,7,1,8,0,7,23
191122826,9,8,6,3,0,26
191122827,2,7,1,3,4,17
191122828,9,8,0,0,9,26
191122829,3,8,9,9,5,34
191122830,6,1,9,5,1,22
191122831,0,4,6,0,7,17
191122832,7,9,9,9,0,34
191122833,7,1,5,4,8,25
191122834,1,1,2,4,1,9
191122835,1,1,7,3,7,19
191122836,9,5,4,3,3,24
191122837,7,8,5,8,7,35
191122838,4,4,8,7,6,29
191122839,2,6,2,9,0,19
191122840,7,5,0,2,4,18
191122841,9,4,0,9,2,24
191122842,7,4,0,2,1,14
191122843,2,4,4,0,7,17
191122844,2,0,1,3,2,8
191122845,7,2,1,4,6,20
191122846,1,4,2,9,2,18
191122847,0,4,9,9,3,25
191122848,8,7,8,9,4,36
191122849,4,3,5,5,9,26
191122850,6,4,6,0,4,20
191122851,9,7,3,4,6,29
191122852,5,2,7,1,4,19
191122853,5,6,5,4,4,24
191122854,4,5,2,6,5,22
191122855,1,6,1,4,0,12
191122856,7,9,4,0,3,23
191122857,2,1,9,1,5,18
191122858,7,9,9,0,8,33
191122859,7,3,0,0,5,15
191122860,6,7,3,0,4,20
191122861,8,6,4,2,8,28
191122862,0,5,3,7,5,20
191122863,2,2,8,5,0,17
191122864,3,9,7,3,7,29
191122865,1,9,1,1,1,13
191122866,3,9,3,7,4,26
191122867,6,4,0,3,0,13
191122868,1,3,8,4,5,21
191122869,8,9,8,3,0,28
191122870,4,3,2,2,3,14
191122871,6,2,6,7,3,24
191122872,1,8,2,3,4,18
191122873,4,6,1,5,7,23
191122874,6,5,7,5,9,32
191122875,1,1,9,0,2,13
191122876,5,7,7,7,7,33
191122877,5,7,2,8,4,26
191122878,5,7,1,9,1,23
191122879,5,5,4,1,5,20
191122880,0,1,7,9,1,18
191122881,2,1,9,2,0,14
191122882,9,7,8,1,3,28
191122883,5,0,7,9,7,28
191122884,1,1,3,9,5,19
191122885,3,0,2,5,7,17
191122886,4,9,9,1,3,26
191122887,1,6,8,5,7,27
191122888,4,7,5,2,1,19
191122889,3,8,0,4,2,17
191122890,8,4,0,8,9,29
191122891,6,7,2,1,0,16
191122892,1,2,3,6,0,12
191122893,9,1,9,7,2,28
191122894,0,9,9,1,5,24
191122895,8,1,1,2,6,18
191122896,4,7,0,0,0,11
191122897,1,8,2,5,2,18
191122898,9,5,3,4,6,27
191122899,5,7,6,2,0,20
191122900,5,4,2,0,8,19
191122901,7,0,6,1,3,17
191122902,5,7,1,6,4,23
191122903,7,9,3,4,1,24
191122904,0,8,0,4,2,14
191122905,6,9,1,7,0,23
191122906,7,6,8,2,8,31
191122907,6,8,5,2,4,25
191122908,4,2,1,5,6,18
191122909,9,3,8,7,4,31
191122910,3,6,5,5,4,23
191122911,8,6,3,6,5,28
191122912,3,9,4,8,2,26
191122913,7,4,0,4,2,17
191122914,9,8,5,7,8,37
191122915,6,3,9,5,5,28
191122916,0,0,5,3,9,17
191122917,4,2,2,3,3,14
191122918,2,4,8,5,8,27
191122919,9,7,0,2,8,26
191122920,1,7,0,9,9,26
191122921,2,5,4,1,4,16
191122922,8,0,5,2,6,21
191122923,2,4,3,1,1,11
191122924,7,7,6,8,8,36
191122925,7,9,8,9,8,41
191122926,2,1,7,8,1,19
191122927,8,2,5,3,5,23
191122928,2,9,0,9,2,22
191122929,9,6,1,8,9,33
191122930,1,0,5,4,7,17
191122931,0,5,4,3,9,21
191122932,2,1,1,4,0,8
191122933,2,0,2,6,4,14
191122934,1,9,7,2,3,22
191122935,2,7,4,6,5,24
191122936,8,2,4,3,8,25
191122937,5,3,8,1,3,20
191122938,1,0,4,4,4,13
191122939,9,6,2,8,6,31
191122940,5,9,6,7,9,36
191122941,6,1,8,6,0,21
191122942,3,7,6,8,0,24
191122943,1,1,3,8,9,22
191122944,0,2,3,7,5,17
191122945,2,2,6,5,4,19
191122946,6,2,7,8,2,25
191122947,3,1,7,2,5,18
191122948,5,7,6,2,8,28
191122949,5,1,1,8,7,22
191122950,1,8,1,1,6,17
191122951,9,7,9,4,6,35
191122952,8,0,3,6,2,19
191122953,6,9,3,9,2,29
191122954,9,1,7,4,7,28
191122955,5,0,8,5,7,25
191122956,0,3,1,3,5,12
191122957,2,3,6,0,0,11
191122958,8,7,3,6,5,29
191122959,9,5,8,6,5,33
191122960,4,3,3,1,2,13
191122961,3,3,2,3,4,15
191122962,0,2,3,0,2,7
191122963,4,3,9,4,7,27
191122964,6,9,2,4,8,29
191122965,3,1,6,6,6,22
191122966,0,5,1,2,5,13
191122967,6,6,8,9,6,35
191122968,1,9,6,4,2,22
191122969,3,9,3,4,1,20
191122970,4,3,4,6,1,18
191122971,5,2,2,8,5,22
191122972,5,3,5,9,5,27
191122973,0,5,3,1,0,9
191122974,4,6,4,7,5,26
191122975,9,1,8,7,8,33
191122976,6,0,3,9,1,19
191122977,0,6,3,2,6,17
191122978,8,4,8,7,9,36
191122979,3,6,4,8,7,28
191122980,2,1,8,5,0,16
191122981,7,2,6,2,9,26
191122982,2,5,4,4,1,16
191122983,9,5,3,3,8,28
191122984,0,7,5,4,1,17
191122985,3,9,6,6,4,28
191122986,7,9,3,5,2,26
191122987,2,5,4,7,4,22
191122988,7,7,0,3,1,18
191122989,0,4,6,9,3,22
191122990,2,9,7,1,1,20
191122991,2,3,9,2,6,22
191122992,0,1,9,6,8,24
191122993,0,5,1,7,1,14
191122994,5,7,2,1,3,18
191122995,4,6,2,8,5,25
191122996,5,3,8,8,7,31
191122997,3,0,0,2,8,13
191122998,3,5,3,4,0,15
191122999,1,0,0,7,8,16
1911221000,3,5,2,5,5,20
1911221001,1,1,4,1,6,13
1911221002,1,1,6,5,9,22
1911221003,5,0,3,1,4,13
1911221004,2,8,8,7,6,31
1911221005,4,9,3,1,7,24
1911221006,3,0,5,6,1,15
1911221007,9,6,5,6,5,31
1911221008,9,2,4,9,3,27
1911221009,7,0,9,2,9,27
1911221010,6,9,3,6,1,25
1911221011,7,3,4,1,8,23
1911221012,1,3,7,5,0,16
1911221013,7,4,8,7,8,34
1911221014,1,8,7,7,6,29
1911221015,5,6,6,1,2,20
1911221016,7,4,4,4,5,24
1911221017,2,7,7,4,2,22
1911221018,2,1,3,2,2,10
1911221019,6,7,9,9,6,37
1911221020,6,9,3,5,3,26
1911221021,2,3,3,1,3,12
1911221022,7,4,6,3,6,26
1911221023,0,5,3,4,6,18
1911221024,8,4,3,5,0,20
1911221025,3,5,0,3,4,15
1911221026,3,2,6,1,6,18
1911221027,1,5,7,4,1,18
1911221028,4,5,2,3,4,18
1911221029,4,0,5,4,7,20
1911221030,3,2,0,4,7,16
1911221031,3,1,1,5,1,11
1911221032,3,4,2,0,5,14
1911221033,4,5,7,1,9,26
1911221034,0,7,3,2,5,17
1911221035,2,6,4,8,4,24
1911221036,9,6,5,3,7,30
1911221037,3,5,8,7,6,29
1911221038,0,7,4,5,4,20
1911221039,6,1,5,0,0,12
1911221040,6,8,7,5,9,35
1911221041,3,4,0,7,7,21
1911221042,0,8,8,2,7,25
1911221043,0,6,0,0,8,14
1911221044,4,4,4,9,0,21
1911221045,4,1,3,5,9,22
1911221046,7,7,2,2,8,26
1911221047,7,8,6,0,7,28
1911221048,1,8,9,2,9,29
1911221049,1,5,5,1,6,18
1911221050,3,2,5,0,1,11
1911221051,5,7,3,2,8,25
1911221052,2,9,2,3,3,19
1911221053,5,0,1,5,7,18
1911221054,3,8,0,1,8,20
1911221055,3,7,8,4,2,24
1911221056,7,5,9,8,4,33
1911221057,3,2,9,7,8,29
1911221058,8,1,9,3,1,22
1911221059,5,5,9,6,7,32
1911221060,8,0,0,0,9,17
1911221061,9,4,0,5,2,20
1911221062,9,7,9,3,8,36
1911221063,4,8,1,7,9,29
1911221064,9,3,6,9,3,30
1911221065,5,3,0,3,4,15
1911221066,1,3,1,8,2,15
1911221067,7,2,0,8,7,24
1911221068,5,4,4,1,4,18
1911221069,4,2,8,8,5,27
1911221070,2,5,7,2,6,22
1911221071,2,2,5,0,4,13
1911221072,1,7,5,9,0,22
1911221073,6,5,7,0,1,19
1911221074,0,3,4,1,7,15
1911221075,2,5,0,4,2,13
1911221076,9,0,4,1,6,20
1911221077,0,5,0,6,5,16
1911221078,5,3,1,2,0,11
1911221079,7,2,6,5,1,21
1911221080,0,5,0,5,8,18
1911221081,7,5,1,9,0,22
1911221082,3,1,8,9,4,25
1911221083,1,6,5,0,1,13
1911221084,2,8,1,5,8,24
1911221085,9,3,3,2,9,26
1911221086,3,5,5,3,1,17
1911221087,5,1,3,0,2,11
1911221088,1,1,9,4,8,23
1911221089,0,0,0,8,0,8
1911221090,8,7,6,7,7,35
1911221091,5,7,4,4,5,25
1911221092,3,3,7,3,7,23
1911221093,2,9,8,8,7,34
1911221094,5,1,4,1,2,13
1911221095,7,9,8,8,6,38
1911221096,9,2,7,5,0,23
1911221097,8,8,2,1,1,20
1911221098,6,2,2,5,7,22
1911221099,9,9,7,4,9,38
1911221100,6,8,3,8,9,34
1911221101,2,3,8,2,6,21
1911221102,0,3,5,5,9,22
1911221103,5,6,0,7,5,23
1911221104,9,1,3,6,5,24
1911221105,1,5,6,0,6,18
191123001,6,8,4,0,0,18
191123002,4,7,5,3,9,28
191123003,2,7,1,2,8,20
191123004,1,4,2,4,4,15
191123005,0,9,9,4,0,22
191123006,4,5,5,5,6,25
191123007,1,6,3,6,7,23
191123008,4,3,7,7,7,28
191123009,6,8,7,6,0,27
191123010,9,1,4,1,7,22
191123011,0,5,9,7,8,29
191123012,1,9,0,1,6,17
191123013,6,7,7,5,8,33
191123014,8,5,5,6,2,26
191123015,7,0,9,9,9,34
191123016,4,9,1,3,8,25
191123017,6,1,1,0,5,13
191123018,5,7,4,1,4,21
191123019,3,8,8,2,3,24
191123020,7,2,0,5,5,19
191123021,1,2,7,8,1,19
191123022,0,9,8,6,6,29
191123023,6,9,9,9,2,35
191123024,3,6,7,0,5,21
191123025,1,9,5,0,6,21
191123026,9,9,0,3,7,28
191123027,8,8,6,2,7,31
191123028,8,0,4,0,4,16
191123029,3,1,5,0,4,13
191123030,3,7,9,5,8,32
191123031,0,7,2,4,1,14
191123032,8,5,1,3,3,20
191123033,8,4,3,8,9,32
191123034,6,8,3,3,1,21
191123035,0,2,4,7,1,14
191123036,4,7,2,2,2,17
191123037,3,4,1,7,0,15
191123038,3,5,2,6,3,19
191123039,2,8,6,7,2,25
191123040,5,5,8,6,2,26
191123041,5,0,8,5,6,24
191123042,0,9,0,9,9,27
191123043,3,9,7,7,4,30
191123044,1,9,0,6,2,18
191123045,9,7,0,2,2,20
191123046,0,3,0,0,7,10
191123047,5,0,4,2,2,13
191123048,5,7,3,0,6,21
191123049,8,9,2,5,7,31
191123050,7,8,2,3,6,26
191123051,8,2,6,9,8,33
191123052,8,6,1,6,7,28
191123053,8,8,2,8,9,35
191123054,7,9,9,7,9,41
191123055,1,7,9,7,4,28
191123056,7,4,3,8,1,23
191123057,0,3,6,5,9,23
191123058,1,1,7,4,1,14
191123059,1,4,0,7,3,15
191123060,2,4,0,5,0,11
191123061,5,2,9,7,9,32
191123062,3,4,2,4,8,21
191123063,7,9,6,2,8,32
191123064,4,3,4,0,6,17
191123065,6,0,5,2,2,15
191123066,7,5,6,5,2,25
191123067,4,1,1,1,6,13
191123068,5,2,0,6,2,15
191123069,5,9,4,5,0,23
191123070,6,4,9,7,3,29
191123071,6,1,5,9,4,25
191123072,2,9,0,2,6,19
191123073,4,5,0,6,9,24
191123074,5,9,6,8,9,37
191123075,8,0,1,0,3,12
191123076,3,7,2,7,7,26
191123077,7,9,3,3,7,29
191123078,6,9,7,3,9,34
191123079,8,3,5,5,9,30
191123080,1,3,1,6,9,20
191123081,3,6,2,7,6,24
191123082,2,3,3,8,0,16
191123083,6,4,2,9,8,29
191123084,3,3,3,8,7,24
191123085,4,0,9,9,6,28
191123086,6,5,3,6,4,24
191123087,3,2,2,9,0,16
191123088,6,0,3,3,2,14
191123089,9,6,9,6,1,31
191123090,2,8,7,3,8,28
191123091,5,4,4,9,0,22
191123092,8,0,9,2,1,20
191123093,5,2,3,9,9,28
191123094,0,1,5,6,3,15
191123095,1,2,7,9,9,28
191123096,2,6,3,3,5,19
191123097,3,4,7,4,2,20
191123098,9,9,2,8,3,31
191123099,6,6,6,0,9,27
191123100,8,6,6,1,7,28
191123101,6,0,4,1,6,17
191123102,8,6,1,1,4,20
191123103,9,2,8,7,8,34
191123104,5,2,0,6,3,16
191123105,2,9,2,4,0,17
191123106,1,5,6,8,1,21
191123107,4,4,2,5,8,23
191123108,8,0,9,6,3,26
191123109,8,4,2,8,4,26
191123110,8,3,6,5,4,26
191123111,5,5,0,2,6,18
191123112,8,3,8,2,2,23
191123113,6,1,6,0,2,15
191123114,0,8,6,2,7,23
191123115,1,9,9,7,1,27
191123116,6,5,0,3,9,23
191123117,7,9,6,0,1,23
191123118,4,5,6,9,0,24
191123119,7,2,5,8,2,24
191123120,3,4,0,4,6,17
191123121,1,7,1,7,6,22
191123122,1,7,3,2,3,16
191123123,0,8,8,1,5,22
191123124,1,7,0,6,3,17
191123125,6,3,6,5,5,25
191123126,9,5,9,8,8,39
191123127,0,5,5,4,8,22
191123128,5,9,5,9,1,29
191123129,6,3,9,6,3,27
191123130,2,4,3,6,1,16
191123131,9,7,1,6,7,30
191123132,2,5,8,3,4,22
191123133,1,8,2,4,5,20
191123134,3,3,4,1,2,13
191123135,4,1,0,6,0,11
191123136,2,6,6,2,4,20
191123137,5,5,0,7,8,25
191123138,0,7,1,0,7,15
191123139,6,4,7,5,8,30
191123140,4,3,1,6,1,15
191123141,5,7,6,8,1,27
191123142,5,2,3,8,5,23
191123143,1,4,9,9,7,30
191123144,4,7,8,7,2,28
191123145,7,6,9,7,2,31
191123146,8,4,1,7,1,21
191123147,3,1,3,8,0,15
191123148,5,8,1,9,2,25
191123149,5,2,2,0,7,16
191123150,1,7,0,0,6,14
191123151,3,8,9,2,2,24
191123152,3,0,8,1,6,18
191123153,4,1,0,7,6,18
191123154,0,1,0,8,3,12
191123155,1,9,3,3,5,21
191123156,5,5,0,3,3,16
191123157,9,7,1,8,8,33
191123158,4,4,0,9,5,22
191123159,5,2,1,8,5,21
191123160,8,8,5,6,1,28
191123161,1,1,7,8,5,22
191123162,2,7,1,7,7,24
191123163,7,8,3,3,5,26
191123164,5,8,6,5,6,30
191123165,4,7,6,9,4,30
191123166,0,3,7,2,0,12
191123167,4,2,3,0,0,9
191123168,9,8,2,7,0,26
191123169,5,1,3,0,9,18
191123170,9,6,4,8,5,32
191123171,2,5,0,8,8,23
191123172,0,6,0,8,7,21
191123173,4,8,6,0,2,20
191123174,4,7,4,4,9,28
191123175,3,5,1,6,7,22
191123176,3,7,8,7,9,34
191123177,9,8,1,4,9,31
191123178,4,9,1,8,9,31
191123179,2,1,7,4,4,18
191123180,3,1,5,3,1,13
191123181,6,6,9,4,4,29
191123182,6,9,8,7,5,35
191123183,6,7,7,5,3,28
191123184,8,9,0,2,8,27
191123185,9,4,8,3,3,27
191123186,4,5,4,2,9,24
191123187,5,1,6,9,3,24
191123188,7,1,7,2,1,18
191123189,1,9,8,5,3,26
191123190,1,9,7,0,8,25
191123191,1,0,3,4,4,12
191123192,4,3,1,2,1,11
191123193,6,3,0,8,2,19
191123194,8,2,0,0,9,19
191123195,8,3,8,7,2,28
191123196,1,1,5,1,1,9
191123197,1,8,8,9,8,34
191123198,8,0,9,4,7,28
191123199,3,5,8,5,9,30
191123200,3,2,0,5,5,15
191123201,0,6,9,0,8,23
191123202,9,0,7,4,3,23
191123203,0,9,6,7,5,27
191123204,6,0,7,2,1,16
191123205,7,4,5,4,0,20
191123206,7,6,7,6,3,29
191123207,4,2,3,3,6,18
191123208,7,4,0,4,5,20
191123209,3,9,7,2,7,28
191123210,6,5,1,7,0,19
191123211,9,4,1,5,5,24
191123212,0,6,4,5,9,24
191123213,0,8,2,5,9,24
191123214,1,4,9,7,5,26
191123215,2,9,8,0,7,26
191123216,0,7,1,9,7,24
191123217,5,5,8,5,5,28
191123218,5,4,8,4,2,23
191123219,8,8,6,1,2,25
191123220,6,1,7,9,8,31
191123221,3,3,0,4,1,11
191123222,8,5,4,1,8,26
191123223,2,2,9,1,1,15
191123224,2,5,1,0,9,17
191123225,9,5,4,8,2,28
191123226,4,7,1,6,2,20
191123227,7,7,0,2,1,17
191123228,2,1,1,8,1,13
191123229,1,3,4,5,7,20
191123230,6,2,3,9,4,24
191123231,4,3,2,6,3,18
191123232,5,4,9,4,4,26
191123233,5,0,5,5,2,17
191123234,2,8,1,8,1,20
191123235,8,9,0,8,5,30
191123236,5,8,6,4,5,28
191123237,7,8,9,7,9,40
191123238,4,8,0,2,3,17
191123239,0,8,6,8,6,28
191123240,1,4,0,8,8,21
191123241,2,0,7,3,0,12
191123242,0,9,3,5,4,21
191123243,2,1,4,5,6,18
191123244,8,8,1,5,3,25
191123245,4,3,2,6,7,22
191123246,7,9,6,4,8,34
191123247,1,1,2,7,1,12
191123248,5,5,9,0,3,22
191123249,2,1,7,2,2,14
191123250,0,5,6,4,9,24
191123251,2,9,7,0,5,23
191123252,6,1,8,5,1,21
191123253,3,8,3,5,7,26
191123254,2,4,6,7,4,23
191123255,8,0,9,4,2,23
191123256,8,1,7,8,8,32
191123257,3,1,4,4,1,13
191123258,5,5,4,6,6,26
191123259,9,9,3,5,9,35
191123260,1,6,5,9,2,23
191123261,6,6,0,5,5,22
191123262,2,5,6,7,1,21
191123263,7,5,1,6,3,22
191123264,1,5,4,9,6,25
191123265,4,8,0,8,5,25
191123266,4,3,1,7,1,16
191123267,4,4,6,8,1,23
191123268,8,7,8,4,5,32
191123269,0,4,0,1,9,14
191123270,1,9,2,7,1,20
191123271,6,2,3,6,9,26
191123272,0,3,1,8,7,19
191123273,0,0,5,3,8,16
191123274,3,0,0,4,6,13
191123275,0,2,4,2,7,15
191123276,9,4,3,2,2,20
191123277,1,9,9,5,1,25
191123278,3,7,9,7,9,35
191123279,6,1,2,1,6,16
191123280,9,4,3,8,5,29
191123281,5,4,4,8,9,30
191123282,9,6,7,0,6,28
191123283,3,6,2,4,9,24
191123284,1,1,3,5,5,15
191123285,2,2,4,3,9,20
191123286,6,1,1,6,5,19
191123287,1,0,8,1,3,13
191123288,6,7,9,8,2,32
191123289,7,1,4,9,0,21
191123290,4,6,1,0,5,16
191123291,2,0,1,0,8,11
191123292,2,9,3,4,4,22
191123293,7,1,8,8,0,24
191123294,0,5,4,1,0,10
191123295,3,7,7,4,7,28
191123296,8,5,5,7,3,28
191123297,9,2,9,6,1,27
191123298,1,6,4,8,3,22
191123299,3,0,8,6,1,18
191123300,6,9,1,6,1,23
191123301,3,3,0,1,5,12
191123302,3,8,9,1,3,24
191123303,0,7,3,3,8,21
191123304,2,8,9,2,7,28
191123305,3,4,8,3,4,22
191123306,8,9,1,2,0,20
191123307,6,0,9,2,6,23
191123308,3,3,4,6,8,24
191123309,4,5,8,1,0,18
191123310,4,4,8,0,7,23
191123311,8,4,1,6,1,20
191123312,0,1,5,5,9,20
191123313,9,6,7,7,4,33
191123314,7,9,9,5,8,38
191123315,9,4,8,7,7,35
191123316,4,1,0,9,2,16
191123317,9,6,3,0,2,20
191123318,1,6,1,7,0,15
191123319,3,2,6,4,2,17
191123320,8,6,2,0,0,16
191123321,8,2,9,1,3,23
191123322,4,2,7,8,0,21
191123323,0,4,9,7,6,26
191123324,5,1,8,0,7,21
191123325,1,0,5,7,9,22
191123326,4,8,3,0,6,21
191123327,4,5,4,3,9,25
191123328,3,1,2,2,3,11
191123329,5,1,8,9,0,23
191123330,8,6,0,6,8,28
191123331,2,1,1,9,9,22
191123332,0,9,8,8,7,32
191123333,9,1,3,9,3,25
191123334,4,2,2,3,7,18
191123335,6,8,1,0,2,17
191123336,7,7,0,3,2,19
191123337,5,1,1,4,0,11
191123338,3,1,2,4,2,12
191123339,2,4,5,1,9,21
191123340,5,0,6,4,0,15
191123341,7,9,6,6,4,32
191123342,1,9,9,2,0,21
191123343,7,4,0,6,8,25
191123344,9,8,4,3,1,25
191123345,5,9,9,5,8,36
191123346,4,2,3,9,7,25
191123347,5,8,5,7,7,32
191123348,9,3,5,7,3,27
191123349,4,6,2,8,6,26
191123350,6,5,0,8,0,19
191123351,5,1,8,6,7,27
191123352,1,3,6,6,8,24
191123353,4,8,0,9,5,26
191123354,8,3,0,2,8,21
191123355,7,1,6,2,7,23
191123356,4,5,1,2,9,21
191123357,4,7,0,9,7,27
191123358,2,1,9,1,9,22
191123359,8,3,1,9,8,29
191123360,5,3,3,0,3,14
191123361,5,3,2,6,8,24
191123362,9,7,3,7,9,35
191123363,8,4,7,3,3,25
191123364,5,4,7,1,9,26
191123365,5,7,5,6,0,23
191123366,1,1,3,5,2,12
191123367,0,5,1,6,5,17
191123368,6,3,8,2,7,26
191123369,1,3,6,3,9,22
191123370,2,7,6,8,2,25
191123371,5,1,5,9,8,28
191123372,9,5,4,9,5,32
191123373,5,2,9,8,6,30
191123374,4,7,5,4,5,25
191123375,7,5,5,7,7,31
191123376,7,5,2,6,7,27
191123377,0,6,8,5,2,21
191123378,1,0,0,5,9,15
191123379,3,3,0,8,3,17
191123380,8,3,7,8,5,31
191123381,4,7,5,7,9,32
191123382,6,7,2,2,9,26
191123383,3,8,8,0,2,21
191123384,3,5,5,3,6,22
191123385,1,0,9,5,9,24
191123386,8,6,3,2,6,25
191123387,5,0,8,8,3,24
191123388,5,8,2,0,0,15
191123389,2,9,7,1,5,24
191123390,1,9,4,2,1,17
191123391,4,3,8,4,2,21
191123392,6,9,0,0,0,15
191123393,6,1,4,3,4,18
191123394,0,2,7,9,5,23
191123395,7,2,3,3,4,19
191123396,0,9,0,8,3,20
191123397,7,4,1,2,4,18
191123398,3,8,9,6,7,33
191123399,1,3,4,5,0,13
191123400,2,2,3,6,5,18
191123401,5,1,1,3,4,14
191123402,8,7,4,6,6,31
191123403,9,1,8,9,6,33
191123404,4,6,5,1,3,19
191123405,9,9,2,4,5,29
191123406,2,0,4,7,5,18
191123407,8,9,9,1,5,32
191123408,9,6,2,9,8,34
191123409,4,7,1,2,0,14
191123410,3,7,0,0,2,12
191123411,6,2,8,3,7,26
191123412,2,5,0,8,3,18
191123413,5,9,0,2,1,17
191123414,5,2,7,2,0,16
191123415,6,6,4,2,3,21
191123416,3,7,3,9,2,24
191123417,6,3,6,3,9,27
191123418,8,1,3,0,9,21
191123419,0,5,1,4,1,11
191123420,8,9,1,6,7,31
191123421,2,6,6,4,7,25
191123422,6,9,9,6,2,32
191123423,4,6,8,6,8,32
191123424,4,5,3,2,3,17
191123425,2,9,9,9,5,34
191123426,1,9,3,9,6,28
191123427,5,3,6,6,7,27
191123428,8,0,2,8,6,24
191123429,2,9,4,5,1,21
191123430,3,9,1,1,4,18
191123431,9,5,7,5,5,31
191123432,9,1,3,0,7,20
191123433,4,9,7,4,9,33
191123434,4,1,0,2,1,8
191123435,4,9,7,0,3,23
191123436,3,9,8,3,9,32
191123437,7,0,3,2,8,20
191123438,4,1,7,1,0,13
191123439,5,3,4,7,4,23
191123440,6,7,5,4,1,23
191123441,3,7,2,3,2,17
191123442,6,3,4,4,7,24
191123443,3,8,0,2,2,15
191123444,5,6,1,0,1,13
191123445,8,3,0,8,4,23
191123446,2,1,1,0,2,6
191123447,3,8,5,9,0,25
191123448,4,0,5,0,5,14
191123449,6,3,2,4,6,21
191123450,9,5,4,1,0,19
191123451,2,5,8,5,5,25
191123452,6,8,6,4,6,30
191123453,6,1,1,5,1,14
191123454,3,4,9,7,8,31
191123455,6,1,5,9,1,22
191123456,5,3,3,7,9,27
191123457,1,1,2,3,0,7
191123458,2,7,4,4,7,24
191123459,5,0,7,4,0,16
191123460,6,9,2,7,2,26
191123461,3,2,8,3,4,20
191123462,3,2,4,2,2,13
191123463,6,4,7,3,5,25
191123464,9,7,0,1,4,21
191123465,6,1,4,6,0,17
191123466,9,7,9,7,8,40
191123467,1,1,0,8,1,11
191123468,1,2,5,1,9,18
191123469,1,4,2,0,5,12
191123470,8,1,0,5,6,20
191123471,1,6,9,0,7,23
191123472,7,0,8,0,4,19
191123473,3,5,5,1,3,17
191123474,4,6,3,2,5,20
191123475,2,6,5,2,2,17
191123476,3,9,3,7,7,29
191123477,6,0,9,3,5,23
191123478,9,8,4,9,8,38
191123479,7,8,9,8,5,37
191123480,0,5,3,9,6,23
191123481,1,0,6,1,7,15
191123482,2,9,9,3,3,26
191123483,8,9,7,6,1,31
191123484,2,7,7,2,3,21
191123485,9,9,4,7,5,34
191123486,7,0,5,2,1,15
191123487,5,5,5,9,5,29
191123488,9,2,2,7,9,29
191123489,8,9,3,5,4,29
191123490,8,4,4,3,2,21
191123491,0,4,7,5,8,24
191123492,7,8,2,0,6,23
191123493,4,9,3,2,2,20
191123494,6,4,6,0,2,18
191123495,4,4,0,4,3,15
191123496,0,6,8,7,9,30
191123497,0,7,1,6,0,14
191123498,7,3,0,8,1,19
191123499,5,0,5,3,3,16
191123500,8,8,6,2,2,26
191123501,5,3,4,7,1,20
191123502,3,8,4,2,2,19
191123503,9,5,2,2,0,18
191123504,5,2,2,7,9,25
191123505,4,3,4,9,9,29
191123506,5,0,9,4,8,26
191123507,2,0,1,4,3,10
191123508,0,0,0,1,2,3
191123509,6,6,8,9,3,32
191123510,0,1,9,2,1,13
191123511,3,8,4,1,5,21
191123512,3,5,4,2,1,15
191123513,4,0,4,9,9,26
191123514,2,5,8,1,5,21
191123515,8,5,4,0,5,22
191123516,6,2,9,1,4,22
191123517,8,5,3,2,5,23
191123518,8,0,1,3,0,12
191123519,3,6,1,2,4,16
191123520,3,4,3,6,1,17
191123521,8,6,6,9,1,30
191123522,4,4,6,8,2,24
191123523,5,6,3,0,7,21
191123524,7,8,2,2,1,20
191123525,3,5,2,3,2,15
191123526,8,8,0,5,1,22
191123527,9,4,6,0,7,26
191123528,1,0,3,3,6,13
191123529,8,1,8,9,3,29
191123530,9,6,2,9,9,35
191123531,6,7,0,3,4,20
191123532,0,1,9,0,9,19
191123533,8,4,9,2,3,26
191123534,1,8,1,4,0,14
191123535,8,9,2,1,2,22
191123536,0,7,0,4,7,18
191123537,0,6,2,3,3,14
191123538,4,2,6,3,3,18
191123539,4,5,8,2,2,21
191123540,6,6,9,9,9,39
191123541,1,2,3,5,9,20
191123542,8,2,8,3,6,27
191123543,6,0,4,2,4,16
191123544,4,4,2,0,0,10
191123545,3,4,2,8,5,22
191123546,6,4,2,8,2,22
191123547,4,1,6,2,8,21
191123548,4,3,4,8,9,28
191123549,0,3,6,4,3,16
191123550,4,5,6,6,1,22
191123551,0,4,5,9,0,18
191123552,3,5,8,3,5,24
191123553,9,5,5,9,9,37
191123554,5,2,2,4,7,20
191123555,6,2,1,1,0,10
191123556,6,2,8,4,9,29
191123557,4,1,2,2,5,14
191123558,7,6,2,1,8,24
191123559,0,6,6,6,5,23
191123560,4,5,0,7,8,24
191123561,4,9,5,2,0,20
191123562,7,3,2,8,4,24
191123563,9,6,5,4,4,28
191123564,3,8,8,8,9,36
191123565,9,8,7,4,9,37
191123566,5,4,7,1,3,20
191123567,6,5,8,9,8,36
191123568,5,3,5,1,3,17
191123569,7,0,7,5,6,25
191123570,8,3,9,5,3,28
191123571,1,6,6,6,6,25
191123572,7,2,8,2,0,19
191123573,8,0,7,1,4,20
191123574,8,9,5,7,3,32
191123575,7,1,1,3,8,20
191123576,6,1,7,4,5,23
191123577,1,7,9,0,4,21
191123578,0,8,0,2,6,16
191123579,7,4,6,8,3,28
191123580,9,9,9,0,8,35
191123581,9,1,2,8,8,28
191123582,5,2,9,6,3,25
191123583,4,9,3,8,2,26
191123584,9,2,1,6,3,21
191123585,1,8,5,2,2,18
191123586,2,3,4,0,6,15
191123587,0,1,9,9,1,20
191123588,1,3,6,3,2,15
191123589,9,6,8,2,2,27
191123590,7,8,6,6,8,35
191123591,2,3,5,3,2,15
191123592,1,8,5,9,8,31
191123593,2,5,8,2,9,26
191123594,4,0,6,4,2,16
191123595,9,3,5,6,0,23
191123596,6,0,4,9,4,23
191123597,1,5,8,8,1,23
191123598,9,9,9,8,4,39
191123599,8,5,0,5,2,20
191123600,1,7,5,0,2,15
191123601,1,4,3,4,4,16
191123602,3,7,4,8,6,28
191123603,1,2,6,3,0,12
191123604,0,6,3,3,5,17
191123605,6,2,7,4,8,27
191123606,6,0,7,5,6,24
191123607,3,6,7,8,1,25
191123608,1,3,0,2,4,10
191123609,0,8,0,2,5,15
191123610,4,4,7,7,7,29
191123611,1,6,9,6,8,30
191123612,0,4,6,3,8,21
191123613,6,0,7,8,7,28
191123614,6,6,7,5,0,24
191123615,3,7,5,7,5,27
191123616,5,3,8,8,2,26
191123617,5,5,9,8,2,29
191123618,4,8,6,7,9,34
191123619,2,6,4,3,8,23
191123620,8,9,1,1,6,25
191123621,3,9,6,0,9,27
191123622,2,6,1,8,2,19
191123623,7,0,3,6,1,17
191123624,1,2,6,3,2,14
191123625,9,5,9,7,2,32
191123626,6,2,6,6,9,29
191123627,2,2,1,0,5,10
191123628,6,0,1,8,5,20
191123629,3,0,9,0,5,17
191123630,4,8,1,5,1,19
191123631,3,5,3,0,2,13
191123632,4,5,3,8,1,21
191123633,4,6,8,7,9,34
191123634,6,1,5,2,4,18
191123635,1,7,4,0,8,20
191123636,7,7,7,6,1,28
191123637,7,1,8,5,3,24
191123638,8,7,4,6,8,33
191123639,5,0,9,7,3,24
191123640,2,3,5,5,7,22
191123641,1,8,9,4,4,26
191123642,4,7,3,0,8,22
191123643,5,0,8,6,0,19
191123644,2,1,4,6,6,19
191123645,6,7,0,4,1,18
191123646,7,4,0,0,5,16
191123647,3,4,1,1,5,14
191123648,8,4,2,3,7,24
191123649,4,6,3,8,4,25
191123650,6,0,8,3,7,24
191123651,7,3,2,9,2,23
191123652,7,3,5,6,4,25
191123653,0,5,0,2,4,11
191123654,7,6,7,4,6,30
191123655,7,6,9,4,5,31
191123656,5,6,7,1,2,21
191123657,4,3,6,0,0,13
191123658,3,3,0,5,8,19
191123659,1,5,1,3,0,10
191123660,2,3,6,6,5,22
191123661,6,1,7,4,9,27
191123662,7,7,1,2,2,19
191123663,6,9,4,5,8,32
191123664,3,4,9,0,3,19
191123665,9,1,7,0,0,17
191123666,0,5,2,9,1,17
191123667,9,9,2,5,4,29
191123668,3,5,3,4,3,18
191123669,2,3,2,3,7,17
191123670,9,8,5,5,3,30
191123671,7,6,4,6,0,23
191123672,6,1,5,7,4,23
191123673,4,4,2,7,8,25
191123674,8,6,1,8,3,26
191123675,6,2,7,6,8,29
191123676,0,0,6,3,4,13
191123677,9,7,3,5,2,26
191123678,4,5,6,7,3,25
191123679,7,2,5,1,7,22
191123680,7,3,0,2,4,16
191123681,8,5,7,7,2,29
191123682,5,4,6,2,7,24
191123683,9,7,3,2,7,28
191123684,2,5,5,7,8,27
191123685,0,3,8,4,7,22
191123686,1,4,7,6,9,27
191123687,6,5,6,6,2,25
191123688,8,3,5,5,1,22
191123689,6,5,8,4,9,32
191123690,0,6,3,1,4,14
191123691,1,1,3,7,8,20
191123692,4,3,3,9,3,22
191123693,0,4,9,5,3,21
191123694,8,7,8,2,0,25
191123695,4,5,3,5,7,24
191123696,1,6,9,9,4,29
191123697,8,5,0,4,7,24
191123698,2,3,0,9,6,20
191123699,8,9,1,6,1,25
191123700,2,0,8,3,4,17
191123701,7,7,6,2,4,26
191123702,0,4,7,4,2,17
191123703,8,7,5,8,3,31
191123704,6,7,7,5,5,30
191123705,3,2,4,8,6,23
191123706,5,9,0,5,2,21
191123707,6,9,2,2,2,21
191123708,4,6,9,7,5,31
191123709,1,2,8,3,9,23
191123710,9,8,7,0,7,31
191123711,7,2,7,9,1,26
191123712,2,8,4,3,7,24
191123713,6,2,0,9,5,22
191123714,2,5,8,7,4,26
191123715,5,8,7,1,1,22
191123716,6,1,3,2,3,15
191123717,9,2,7,0,6,24
191123718,6,2,6,1,3,18
191123719,3,7,8,5,0,23
191123720,9,3,3,2,0,17
191123721,1,2,9,7,7,26
191123722,8,2,2,6,3,21
191123723,4,9,8,5,8,34
191123724,3,3,9,1,4,20
191123725,6,4,6,7,6,29
191123726,0,6,6,7,0,19
191123727,3,5,3,8,2,21
191123728,9,8,7,1,0,25
191123729,2,1,7,8,5,23
191123730,2,0,4,1,1,8
191123731,0,4,8,5,2,19
191123732,0,4,8,0,5,17
191123733,0,8,2,0,3,13
191123734,3,6,1,5,1,16
191123735,7,9,7,9,7,39
191123736,8,4,7,9,3,31
191123737,5,8,1,9,3,26
191123738,5,0,6,9,6,26
191123739,2,1,8,4,0,15
191123740,5,9,8,2,4,28
191123741,3,8,0,9,8,28
191123742,7,4,4,8,2,25
191123743,7,8,7,5,8,35
191123744,3,9,2,8,4,26
191123745,5,1,2,2,8,18
191123746,7,5,5,2,9,28
191123747,7,2,3,2,3,17
191123748,3,2,9,9,4,27
191123749,1,5,4,0,8,18
191123750,7,4,5,3,1,20
191123751,0,3,6,7,4,20
191123752,0,2,6,6,2,16
191123753,5,4,5,4,3,21
191123754,5,5,1,6,1,18
191123755,9,0,0,7,0,16
191123756,6,4,8,2,3,23
191123757,6,2,1,9,8,26
191123758,4,9,4,4,0,21
191123759,4,7,0,4,6,21
191123760,4,0,8,1,5,18
191123761,1,0,4,6,7,18
191123762,7,6,4,0,1,18
191123763,9,0,9,4,8,30
191123764,3,4,6,3,5,21
191123765,2,0,3,4,5,14
191123766,3,6,8,8,0,25
191123767,2,2,1,2,8,15
191123768,0,3,2,8,6,19
191123769,3,8,0,5,0,16
191123770,2,1,9,8,4,24
191123771,7,6,5,9,8,35
191123772,7,0,0,8,1,16
191123773,1,7,2,7,0,17
191123774,7,9,7,6,3,32
191123775,1,2,5,2,7,17
191123776,7,1,5,9,5,27
191123777,7,5,5,6,2,25
191123778,3,6,6,1,6,22
191123779,8,3,2,2,1,16
191123780,2,8,4,8,3,25
191123781,2,5,1,5,0,13
191123782,2,9,4,7,6,28
191123783,4,8,8,8,7,35
191123784,9,0,5,5,1,20
191123785,4,2,9,8,6,29
191123786,9,6,5,4,9,33
191123787,3,6,0,9,7,25
191123788,2,6,3,4,4,19
191123789,5,3,1,2,6,17
191123790,7,8,3,0,7,25
191123791,3,6,9,7,5,30
191123792,4,1,9,2,6,22
191123793,9,6,5,5,7,32
191123794,8,5,8,8,6,35
191123795,1,3,5,9,0,18
191123796,7,0,5,3,6,21
191123797,1,7,5,0,5,18
191123798,7,5,7,4,4,27
191123799,2,3,1,0,9,15
191123800,4,7,9,8,3,31
191123801,7,0,2,1,5,15
191123802,9,1,5,0,9,24
191123803,0,2,4,3,8,17
191123804,0,4,9,5,4,22
191123805,8,5,9,4,5,31
191123806,9,3,0,6,1,19
191123807,9,8,3,2,1,23
191123808,5,7,9,1,7,29
191123809,8,7,4,4,7,30
191123810,0,2,0,5,9,16
191123811,9,9,8,7,0,33
191123812,4,0,8,5,1,18
191123813,7,2,6,5,5,25
191123814,5,3,5,1,8,22
191123815,6,2,5,9,9,31
191123816,3,8,3,6,0,20
191123817,5,2,2,8,7,24
191123818,7,3,7,9,5,31
191123819,8,2,2,4,4,20
191123820,0,9,7,2,9,27
191123821,2,3,8,5,1,19
191123822,8,7,2,4,1,22
191123823,0,9,5,8,5,27
191123824,3,1,2,9,0,15
191123825,6,4,7,0,8,25
191123826,2,0,3,8,4,17
191123827,7,9,9,7,2,34
191123828,5,3,7,1,8,24
191123829,7,9,7,9,3,35
191123830,4,9,7,0,4,24
191123831,1,4,1,7,0,13
191123832,8,4,0,3,0,15
191123833,7,6,7,0,9,29
191123834,4,9,0,4,9,26
191123835,7,4,4,8,9,32
191123836,8,8,9,2,7,34
191123837,0,4,5,1,5,15
191123838,8,4,5,0,8,25
191123839,0,1,6,9,2,18
191123840,8,8,5,8,5,34
191123841,0,9,8,3,5,25
191123842,8,1,8,9,5,31
191123843,8,6,8,9,4,35
191123844,7,2,6,4,4,23
191123845,3,2,2,9,3,19
191123846,6,5,2,4,7,24
191123847,2,5,8,3,7,25
191123848,6,3,4,4,6,23
191123849,2,0,5,1,7,15
191123850,2,8,0,6,6,22
191123851,8,7,4,4,4,27
191123852,2,6,2,5,0,15
191123853,6,0,4,4,3,17
191123854,9,9,6,7,1,32
191123855,5,4,0,5,1,15
191123856,2,1,4,2,1,10
191123857,1,4,0,0,5,10
191123858,2,5,9,8,5,29
191123859,1,6,4,9,3,23
191123860,4,0,7,7,3,21
191123861,4,2,5,6,2,19
191123862,0,9,7,4,8,28
191123863,0,6,3,5,8,22
191123864,0,5,4,3,3,15
191123865,9,3,7,4,6,29
191123866,5,8,6,7,6,32
191123867,9,9,2,3,6,29
191123868,4,1,2,9,1,17
191123869,2,9,2,9,0,22
191123870,9,9,0,2,2,22
191123871,8,3,9,4,4,28
191123872,9,6,3,2,0,20
191123873,2,3,6,3,3,17
191123874,4,4,0,7,8,23
191123875,8,3,1,7,0,19
191123876,3,0,2,6,6,17
191123877,1,2,2,8,3,16
191123878,1,7,6,4,2,20
191123879,9,4,6,0,6,25
191123880,3,7,3,8,8,29
191123881,0,7,9,9,5,30
191123882,4,0,7,3,2,16
191123883,8,7,0,1,5,21
191123884,6,2,8,4,8,28
191123885,9,2,2,2,7,22
191123886,7,7,0,2,0,16
191123887,9,4,0,0,0,13
191123888,7,2,9,7,7,32
191123889,4,8,4,8,5,29
191123890,6,7,9,8,6,36
191123891,6,0,5,5,5,21
191123892,6,7,9,7,8,37
191123893,1,4,1,1,7,14
191123894,1,1,4,6,6,18
191123895,9,8,6,8,3,34
191123896,4,6,3,7,1,21
191123897,7,5,1,6,8,27
191123898,8,0,1,1,1,11
191123899,5,1,9,0,2,17
191123900,1,9,3,5,1,19
191123901,6,1,6,7,4,24
191123902,8,1,7,5,9,30
191123903,9,1,3,6,0,19
191123904,0,8,2,7,7,24
191123905,2,6,2,2,2,14
191123906,6,3,5,5,8,27
191123907,6,5,6,7,1,25
191123908,1,0,3,0,6,10
191123909,8,3,9,6,8,34
191123910,0,9,1,3,0,13
191123911,6,3,1,8,9,27
191123912,7,2,7,7,0,23
191123913,1,3,8,1,8,21
191123914,0,2,5,0,6,13
191123915,3,0,9,7,8,27
191123916,5,8,9,2,4,28
191123917,0,4,3,5,7,19
191123918,0,3,1,7,9,20
191123919,5,3,3,7,0,18
191123920,0,5,6,3,5,19
191123921,0,1,1,4,1,7
191123922,8,1,7,1,6,23
191123923,5,7,8,0,7,27
191123924,1,7,6,6,3,23
191123925,5,2,0,2,8,17
191123926,9,3,9,5,8,34
191123927,8,1,0,5,9,23
191123928,8,8,4,2,9,31
191123929,3,4,7,8,7,29
191123930,7,7,3,4,1,22
191123931,6,4,2,6,5,23
191123932,0,6,2,4,9,21
191123933,4,4,2,3,3,16
191123934,6,2,3,1,4,16
191123935,1,8,8,4,9,30
191123936,0,2,2,9,8,21
191123937,7,4,6,8,7,32
191123938,3,7,4,8,5,27
191123939,6,3,2,1,2,14
191123940,4,0,2,7,1,14
191123941,9,6,8,7,1,31
191123942,6,0,3,3,8,20
191123943,0,5,5,8,5,23
191123944,7,1,7,1,4,20
191123945,5,4,4,6,0,19
191123946,3,9,1,9,8,30
191123947,9,2,3,4,5,23
191123948,9,6,9,1,5,30
191123949,3,6,6,3,1,19
191123950,9,6,4,9,8,36
191123951,9,3,7,2,9,30
191123952,3,9,5,9,0,26
191123953,5,8,6,1,2,22
191123954,9,2,1,2,0,14
191123955,6,7,0,0,0,13
191123956,6,3,7,7,4,27
191123957,6,9,0,1,1,17
191123958,4,6,1,7,0,18
191123959,2,6,4,3,0,15
191123960,0,6,1,3,6,16
191123961,6,2,7,7,4,26
191123962,7,8,5,4,0,24
191123963,4,0,3,2,7,16
191123964,3,9,9,4,6,31
191123965,3,1,2,4,6,16
191123966,7,4,4,0,5,20
191123967,8,5,1,1,8,23
191123968,1,2,6,3,8,20
191123969,9,3,8,6,8,34
191123970,2,6,2,0,3,13
191123971,4,8,8,8,6,34
191123972,7,8,3,8,0,26
191123973,7,9,9,7,8,40
191123974,9,3,8,2,0,22
191123975,0,9,5,2,8,24
191123976,0,2,6,8,3,19
191123977,2,8,8,2,2,22
191123978,6,6,6,7,7,32
191123979,3,9,7,4,5,28
191123980,7,8,5,5,2,27
191123981,9,1,2,3,2,17
191123982,9,4,6,5,5,29
191123983,4,6,3,4,8,25
191123984,5,7,6,8,5,31
191123985,7,9,7,3,1,27
191123986,2,5,3,7,2,19
191123987,3,1,3,4,6,17
191123988,5,1,3,3,7,19
191123989,9,2,7,2,7,27
191123990,3,0,4,4,0,11
191123991,8,4,8,3,7,30
191123992,7,4,6,0,6,23
191123993,8,8,4,1,7,28
191123994,7,4,6,2,8,27
191123995,5,5,0,8,3,21
191123996,3,5,6,0,4,18
191123997,3,2,8,8,0,21
191123998,1,1,2,1,8,13
191123999,4,5,7,6,2,24
1911231000,5,0,7,2,5,19
1911231001,9,3,3,9,7,31
1911231002,9,7,6,3,6,31
1911231003,1,4,1,9,3,18
1911231004,8,5,3,2,3,21
1911231005,4,4,1,1,6,16
1911231006,2,6,1,8,5,22
1911231007,0,9,6,6,3,24
1911231008,1,8,0,2,1,12
1911231009,3,1,3,1,5,13
1911231010,3,6,1,4,6,20
1911231011,9,6,2,4,0,21
1911231012,0,5,1,6,8,20
1911231013,6,8,0,6,2,22
1911231014,4,2,6,7,6,25
1911231015,1,6,0,0,0,7
1911231016,2,8,4,9,6,29
1911231017,0,1,1,8,6,16
1911231018,2,6,1,1,3,13
1911231019,5,6,9,4,6,30
1911231020,4,1,5,3,6,19
1911231021,8,0,5,1,9,23
1911231022,6,8,3,8,8,33
1911231023,5,7,2,9,9,32
1911231024,7,4,9,9,6,35
1911231025,7,9,8,9,6,39
1911231026,1,1,2,6,4,14
1911231027,4,0,8,9,1,22
1911231028,6,1,2,4,7,20
1911231029,7,8,9,3,7,34
1911231030,9,5,8,9,6,37
1911231031,1,9,5,0,2,17
1911231032,2,3,7,9,4,25
1911231033,6,0,1,7,8,22
1911231034,2,3,9,6,9,29
1911231035,3,5,2,8,7,25
1911231036,6,9,9,6,6,36
1911231037,7,8,8,8,9,40
1911231038,7,4,9,7,3,30
1911231039,9,7,1,1,6,24
1911231040,3,7,5,2,2,19
1911231041,8,6,1,9,0,24
1911231042,3,5,0,4,1,13
1911231043,3,3,8,8,1,23
1911231044,0,9,5,8,1,23
1911231045,9,6,0,8,1,24
1911231046,8,2,4,5,4,23
1911231047,4,0,1,6,5,16
1911231048,1,5,4,2,6,18
1911231049,6,4,8,7,4,29
1911231050,9,6,7,6,5,33
1911231051,5,2,5,8,7,27
1911231052,3,5,5,3,4,20
1911231053,6,0,5,7,2,20
1911231054,7,4,7,1,3,22
1911231055,5,7,5,3,9,29
1911231056,7,2,3,2,7,21
1911231057,4,0,0,5,5,14
1911231058,3,3,3,6,5,20
1911231059,8,6,1,0,5,20
1911231060,0,4,2,5,3,14
1911231061,6,8,2,4,4,24
1911231062,3,2,8,3,2,18
1911231063,4,7,7,9,8,35
1911231064,3,9,2,6,3,23
1911231065,4,4,9,0,0,17
1911231066,7,9,0,7,4,27
1911231067,2,5,7,2,5,21
1911231068,5,7,9,6,3,30
1911231069,4,0,0,4,3,11
1911231070,5,6,0,6,7,24
1911231071,4,5,6,4,5,24
1911231072,9,6,0,4,2,21
1911231073,5,0,3,9,1,18
1911231074,6,8,3,7,2,26
1911231075,5,1,2,5,3,16
1911231076,3,8,1,4,1,17
1911231077,4,9,5,9,2,29
1911231078,1,3,8,4,0,16
1911231079,6,6,7,9,4,32
1911231080,0,3,1,8,4,16
1911231081,8,7,4,3,4,26
1911231082,5,7,1,0,0,13
1911231083,0,7,5,1,5,18
1911231084,5,6,4,4,7,26
1911231085,8,9,1,5,7,30
1911231086,8,2,4,4,6,24
1911231087,4,3,9,5,9,30
1911231088,7,0,5,8,0,20
1911231089,8,8,4,1,8,29
1911231090,4,2,8,3,9,26
1911231091,2,2,7,3,9,23
1911231092,9,3,7,2,1,22
1911231093,4,1,6,6,7,24
1911231094,0,1,2,3,9,15
1911231095,8,2,7,3,7,27
1911231096,9,1,2,2,1,15
1911231097,6,0,8,7,8,29
1911231098,5,8,3,2,0,18
1911231099,0,9,8,6,0,23
1911231100,2,1,9,8,9,29
1911231101,5,2,3,6,3,19
1911231102,4,0,5,8,2,19
1911231103,2,7,1,2,6,18
1911231104,5,2,0,1,8,16
1911231105,1,9,7,4,5,26
191124001,8,6,4,0,9,27
191124002,1,6,0,8,0,15
191124003,1,1,5,9,9,25
191124004,2,0,1,7,0,10
191124005,9,2,8,4,4,27
191124006,1,4,0,6,7,18
191124007,6,6,2,4,1,19
191124008,2,6,9,9,2,28
191124009,2,0,4,6,9,21
191124010,3,2,7,8,8,28
191124011,9,2,8,2,3,24
191124012,0,4,2,9,7,22
191124013,7,4,3,7,5,26
191124014,9,1,4,1,4,19
191124015,7,1,0,7,3,18
191124016,1,7,7,4,1,20
191124017,3,1,3,3,2,12
191124018,5,9,3,8,3,28
191124019,7,2,5,3,0,17
191124020,5,8,7,3,5,28
191124021,8,4,7,2,5,26
191124022,5,7,0,8,7,27
191124023,7,8,3,7,7,32
191124024,2,8,1,1,7,19
191124025,1,5,4,0,7,17
191124026,5,1,7,5,8,26
191124027,8,2,6,7,3,26
191124028,0,9,3,2,2,16
191124029,8,4,1,8,2,23
191124030,5,5,4,0,0,14
191124031,5,4,0,3,5,17
191124032,0,6,5,4,1,16
191124033,6,9,7,1,7,30
191124034,5,2,7,0,5,19
191124035,9,6,3,6,9,33
191124036,8,1,2,9,9,29
191124037,9,6,7,9,7,38
191124038,3,8,0,0,5,16
191124039,1,3,0,1,6,11
191124040,9,6,4,6,6,31
191124041,9,9,2,7,1,28
191124042,1,8,8,0,3,20
191124043,2,2,2,1,5,12
191124044,9,8,6,3,1,27
191124045,2,5,5,1,9,22
191124046,2,4,9,6,2,23
191124047,5,5,6,1,9,26
191124048,0,8,1,6,9,24
191124049,1,7,3,2,1,14
191124050,8,5,7,2,4,26
191124051,7,4,3,2,6,22
191124052,4,4,2,7,5,22
191124053,1,1,6,6,9,23
191124054,0,9,4,9,5,27
191124055,7,9,5,0,8,29
191124056,1,3,4,7,3,18
191124057,7,6,9,8,4,34
191124058,7,6,8,9,2,32
191124059,3,3,4,5,8,23
191124060,4,7,6,8,5,30
191124061,0,3,1,2,5,11
191124062,6,5,6,5,4,26
191124063,0,5,9,1,8,23
191124064,4,6,4,8,2,24
191124065,1,4,8,5,9,27
191124066,6,4,0,5,3,18
191124067,3,2,9,6,8,28
191124068,6,6,4,8,2,26
191124069,1,0,5,4,1,11
191124070,7,9,0,4,6,26
191124071,5,1,5,8,1,20
191124072,3,7,6,7,3,26
191124073,7,3,2,5,8,25
191124074,6,5,7,6,0,24
191124075,5,0,0,7,8,20
191124076,7,7,3,7,3,27
191124077,4,6,5,5,1,21
191124078,8,2,3,1,1,15
191124079,7,3,8,6,0,24
191124080,0,6,2,4,2,14
191124081,2,9,4,9,3,27
191124082,6,9,2,2,1,20
191124083,0,1,5,6,4,16
191124084,3,2,7,5,6,23
191124085,3,6,5,1,6,21
191124086,2,9,6,8,3,28
191124087,5,6,9,8,4,32
191124088,0,1,3,3,1,8
191124089,2,6,3,2,2,15
191124090,1,6,9,3,8,27
191124091,1,0,6,4,0,11
191124092,3,9,7,9,9,37
191124093,9,8,4,2,9,32
191124094,2,0,5,3,0,10
191124095,8,6,7,1,6,28
191124096,9,6,9,1,9,34
191124097,1,7,4,3,7,22
191124098,5,0,4,4,1,14
191124099,2,8,4,4,3,21
191124100,6,7,6,4,4,27
191124101,0,9,1,5,0,15
191124102,9,7,8,2,3,29
191124103,1,8,6,1,7,23
191124104,1,9,7,0,3,20
191124105,8,6,2,5,2,23
191124106,0,4,7,0,0,11
191124107,2,2,3,8,8,23
191124108,0,8,5,1,8,22
191124109,1,1,1,8,6,17
191124110,2,7,8,8,2,27
191124111,4,5,2,2,8,21
191124112,3,4,3,1,8,19
191124113,4,9,7,8,9,37
191124114,5,1,7,3,8,24
191124115,1,5,6,8,8,28
191124116,0,2,1,3,7,13
191124117,9,8,0,8,9,34
191124118,4,6,9,5,9,33
191124119,5,8,0,0,4,17
191124120,7,6,7,4,3,27
191124121,2,6,7,5,8,28
191124122,9,0,0,4,7,20
191124123,9,5,6,5,0,25
191124124,2,4,6,3,8,23
191124125,5,5,7,3,6,26
191124126,3,4,5,7,5,24
191124127,6,8,7,1,3,25
191124128,5,1,2,9,2,19
191124129,4,5,1,7,3,20
191124130,1,5,2,9,5,22
191124131,0,9,7,3,5,24
191124132,7,2,7,4,6,26
191124133,4,8,6,6,1,25
191124134,1,2,6,5,8,22
191124135,9,4,1,9,5,28
191124136,8,1,7,8,2,26
191124137,0,4,4,3,0,11
191124138,6,7,8,8,8,37
191124139,1,2,4,8,9,24
191124140,1,1,5,2,1,10
191124141,6,1,7,2,3,19
191124142,1,7,4,4,1,17
191124143,5,6,3,3,4,21
191124144,6,8,9,8,4,35
191124145,8,3,0,4,7,22
191124146,0,2,8,5,2,17
191124147,4,7,4,8,7,30
191124148,7,1,2,1,8,19
191124149,0,5,7,7,0,19
191124150,8,4,1,4,3,20
191124151,1,3,3,4,9,20
191124152,2,4,4,2,2,14
191124153,1,0,2,5,0,8
191124154,5,3,4,3,6,21
191124155,8,5,7,7,0,27
191124156,7,4,7,3,0,21
191124157,6,4,1,6,9,26
191124158,0,4,3,4,5,16
191124159,1,2,5,4,8,20
191124160,9,0,5,5,4,23
191124161,7,2,2,8,8,27
191124162,6,7,9,2,3,27
191124163,8,3,1,3,7,22
191124164,4,3,9,4,6,26
191124165,5,7,9,8,5,34
191124166,6,1,0,2,5,14
191124167,1,1,3,6,4,15
191124168,6,5,1,4,1,17
191124169,2,1,8,8,2,21
191124170,1,1,2,7,2,13
191124171,1,8,2,6,4,21
191124172,0,4,4,6,7,21
191124173,8,8,4,1,0,21
191124174,7,2,0,1,6,16
191124175,9,2,8,1,8,28
191124176,2,2,4,9,1,18
191124177,9,7,3,1,5,25
191124178,7,1,7,9,6,30
191124179,1,6,6,9,3,25
191124180,2,8,4,8,0,22
191124181,7,6,5,8,0,26
191124182,5,8,3,3,4,23
191124183,0,3,5,5,7,20
191124184,5,0,5,0,1,11
191124185,3,4,5,4,9,25
191124186,3,1,3,2,3,12
191124187,7,2,0,5,6,20
191124188,8,1,5,9,1,24
191124189,1,9,5,6,6,27
191124190,2,9,8,4,7,30
191124191,8,9,9,3,9,38
191124192,1,9,7,6,9,32
191124193,9,7,0,3,5,24
191124194,1,5,2,9,1,18
191124195,9,9,6,3,5,32
191124196,3,2,5,9,2,21
191124197,5,8,7,9,1,30
191124198,3,0,9,0,7,19
191124199,3,1,2,9,3,18
191124200,2,1,8,6,5,22
191124201,4,9,0,3,8,24
191124202,6,5,3,1,0,15
191124203,1,0,3,6,5,15
191124204,5,3,7,7,1,23
191124205,5,7,0,5,0,17
191124206,1,2,2,4,4,13
191124207,8,5,3,5,2,23
191124208,3,3,3,8,4,21
191124209,2,2,2,5,1,12
191124210,7,5,8,9,4,33
191124211,0,6,1,2,8,17
191124212,7,5,9,6,9,36
191124213,4,6,3,4,5,22
191124214,9,0,2,7,0,18
191124215,1,0,6,4,7,18
191124216,7,3,5,0,5,20
191124217,8,0,4,3,8,23
191124218,8,6,1,5,8,28
191124219,6,8,2,0,6,22
191124220,0,5,8,3,4,20
191124221,8,7,8,9,1,33
191124222,7,3,3,0,2,15
191124223,2,7,1,1,4,15
191124224,0,9,6,6,7,28
191124225,7,0,6,8,6,27
191124226,5,0,1,1,9,16
191124227,6,2,6,7,7,28
191124228,8,2,8,2,2,22
191124229,4,3,7,6,1,21
191124230,4,3,4,2,8,21
191124231,2,7,3,4,8,24
191124232,3,0,9,7,1,20
191124233,6,9,6,7,5,33
191124234,1,1,8,4,2,16
191124235,4,4,9,7,4,28
191124236,2,9,2,0,5,18
191124237,1,2,5,3,7,18
191124238,1,9,8,5,6,29
191124239,7,6,5,7,6,31
191124240,3,6,9,3,8,29
191124241,4,1,3,6,5,19
191124242,6,0,8,2,4,20
191124243,9,1,4,2,3,19
191124244,1,9,7,7,3,27
191124245,4,5,0,4,0,13
191124246,8,6,5,3,6,28
191124247,2,1,6,3,5,17
191124248,6,3,9,5,9,32
191124249,7,1,3,6,5,22
191124250,2,2,9,9,7,29
191124251,9,6,7,3,3,28
191124252,9,6,9,4,2,30
191124253,3,4,5,0,9,21
191124254,8,9,5,5,3,30
191124255,1,8,7,3,0,19
191124256,7,0,7,4,6,24
191124257,3,6,3,1,3,16
191124258,1,3,9,4,7,24
191124259,5,6,6,1,5,23
191124260,0,1,1,6,2,10
191124261,7,3,3,4,7,24
191124262,0,7,2,0,9,18
191124263,1,2,7,4,5,19
191124264,5,3,9,1,2,20
191124265,3,0,1,2,7,13
191124266,9,5,7,9,3,33
191124267,0,7,8,1,5,21
191124268,3,2,1,8,9,23
191124269,3,8,3,7,0,21
191124270,3,6,6,4,5,24
191124271,1,7,2,0,7,17
191124272,3,0,6,8,7,24
191124273,2,6,6,9,0,23
191124274,0,8,0,7,2,17
191124275,2,5,3,1,4,15
191124276,8,8,6,7,2,31
191124277,7,3,5,1,4,20
191124278,3,7,2,0,7,19
191124279,8,5,3,8,0,24
191124280,6,0,0,6,7,19
191124281,6,9,4,6,4,29
191124282,6,5,7,5,3,26
191124283,2,3,0,5,5,15
191124284,3,5,6,2,7,23
191124285,6,7,1,5,2,21
191124286,2,2,8,4,1,17
191124287,3,1,4,8,5,21
191124288,3,5,6,9,0,23
191124289,1,7,4,9,5,26
191124290,8,0,0,9,3,20
191124291,9,4,4,2,1,20
191124292,7,2,5,2,4,20
191124293,2,4,2,8,5,21
191124294,5,1,5,6,7,24
191124295,4,8,2,5,8,27
191124296,1,0,9,9,4,23
191124297,0,8,3,5,1,17
191124298,2,9,5,1,3,20
191124299,1,7,9,0,8,25
191124300,3,6,1,0,4,14
191124301,5,4,4,5,4,22
191124302,6,8,5,3,3,25
191124303,8,5,8,9,0,30
191124304,5,0,6,9,5,25
191124305,8,3,3,7,5,26
191124306,1,6,2,0,8,17
191124307,5,0,3,8,0,16
191124308,4,6,8,2,6,26
191124309,8,4,4,2,1,19
191124310,0,8,5,4,2,19
191124311,1,5,3,3,5,17
191124312,4,6,5,0,3,18
191124313,0,7,0,8,2,17
191124314,2,5,5,5,5,22
191124315,5,7,0,9,5,26
191124316,3,4,9,0,0,16
191124317,0,8,5,9,7,29
191124318,5,1,4,8,2,20
191124319,5,2,3,8,6,24
191124320,8,2,4,1,6,21
191124321,1,5,0,4,2,12
191124322,6,5,8,6,5,30
191124323,4,1,5,2,5,17
191124324,8,0,4,5,7,24
191124325,0,9,2,0,7,18
191124326,7,6,0,9,2,24
191124327,2,1,7,4,9,23
191124328,8,0,6,8,2,24
191124329,8,9,4,3,9,33
191124330,1,8,2,1,2,14
191124331,6,5,2,0,9,22
191124332,7,2,9,7,3,28
191124333,2,0,6,3,8,19
191124334,6,2,5,1,2,16
191124335,1,0,0,8,7,16
191124336,1,3,6,0,1,11
191124337,3,9,2,5,1,20
191124338,1,1,8,7,4,21
191124339,5,9,3,6,7,30
191124340,2,5,1,2,0,10
191124341,8,4,2,1,6,21
191124342,3,3,5,1,3,15
191124343,8,9,1,4,6,28
191124344,5,9,2,5,8,29
191124345,1,9,9,8,3,30
191124346,1,1,5,4,7,18
191124347,6,1,5,9,9,30
191124348,1,6,3,2,4,16
191124349,3,4,5,9,2,23
191124350,5,4,6,8,9,32
191124351,7,5,4,6,7,29
191124352,5,4,9,2,7,27
191124353,4,0,2,7,6,19
191124354,8,6,8,8,2,32
191124355,4,8,3,2,7,24
191124356,9,6,1,5,4,25
191124357,9,1,0,7,7,24
191124358,7,8,4,7,4,30
191124359,9,7,7,1,8,32
191124360,0,8,7,4,4,23
191124361,6,0,0,8,4,18
191124362,2,7,8,2,5,24
191124363,0,9,1,2,4,16
191124364,0,8,0,7,0,15
191124365,0,0,4,9,4,17
191124366,1,6,9,7,4,27
191124367,4,4,6,3,9,26
191124368,5,3,2,0,4,14
191124369,9,5,2,2,2,20
191124370,0,2,1,9,5,17
191124371,3,8,2,9,2,24
191124372,4,1,1,2,6,14
191124373,5,5,9,9,4,32
191124374,4,2,9,9,8,32
191124375,7,5,4,8,4,28
191124376,0,8,1,5,7,21
191124377,1,6,9,7,2,25
191124378,1,2,4,9,4,20
191124379,7,5,2,8,4,26
191124380,4,4,3,2,0,13
191124381,0,0,2,1,5,8
191124382,4,6,7,2,9,28
191124383,7,2,0,7,0,16
191124384,9,7,6,7,4,33
191124385,5,9,9,5,4,32
191124386,6,2,1,6,0,15
191124387,8,7,4,4,8,31
191124388,3,2,8,1,9,23
191124389,1,8,9,3,5,26
191124390,3,0,8,1,9,21
191124391,7,0,4,6,1,18
191124392,4,6,3,0,5,18
191124393,6,5,8,5,6,30
191124394,4,3,3,4,3,17
191124395,4,3,8,8,4,27
191124396,8,9,7,7,5,36
191124397,9,1,6,8,7,31
191124398,6,1,4,8,6,25
191124399,7,0,5,9,4,25
191124400,7,2,5,0,0,14
191124401,9,8,5,3,7,32
191124402,3,4,9,7,5,28
191124403,4,3,9,2,4,22
191124404,2,7,2,1,9,21
191124405,8,6,8,5,4,31
191124406,6,0,1,9,2,18
191124407,5,5,7,4,0,21
191124408,0,4,3,6,2,15
191124409,7,5,5,8,5,30
191124410,7,3,6,6,3,25
191124411,6,9,2,9,5,31
191124412,3,2,1,2,8,16
191124413,5,6,5,1,6,23
191124414,8,2,8,0,7,25
191124415,6,0,9,0,2,17
191124416,6,6,4,9,3,28
191124417,7,4,7,7,1,26
191124418,7,2,3,9,1,22
191124419,1,0,3,0,7,11
191124420,8,6,1,3,3,21
191124421,0,0,4,2,9,15
191124422,4,7,4,2,8,25
191124423,4,1,8,8,0,21
191124424,7,5,3,4,2,21
191124425,1,5,3,1,9,19
191124426,4,5,4,7,3,23
191124427,2,5,4,9,2,22
191124428,2,9,5,9,2,27
191124429,8,4,6,9,3,30
191124430,6,1,2,9,5,23
191124431,2,2,5,1,7,17
191124432,0,7,0,7,3,17
191124433,7,1,0,1,3,12
191124434,7,0,3,5,5,20
191124435,2,5,6,2,4,19
191124436,1,9,6,6,4,26
191124437,9,8,7,9,2,35
191124438,3,3,1,0,9,16
191124439,4,9,9,7,6,35
191124440,6,5,3,5,2,21
191124441,0,1,3,4,0,8
191124442,7,2,0,6,9,24
191124443,3,0,7,8,2,20
191124444,4,6,5,3,2,20
191124445,9,9,9,7,2,36
191124446,8,4,1,1,7,21
191124447,1,6,8,4,6,25
191124448,4,8,6,1,7,26
191124449,0,6,9,1,5,21
191124450,8,8,8,2,8,34
191124451,0,6,0,5,6,17
191124452,5,7,3,5,2,22
191124453,3,1,4,5,6,19
191124454,0,9,2,6,1,18
191124455,8,3,2,6,9,28
191124456,2,4,7,4,7,24
191124457,1,5,2,8,6,22
191124458,3,2,7,2,0,14
191124459,8,6,3,8,3,28
191124460,3,6,6,2,2,19
191124461,1,5,0,0,1,7
191124462,5,1,3,5,6,20
191124463,0,3,4,0,2,9
191124464,0,2,1,8,1,12
191124465,8,6,1,1,3,19
191124466,9,0,7,9,2,27
191124467,6,2,4,7,2,21
191124468,8,5,6,8,7,34
191124469,7,7,0,4,0,18
191124470,1,9,4,9,5,28
191124471,0,9,1,8,3,21
191124472,1,1,3,8,1,14
191124473,3,7,3,2,2,17
191124474,1,9,9,3,3,25
191124475,6,1,5,1,4,17
191124476,8,4,4,3,5,24
191124477,2,2,6,4,2,16
191124478,3,6,3,6,2,20
191124479,8,3,8,5,3,27
191124480,4,2,9,0,0,15
191124481,2,8,2,8,5,25
191124482,9,6,3,9,4,31
191124483,0,1,8,1,0,10
191124484,7,7,0,8,6,28
191124485,6,3,7,2,8,26
191124486,0,7,0,4,0,11
191124487,0,8,9,3,5,25
191124488,9,6,7,8,4,34
191124489,2,8,3,4,6,23
191124490,7,1,2,3,0,13
191124491,3,5,6,6,9,29
191124492,1,2,7,3,3,16
191124493,1,5,6,2,7,21
191124494,3,9,2,0,1,15
191124495,9,2,2,7,8,28
191124496,8,0,9,7,2,26
191124497,1,3,2,1,8,15
191124498,2,1,3,2,4,12
191124499,9,4,9,8,7,37
191124500,0,4,8,6,7,25
191124501,5,7,3,0,8,23
191124502,1,5,9,8,3,26
191124503,3,7,6,6,0,22
191124504,7,0,7,9,8,31
191124505,6,1,2,5,2,16
191124506,6,1,2,0,2,11
191124507,9,6,3,3,2,23
191124508,0,0,8,3,1,12
191124509,8,2,5,9,4,28
191124510,1,7,4,2,9,23
191124511,5,9,0,2,2,18
191124512,1,1,0,6,7,15
191124513,4,2,9,2,8,25
191124514,9,9,3,4,8,33
191124515,1,8,3,9,1,22
191124516,5,5,0,3,8,21
191124517,8,2,1,3,0,14
191124518,9,9,8,0,4,30
191124519,5,1,6,2,7,21
191124520,0,1,4,6,7,18
191124521,5,4,9,2,9,29
191124522,7,4,5,9,0,25
191124523,0,0,2,5,3,10
191124524,7,5,0,4,7,23
191124525,7,9,4,2,4,26
191124526,4,2,7,2,1,16
191124527,8,1,7,3,0,19
191124528,9,5,8,1,8,31
191124529,0,1,6,5,0,12
191124530,8,3,7,5,5,28
191124531,9,1,2,2,2,16
191124532,6,7,7,8,7,35
191124533,4,4,1,2,1,12
191124534,8,2,1,8,3,22
191124535,0,5,7,7,6,25
191124536,8,7,3,1,9,28
191124537,1,0,2,9,5,17
191124538,4,8,9,1,3,25
191124539,4,8,2,4,3,21
191124540,1,4,5,5,7,22
191124541,7,9,2,8,5,31
191124542,1,8,7,0,9,25
191124543,3,6,3,2,0,14
191124544,8,8,5,4,4,29
191124545,6,2,0,5,6,19
191124546,7,2,2,4,6,21
191124547,0,3,3,6,0,12
191124548,1,6,8,2,0,17
191124549,7,2,3,6,3,21
191124550,3,6,4,2,6,21
191124551,7,6,9,3,4,29
191124552,3,4,5,1,9,22
191124553,2,6,6,2,8,24
191124554,5,5,7,1,5,23
191124555,4,7,8,7,6,32
191124556,2,6,7,3,4,22
191124557,9,8,2,6,4,29
191124558,2,4,2,6,3,17
191124559,4,2,9,3,0,18
191124560,6,4,7,6,5,28
191124561,6,2,6,3,8,25
191124562,6,6,0,0,0,12
191124563,0,5,0,2,9,16
191124564,6,2,3,0,5,16
191124565,9,9,7,9,9,43
191124566,6,8,7,6,6,33
191124567,6,4,9,0,5,24
191124568,5,9,4,9,1,28
191124569,5,1,3,8,1,18
191124570,3,8,7,9,3,30
191124571,5,1,7,4,7,24
191124572,4,5,8,8,3,28
191124573,0,9,8,1,1,19
191124574,3,8,9,8,5,33
191124575,9,2,0,8,7,26
191124576,8,4,5,4,5,26
191124577,1,2,8,8,6,25
191124578,8,6,6,2,4,26
191124579,0,7,8,1,8,24
191124580,1,2,6,3,6,18
191124581,4,8,5,6,5,28
191124582,0,7,5,7,8,27
191124583,0,3,7,5,5,20
191124584,7,2,7,0,5,21
191124585,4,8,5,0,1,18
191124586,0,8,6,6,3,23
191124587,3,3,0,2,7,15
191124588,8,9,6,4,4,31
191124589,1,5,8,7,1,22
191124590,9,4,4,6,9,32
191124591,0,5,5,8,0,18
191124592,9,7,6,3,0,25
191124593,2,3,0,0,2,7
191124594,1,8,0,7,0,16
191124595,0,4,6,7,8,25
191124596,7,4,0,5,6,22
191124597,3,1,3,9,6,22
191124598,4,5,3,1,5,18
191124599,0,7,7,0,9,23
191124600,4,0,0,7,5,16
191124601,3,0,5,3,8,19
191124602,9,4,5,0,4,22
191124603,4,8,9,8,3,32
191124604,0,0,0,8,6,14
191124605,1,1,8,7,0,17
191124606,4,9,1,0,2,16
191124607,7,0,0,8,2,17
191124608,6,8,6,3,9,32
191124609,2,7,5,1,3,18
191124610,2,7,6,7,1,23
191124611,3,4,4,0,9,20
191124612,9,9,1,1,9,29
191124613,3,3,2,7,9,24
191124614,6,6,9,9,2,32
191124615,5,6,6,2,9,28
191124616,6,1,7,0,6,20
191124617,0,9,4,3,2,18
191124618,5,2,1,2,5,15
191124619,7,7,2,1,9,26
191124620,2,3,5,9,6,25
191124621,7,3,2,5,2,19
191124622,3,4,8,7,7,29
191124623,1,6,0,6,4,17
191124624,7,4,1,9,5,26
191124625,1,9,3,4,6,23
191124626,9,3,0,1,4,17
191124627,6,3,3,3,7,22
191124628,6,3,3,4,5,21
191124629,2,9,5,3,3,22
191124630,6,6,3,9,7,31
191124631,2,3,5,2,7,19
191124632,9,6,0,5,6,26
191124633,7,2,8,7,0,24
191124634,3,4,0,4,8,19
191124635,3,1,0,4,2,10
191124636,9,8,3,7,5,32
191124637,2,2,3,2,6,15
191124638,5,4,6,0,5,20
191124639,5,9,5,3,1,23
191124640,6,2,2,0,1,11
191124641,5,4,6,5,0,20
191124642,6,8,1,9,0,24
191124643,9,6,6,5,1,27
191124644,2,0,1,0,7,10
191124645,0,3,4,9,0,16
191124646,0,7,4,0,3,14
191124647,1,3,8,4,6,22
191124648,4,0,8,0,2,14
191124649,0,2,9,9,8,28
191124650,9,6,1,9,4,29
191124651,8,1,2,1,9,21
191124652,3,8,9,7,8,35
191124653,7,8,3,3,0,21
191124654,9,7,3,3,4,26
191124655,7,5,6,3,3,24
191124656,2,9,0,0,5,16
191124657,2,1,8,8,3,22
191124658,0,4,2,3,7,16
191124659,7,1,2,9,5,24
191124660,3,8,9,8,3,31
191124661,5,4,4,7,1,21
191124662,8,1,2,1,5,17
191124663,7,0,2,0,4,13
191124664,7,1,6,1,8,23
191124665,4,2,9,1,8,24
191124666,2,2,2,6,7,19
191124667,0,9,8,2,4,23
191124668,1,6,3,4,8,22
191124669,9,5,1,8,9,32
191124670,1,0,3,2,8,14
191124671,7,9,3,9,2,30
191124672,7,2,6,1,8,24
191124673,4,6,9,6,6,31
191124674,2,2,2,6,4,16
191124675,0,1,7,7,4,19
191124676,2,4,3,4,1,14
191124677,2,4,0,0,6,12
191124678,5,6,1,2,9,23
191124679,8,8,2,5,4,27
191124680,9,9,1,4,6,29
191124681,1,4,4,2,4,15
191124682,3,3,3,8,3,20
191124683,6,5,5,4,8,28
191124684,4,3,9,3,2,21
191124685,5,1,8,2,2,18
191124686,7,2,2,8,3,22
191124687,5,9,0,3,7,24
191124688,7,5,4,1,9,26
191124689,9,6,7,8,8,38
191124690,0,5,8,7,8,28
191124691,2,4,3,1,7,17
191124692,4,7,9,2,0,22
191124693,6,8,2,8,8,32
191124694,4,9,4,0,0,17
191124695,6,0,4,0,2,12
191124696,6,3,2,7,7,25
191124697,7,9,2,0,1,19
191124698,3,3,3,9,2,20
191124699,1,5,2,9,2,19
191124700,4,4,0,5,2,15
191124701,5,9,2,2,6,24
191124702,3,8,1,6,4,22
191124703,7,4,3,8,9,31
191124704,5,6,4,2,3,20
191124705,5,0,0,7,3,15
191124706,2,8,3,8,0,21
191124707,4,5,8,4,3,24
191124708,1,2,2,3,4,12
191124709,9,7,0,7,4,27
191124710,4,0,9,0,5,18
191124711,6,8,6,3,6,29
191124712,6,6,4,3,2,21
191124713,4,7,1,4,1,17
191124714,1,5,0,6,0,12
191124715,3,9,0,2,5,19
191124716,3,5,8,9,2,27
191124717,5,1,4,4,1,15
191124718,0,5,1,0,7,13
191124719,2,9,6,9,8,34
191124720,1,8,6,6,7,28
191124721,7,3,8,4,9,31
191124722,3,7,9,2,1,22
191124723,0,9,6,2,0,17
191124724,3,9,3,4,5,24
191124725,9,3,8,5,6,31
191124726,1,4,6,1,7,19
191124727,0,1,7,0,2,10
191124728,2,6,8,9,4,29
191124729,6,1,4,6,6,23
191124730,9,0,7,3,8,27
191124731,8,2,3,2,9,24
191124732,3,4,1,7,9,24
191124733,1,6,0,9,7,23
191124734,3,4,1,7,4,19
191124735,5,3,2,5,2,17
191124736,4,0,1,3,4,12
191124737,4,7,7,7,5,30
191124738,1,5,9,0,3,18
191124739,1,9,4,4,9,27
191124740,3,7,8,0,4,22
191124741,0,6,0,3,4,13
191124742,7,3,4,6,0,20
191124743,4,8,0,4,8,24
191124744,4,8,4,3,1,20
191124745,4,5,1,8,6,24
191124746,6,3,5,0,9,23
191124747,7,9,2,5,7,30
191124748,1,9,3,9,0,22
191124749,8,4,4,5,5,26
191124750,9,2,5,7,1,24
191124751,1,5,3,1,5,15
191124752,1,7,4,4,9,25
191124753,4,3,6,4,0,17
191124754,5,0,9,5,5,24
191124755,9,4,1,0,4,18
191124756,0,4,9,0,5,18
191124757,2,5,6,8,6,27
191124758,6,7,9,4,3,29
191124759,5,7,3,8,6,29
191124760,7,5,9,2,1,24
191124761,1,7,6,0,4,18
191124762,5,8,6,0,1,20
191124763,9,8,5,4,8,34
191124764,6,6,2,5,5,24
191124765,1,2,4,5,0,12
191124766,1,8,6,3,1,19
191124767,8,2,4,6,7,27
191124768,8,5,9,6,5,33
191124769,7,2,0,0,3,12
191124770,6,4,1,1,8,20
191124771,2,7,8,0,7,24
191124772,3,3,2,7,2,17
191124773,3,2,8,6,8,27
191124774,9,2,4,6,6,27
191124775,2,8,2,0,1,13
191124776,3,3,4,5,5,20
191124777,5,5,8,4,2,24
191124778,9,3,4,7,0,23
191124779,9,4,7,5,3,28
191124780,1,5,0,5,9,20
191124781,4,3,1,0,8,16
191124782,0,5,3,2,5,15
191124783,3,0,6,2,5,16
191124784,3,5,2,0,4,14
191124785,5,1,1,9,1,17
191124786,6,8,7,7,6,34
191124787,1,6,0,2,5,14
191124788,7,5,3,8,7,30
191124789,4,2,0,7,2,15
191124790,9,4,0,2,3,18
191124791,8,3,3,3,5,22
191124792,8,6,2,6,5,27
191124793,4,8,2,8,0,22
191124794,6,9,6,2,1,24
191124795,7,9,1,4,5,26
191124796,0,6,3,2,9,20
191124797,4,1,4,1,4,14
191124798,4,8,6,3,3,24
191124799,5,4,1,7,5,22
191124800,4,3,0,3,0,10
191124801,5,8,4,2,8,27
191124802,7,4,5,0,0,16
191124803,5,6,4,2,8,25
191124804,8,8,4,8,9,37
191124805,5,4,7,5,0,21
191124806,0,2,0,0,3,5
191124807,4,6,4,7,7,28
191124808,0,4,3,5,6,18
191124809,1,6,1,8,7,23
191124810,1,8,5,0,4,18
191124811,6,4,7,8,9,34
191124812,1,5,4,2,3,15
191124813,4,2,6,7,5,24
191124814,2,3,9,7,6,27
191124815,0,2,7,5,6,20
191124816,5,8,6,3,7,29
191124817,5,3,1,7,7,23
191124818,8,3,3,9,1,24
191124819,1,1,6,9,0,17
191124820,5,8,0,4,2,19
191124821,3,6,8,7,7,31
191124822,6,7,3,5,0,21
191124823,0,0,7,9,9,25
191124824,6,5,9,5,4,29
191124825,2,2,1,6,6,17
191124826,8,9,1,9,0,27
191124827,1,9,2,0,2,14
191124828,6,6,8,6,8,34
191124829,8,2,3,3,5,21
191124830,6,5,2,1,4,18
191124831,2,3,7,4,1,17
191124832,7,6,5,0,6,24
191124833,7,3,5,2,4,21
191124834,3,1,5,9,5,23
191124835,4,5,2,2,3,16
191124836,8,4,1,5,6,24
191124837,0,2,0,6,9,17
191124838,3,7,9,0,8,27
191124839,4,0,5,2,8,19
191124840,3,7,3,7,3,23
191124841,7,9,7,0,7,30
191124842,8,7,2,5,1,23
191124843,8,0,0,1,7,16
191124844,6,1,8,6,7,28
191124845,1,7,3,1,4,16
191124846,0,0,1,6,0,7
191124847,9,3,2,2,3,19
191124848,7,8,8,6,0,29
191124849,5,0,1,7,8,21
191124850,1,4,1,6,1,13
191124851,4,1,2,4,9,20
191124852,8,2,2,9,8,29
191124853,0,9,3,3,7,22
191124854,1,2,1,7,3,14
191124855,9,6,5,9,9,38
191124856,1,0,0,7,7,15
191124857,1,9,9,6,0,25
191124858,5,0,7,3,0,15
191124859,6,5,5,0,7,23
191124860,6,4,8,9,4,31
191124861,3,8,2,2,4,19
191124862,6,1,7,5,9,28
191124863,7,6,7,3,7,30
191124864,5,0,1,0,4,10
191124865,8,4,9,0,7,28
191124866,1,3,1,3,5,13
191124867,8,6,4,3,9,30
191124868,6,6,3,9,9,33
191124869,0,8,1,1,0,10
191124870,3,6,1,0,2,12
191124871,8,6,5,9,1,29
191124872,3,1,8,4,4,20
191124873,5,4,8,0,4,21
191124874,9,2,1,8,1,21
191124875,1,9,2,9,7,28
191124876,6,8,9,8,0,31
191124877,5,1,9,1,2,18
191124878,4,2,9,6,7,28
191124879,7,7,5,3,3,25
191124880,9,8,3,1,6,27
191124881,7,4,3,7,3,24
191124882,5,0,0,0,4,9
191124883,7,8,7,1,4,27
191124884,8,6,3,9,7,33
191124885,0,4,3,1,5,13
191124886,2,6,6,6,2,22
191124887,3,9,2,1,5,20
191124888,8,1,3,6,9,27
191124889,6,5,8,5,5,29
191124890,3,0,9,2,3,17
191124891,9,5,6,2,9,31
191124892,4,1,9,8,5,27
191124893,1,8,6,4,6,25
191124894,9,8,2,8,9,36
191124895,0,2,1,1,1,5
191124896,0,5,6,8,6,25
191124897,8,9,8,3,5,33
191124898,8,5,5,3,8,29
191124899,7,6,1,9,6,29
191124900,6,5,8,4,5,28
191124901,5,2,7,3,7,24
191124902,7,2,3,1,4,17
191124903,1,6,1,8,5,21
191124904,8,4,8,1,1,22
191124905,3,7,9,5,1,25
191124906,5,2,8,5,7,27
191124907,7,0,2,6,8,23
191124908,8,4,0,4,5,21
191124909,0,4,3,3,4,14
191124910,1,2,7,5,6,21
191124911,3,8,7,6,1,25
191124912,9,2,7,2,5,25
191124913,0,6,6,5,1,18
191124914,1,2,5,2,2,12
191124915,4,8,1,0,1,14
191124916,4,9,7,2,6,28
191124917,8,8,6,9,9,40
191124918,5,5,3,8,5,26
191124919,5,2,3,7,4,21
191124920,4,2,7,5,7,25
191124921,3,4,9,7,1,24
191124922,7,6,9,6,9,37
191124923,2,8,4,1,2,17
191124924,9,1,8,0,4,22
191124925,9,6,8,1,3,27
191124926,9,9,9,9,1,37
191124927,6,1,3,3,4,17
191124928,3,9,8,2,6,28
191124929,2,7,9,2,2,22
191124930,4,1,5,7,6,23
191124931,3,8,9,5,1,26
191124932,1,2,9,4,3,19
191124933,8,1,5,9,9,32
191124934,8,6,7,7,4,32
191124935,3,1,1,2,9,16
191124936,2,2,0,3,5,12
191124937,5,4,9,6,6,30
191124938,6,3,8,0,6,23
191124939,0,1,7,8,6,22
191124940,4,9,4,6,7,30
191124941,7,9,6,7,2,31
191124942,5,1,4,2,9,21
191124943,4,2,7,1,9,23
191124944,4,1,2,4,0,11
191124945,4,3,1,5,4,17
191124946,4,4,8,5,2,23
191124947,1,7,9,1,1,19
191124948,7,0,0,4,5,16
191124949,8,8,5,7,2,30
191124950,1,8,8,3,6,26
191124951,1,9,8,1,0,19
191124952,8,6,4,2,6,26
191124953,9,5,0,5,7,26
191124954,7,7,9,8,7,38
191124955,4,4,1,4,8,21
191124956,3,1,2,9,2,17
191124957,1,3,1,4,9,18
191124958,6,7,9,7,1,30
191124959,6,8,6,9,0,29
191124960,5,9,2,4,7,27
191124961,1,3,6,0,8,18
191124962,1,6,2,9,2,20
191124963,6,0,8,7,4,25
191124964,8,2,6,6,6,28
191124965,1,1,9,4,5,20
191124966,0,8,7,6,9,30
191124967,9,2,1,3,8,23
191124968,4,6,7,3,0,20
191124969,8,2,3,5,2,20
191124970,8,6,2,3,8,27
191124971,9,7,1,1,3,21
191124972,8,3,3,5,8,27
191124973,2,5,5,8,4,24
191124974,6,4,8,7,8,33
191124975,5,2,3,2,7,19
191124976,5,9,8,4,1,27
191124977,2,1,9,2,8,22
191124978,3,6,8,4,9,30
191124979,8,5,7,9,9,38
191124980,4,5,6,6,7,28
191124981,0,6,8,2,7,23
191124982,9,8,9,3,2,31
191124983,2,9,0,7,6,24
191124984,6,2,4,7,1,20
191124985,3,4,0,0,7,14
191124986,8,9,5,6,5,33
191124987,3,7,4,7,5,26
191124988,6,1,0,0,4,11
191124989,3,2,1,0,5,11
191124990,7,5,8,0,9,29
191124991,5,4,5,6,7,27
191124992,1,3,3,2,4,13
191124993,0,1,5,8,6,20
191124994,0,3,6,0,0,9
191124995,6,3,9,5,6,29
191124996,4,6,1,5,9,25
191124997,4,3,2,3,8,20
191124998,7,1,5,2,3,18
191124999,1,2,2,5,7,17
1911241000,8,2,2,0,7,19
1911241001,0,0,0,0,1,1
1911241002,4,8,8,7,1,28
1911241003,0,2,6,5,5,18
1911241004,7,3,6,9,4,29
1911241005,8,4,5,5,2,24
1911241006,4,7,2,5,4,22
1911241007,9,6,5,7,3,30
1911241008,9,1,1,6,1,18
1911241009,6,2,5,0,2,15
1911241010,4,5,5,4,9,27
1911241011,6,1,2,3,6,18
1911241012,9,1,4,3,8,25
1911241013,3,2,6,3,7,21
1911241014,4,8,4,3,5,24
1911241015,4,1,4,4,9,22
1911241016,8,0,6,1,0,15
1911241017,6,1,5,1,9,22
1911241018,9,3,2,8,9,31
1911241019,9,5,9,5,3,31
1911241020,5,2,1,3,3,14
1911241021,1,4,3,3,2,13
1911241022,6,2,8,7,5,28
1911241023,3,6,9,4,1,23
1911241024,4,8,7,4,0,23
1911241025,7,9,6,5,0,27
1911241026,1,2,6,8,2,19
1911241027,0,7,0,0,3,10
1911241028,6,8,2,6,8,30
1911241029,0,0,4,1,2,7
1911241030,8,0,6,1,2,17
1911241031,1,7,5,0,0,13
1911241032,9,0,6,0,2,17
1911241033,6,1,5,8,3,23
1911241034,3,5,6,6,8,28
1911241035,6,7,5,1,7,26
1911241036,5,5,5,1,4,20
1911241037,5,9,1,4,4,23
1911241038,3,8,5,7,9,32
1911241039,2,3,8,3,2,18
1911241040,3,7,8,9,2,29
1911241041,6,4,2,6,4,22
1911241042,5,9,5,2,7,28
1911241043,1,3,3,8,7,22
1911241044,0,2,2,6,2,12
1911241045,1,5,2,3,5,16
1911241046,7,3,6,1,9,26
1911241047,5,8,8,5,0,26
1911241048,2,0,5,9,3,19
1911241049,8,9,6,1,2,26
1911241050,8,2,7,2,7,26
1911241051,0,7,7,6,0,20
1911241052,2,9,8,6,1,26
1911241053,5,9,8,0,6,28
1911241054,6,4,8,0,0,18
1911241055,7,4,6,7,3,27
1911241056,6,9,0,0,7,22
1911241057,0,8,4,7,8,27
1911241058,8,4,6,3,8,29
1911241059,3,9,5,6,2,25
1911241060,3,0,6,2,8,19
1911241061,3,7,5,4,5,24
1911241062,2,2,4,8,2,18
1911241063,8,6,6,4,1,25
1911241064,7,9,1,0,2,19
1911241065,2,8,6,9,6,31
1911241066,4,5,2,5,7,23
1911241067,7,4,4,3,9,27
1911241068,8,7,7,4,6,32
1911241069,4,9,8,1,1,23
1911241070,2,8,2,6,4,22
1911241071,3,8,4,9,1,25
1911241072,8,1,9,0,6,24
1911241073,9,8,8,3,6,34
1911241074,8,1,6,9,7,31
1911241075,7,8,5,9,9,38
1911241076,4,5,4,2,8,23
1911241077,1,8,2,5,7,23
1911241078,0,9,3,2,6,20
1911241079,5,5,8,4,9,31
1911241080,8,3,5,4,9,29
1911241081,9,0,9,9,5,32
1911241082,9,9,4,4,5,31
1911241083,3,3,7,8,8,29
1911241084,8,6,5,1,8,28
1911241085,3,4,2,0,2,11
1911241086,9,2,8,6,3,28
1911241087,1,1,9,4,0,15
1911241088,2,0,9,8,8,27
1911241089,2,8,8,0,4,22
1911241090,4,0,5,4,8,21
1911241091,2,4,6,7,8,27
1911241092,5,1,9,6,7,28
1911241093,5,3,3,6,9,26
1911241094,9,4,0,1,3,17
1911241095,0,4,0,8,4,16
1911241096,8,0,3,3,6,20
1911241097,3,5,3,6,9,26
1911241098,7,0,3,4,3,17
1911241099,8,0,6,2,0,16
1911241100,2,4,8,0,2,16
1911241101,5,0,9,8,6,28
1911241102,6,9,8,7,6,36
1911241103,9,4,4,5,2,24
1911241104,3,0,8,5,3,19
1911241105,7,9,7,8,3,34
191125001,7,6,7,7,6,33
191125002,3,8,1,7,7,26
191125003,9,2,2,7,4,24
191125004,7,6,2,2,6,23
191125005,0,0,2,3,1,6
191125006,6,9,4,2,9,30
191125007,8,5,1,8,5,27
191125008,0,6,0,0,9,15
191125009,6,8,9,8,7,38
191125010,9,3,7,1,7,27
191125011,2,8,5,9,0,24
191125012,0,0,1,1,8,10
191125013,0,5,2,0,9,16
191125014,3,7,8,7,7,32
191125015,2,8,3,9,9,31
191125016,8,4,8,3,1,24
191125017,0,1,8,6,8,23
191125018,0,4,3,0,6,13
191125019,5,0,7,0,4,16
191125020,9,2,6,8,0,25
191125021,9,3,9,7,9,37
191125022,6,9,5,4,5,29
191125023,7,3,0,5,0,15
191125024,8,1,4,5,0,18
191125025,6,1,0,9,1,17
191125026,9,3,8,8,9,37
191125027,9,5,6,4,5,29
191125028,0,5,7,5,0,17
191125029,1,7,5,7,8,28
191125030,4,4,8,2,1,19
191125031,7,1,9,9,2,28
191125032,9,2,2,4,0,17
191125033,8,1,3,8,7,27
191125034,0,0,1,5,3,9
191125035,1,1,8,5,0,15
191125036,3,5,8,9,4,29
191125037,5,7,2,6,3,23
191125038,5,9,0,3,3,20
191125039,1,1,7,5,1,15
191125040,9,9,1,8,0,27
191125041,8,1,2,0,1,12
191125042,2,1,0,2,6,11
191125043,1,2,8,2,9,22
191125044,7,9,3,9,0,28
191125045,1,5,3,5,0,14
191125046,1,9,4,1,9,24
191125047,3,1,1,0,7,12
191125048,0,6,7,2,7,22
191125049,1,5,8,0,8,22
191125050,4,0,0,4,6,14
191125051,2,8,4,5,1,20
191125052,9,1,4,1,9,24
191125053,8,2,6,2,5,23
191125054,3,4,5,4,0,16
191125055,8,3,0,5,0,16
191125056,4,1,2,6,7,20
191125057,4,7,2,5,1,19
191125058,8,1,7,0,2,18
191125059,0,0,2,8,8,18
191125060,7,3,6,6,9,31
191125061,2,9,3,6,6,26
191125062,8,2,6,9,4,29
191125063,2,6,5,1,7,21
191125064,8,3,1,3,4,19
191125065,8,5,5,5,4,27
191125066,6,3,8,2,0,19
191125067,6,9,5,3,8,31
191125068,6,6,1,0,0,13
191125069,4,6,1,9,0,20
191125070,5,0,6,4,2,17
191125071,8,5,0,4,2,19
191125072,9,3,6,1,3,22
191125073,6,7,2,3,6,24
191125074,5,3,9,3,3,23
191125075,3,2,8,3,8,24
191125076,0,3,6,6,5,20
191125077,7,3,3,7,9,29
191125078,9,4,8,7,2,30
191125079,1,0,4,2,1,8
191125080,9,2,5,9,1,26
191125081,4,8,5,8,2,27
191125082,2,1,8,6,4,21
191125083,6,1,6,5,5,23
191125084,0,7,1,3,5,16
191125085,3,4,0,3,5,15
191125086,8,5,1,9,0,23
191125087,5,3,9,7,7,31
191125088,0,3,1,6,8,18
191125089,0,0,3,2,4,9
191125090,9,9,4,6,7,35
191125091,7,1,6,5,8,27
191125092,7,6,0,0,1,14
191125093,3,8,7,8,2,28
191125094,4,7,5,1,1,18
191125095,7,2,0,5,9,23
191125096,6,6,9,1,0,22
191125097,7,1,5,1,2,16
191125098,1,8,0,4,8,21
191125099,9,9,7,0,5,30
191125100,2,8,3,7,3,23
191125101,1,3,8,6,9,27
191125102,0,5,6,6,6,23
191125103,0,1,5,4,7,17
191125104,9,7,8,5,1,30
191125105,7,3,0,6,6,22
191125106,6,8,2,8,7,31
191125107,0,3,3,8,9,23
191125108,3,1,7,5,8,24
191125109,5,3,1,9,0,18
191125110,2,6,4,8,4,24
191125111,2,3,6,5,3,19
191125112,4,2,9,9,9,33
191125113,5,0,7,3,4,19
191125114,3,5,3,9,4,24
191125115,9,1,2,2,6,20
191125116,4,4,9,4,2,23
191125117,2,7,2,9,5,25
191125118,0,0,5,1,4,10
191125119,4,4,9,3,4,24
191125120,3,9,9,4,3,28
191125121,4,8,8,2,3,25
191125122,1,2,4,7,4,18
191125123,5,1,1,1,5,13
191125124,7,0,2,3,2,14
191125125,5,7,9,5,3,29
191125126,2,8,6,2,9,27
191125127,8,3,6,9,2,28
191125128,8,6,2,6,3,25
191125129,4,1,8,7,3,23
191125130,6,1,6,7,1,21
191125131,7,6,2,2,0,17
191125132,1,6,0,7,8,22
191125133,9,4,3,3,2,21
191125134,5,0,1,2,2,10
191125135,9,6,0,5,7,27
191125136,8,8,4,3,7,30
191125137,7,9,2,1,9,28
191125138,8,1,2,0,3,14
191125139,6,0,4,6,7,23
191125140,7,8,8,5,2,30
191125141,9,9,3,7,0,28
191125142,1,0,8,8,1,18
191125143,5,6,8,1,8,28
191125144,9,5,9,7,4,34
191125145,9,1,1,7,5,23
191125146,0,4,9,1,5,19
191125147,9,0,2,5,4,20
191125148,9,2,4,3,7,25
191125149,1,1,3,1,6,12
191125150,2,7,0,3,0,12
191125151,2,3,6,5,6,22
191125152,0,6,6,9,1,22
191125153,0,6,1,9,7,23
191125154,5,5,7,6,6,29
191125155,5,9,8,7,1,30
191125156,0,4,2,4,6,16
191125157,2,0,8,1,1,12
191125158,1,7,0,8,4,20
191125159,8,2,4,8,4,26
191125160,1,0,2,5,2,10
191125161,6,4,5,3,5,23
191125162,7,8,9,0,6,30
191125163,2,6,5,6,9,28
191125164,9,3,6,9,8,35
191125165,9,5,1,9,0,24
191125166,6,3,9,9,3,30
191125167,4,6,9,9,6,34
191125168,5,0,8,6,8,27
191125169,6,1,7,1,6,21
191125170,3,9,9,9,4,34
191125171,2,8,7,7,4,28
191125172,3,6,8,8,6,31
191125173,2,5,1,1,8,17
191125174,8,2,5,4,0,19
191125175,4,1,5,8,3,21
191125176,8,5,8,9,8,38
191125177,7,0,6,3,2,18
191125178,1,2,3,3,9,18
191125179,0,0,7,6,6,19
191125180,6,3,9,3,8,29
191125181,9,2,0,0,9,20
191125182,7,5,8,7,3,30
191125183,0,6,5,9,8,28
191125184,3,5,2,3,5,18
191125185,6,0,0,9,8,23
191125186,5,6,6,2,8,27
191125187,6,0,0,3,4,13
191125188,4,4,1,7,4,20
191125189,2,0,6,9,4,21
191125190,7,1,6,9,1,24
191125191,5,4,5,3,7,24
191125192,1,3,1,5,3,13
191125193,4,1,8,3,3,19
191125194,9,2,3,2,1,17
191125195,2,6,1,5,0,14
191125196,7,1,6,8,1,23
191125197,4,0,0,1,5,10
191125198,5,5,8,3,8,29
191125199,4,0,4,1,2,11
191125200,3,7,4,4,4,22
191125201,9,9,5,0,0,23
191125202,2,2,1,0,7,12
191125203,1,6,7,9,0,23
191125204,7,9,2,3,1,22
191125205,2,2,2,7,8,21
191125206,3,7,7,9,4,30
191125207,3,1,1,5,2,12
191125208,0,2,8,6,2,18
191125209,1,1,7,5,3,17
191125210,2,5,8,6,0,21
191125211,3,8,7,9,2,29
191125212,3,7,1,8,4,23
191125213,2,1,4,6,4,17
191125214,9,0,3,8,3,23
191125215,3,4,9,5,2,23
191125216,8,5,4,9,6,32
191125217,3,2,8,5,1,19
191125218,5,3,2,9,0,19
191125219,2,3,4,8,6,23
191125220,1,0,9,0,0,10
191125221,7,0,2,8,6,23
191125222,1,3,5,0,7,16
191125223,6,8,9,4,2,29
191125224,8,2,0,1,4,15
191125225,0,3,8,9,4,24
191125226,0,3,2,8,2,15
191125227,3,3,8,1,4,19
191125228,4,6,1,5,1,17
191125229,0,5,4,2,4,15
191125230,7,3,6,4,7,27
191125231,7,0,1,6,3,17
191125232,5,4,9,8,5,31
191125233,7,7,9,6,1,30
191125234,3,2,2,1,2,10
191125235,5,6,8,7,6,32
191125236,3,4,9,1,8,25
191125237,0,1,3,6,1,11
191125238,8,4,6,6,2,26
191125239,6,0,2,5,5,18
191125240,8,8,7,2,8,33
191125241,7,1,5,1,1,15
191125242,5,0,3,3,6,17
191125243,7,8,3,1,1,20
191125244,4,6,6,5,4,25
191125245,1,8,5,2,4,20
191125246,6,7,3,7,9,32
191125247,7,0,3,9,0,19
191125248,0,3,9,9,9,30
191125249,5,8,8,0,3,24
191125250,4,7,3,9,0,23
191125251,2,8,1,5,3,19
191125252,7,6,4,4,9,30
191125253,7,2,2,2,1,14
191125254,1,0,2,6,2,11
191125255,6,8,2,1,3,20
191125256,3,4,7,5,7,26
191125257,5,6,1,1,0,13
191125258,8,0,3,5,0,16
191125259,5,3,3,0,2,13
191125260,0,2,0,0,1,3
191125261,1,9,6,7,8,31
191125262,8,3,3,7,9,30
191125263,1,0,6,3,5,15
191125264,7,2,3,6,7,25
191125265,8,9,9,8,8,42
191125266,8,5,7,3,5,28
191125267,5,4,1,8,7,25
191125268,5,4,3,6,3,21
191125269,9,4,9,6,3,31
191125270,1,5,7,2,0,15
191125271,8,7,1,0,8,24
191125272,6,8,2,3,6,25
191125273,1,2,2,5,3,13
191125274,6,5,5,1,3,20
191125275,5,2,5,3,1,16
191125276,5,8,4,1,2,20
191125277,3,0,5,1,0,9
191125278,2,5,4,8,1,20
191125279,1,8,0,4,9,22
191125280,2,7,3,0,7,19
191125281,0,7,8,5,9,29
191125282,3,9,5,0,9,26
191125283,3,7,7,4,2,23
191125284,5,1,7,4,9,26
191125285,3,9,6,4,8,30
191125286,7,5,5,1,2,20
191125287,8,3,1,8,4,24
191125288,0,9,6,3,7,25
191125289,7,7,1,5,8,28
191125290,8,4,2,0,7,21
191125291,7,6,4,3,8,28
191125292,0,3,3,9,6,21
191125293,5,7,0,1,5,18
191125294,8,8,1,3,6,26
191125295,3,7,8,2,2,22
191125296,3,9,4,7,5,28
191125297,6,0,8,5,9,28
191125298,6,4,1,4,0,15
191125299,7,5,9,7,2,30
191125300,2,3,9,5,9,28
191125301,8,4,1,9,3,25
191125302,4,9,2,1,3,19
191125303,6,8,7,9,0,30
191125304,3,5,6,5,2,21
191125305,1,2,9,9,3,24
191125306,2,4,3,7,3,19
191125307,6,5,8,6,6,31
191125308,4,8,8,8,0,28
191125309,1,5,7,1,3,17
191125310,8,0,4,6,9,27
191125311,9,7,9,9,7,41
191125312,1,8,3,2,3,17
191125313,1,6,8,4,9,28
191125314,2,1,2,8,7,20
191125315,5,8,6,1,4,24
191125316,8,4,4,8,6,30
191125317,8,7,2,1,7,25
191125318,5,6,4,6,4,25
191125319,3,1,0,5,7,16
191125320,2,8,6,7,7,30
191125321,5,5,6,1,6,23
191125322,2,3,1,8,2,16
191125323,3,9,8,9,3,32
191125324,8,9,0,3,9,29
191125325,4,2,2,5,9,22
191125326,4,8,8,2,5,27
191125327,1,4,2,3,6,16
191125328,0,8,1,1,4,14
191125329,2,0,7,1,6,16
191125330,0,8,3,9,9,29
191125331,5,9,9,6,5,34
191125332,8,1,0,5,2,16
191125333,3,2,0,7,1,13
191125334,7,5,1,2,4,19
191125335,9,6,3,4,5,27
191125336,9,3,8,9,2,31
191125337,6,1,4,1,5,17
191125338,6,4,0,2,7,19
191125339,8,6,0,3,7,24
191125340,7,7,7,3,1,25
191125341,4,0,5,5,3,17
191125342,9,4,0,1,0,14
191125343,7,7,0,4,5,23
191125344,4,0,2,8,4,18
191125345,4,9,8,7,1,29
191125346,8,6,6,2,8,30
191125347,2,4,2,9,2,19
191125348,7,8,7,8,3,33
191125349,3,8,0,9,1,21
191125350,3,0,7,8,6,24
191125351,4,0,2,7,2,15
191125352,8,4,8,8,7,35
191125353,7,9,9,3,7,35
191125354,0,9,9,7,7,32
191125355,2,9,3,9,1,24
191125356,0,0,7,3,0,10
191125357,9,6,5,2,8,30
191125358,5,0,5,4,3,17
191125359,0,9,3,5,7,24
191125360,1,9,9,0,9,28
191125361,9,9,3,4,2,27
191125362,6,1,0,6,3,16
191125363,9,5,5,5,7,31
191125364,0,8,0,7,1,16
191125365,8,1,2,4,3,18
191125366,7,3,8,0,1,19
191125367,2,8,4,0,8,22
191125368,8,4,8,1,6,27
191125369,1,0,3,1,7,12
191125370,8,3,9,3,4,27
191125371,8,4,3,2,3,20
191125372,0,8,0,5,7,20
191125373,8,7,8,7,0,30
191125374,6,7,9,5,4,31
191125375,2,8,9,5,3,27
191125376,1,7,2,8,3,21
191125377,3,2,2,8,7,22
191125378,4,9,1,5,2,21
191125379,4,6,3,2,9,24
191125380,4,9,5,9,1,28
191125381,6,3,5,1,1,16
191125382,7,6,7,3,2,25
191125383,1,7,1,2,7,18
191125384,4,9,5,0,5,23
191125385,6,2,9,2,8,27
191125386,2,7,5,6,1,21
191125387,2,7,2,7,4,22
191125388,9,1,0,1,6,17
191125389,2,5,8,9,2,26
191125390,7,7,2,5,6,27
191125391,4,6,0,8,3,21
191125392,1,1,6,0,8,16
191125393,4,6,2,5,7,24
191125394,9,6,9,1,2,27
191125395,5,8,0,8,3,24
191125396,2,6,0,2,9,19
191125397,1,7,1,0,5,14
191125398,6,2,6,1,9,24
191125399,0,7,7,5,2,21
191125400,8,2,7,9,5,31
191125401,1,0,0,1,4,6
191125402,1,6,1,3,0,11
191125403,8,6,8,4,0,26
191125404,8,0,8,3,8,27
191125405,7,1,4,2,5,19
191125406,7,1,9,0,6,23
191125407,2,9,2,9,1,23
191125408,9,3,5,6,2,25
191125409,7,3,4,0,7,21
191125410,1,2,8,0,1,12
191125411,4,4,3,4,8,23
191125412,0,0,4,3,3,10
191125413,6,8,1,0,7,22
191125414,4,0,7,9,3,23
191125415,9,1,6,8,5,29
191125416,8,7,2,9,5,31
191125417,7,0,6,1,6,20
191125418,5,7,1,3,2,18
191125419,7,3,6,3,9,28
191125420,3,7,5,8,5,28
191125421,0,3,9,2,3,17
191125422,2,4,3,3,3,15
191125423,9,8,7,3,2,29
191125424,3,0,3,7,3,16
191125425,6,6,7,4,3,26
191125426,9,7,4,7,1,28
191125427,5,5,5,5,8,28
191125428,0,3,5,8,2,18
191125429,2,2,1,9,3,17
191125430,5,5,7,5,1,23
191125431,1,2,4,4,4,15
191125432,5,5,0,4,8,22
191125433,8,9,7,9,5,38
191125434,1,8,6,9,9,33
191125435,9,1,1,3,9,23
191125436,2,6,9,8,4,29
191125437,6,4,7,7,6,30
191125438,7,4,1,2,3,17
191125439,5,7,7,6,2,27
191125440,4,4,1,0,1,10
191125441,4,4,7,5,0,20
191125442,5,9,7,5,5,31
191125443,6,9,1,4,2,22
191125444,1,8,6,3,8,26
191125445,6,8,2,6,1,23
191125446,2,3,5,4,0,14
191125447,6,0,6,2,2,16
191125448,0,1,0,9,4,14
191125449,2,5,1,0,2,10
191125450,7,4,0,2,7,20
191125451,6,3,5,4,3,21
191125452,5,1,2,6,3,17
191125453,2,9,2,3,2,18
191125454,8,8,7,2,7,32
191125455,4,5,2,2,5,18
191125456,5,6,2,0,8,21
191125457,5,6,3,7,2,23
191125458,1,1,2,8,5,17
191125459,3,6,5,1,1,16
191125460,8,1,2,5,6,22
191125461,4,7,0,8,3,22
191125462,6,2,9,8,2,27
191125463,0,5,2,5,6,18
191125464,3,6,4,2,1,16
191125465,6,2,2,8,7,25
191125466,5,7,0,4,4,20
191125467,1,3,0,3,0,7
191125468,1,8,6,5,1,21
191125469,8,6,1,8,9,32
191125470,5,4,8,0,6,23
191125471,3,1,0,3,2,9
191125472,6,1,2,2,4,15
191125473,9,4,0,9,8,30
191125474,8,8,6,1,5,28
191125475,6,5,6,5,0,22
191125476,0,3,1,9,5,18
191125477,0,1,2,2,1,6
191125478,2,9,5,1,9,26
191125479,1,0,0,5,6,12
191125480,0,4,3,5,8,20
191125481,4,5,0,0,8,17
191125482,5,1,8,5,6,25
191125483,9,6,6,4,4,29
191125484,7,7,8,9,5,36
191125485,9,5,7,5,9,35
191125486,3,5,0,4,3,15
191125487,1,3,9,8,9,30
191125488,4,5,1,6,3,19
191125489,5,6,6,1,1,19
191125490,0,8,8,5,8,29
191125491,2,0,2,2,3,9
191125492,2,0,6,3,3,14
191125493,0,3,5,6,7,21
191125494,0,7,4,9,0,20
191125495,9,0,2,9,9,29
191125496,7,8,6,3,1,25
191125497,1,7,6,7,8,29
191125498,9,8,0,9,7,33
191125499,3,4,6,7,2,22
191125500,5,3,6,3,7,24
191125501,1,1,1,3,5,11
191125502,7,4,5,3,5,24
191125503,7,7,3,5,9,31
191125504,7,9,9,7,7,39
191125505,9,3,8,3,5,28
191125506,5,1,4,6,2,18
191125507,4,2,6,0,6,18
191125508,6,0,3,9,4,22
191125509,6,2,0,8,1,17
191125510,7,1,0,0,4,12
191125511,5,8,6,8,2,29
191125512,2,8,3,0,9,22
191125513,6,8,5,3,4,26
191125514,6,9,4,9,1,29
191125515,8,6,1,7,7,29
191125516,0,3,4,5,4,16
191125517,9,4,6,3,8,30
191125518,3,2,9,9,5,28
191125519,5,3,3,7,9,27
191125520,2,6,2,2,8,20
191125521,6,3,0,6,7,22
191125522,0,5,5,7,3,20
191125523,7,0,2,6,9,24
191125524,7,5,1,9,4,26
191125525,8,0,1,6,5,20
191125526,2,9,8,9,1,29
191125527,4,5,8,7,9,33
191125528,3,5,8,0,9,25
191125529,2,6,7,2,5,22
191125530,5,1,9,9,2,26
191125531,2,6,9,5,6,28
191125532,0,3,3,2,2,10
191125533,8,5,9,6,0,28
191125534,7,2,5,7,3,24
191125535,3,5,1,2,9,20
191125536,2,0,1,5,2,10
191125537,9,9,2,2,5,27
191125538,6,9,3,6,1,25
191125539,0,4,1,0,9,14
191125540,9,2,0,5,7,23
191125541,5,5,8,8,2,28
191125542,2,1,2,4,0,9
191125543,3,2,7,5,4,21
191125544,7,5,7,2,8,29
191125545,1,5,7,1,1,15
191125546,3,9,2,5,8,27
191125547,8,0,9,5,8,30
191125548,3,8,6,5,2,24
191125549,2,9,1,8,4,24
191125550,6,5,6,6,3,26
191125551,1,4,7,8,4,24
191125552,5,5,5,9,8,32
191125553,5,4,8,3,0,20
191125554,6,9,5,5,4,29
191125555,7,4,6,5,1,23
191125556,6,0,8,2,8,24
191125557,3,0,1,0,1,5
191125558,3,3,4,7,8,25
191125559,2,0,2,7,9,20
191125560,5,4,5,2,6,22
191125561,2,0,1,6,0,9
191125562,5,2,5,9,5,26
191125563,2,8,1,9,2,22
191125564,6,0,9,7,8,30
191125565,9,9,2,0,1,21
191125566,2,2,6,0,8,18
191125567,0,2,1,6,7,16
191125568,2,7,9,8,1,27
191125569,4,1,3,1,7,16
191125570,7,9,6,5,7,34
191125571,5,3,7,0,1,16
191125572,2,3,2,6,8,21
191125573,5,6,4,1,3,19
191125574,6,3,1,0,5,15
191125575,2,7,9,2,1,21
191125576,2,4,9,7,9,31
191125577,2,0,4,7,2,15
191125578,6,4,3,5,1,19
191125579,6,6,9,0,5,26
191125580,0,2,7,7,4,20
191125581,0,0,5,9,1,15
191125582,6,9,5,7,2,29
191125583,5,0,9,4,4,22
191125584,4,4,4,1,8,21
191125585,6,7,4,0,7,24
191125586,1,2,6,5,1,15
191125587,3,6,0,4,7,20
191125588,2,2,7,6,2,19
191125589,4,7,5,2,2,20
191125590,0,6,2,2,8,18
191125591,6,0,9,7,6,28
191125592,0,8,5,3,1,17
191125593,1,7,4,7,0,19
191125594,6,0,9,6,6,27
191125595,8,3,5,7,8,31
191125596,6,8,5,4,8,31
191125597,6,3,5,9,2,25
191125598,1,6,8,2,1,18
191125599,3,8,0,0,3,14
191125600,5,0,0,8,7,20
191125601,7,0,1,9,3,20
191125602,1,4,9,4,9,27
191125603,5,2,3,6,6,22
191125604,4,8,3,5,2,22
191125605,4,9,2,4,4,23
191125606,4,0,5,8,3,20
191125607,7,5,3,6,9,30
191125608,7,2,2,3,8,22
191125609,8,3,3,3,1,18
191125610,6,4,7,3,6,26
191125611,2,1,7,6,2,18
191125612,8,5,5,9,8,35
191125613,4,7,9,9,7,36
191125614,9,4,5,3,7,28
191125615,2,8,7,7,9,33
191125616,1,0,9,6,3,19
191125617,2,2,3,9,7,23
191125618,4,8,3,7,5,27
191125619,6,7,8,4,0,25
191125620,6,6,4,8,7,31
191125621,1,1,9,0,7,18
191125622,6,7,6,4,2,25
191125623,2,7,2,8,6,25
191125624,6,4,1,7,6,24
191125625,6,9,9,6,2,32
191125626,4,1,3,2,7,17
191125627,3,4,2,9,9,27
191125628,5,7,8,2,8,30
191125629,3,9,2,7,9,30
191125630,2,3,8,6,8,27
191125631,5,7,2,1,9,24
191125632,6,7,4,7,6,30
191125633,9,5,9,6,6,35
191125634,6,0,9,0,7,22
191125635,2,4,8,8,7,29
191125636,4,2,3,9,2,20
191125637,7,9,8,5,6,35
191125638,5,1,0,0,6,12
191125639,2,8,8,5,9,32
191125640,4,0,6,9,9,28
191125641,9,0,0,8,7,24
191125642,7,5,2,1,9,24
191125643,7,4,9,1,2,23
191125644,0,6,7,1,4,18
191125645,3,0,1,4,1,9
191125646,3,5,3,6,5,22
191125647,3,7,8,4,2,24
191125648,2,8,3,3,7,23
191125649,5,6,7,9,6,33
191125650,5,4,4,0,4,17
191125651,9,8,1,4,7,29
191125652,6,0,5,7,1,19
191125653,8,7,5,8,1,29
191125654,4,2,0,0,9,15
191125655,5,1,1,7,6,20
191125656,4,2,3,2,8,19
191125657,4,2,5,8,8,27
191125658,2,7,2,7,3,21
191125659,4,7,4,4,0,19
191125660,9,5,8,3,5,30
191125661,3,1,3,3,8,18
191125662,3,0,9,3,8,23
191125663,3,9,1,9,9,31
191125664,1,7,0,3,3,14
191125665,5,2,4,5,4,20
191125666,3,5,8,5,0,21
191125667,9,0,0,6,7,22
191125668,0,3,2,1,7,13
191125669,2,1,5,1,3,12
191125670,0,9,0,0,4,13
191125671,3,2,5,5,3,18
191125672,9,8,0,1,6,24
191125673,1,9,7,2,2,21
191125674,7,3,8,1,2,21
191125675,5,8,9,6,1,29
191125676,5,5,2,9,2,23
191125677,9,3,2,2,0,16
191125678,0,5,3,9,9,26
191125679,7,1,5,8,2,23
191125680,8,4,5,9,3,29
191125681,3,6,4,8,7,28
191125682,7,9,5,7,7,35
191125683,3,3,8,5,9,28
191125684,3,6,9,4,9,31
191125685,6,6,7,5,8,32
191125686,8,2,2,2,9,23
191125687,7,9,8,4,8,36
191125688,2,8,2,9,0,21
191125689,3,9,5,7,8,32
191125690,2,4,6,3,3,18
191125691,3,7,3,6,8,27
191125692,5,0,6,6,4,21
191125693,9,1,4,8,0,22
191125694,8,7,1,6,5,27
191125695,2,4,7,4,6,23
191125696,5,9,8,2,1,25
191125697,5,1,7,4,4,21
191125698,8,3,8,4,1,24
191125699,2,5,6,3,6,22
191125700,7,6,0,9,0,22
191125701,3,7,4,3,6,23
191125702,5,3,1,3,1,13
191125703,7,6,5,3,5,26
191125704,4,2,4,4,3,17
191125705,6,4,6,8,5,29
191125706,1,8,4,5,4,22
191125707,7,6,0,5,2,20
191125708,4,5,3,2,5,19
191125709,4,0,8,6,7,25
191125710,8,9,9,8,9,43
191125711,4,4,7,0,2,17
191125712,6,2,3,7,6,24
191125713,8,8,2,6,0,24
191125714,0,3,6,9,1,19
191125715,5,6,8,8,6,33
191125716,8,1,3,2,4,18
191125717,8,0,4,5,5,22
191125718,1,4,6,8,1,20
191125719,6,6,2,3,7,24
191125720,2,7,2,9,3,23
191125721,9,8,0,9,0,26
191125722,8,3,7,5,1,24
191125723,1,6,5,1,4,17
191125724,3,8,4,0,0,15
191125725,1,0,5,7,1,14
191125726,4,0,4,2,9,19
191125727,3,5,3,8,2,21
191125728,6,3,0,9,4,22
191125729,4,1,9,5,7,26
191125730,7,8,6,0,1,22
191125731,0,6,4,1,1,12
191125732,6,5,9,8,9,37
191125733,2,9,6,2,3,22
191125734,7,0,8,3,8,26
191125735,7,8,0,9,3,27
191125736,9,9,2,7,2,29
191125737,8,5,4,0,7,24
191125738,9,2,2,8,2,23
191125739,7,8,6,0,4,25
191125740,4,2,2,1,2,11
191125741,5,8,9,6,0,28
191125742,3,7,0,8,1,19
191125743,5,3,1,1,7,17
191125744,5,1,1,3,3,13
191125745,9,3,1,1,9,23
191125746,6,5,2,6,6,25
191125747,9,1,6,3,6,25
191125748,9,5,4,1,6,25
191125749,1,5,7,8,5,26
191125750,8,3,6,3,2,22
191125751,3,1,9,5,5,23
191125752,5,6,2,1,4,18
191125753,0,6,9,1,3,19
191125754,5,0,3,4,1,13
191125755,8,1,3,9,9,30
191125756,1,8,1,9,0,19
191125757,6,7,5,8,6,32
191125758,9,6,6,4,8,33
191125759,1,4,1,8,3,17
191125760,9,3,5,1,6,24
191125761,6,2,6,9,3,26
191125762,2,8,5,4,4,23
191125763,6,6,3,4,8,27
191125764,3,1,4,2,3,13
191125765,3,3,3,4,8,21
191125766,4,7,2,9,6,28
191125767,3,6,2,8,7,26
191125768,6,1,7,8,8,30
191125769,5,0,7,5,3,20
191125770,2,5,2,9,6,24
191125771,2,7,0,3,2,14
191125772,4,6,7,1,3,21
191125773,3,1,5,2,9,20
191125774,2,0,3,2,2,9
191125775,9,0,1,7,3,20
191125776,6,6,9,6,0,27
191125777,7,4,0,5,4,20
191125778,9,5,5,9,4,32
191125779,6,2,4,2,3,17
191125780,7,3,4,6,3,23
191125781,2,6,8,7,6,29
191125782,0,5,0,8,7,20
191125783,4,6,5,3,1,19
191125784,5,5,8,1,5,24
191125785,9,5,6,2,7,29
191125786,1,7,1,8,1,18
191125787,4,2,5,0,2,13
191125788,4,6,2,7,9,28
191125789,4,0,4,0,7,15
191125790,5,7,3,5,9,29
191125791,8,9,0,0,7,24
191125792,5,9,5,9,3,31
191125793,6,7,0,3,6,22
191125794,1,5,5,0,6,17
191125795,3,6,3,3,5,20
191125796,0,9,2,6,5,22
191125797,6,7,2,3,4,22
191125798,9,8,4,6,6,33
191125799,2,3,4,2,7,18
191125800,3,9,3,8,3,26
191125801,2,3,4,9,0,18
191125802,8,1,7,2,6,24
191125803,8,7,1,5,9,30
191125804,9,0,4,9,4,26
191125805,3,1,8,3,8,23
191125806,6,2,2,1,6,17
191125807,0,7,7,6,7,27
191125808,9,0,8,8,0,25
191125809,5,4,8,2,9,28
191125810,4,2,9,9,5,29
191125811,3,9,8,1,5,26
191125812,5,2,3,2,4,16
191125813,8,5,0,0,0,13
191125814,5,8,2,2,5,22
191125815,4,0,8,3,8,23
191125816,8,2,5,7,0,22
191125817,7,0,2,9,6,24
191125818,2,3,8,1,9,23
191125819,6,0,7,1,6,20
191125820,9,6,4,6,3,28
191125821,3,9,9,3,1,25
191125822,7,7,0,0,3,17
191125823,9,2,9,4,4,28
191125824,2,9,1,7,6,25
191125825,7,2,0,2,0,11
191125826,0,5,4,9,9,27
191125827,1,1,4,7,5,18
191125828,4,1,1,7,0,13
191125829,0,4,7,4,4,19
191125830,1,0,7,6,3,17
191125831,0,1,8,9,4,22
191125832,3,9,9,6,5,32
191125833,4,7,6,6,7,30
191125834,4,1,1,7,1,14
191125835,6,9,6,6,3,30
191125836,6,3,7,3,9,28
191125837,0,1,0,2,3,6
191125838,1,9,2,3,7,22
191125839,6,5,7,0,0,18
191125840,5,3,5,3,3,19
191125841,0,4,6,6,7,23
191125842,6,1,4,3,8,22
191125843,4,1,9,5,3,22
191125844,8,0,7,8,5,28
191125845,4,7,8,4,8,31
191125846,8,1,0,6,6,21
191125847,7,4,2,7,8,28
191125848,6,5,3,8,8,30
191125849,1,3,0,5,2,11
191125850,7,3,0,0,8,18
191125851,0,4,4,6,1,15
191125852,7,9,2,0,2,20
191125853,6,6,9,5,1,27
191125854,5,3,3,8,7,26
191125855,9,8,0,5,5,27
191125856,5,3,3,7,3,21
191125857,4,7,9,1,3,24
191125858,9,7,3,5,5,29
191125859,3,0,1,7,5,16
191125860,5,8,7,3,6,29
191125861,8,4,0,0,5,17
191125862,0,4,9,3,5,21
191125863,9,6,1,8,0,24
191125864,2,3,1,0,3,9
191125865,7,3,7,0,1,18
191125866,3,7,2,2,5,19
191125867,3,6,9,2,5,25
191125868,1,5,4,1,0,11
191125869,5,3,4,4,8,24
191125870,9,9,6,3,1,28
191125871,9,1,7,6,4,27
191125872,6,1,1,4,6,18
191125873,5,8,3,1,2,19
191125874,2,7,8,4,0,21
191125875,0,0,9,9,0,18
191125876,2,5,8,6,2,23
191125877,1,6,6,7,4,24
191125878,1,8,7,2,1,19
191125879,3,5,6,2,7,23
191125880,4,6,7,7,7,31
191125881,4,2,8,3,2,19
191125882,8,8,6,9,6,37
191125883,5,4,4,5,2,20
191125884,9,1,5,0,4,19
191125885,4,1,4,6,0,15
191125886,2,2,3,4,7,18
191125887,8,6,2,1,4,21
191125888,3,8,6,0,9,26
191125889,1,1,6,7,6,21
191125890,3,4,3,6,8,24
191125891,8,9,0,4,7,28
191125892,9,7,0,4,4,24
191125893,9,7,9,1,3,29
191125894,2,9,8,9,0,28
191125895,5,2,6,7,1,21
191125896,6,1,0,8,1,16
191125897,2,8,2,7,4,23
191125898,2,1,8,4,3,18
191125899,0,7,6,0,1,14
191125900,3,9,4,2,0,18
191125901,4,3,0,5,2,14
191125902,2,2,1,2,8,15
191125903,0,1,0,0,8,9
191125904,8,7,1,9,5,30
191125905,9,1,5,1,0,16
191125906,7,7,5,0,9,28
191125907,0,5,6,3,2,16
191125908,0,5,9,0,3,17
191125909,1,6,5,7,3,22
191125910,0,1,8,2,6,17
191125911,5,2,0,0,7,14
191125912,3,1,2,5,1,12
191125913,6,7,0,7,0,20
191125914,7,2,9,7,4,29
191125915,0,0,0,5,5,10
191125916,7,5,7,5,0,24
191125917,1,5,4,8,1,19
191125918,8,3,8,4,4,27
191125919,8,0,1,1,9,19
191125920,2,9,0,0,9,20
191125921,4,5,3,4,3,19
191125922,0,6,7,1,2,16
191125923,8,1,0,4,2,15
191125924,8,8,0,9,9,34
191125925,7,6,5,8,0,26
191125926,6,8,4,4,7,29
191125927,5,4,7,5,7,28
191125928,1,1,3,7,1,13
191125929,7,4,2,1,0,14
191125930,4,8,4,6,1,23
191125931,4,0,3,2,5,14
191125932,5,8,4,1,7,25
191125933,6,8,4,9,6,33
191125934,5,7,7,6,1,26
191125935,4,7,6,6,2,25
191125936,6,3,6,7,1,23
191125937,8,4,1,5,4,22
191125938,8,0,5,4,5,22
191125939,0,1,0,0,5,6
191125940,8,3,6,8,8,33
191125941,1,8,0,8,5,22
191125942,3,7,8,2,9,29
191125943,4,8,2,4,6,24
191125944,4,3,4,2,3,16
191125945,9,3,6,8,0,26
191125946,0,2,5,4,7,18
191125947,3,7,3,6,0,19
191125948,8,6,6,1,1,22
191125949,8,8,4,2,0,22
191125950,3,5,6,4,0,18
191125951,2,4,3,0,6,15
191125952,4,4,1,9,5,23
191125953,5,1,8,0,4,18
191125954,3,8,5,1,4,21
191125955,8,1,3,0,6,18
191125956,7,5,1,4,6,23
191125957,8,3,8,6,3,28
191125958,7,1,3,9,8,28
191125959,9,7,1,8,7,32
191125960,6,5,5,4,9,29
191125961,8,8,7,8,4,35
191125962,5,0,0,6,6,17
191125963,6,3,3,0,6,18
191125964,3,0,5,8,6,22
191125965,2,5,4,4,0,15
191125966,2,9,0,5,0,16
191125967,0,6,0,0,1,7
191125968,7,5,2,1,6,21
191125969,0,1,8,0,9,18
191125970,4,3,9,5,2,23
191125971,4,6,8,8,0,26
191125972,0,5,7,8,5,25
191125973,3,1,7,1,9,21
191125974,8,3,0,1,9,21
191125975,0,2,0,2,4,8
191125976,3,7,1,1,3,15
191125977,3,3,4,4,5,19
191125978,8,3,1,3,1,16
191125979,9,5,4,9,8,35
191125980,2,0,3,3,9,17
191125981,5,6,9,7,7,34
191125982,2,3,5,9,0,19
191125983,7,4,1,4,8,24
191125984,4,7,8,4,3,26
191125985,9,9,2,3,3,26
191125986,8,2,3,7,4,24
191125987,4,8,6,4,5,27
191125988,8,1,7,0,4,20
191125989,2,3,5,6,1,17
191125990,0,7,4,0,0,11
191125991,1,1,6,0,6,14
191125992,0,4,6,4,0,14
191125993,3,2,5,0,6,16
191125994,3,4,5,0,3,15
191125995,2,0,2,5,7,16
191125996,9,7,1,1,2,20
191125997,9,0,5,0,3,17
191125998,7,2,3,5,5,22
191125999,9,3,8,5,7,32
1911251000,0,2,4,7,4,17
1911251001,6,6,0,1,3,16
1911251002,3,4,8,4,2,21
1911251003,5,2,1,3,7,18
1911251004,0,4,2,9,6,21
1911251005,0,4,4,7,9,24
1911251006,0,8,7,3,3,21
1911251007,4,9,8,9,9,39
1911251008,7,6,0,7,5,25
1911251009,9,5,4,3,1,22
1911251010,6,1,7,2,3,19
1911251011,8,7,4,2,9,30
1911251012,6,9,5,6,3,29
1911251013,6,3,5,5,1,20
1911251014,2,3,4,9,5,23
1911251015,7,6,5,8,3,29
1911251016,0,5,3,3,0,11
1911251017,9,1,5,1,9,25
1911251018,0,0,4,9,5,18
1911251019,8,0,4,6,3,21
1911251020,6,9,0,9,9,33
1911251021,5,9,7,0,9,30
1911251022,0,3,3,8,4,18
1911251023,3,0,2,6,1,12
1911251024,5,6,4,8,5,28
1911251025,8,6,9,1,1,25
1911251026,9,3,6,4,7,29
1911251027,9,4,2,4,9,28
1911251028,4,6,1,6,1,18
1911251029,8,2,7,7,9,33
1911251030,0,9,5,0,6,20
1911251031,8,7,3,6,0,24
1911251032,4,5,8,0,8,25
1911251033,7,3,4,2,0,16
1911251034,8,9,8,2,6,33
1911251035,1,8,5,1,2,17
1911251036,8,7,8,0,9,32
1911251037,8,1,8,2,4,23
1911251038,4,8,0,5,6,23
1911251039,2,8,0,3,7,20
1911251040,6,0,6,2,4,18
1911251041,9,2,7,3,2,23
1911251042,6,3,0,4,8,21
1911251043,8,6,0,8,1,23
1911251044,2,1,7,5,0,15
1911251045,8,5,4,8,9,34
1911251046,9,9,1,7,7,33
1911251047,3,9,5,0,5,22
1911251048,4,4,5,2,5,20
1911251049,1,5,0,3,6,15
1911251050,8,4,2,0,9,23
1911251051,5,8,2,5,6,26
1911251052,1,4,6,4,3,18
1911251053,1,7,3,3,1,15
1911251054,4,1,7,2,7,21
1911251055,5,8,9,0,8,30
1911251056,2,9,4,0,4,19
1911251057,0,5,2,6,3,16
1911251058,9,7,3,6,1,26
1911251059,2,5,7,0,8,22
1911251060,6,2,5,1,1,15
1911251061,1,9,8,3,5,26
1911251062,0,6,4,9,4,23
1911251063,7,9,5,0,9,30
1911251064,9,6,7,3,1,26
1911251065,3,2,8,7,1,21
1911251066,2,5,5,2,1,15
1911251067,2,9,6,8,9,34
1911251068,2,4,4,2,7,19
1911251069,0,6,1,9,2,18
1911251070,1,1,6,5,9,22
1911251071,0,5,4,8,6,23
1911251072,9,7,5,8,8,37
1911251073,6,4,6,9,2,27
1911251074,9,4,3,1,8,25
1911251075,6,8,8,8,6,36
1911251076,4,2,5,7,6,24
1911251077,1,5,4,1,7,18
1911251078,0,3,6,7,6,22
1911251079,7,2,8,5,9,31
1911251080,9,2,7,4,5,27
1911251081,3,3,5,9,9,29
1911251082,0,1,5,5,0,11
1911251083,6,2,5,2,8,23
1911251084,4,4,4,9,2,23
1911251085,9,1,2,4,4,20
1911251086,5,9,1,8,4,27
1911251087,3,6,5,0,2,16
1911251088,9,9,8,7,3,36
1911251089,4,5,9,5,9,32
1911251090,0,1,5,0,3,9
1911251091,9,4,6,6,7,32
1911251092,6,6,4,2,6,24
1911251093,4,1,6,3,7,21
1911251094,1,7,1,2,6,17
1911251095,9,1,7,6,9,32
1911251096,1,5,3,9,6,24
1911251097,7,5,3,3,2,20
1911251098,2,0,9,6,8,25
1911251099,6,2,7,8,7,30
1911251100,2,6,1,4,9,22
1911251101,3,5,1,0,7,16
1911251102,4,1,7,4,2,18
1911251103,7,6,9,4,9,35
1911251104,3,9,4,9,5,30
1911251105,0,1,6,1,6,14
191126001,7,7,0,2,2,18
191126002,2,5,9,5,4,25
191126003,8,4,0,3,7,22
191126004,1,2,4,7,6,20
191126005,8,0,5,2,6,21
191126006,5,5,1,3,7,21
191126007,1,7,9,7,5,29
191126008,3,9,8,1,6,27
191126009,9,5,2,0,7,23
191126010,2,1,0,4,3,10
191126011,0,1,3,8,5,17
191126012,7,0,1,4,3,15
191126013,3,0,8,0,2,13
191126014,9,7,0,9,2,27
191126015,2,6,0,4,0,12
191126016,1,6,4,7,9,27
191126017,0,8,7,7,5,27
191126018,7,9,4,6,3,29
191126019,1,3,5,7,6,22
191126020,7,6,2,1,1,17
191126021,8,0,0,4,3,15
191126022,9,1,9,7,9,35
191126023,1,5,7,8,0,21
191126024,9,0,2,8,2,21
191126025,9,9,3,3,5,29
191126026,3,0,5,8,0,16
191126027,1,8,0,0,8,17
191126028,0,8,0,1,5,14
191126029,8,2,1,1,7,19
191126030,7,5,4,8,8,32
191126031,6,0,3,8,6,23
191126032,3,1,3,6,7,20
191126033,3,0,6,7,1,17
191126034,3,8,1,3,7,22
191126035,3,2,0,2,0,7
191126036,0,3,4,7,7,21
191126037,9,6,3,3,0,21
191126038,3,3,1,6,7,20
191126039,7,4,3,4,0,18
191126040,2,1,8,2,2,15
191126041,9,8,0,6,0,23
191126042,4,1,1,8,0,14
191126043,2,4,2,4,6,18
191126044,4,8,7,0,1,20
191126045,9,4,1,1,6,21
191126046,3,4,3,9,8,27
191126047,0,5,7,4,0,16
191126048,1,2,0,3,3,9
191126049,6,9,1,9,9,34
191126050,4,8,9,3,5,29
191126051,1,9,1,0,4,15
191126052,8,2,1,9,7,27
191126053,9,5,0,7,5,26
191126054,5,2,8,5,3,23
191126055,2,3,2,8,8,23
191126056,9,2,5,3,7,26
191126057,9,5,0,1,8,23
191126058,1,4,8,8,5,26
191126059,3,7,5,1,9,25
191126060,8,3,9,0,8,28
191126061,2,1,1,3,3,10
191126062,3,4,0,0,8,15
191126063,5,9,5,1,7,27
191126064,9,1,1,3,2,16
191126065,6,7,5,6,8,32
191126066,8,9,5,2,5,29
191126067,2,0,0,1,0,3
191126068,3,8,1,5,7,24
191126069,3,8,3,1,6,21
191126070,0,0,3,8,7,18
191126071,4,5,5,7,6,27
191126072,0,3,5,2,9,19
191126073,7,3,7,1,6,24
191126074,7,5,2,3,5,22
191126075,2,6,1,7,1,17
191126076,4,4,9,4,5,26
191126077,0,4,2,0,0,6
191126078,7,8,0,2,4,21
191126079,1,7,1,3,2,14
191126080,9,8,3,7,9,36
191126081,1,7,9,8,2,27
191126082,7,7,2,0,3,19
191126083,4,5,6,2,6,23
191126084,3,9,5,0,3,20
191126085,2,8,9,6,6,31
191126086,6,0,8,7,3,24
191126087,1,6,5,5,1,18
191126088,4,1,7,3,4,19
191126089,8,0,7,5,5,25
191126090,6,2,4,6,9,27
191126091,7,3,9,9,7,35
191126092,4,7,0,0,8,19
191126093,7,5,1,7,9,29
191126094,1,2,3,6,9,21
191126095,4,9,3,4,3,23
191126096,1,3,8,4,5,21
191126097,2,6,2,0,8,18
191126098,8,0,4,0,2,14
191126099,0,6,3,7,5,21
191126100,3,5,6,3,4,21
191126101,0,0,3,6,8,17
191126102,6,1,6,1,1,15
191126103,3,4,1,0,4,12
191126104,1,0,2,9,0,12
191126105,1,6,2,6,3,18
191126106,6,8,5,3,1,23
191126107,9,7,8,8,1,33
191126108,4,9,9,4,7,33
191126109,4,3,4,3,1,15
191126110,8,9,1,8,0,26
191126111,0,5,5,5,3,18
191126112,3,6,8,4,6,27
191126113,6,9,4,0,3,22
191126114,7,1,5,0,6,19
191126115,8,9,8,8,8,41
191126116,9,2,2,7,2,22
191126117,6,2,2,7,5,22
191126118,4,4,7,8,4,27
191126119,4,5,8,9,1,27
191126120,3,0,0,8,3,14
191126121,9,3,7,8,1,28
191126122,6,0,4,5,9,24
191126123,0,6,1,6,1,14
191126124,9,4,3,0,0,16
191126125,1,8,7,4,6,26
191126126,4,5,7,3,0,19
191126127,7,4,5,5,4,25
191126128,3,8,6,1,7,25
191126129,1,6,7,0,2,16
191126130,1,5,1,9,9,25
191126131,2,4,7,9,1,23
191126132,1,8,1,3,1,14
191126133,6,9,1,2,2,20
191126134,5,4,1,1,5,16
191126135,6,7,4,3,3,23
191126136,9,2,7,4,6,28
191126137,7,0,4,1,0,12
191126138,1,9,0,0,4,14
191126139,2,6,2,3,1,14
191126140,9,7,1,7,6,30
191126141,2,8,6,1,6,23
191126142,3,1,4,4,5,17
191126143,9,2,6,3,8,28
191126144,1,7,5,7,1,21
191126145,0,0,7,5,3,15
191126146,6,1,9,4,7,27
191126147,0,9,4,2,4,19
191126148,3,6,9,0,9,27
191126149,4,8,9,6,4,31
191126150,5,2,0,5,8,20
191126151,1,9,6,8,2,26
191126152,2,7,8,3,4,24
191126153,5,4,7,3,2,21
191126154,6,7,5,1,5,24
191126155,3,1,5,5,4,18
191126156,7,3,1,3,1,15
191126157,1,1,5,4,1,12
191126158,2,4,2,3,3,14
191126159,7,6,8,4,8,33
191126160,2,7,1,6,4,20
191126161,7,3,0,5,7,22
191126162,9,3,5,7,9,33
191126163,2,9,7,1,5,24
191126164,9,9,9,4,8,39
191126165,2,2,6,4,3,17
191126166,2,9,3,3,2,19
191126167,7,1,0,4,2,14
191126168,2,3,5,5,8,23
191126169,1,7,3,1,3,15
191126170,1,9,0,0,5,15
191126171,7,1,6,7,8,29
191126172,0,8,3,6,1,18
191126173,5,4,6,6,9,30
191126174,8,1,8,5,5,27
191126175,0,8,6,7,9,30
191126176,0,7,1,4,9,21
191126177,9,7,1,4,1,22
191126178,2,4,3,3,4,16
191126179,2,3,7,2,6,20
191126180,1,8,8,9,7,33
191126181,6,8,6,0,5,25
191126182,5,2,2,0,4,13
191126183,8,7,1,8,4,28
191126184,4,0,0,6,6,16
191126185,7,2,5,6,5,25
191126186,1,8,6,4,8,27
191126187,9,8,6,6,5,34
191126188,2,2,8,4,1,17
191126189,9,0,5,2,9,25
191126190,3,0,9,8,4,24
191126191,7,3,8,6,8,32
191126192,3,3,2,1,7,16
191126193,7,6,8,6,8,35
191126194,8,1,8,3,7,27
191126195,4,4,8,1,7,24
191126196,2,9,8,4,3,26
191126197,3,2,2,6,3,16
191126198,4,4,3,2,0,13
191126199,6,1,3,6,6,22
191126200,9,2,5,1,2,19
191126201,0,4,5,9,1,19
191126202,5,3,7,7,2,24
191126203,8,0,1,2,4,15
191126204,0,8,9,2,2,21
191126205,0,8,6,8,3,25
191126206,6,3,1,4,5,19
191126207,7,1,9,5,6,28
191126208,8,9,3,4,5,29
191126209,8,6,8,7,3,32
191126210,8,5,3,7,4,27
191126211,3,0,8,8,1,20
191126212,9,4,5,2,0,20
191126213,9,8,1,7,1,26
191126214,1,8,5,6,6,26
191126215,5,9,2,6,9,31
191126216,3,5,7,8,2,25
191126217,9,1,8,5,6,29
191126218,7,9,0,1,0,17
191126219,5,3,7,9,1,25
191126220,1,0,6,0,6,13
191126221,5,2,3,0,8,18
191126222,8,7,3,7,4,29
191126223,3,7,6,3,2,21
191126224,0,3,1,5,6,15
191126225,5,3,0,1,5,14
191126226,2,6,7,6,0,21
191126227,0,6,5,0,2,13
191126228,9,9,1,7,8,34
191126229,5,9,6,2,7,29
191126230,1,1,5,5,8,20
191126231,0,0,0,2,8,10
191126232,7,8,1,2,8,26
191126233,3,7,3,7,1,21
191126234,5,9,3,0,2,19
191126235,4,8,2,9,1,24
191126236,3,6,2,3,7,21
191126237,8,3,1,6,3,21
191126238,4,0,1,6,4,15
191126239,2,1,5,6,6,20
191126240,8,6,9,9,7,39
191126241,0,4,6,2,8,20
191126242,8,4,5,8,9,34
191126243,3,5,4,8,9,29
191126244,8,7,9,4,3,31
191126245,7,0,2,2,0,11
191126246,5,7,6,0,1,19
191126247,9,6,3,8,8,34
191126248,1,5,8,1,2,17
191126249,8,2,9,6,7,32
191126250,9,6,2,0,6,23
191126251,7,0,5,3,5,20
191126252,2,8,2,2,9,23
191126253,4,6,3,7,1,21
191126254,5,2,3,9,0,19
191126255,5,4,8,5,9,31
191126256,4,6,4,1,6,21
191126257,1,9,1,3,4,18
191126258,0,6,1,5,1,13
191126259,1,1,9,7,2,20
191126260,8,6,3,6,8,31
191126261,8,1,9,7,5,30
191126262,5,4,6,4,3,22
191126263,5,5,6,0,6,22
191126264,0,4,7,2,0,13
191126265,1,0,6,6,6,19
191126266,6,9,3,7,5,30
191126267,9,0,7,3,4,23
191126268,4,8,4,0,4,20
191126269,9,6,3,1,1,20
191126270,0,8,7,7,4,26
191126271,7,5,0,8,6,26
191126272,7,3,7,6,9,32
191126273,7,2,7,8,7,31
191126274,2,7,4,8,0,21
191126275,9,3,8,2,1,23
191126276,6,2,1,2,0,11
191126277,0,1,7,5,1,14
191126278,6,8,9,3,2,28
191126279,9,4,4,0,6,23
191126280,7,0,6,7,6,26
191126281,1,6,4,8,1,20
191126282,9,8,5,7,8,37
191126283,0,8,0,6,7,21
191126284,3,4,1,9,2,19
191126285,6,5,1,3,6,21
191126286,0,5,7,2,2,16
191126287,1,2,4,2,4,13
191126288,0,7,0,0,0,7
191126289,2,6,7,6,6,27
191126290,5,9,9,0,7,30
191126291,6,1,2,6,1,16
191126292,7,6,4,7,5,29
191126293,4,7,1,5,2,19
191126294,0,1,8,2,3,14
191126295,9,7,2,0,0,18
191126296,8,4,7,8,4,31
191126297,9,2,5,8,5,29
191126298,8,1,8,5,1,23
191126299,0,5,3,9,6,23
191126300,1,1,0,8,6,16
191126301,9,8,1,1,5,24
191126302,5,9,4,7,0,25
191126303,3,8,0,2,2,15
191126304,7,6,5,7,6,31
191126305,4,3,7,5,2,21
191126306,3,5,5,3,6,22
191126307,2,9,2,9,4,26
191126308,8,8,2,0,5,23
191126309,6,9,4,1,4,24
191126310,4,5,6,1,5,21
191126311,4,4,4,9,4,25
191126312,7,1,7,2,9,26
191126313,5,8,9,0,9,31
191126314,4,4,0,7,0,15
191126315,2,3,8,9,3,25
191126316,7,0,1,5,3,16
191126317,7,4,0,7,4,22
191126318,7,2,1,1,4,15
191126319,4,3,6,9,3,25
191126320,7,3,7,5,8,30
191126321,4,1,4,3,6,18
191126322,4,2,9,1,3,19
191126323,3,0,9,7,8,27
191126324,9,3,4,0,8,24
191126325,1,4,8,5,0,18
191126326,4,9,3,5,3,24
191126327,7,3,3,2,7,22
191126328,6,2,2,2,4,16
191126329,9,5,8,4,9,35
191126330,4,9,9,6,0,28
191126331,5,8,8,7,9,37
191126332,7,7,5,0,6,25
191126333,5,7,3,7,7,29
191126334,2,5,5,1,2,15
191126335,5,7,7,1,0,20
191126336,9,7,4,4,5,29
191126337,9,5,3,6,5,28
191126338,7,8,0,9,2,26
191126339,8,9,3,1,3,24
191126340,9,2,3,3,3,20
191126341,9,0,8,8,4,29
191126342,3,9,2,5,6,25
191126343,5,7,0,7,0,19
191126344,0,7,3,3,3,16
191126345,9,6,1,0,4,20
191126346,9,1,0,2,8,20
191126347,6,3,7,8,8,32
191126348,2,1,1,4,8,16
191126349,8,7,0,8,4,27
191126350,7,1,8,9,5,30
191126351,0,6,1,6,0,13
191126352,4,9,6,4,8,31
191126353,5,9,3,9,6,32
191126354,9,3,4,6,1,23
191126355,6,1,3,6,4,20
191126356,1,5,0,1,3,10
191126357,5,7,3,7,6,28
191126358,4,6,8,9,9,36
191126359,7,7,4,8,0,26
191126360,3,4,6,0,4,17
191126361,6,2,8,9,1,26
191126362,5,1,6,3,8,23
191126363,5,9,7,2,9,32
191126364,7,9,3,5,7,31
191126365,8,2,8,5,8,31
191126366,0,5,0,7,2,14
191126367,6,2,4,0,3,15
191126368,9,3,8,2,9,31
191126369,0,1,8,9,0,18
191126370,3,9,4,7,1,24
191126371,9,2,4,1,6,22
191126372,8,1,5,6,2,22
191126373,3,3,3,8,0,17
191126374,3,6,8,7,2,26
191126375,1,0,9,5,1,16
191126376,7,8,8,1,4,28
191126377,2,9,8,4,1,24
191126378,1,0,5,1,7,14
191126379,7,7,8,0,9,31
191126380,1,4,2,0,4,11
191126381,4,7,7,1,3,22
191126382,7,5,9,9,7,37
191126383,8,3,6,0,8,25
191126384,0,6,6,2,9,23
191126385,9,9,4,3,4,29
191126386,9,9,8,3,5,34
191126387,9,6,8,1,7,31
191126388,0,5,4,6,5,20
191126389,2,6,3,6,8,25
191126390,2,9,2,6,7,26
191126391,0,9,0,4,6,19
191126392,0,8,9,0,2,19
191126393,7,8,5,8,4,32
191126394,7,5,2,0,3,17
191126395,3,4,6,9,2,24
191126396,6,1,1,5,8,21
191126397,7,5,1,9,1,23
191126398,5,0,2,1,6,14
191126399,4,4,0,7,6,21
191126400,0,1,1,7,9,18
191126401,0,8,5,9,5,27
191126402,1,2,9,7,6,25
191126403,7,9,4,4,6,30
191126404,9,3,8,6,5,31
191126405,9,4,6,4,4,27
191126406,2,0,0,7,1,10
191126407,9,8,5,6,7,35
191126408,2,5,4,6,3,20
191126409,1,0,6,0,5,12
191126410,8,6,8,0,5,27
191126411,4,3,4,6,5,22
191126412,5,8,1,2,8,24
191126413,2,4,2,9,6,23
191126414,9,5,4,1,5,24
191126415,1,3,5,1,7,17
191126416,8,9,2,5,3,27
191126417,9,1,1,4,1,16
191126418,2,1,3,1,9,16
191126419,2,2,6,8,8,26
191126420,8,2,6,9,3,28
191126421,2,9,0,0,5,16
191126422,4,5,1,0,9,19
191126423,8,3,6,7,0,24
191126424,8,0,3,0,8,19
191126425,9,5,9,8,8,39
191126426,2,3,2,9,1,17
191126427,1,8,9,2,7,27
191126428,6,2,3,9,7,27
191126429,7,1,5,2,9,24
191126430,7,6,2,0,0,15
191126431,3,7,7,3,3,23
191126432,0,3,0,5,5,13
191126433,2,5,8,2,6,23
191126434,7,9,8,0,0,24
191126435,3,4,3,3,7,20
191126436,0,2,6,5,9,22
191126437,4,0,7,3,7,21
191126438,4,1,7,6,3,21
191126439,0,9,8,3,5,25
191126440,9,2,8,7,6,32
191126441,3,5,7,3,7,25
191126442,9,1,6,2,1,19
191126443,2,0,5,0,6,13
191126444,1,9,0,9,7,26
191126445,6,5,4,0,6,21
191126446,7,2,7,0,6,22
191126447,9,8,7,3,5,32
191126448,0,0,6,5,5,16
191126449,0,7,9,1,7,24
191126450,4,4,4,4,9,25
191126451,4,8,3,4,5,24
191126452,3,3,3,8,3,20
191126453,8,7,6,1,2,24
191126454,8,6,1,2,6,23
191126455,8,3,5,0,3,19
191126456,8,0,1,8,8,25
191126457,0,2,1,7,5,15
191126458,3,2,9,4,3,21
191126459,1,9,4,0,5,19
191126460,4,8,5,7,4,28
191126461,5,5,4,3,7,24
191126462,7,5,5,0,2,19
191126463,4,2,8,1,5,20
191126464,8,4,4,0,5,21
191126465,9,5,2,1,1,18
191126466,9,3,5,8,3,28
191126467,4,1,9,4,9,27
191126468,7,0,1,2,4,14
191126469,8,0,9,0,9,26
191126470,6,8,8,2,9,33
191126471,2,2,9,7,2,22
191126472,9,7,8,6,2,32
191126473,7,2,4,3,9,25
191126474,8,0,4,9,9,30
191126475,7,6,8,0,0,21
191126476,3,5,7,8,8,31
191126477,4,1,0,1,5,11
191126478,1,0,0,9,4,14
191126479,8,1,8,9,7,33
191126480,7,0,8,9,1,25
191126481,3,7,6,0,1,17
191126482,2,4,1,0,7,14
191126483,7,2,9,0,6,24
191126484,6,7,0,0,6,19
191126485,0,8,3,2,7,20
191126486,3,5,5,0,9,22
191126487,6,2,3,4,3,18
191126488,7,9,6,8,5,35
191126489,7,8,4,8,8,35
191126490,6,1,0,8,6,21
191126491,1,8,8,5,4,26
191126492,8,8,4,3,0,23
191126493,4,1,5,1,9,20
191126494,3,9,0,6,8,26
191126495,0,6,3,8,8,25
191126496,2,9,2,7,6,26
191126497,1,5,8,7,2,23
191126498,0,4,1,1,7,13
191126499,1,8,1,9,2,21
191126500,1,2,6,8,9,26
191126501,7,2,7,4,6,26
191126502,3,4,4,9,1,21
191126503,2,0,4,3,5,14
191126504,9,5,4,5,0,23
191126505,7,0,2,8,7,24
191126506,4,6,6,2,5,23
191126507,1,4,8,7,6,26
191126508,6,6,3,6,3,24
191126509,2,1,7,0,0,10
191126510,7,5,2,2,9,25
191126511,7,6,8,9,1,31
191126512,6,4,3,4,7,24
191126513,2,1,8,2,5,18
191126514,7,3,3,0,4,17
191126515,9,8,8,4,3,32
191126516,6,3,0,8,0,17
191126517,3,1,0,1,7,12
191126518,7,5,8,9,7,36
191126519,2,8,5,2,6,23
191126520,5,5,1,8,0,19
191126521,3,6,5,5,5,24
191126522,9,3,7,1,8,28
191126523,4,3,8,2,0,17
191126524,9,5,1,6,8,29
191126525,5,2,3,2,9,21
191126526,4,4,8,9,7,32
191126527,8,4,5,2,5,24
191126528,5,9,9,3,0,26
191126529,7,9,6,2,2,26
191126530,9,3,1,0,0,13
191126531,8,9,6,4,1,28
191126532,2,6,5,9,4,26
191126533,4,2,0,0,8,14
191126534,4,3,8,7,0,22
191126535,1,3,3,9,3,19
191126536,4,8,9,8,5,34
191126537,7,4,9,6,1,27
191126538,4,5,2,0,8,19
191126539,4,0,8,7,0,19
191126540,0,4,5,7,5,21
191126541,1,8,8,3,0,20
191126542,7,1,8,6,0,22
191126543,9,1,3,1,2,16
191126544,1,7,9,2,0,19
191126545,7,7,9,4,0,27
191126546,1,8,6,2,5,22
191126547,7,8,0,4,0,19
191126548,5,3,4,3,6,21
191126549,9,7,9,7,8,40
191126550,5,0,2,9,5,21
191126551,1,2,0,2,2,7
191126552,9,2,7,4,7,29
191126553,8,8,3,5,2,26
191126554,7,0,7,9,5,28
191126555,9,4,2,2,0,17
191126556,1,9,5,6,9,30
191126557,9,8,3,7,0,27
191126558,8,6,5,9,2,30
191126559,4,3,3,1,0,11
191126560,5,8,5,1,5,24
191126561,4,0,9,0,2,15
191126562,1,9,9,4,7,30
191126563,0,4,4,7,0,15
191126564,5,0,5,1,0,11
191126565,3,4,8,2,9,26
191126566,9,3,3,9,6,30
191126567,2,0,0,1,1,4
191126568,1,4,9,1,7,22
191126569,4,0,1,6,3,14
191126570,1,7,4,6,2,20
191126571,2,5,8,0,1,16
191126572,4,0,0,6,5,15
191126573,4,6,0,7,3,20
191126574,7,5,3,0,2,17
191126575,2,0,8,2,8,20
191126576,8,8,6,9,1,32
191126577,6,0,1,1,8,16
191126578,3,1,3,1,7,15
191126579,5,2,7,3,5,22
191126580,3,1,0,0,5,9
191126581,0,8,8,1,9,26
191126582,8,9,8,3,7,35
191126583,2,5,0,2,6,15
191126584,8,6,2,0,1,17
191126585,8,7,1,1,8,25
191126586,3,6,6,9,7,31
191126587,1,4,1,0,3,9
191126588,0,9,7,3,5,24
191126589,0,8,5,8,9,30
191126590,3,3,8,8,0,22
191126591,2,0,4,4,1,11
191126592,9,8,0,4,8,29
191126593,5,6,2,3,2,18
191126594,7,4,9,6,8,34
191126595,0,4,5,1,8,18
191126596,0,4,3,6,9,22
191126597,4,1,4,8,1,18
191126598,7,1,1,7,9,25
191126599,9,6,1,4,3,23
191126600,2,6,1,2,8,19
191126601,7,4,1,5,4,21
191126602,0,7,3,8,5,23
191126603,9,2,7,8,8,34
191126604,6,0,0,5,9,20
191126605,3,0,1,1,9,14
191126606,6,5,4,5,5,25
191126607,6,6,7,7,3,29
191126608,5,2,7,5,4,23
191126609,6,2,5,4,2,19
191126610,2,9,8,1,0,20
191126611,9,5,2,1,6,23
191126612,1,7,6,1,0,15
191126613,4,4,9,6,2,25
191126614,0,2,8,5,8,23
191126615,9,8,4,6,1,28
191126616,4,1,1,6,3,15
191126617,3,5,2,1,4,15
191126618,8,2,2,3,6,21
191126619,4,3,1,5,5,18
191126620,5,5,0,2,4,16
191126621,3,4,3,9,0,19
191126622,0,4,3,8,2,17
191126623,8,9,3,1,8,29
191126624,6,9,8,1,0,24
191126625,1,8,1,5,6,21
191126626,4,3,4,3,5,19
191126627,1,0,8,5,7,21
191126628,9,3,6,7,5,30
191126629,7,6,1,9,2,25
191126630,8,0,6,8,8,30
191126631,6,8,2,8,0,24
191126632,9,1,4,6,8,28
191126633,1,5,2,2,3,13
191126634,2,9,8,5,1,25
191126635,9,5,0,8,0,22
191126636,1,8,9,8,9,35
191126637,0,0,3,4,5,12
191126638,9,0,1,3,9,22
191126639,2,8,5,3,2,20
191126640,1,8,9,2,6,26
191126641,6,1,9,8,5,29
191126642,4,2,4,1,7,18
191126643,3,0,9,4,4,20
191126644,3,1,3,4,8,19
191126645,9,7,7,2,8,33
191126646,0,7,1,6,9,23
191126647,0,5,6,9,5,25
191126648,8,8,1,6,7,30
191126649,4,5,4,9,6,28
191126650,6,6,9,9,6,36
191126651,3,6,9,2,6,26
191126652,8,0,0,8,4,20
191126653,9,1,6,9,5,30
191126654,1,3,4,5,3,16
191126655,3,9,3,4,9,28
191126656,4,5,0,0,1,10
191126657,1,2,9,4,2,18
191126658,0,4,8,9,3,24
191126659,0,0,2,3,3,8
191126660,4,9,5,1,7,26
191126661,1,3,1,8,7,20
191126662,4,1,5,1,2,13
191126663,0,4,9,1,3,17
191126664,7,5,0,9,7,28
191126665,3,6,1,9,7,26
191126666,1,5,7,3,1,17
191126667,4,5,9,6,8,32
191126668,4,9,6,0,1,20
191126669,1,4,2,6,4,17
191126670,7,2,4,9,9,31
191126671,8,8,6,0,5,27
191126672,1,2,0,2,8,13
191126673,2,8,8,1,6,25
191126674,0,4,0,8,5,17
191126675,4,1,8,0,9,22
191126676,2,2,5,1,4,14
191126677,2,0,5,1,5,13
191126678,9,4,3,6,3,25
191126679,5,1,8,2,3,19
191126680,4,6,2,9,1,22
191126681,2,5,0,4,0,11
191126682,0,0,2,4,5,11
191126683,9,3,0,3,3,18
191126684,1,9,1,6,6,23
191126685,0,0,5,9,6,20
191126686,9,0,9,0,1,19
191126687,3,6,9,3,7,28
191126688,8,0,9,2,0,19
191126689,7,8,1,3,6,25
191126690,7,9,6,7,6,35
191126691,6,9,9,1,6,31
191126692,7,1,4,1,0,13
191126693,4,1,9,3,2,19
191126694,3,3,2,9,1,18
191126695,0,9,5,7,1,22
191126696,5,0,9,1,3,18
191126697,6,4,5,2,5,22
191126698,2,7,8,1,7,25
191126699,4,6,1,4,9,24
191126700,1,5,8,9,7,30
191126701,1,1,2,4,0,8
191126702,3,6,2,5,8,24
191126703,0,8,9,6,5,28
191126704,5,8,2,8,6,29
191126705,2,9,2,2,4,19
191126706,9,0,6,6,8,29
191126707,4,4,7,6,2,23
191126708,6,5,7,9,8,35
191126709,1,4,2,6,0,13
191126710,4,6,8,9,0,27
191126711,6,2,7,7,0,22
191126712,2,9,1,0,1,13
191126713,7,4,8,7,3,29
191126714,8,4,3,9,5,29
191126715,0,8,3,2,1,14
191126716,3,1,2,4,4,14
191126717,3,1,8,6,3,21
191126718,5,6,7,7,1,26
191126719,5,7,9,6,7,34
191126720,4,8,5,7,8,32
191126721,0,7,8,5,3,23
191126722,1,7,6,8,0,22
191126723,0,2,1,2,4,9
191126724,6,0,6,3,8,23
191126725,2,8,7,3,0,20
191126726,8,5,1,4,9,27
191126727,8,6,2,6,4,26
191126728,5,0,2,6,9,22
191126729,1,9,4,1,5,20
191126730,8,5,5,4,3,25
191126731,1,9,0,6,9,25
191126732,4,4,0,6,7,21
191126733,1,3,9,2,5,20
191126734,7,0,2,7,2,18
191126735,0,5,3,1,3,12
191126736,7,3,6,3,1,20
191126737,5,6,3,1,3,18
191126738,6,2,6,8,1,23
191126739,4,8,3,3,2,20
191126740,4,6,6,7,4,27
191126741,6,5,3,6,8,28
191126742,7,1,2,5,8,23
191126743,4,7,1,5,0,17
191126744,0,9,4,9,7,29
191126745,7,4,7,5,8,31
191126746,5,3,8,3,5,24
191126747,8,4,7,7,3,29
191126748,3,8,6,1,0,18
191126749,9,3,6,9,6,33
191126750,8,6,4,0,1,19
191126751,8,9,1,7,3,28
191126752,1,6,0,1,8,16
191126753,2,2,0,2,8,14
191126754,3,1,1,0,5,10
191126755,8,4,0,1,8,21
191126756,0,7,4,2,6,19
191126757,4,9,6,1,6,26
191126758,5,1,1,9,6,22
191126759,3,1,6,9,8,27
191126760,4,1,3,1,5,14
191126761,7,4,0,4,5,20
191126762,4,9,5,1,9,28
191126763,3,7,3,9,6,28
191126764,3,9,5,0,1,18
191126765,7,8,8,0,5,28
191126766,5,6,4,5,2,22
191126767,6,5,9,8,7,35
191126768,8,0,6,0,2,16
191126769,2,6,6,9,9,32
191126770,9,5,7,5,8,34
191126771,4,5,9,7,0,25
191126772,6,5,0,7,4,22
191126773,3,1,0,3,3,10
191126774,7,9,9,3,1,29
191126775,0,5,1,8,6,20
191126776,0,4,2,7,0,13
191126777,1,9,1,9,9,29
191126778,8,5,8,7,3,31
191126779,3,6,2,7,2,20
191126780,0,8,3,6,3,20
191126781,8,2,2,9,7,28
191126782,2,4,6,0,7,19
191126783,2,4,4,1,7,18
191126784,5,5,4,9,1,24
191126785,3,6,7,2,7,25
191126786,8,0,8,1,7,24
191126787,7,1,2,7,1,18
191126788,3,8,6,3,5,25
191126789,5,5,4,7,5,26
191126790,2,5,0,1,0,8
191126791,0,4,8,3,3,18
191126792,4,3,4,9,0,20
191126793,9,3,0,5,8,25
191126794,7,7,3,0,3,20
191126795,0,6,4,4,9,23
191126796,3,3,3,2,5,16
191126797,5,3,9,7,4,28
191126798,1,7,4,6,0,18
191126799,4,1,2,2,3,12
191126800,3,5,3,7,0,18
191126801,4,9,2,5,9,29
191126802,6,8,6,7,1,28
191126803,1,0,1,8,6,16
191126804,0,7,7,9,1,24
191126805,6,3,6,9,2,26
191126806,8,2,2,2,1,15
191126807,1,5,7,6,1,20
191126808,3,7,6,4,8,28
191126809,1,5,5,6,5,22
191126810,6,0,7,2,4,19
191126811,1,5,3,8,6,23
191126812,6,6,1,8,5,26
191126813,5,9,7,5,7,33
191126814,2,7,9,8,4,30
191126815,6,8,2,6,4,26
191126816,7,8,9,5,2,31
191126817,5,9,0,4,0,18
191126818,8,8,2,3,2,23
191126819,2,6,2,2,1,13
191126820,6,0,9,8,3,26
191126821,3,3,8,1,1,16
191126822,1,0,4,2,6,13
191126823,2,5,2,6,6,21
191126824,9,7,4,1,8,29
191126825,9,2,8,1,4,24
191126826,7,2,5,1,4,19
191126827,9,4,8,7,4,32
191126828,8,1,8,9,8,34
191126829,7,6,3,9,4,29
191126830,7,8,4,1,2,22
191126831,8,2,1,6,9,26
191126832,4,0,3,6,9,22
191126833,7,9,2,7,0,25
191126834,2,9,8,4,6,29
191126835,1,7,2,6,6,22
191126836,3,1,3,2,3,12
191126837,4,5,9,5,7,30
191126838,7,8,0,4,8,27
191126839,7,9,5,3,5,29
191126840,5,9,7,4,8,33
191126841,8,7,3,0,2,20
191126842,3,9,6,7,4,29
191126843,8,6,3,5,8,30
191126844,6,7,5,8,2,28
191126845,2,7,5,5,7,26
191126846,7,7,1,2,3,20
191126847,5,2,5,5,6,23
191126848,9,9,8,3,4,33
191126849,2,6,1,2,5,16
191126850,9,6,6,9,2,32
191126851,6,7,7,1,5,26
191126852,0,8,8,4,8,28
191126853,2,5,4,6,9,26
191126854,4,8,8,6,6,32
191126855,1,8,1,5,9,24
191126856,6,7,4,4,1,22
191126857,5,5,4,3,1,18
191126858,3,8,4,3,8,26
191126859,8,9,3,7,3,30
191126860,9,5,3,2,6,25
191126861,7,2,9,9,5,32
191126862,0,0,3,3,9,15
191126863,7,0,7,5,1,20
191126864,5,4,1,0,7,17
191126865,5,6,7,4,0,22
191126866,3,4,6,5,2,20
191126867,4,2,9,9,7,31
191126868,8,2,2,7,9,28
191126869,1,3,6,6,4,20
191126870,1,3,0,5,9,18
191126871,8,6,3,0,5,22
191126872,6,9,8,9,9,41
191126873,2,5,5,4,2,18
191126874,0,9,6,5,9,29
191126875,9,9,2,0,7,27
191126876,3,8,4,6,8,29
191126877,2,6,2,5,7,22
191126878,9,7,5,9,8,38
191126879,0,9,6,5,6,26
191126880,2,5,9,6,8,30
191126881,3,8,8,9,5,33
191126882,9,9,2,4,0,24
191126883,4,9,5,3,6,27
191126884,3,9,7,9,4,32
191126885,8,5,0,9,3,25
191126886,4,0,7,8,5,24
191126887,5,9,8,6,0,28
191126888,8,2,7,6,2,25
191126889,5,1,3,3,9,21
191126890,9,3,1,8,9,30
191126891,2,4,9,8,8,31
191126892,5,7,5,1,9,27
191126893,5,8,9,3,7,32
191126894,2,1,8,4,1,16
191126895,7,6,1,5,0,19
191126896,2,0,8,4,7,21
191126897,1,6,9,8,8,32
191126898,0,5,2,2,8,17
191126899,2,7,2,4,4,19
191126900,3,6,5,7,4,25
191126901,0,3,3,7,9,22
191126902,5,9,3,0,8,25
191126903,6,8,7,6,0,27
191126904,5,6,5,8,5,29
191126905,4,3,7,2,9,25
191126906,6,6,4,3,5,24
191126907,4,8,6,9,2,29
191126908,8,4,9,4,3,28
191126909,0,9,0,8,9,26
191126910,5,8,0,7,1,21
191126911,1,9,4,6,6,26
191126912,6,2,5,9,4,26
191126913,0,6,2,6,7,21
191126914,3,7,8,6,1,25
191126915,3,9,3,8,6,29
191126916,5,4,9,4,3,25
191126917,0,3,9,0,2,14
191126918,2,1,5,7,3,18
191126919,1,8,3,9,0,21
191126920,7,5,4,0,5,21
191126921,9,1,4,2,4,20
191126922,2,1,7,0,5,15
191126923,6,7,6,0,7,26
191126924,0,7,9,7,2,25
191126925,3,8,2,1,9,23
191126926,0,5,3,4,7,19
191126927,5,7,0,6,7,25
191126928,6,8,6,0,1,21
191126929,4,6,9,8,6,33
191126930,2,5,3,0,6,16
191126931,5,5,7,8,7,32
191126932,9,9,5,6,8,37
191126933,0,6,1,3,9,19
191126934,6,7,6,1,4,24
191126935,7,0,9,6,2,24
191126936,8,1,2,9,4,24
191126937,1,3,0,9,6,19
191126938,6,3,4,0,3,16
191126939,0,9,3,3,4,19
191126940,7,6,6,4,6,29
191126941,3,7,0,7,3,20
191126942,8,0,7,4,2,21
191126943,1,6,9,6,2,24
191126944,2,9,8,7,6,32
191126945,9,3,0,1,9,22
191126946,2,5,1,5,3,16
191126947,6,3,7,3,6,25
191126948,7,4,2,4,7,24
191126949,6,9,1,5,5,26
191126950,2,5,4,3,1,15
191126951,9,1,6,5,6,27
191126952,1,3,8,9,7,28
191126953,4,5,1,4,6,20
191126954,6,5,3,9,2,25
191126955,5,1,3,2,0,11
191126956,9,0,1,9,8,27
191126957,6,2,6,5,9,28
191126958,0,9,7,4,7,27
191126959,3,4,5,3,1,16
191126960,4,6,9,3,8,30
191126961,4,9,0,3,5,21
191126962,1,8,1,3,5,18
191126963,6,2,8,9,5,30
191126964,7,0,8,4,7,26
191126965,5,0,5,0,8,18
191126966,7,1,3,9,3,23
191126967,8,8,0,6,2,24
191126968,2,7,3,6,1,19
191126969,7,4,7,3,6,27
191126970,6,5,4,4,7,26
191126971,8,0,7,9,3,27
191126972,4,8,2,4,9,27
191126973,8,8,5,5,0,26
191126974,6,7,1,2,1,17
191126975,4,5,2,7,3,21
191126976,8,3,4,1,2,18
191126977,4,2,9,0,8,23
191126978,5,5,2,0,4,16
191126979,5,3,1,9,5,23
191126980,6,9,3,8,7,33
191126981,1,8,4,8,5,26
191126982,6,7,8,3,4,28
191126983,0,2,8,4,8,22
191126984,4,9,3,2,6,24
191126985,5,2,7,9,0,23
191126986,4,5,8,4,3,24
191126987,0,0,9,8,2,19
191126988,4,1,5,8,4,22
191126989,8,2,0,6,4,20
191126990,3,6,6,0,7,22
191126991,1,7,1,2,9,20
191126992,8,8,2,4,1,23
191126993,1,5,7,2,1,16
191126994,7,7,8,5,9,36
191126995,2,9,0,9,4,24
191126996,4,1,4,2,0,11
191126997,8,3,4,3,0,18
191126998,2,0,8,9,4,23
191126999,4,8,9,0,4,25
1911261000,1,1,9,7,1,19
1911261001,0,5,2,4,8,19
1911261002,7,5,5,2,9,28
1911261003,2,5,8,9,9,33
1911261004,0,7,4,4,8,23
1911261005,4,7,0,3,9,23
1911261006,6,0,6,8,1,21
1911261007,6,6,8,7,0,27
1911261008,5,9,7,0,6,27
1911261009,9,0,4,6,0,19
1911261010,3,2,6,4,5,20
1911261011,8,3,5,1,5,22
1911261012,9,9,0,1,2,21
1911261013,2,8,3,9,2,24
1911261014,3,1,2,2,7,15
1911261015,2,2,6,4,9,23
1911261016,7,5,7,4,1,24
1911261017,4,9,9,7,7,36
1911261018,1,2,8,0,7,18
1911261019,4,3,2,9,5,23
1911261020,5,2,3,3,6,19
1911261021,1,8,1,8,8,26
1911261022,3,7,1,9,9,29
1911261023,9,3,7,0,2,21
1911261024,6,9,4,7,3,29
1911261025,0,2,1,3,5,11
1911261026,8,4,6,0,4,22
1911261027,7,2,0,7,9,25
1911261028,4,0,2,8,9,23
1911261029,2,0,8,2,3,15
1911261030,5,8,5,8,4,30
1911261031,4,0,3,2,0,9
1911261032,8,1,8,3,3,23
1911261033,3,8,1,6,8,26
1911261034,6,7,3,0,1,17
1911261035,5,6,9,8,9,37
1911261036,3,8,3,5,0,19
1911261037,3,5,6,9,8,31
1911261038,5,4,4,5,3,21
1911261039,4,7,5,4,6,26
1911261040,6,2,5,2,0,15
1911261041,1,5,1,0,9,16
1911261042,4,9,7,7,7,34
1911261043,7,6,9,4,0,26
1911261044,4,1,4,3,2,14
1911261045,8,2,1,9,0,20
1911261046,5,1,3,7,1,17
1911261047,1,9,1,3,9,23
1911261048,6,8,2,6,1,23
1911261049,3,9,6,6,9,33
1911261050,5,4,0,0,3,12
1911261051,4,0,0,7,3,14
1911261052,5,5,5,0,0,15
1911261053,3,8,1,5,9,26
1911261054,0,1,7,1,9,18
1911261055,7,3,5,0,7,22
1911261056,8,6,9,2,4,29
1911261057,2,6,9,9,7,33
1911261058,7,1,1,3,1,13
1911261059,6,0,6,5,0,17
1911261060,7,5,7,4,0,23
1911261061,0,6,9,6,6,27
1911261062,0,5,6,4,3,18
1911261063,8,7,3,7,3,28
1911261064,2,7,6,8,9,32
1911261065,0,8,0,0,2,10
1911261066,9,4,6,2,0,21
1911261067,1,2,9,6,8,26
1911261068,7,3,3,1,3,17
1911261069,4,9,4,8,3,28
1911261070,5,3,1,1,4,14
1911261071,9,9,3,8,2,31
1911261072,3,9,3,1,6,22
1911261073,7,7,4,8,1,27
1911261074,3,8,8,3,1,23
1911261075,6,1,6,5,7,25
1911261076,3,6,2,4,7,22
1911261077,6,0,9,9,2,26
1911261078,7,4,7,8,0,26
1911261079,4,1,7,3,1,16
1911261080,6,1,7,1,8,23
1911261081,9,0,7,3,0,19
1911261082,2,6,8,0,3,19
1911261083,5,2,4,2,1,14
1911261084,3,9,8,7,6,33
1911261085,0,0,6,2,1,9
1911261086,5,9,0,8,4,26
1911261087,3,2,3,6,6,20
1911261088,8,4,4,8,0,24
1911261089,1,0,8,3,1,13
1911261090,7,6,0,9,6,28
1911261091,6,1,0,2,0,9
1911261092,6,0,5,2,7,20
1911261093,3,2,3,9,7,24
1911261094,3,7,9,1,0,20
1911261095,4,1,1,6,7,19
1911261096,1,7,1,9,8,26
1911261097,4,7,0,5,5,21
1911261098,4,2,7,0,8,21
1911261099,8,2,2,6,5,23
1911261100,5,4,6,3,5,23
1911261101,1,9,1,7,7,25
1911261102,7,7,4,7,5,30
1911261103,7,7,1,3,8,26
1911261104,2,2,1,3,6,14
1911261105,4,7,1,4,5,21
191127001,1,6,2,2,9,20
191127002,3,3,2,8,0,16
191127003,2,8,1,0,9,20
191127004,6,7,8,7,9,37
191127005,1,8,4,6,5,24
191127006,1,1,5,4,5,16
191127007,4,5,9,2,6,26
191127008,2,9,1,3,4,19
191127009,9,9,1,2,1,22
191127010,8,9,3,8,9,37
191127011,7,4,3,4,6,24
191127012,7,3,5,9,5,29
191127013,6,4,2,7,2,21
191127014,1,7,8,9,4,29
191127015,8,1,8,4,3,24
191127016,0,6,7,0,3,16
191127017,1,9,4,5,5,24
191127018,1,9,2,3,9,24
191127019,2,9,6,5,7,29
191127020,8,9,8,5,8,38
191127021,2,9,2,8,1,22
191127022,4,2,9,3,0,18
191127023,3,7,0,9,4,23
191127024,3,1,5,5,7,21
191127025,0,2,8,8,2,20
191127026,6,9,0,7,7,29
191127027,0,2,5,6,5,18
191127028,1,9,9,1,7,27
191127029,1,7,6,6,6,26
191127030,3,7,9,5,2,26
191127031,7,4,5,3,2,21
191127032,8,6,9,4,7,34
191127033,0,3,4,1,1,9
191127034,0,7,7,2,3,19
191127035,8,1,8,1,9,27
191127036,5,6,0,3,1,15
191127037,6,7,8,8,0,29
191127038,2,1,8,4,9,24
191127039,0,4,4,3,2,13
191127040,1,0,2,4,7,14
191127041,7,5,8,8,5,33
191127042,3,6,5,3,9,26
191127043,9,6,0,6,5,26
191127044,6,3,2,2,1,14
191127045,1,5,7,7,3,23
191127046,7,0,9,4,1,21
191127047,3,4,2,2,2,13
191127048,5,9,6,3,9,32
191127049,8,7,3,1,7,26
191127050,4,2,9,8,1,24
191127051,6,4,6,0,1,17
191127052,9,4,7,4,5,29
191127053,8,7,1,7,8,31
191127054,6,8,5,0,6,25
191127055,7,7,1,0,7,22
191127056,9,8,4,1,6,28
191127057,7,2,1,0,5,15
191127058,8,1,1,8,3,21
191127059,6,5,3,4,1,19
191127060,7,7,2,5,9,30
191127061,4,2,0,0,5,11
191127062,5,7,9,0,5,26
191127063,7,0,6,9,7,29
191127064,3,2,6,4,3,18
191127065,7,0,7,2,8,24
191127066,3,7,5,4,2,21
191127067,3,3,3,7,7,23
191127068,0,9,0,6,3,18
191127069,9,7,6,2,1,25
191127070,0,9,3,6,5,23
191127071,3,5,8,7,0,23
191127072,9,8,1,4,0,22
191127073,8,8,7,9,6,38
191127074,0,5,6,5,9,25
191127075,9,1,6,1,1,18
191127076,1,4,5,6,0,16
191127077,1,3,6,4,3,17
191127078,6,5,8,0,0,19
191127079,0,2,5,5,3,15
191127080,8,1,2,6,6,23
191127081,0,2,3,8,1,14
191127082,5,4,6,5,8,28
191127083,9,2,2,3,6,22
191127084,4,6,4,6,8,28
191127085,5,6,9,2,3,25
191127086,7,8,9,0,3,27
191127087,4,4,9,3,8,28
191127088,6,4,8,5,6,29
191127089,0,7,5,6,7,25
191127090,1,0,0,3,5,9
191127091,0,1,9,4,5,19
191127092,2,3,7,9,8,29
191127093,1,7,7,0,4,19
191127094,6,8,6,4,2,26
191127095,1,6,5,2,7,21
191127096,4,9,5,7,2,27
191127097,1,9,2,4,6,22
191127098,1,9,9,0,3,22
191127099,1,5,7,0,0,13
191127100,5,3,9,1,3,21
191127101,6,0,1,0,0,7
191127102,2,9,3,0,8,22
191127103,2,7,7,2,1,19
191127104,0,6,4,1,0,11
191127105,1,1,1,1,2,6
191127106,0,8,7,1,2,18
191127107,5,9,3,7,3,27
191127108,5,1,9,9,8,32
191127109,2,8,5,1,1,17
191127110,4,2,4,9,1,20
191127111,8,5,8,2,4,27
191127112,4,0,6,1,8,19
191127113,1,0,9,0,9,19
191127114,3,5,3,6,0,17
191127115,8,3,7,3,9,30
191127116,3,8,5,4,3,23
191127117,9,0,1,3,0,13
191127118,7,6,1,7,7,28
191127119,4,5,4,9,1,23
191127120,3,7,5,4,4,23
191127121,1,5,1,5,9,21
191127122,2,5,9,1,5,22
191127123,6,5,6,9,7,33
191127124,6,4,5,1,7,23
191127125,0,1,1,1,2,5
191127126,8,9,0,5,8,30
191127127,8,3,1,2,1,15
191127128,2,6,3,4,0,15
191127129,4,0,7,8,1,20
191127130,3,2,1,1,3,10
191127131,2,5,5,2,2,16
191127132,1,1,6,8,9,25
191127133,3,0,9,8,8,28
191127134,8,7,7,0,3,25
191127135,3,1,6,7,7,24
191127136,1,4,8,1,3,17
191127137,5,1,5,7,1,19
191127138,5,9,0,7,8,29
191127139,9,4,2,6,4,25
191127140,1,8,8,4,3,24
191127141,1,5,2,7,8,23
191127142,6,2,7,7,3,25
191127143,5,5,7,4,9,30
191127144,5,1,0,4,7,17
191127145,9,7,0,2,9,27
191127146,2,7,3,6,7,25
191127147,8,4,3,6,1,22
191127148,9,6,7,3,8,33
191127149,8,0,5,0,2,15
191127150,8,9,3,0,8,28
191127151,2,0,1,7,4,14
191127152,0,7,4,1,8,20
191127153,2,5,1,0,5,13
191127154,3,4,0,6,7,20
191127155,1,8,1,4,9,23
191127156,9,2,9,8,3,31
191127157,1,1,4,4,4,14
191127158,9,5,7,3,4,28
191127159,1,3,3,0,5,12
191127160,3,0,6,2,7,18
191127161,3,1,4,3,8,19
191127162,3,1,3,8,5,20
191127163,9,2,1,8,2,22
191127164,0,6,8,6,6,26
191127165,2,0,8,5,4,19
191127166,3,8,2,3,1,17
191127167,3,9,1,9,8,30
191127168,1,9,4,6,9,29
191127169,7,0,9,1,0,17
191127170,7,7,6,3,0,23
191127171,7,5,7,7,9,35
191127172,4,3,4,0,0,11
191127173,7,0,1,6,5,19
191127174,2,2,4,0,6,14
191127175,6,0,6,3,0,15
191127176,4,8,2,0,9,23
191127177,6,7,3,3,8,27
191127178,0,8,9,9,2,28
191127179,5,5,0,3,9,22
191127180,7,5,6,9,2,29
191127181,9,1,0,4,0,14
191127182,1,2,5,4,1,13
191127183,4,6,7,7,3,27
191127184,8,0,3,6,0,17
191127185,4,3,0,8,4,19
191127186,6,3,8,7,6,30
191127187,4,8,7,1,5,25
191127188,7,9,9,4,1,30
191127189,3,7,7,6,9,32
191127190,7,2,2,5,3,19
191127191,8,8,9,4,1,30
191127192,1,1,7,4,2,15
191127193,3,0,0,4,9,16
191127194,2,5,9,5,5,26
191127195,9,5,1,4,0,19
191127196,1,2,5,4,2,14
191127197,9,4,5,7,6,31
191127198,5,8,3,4,1,21
191127199,0,9,3,0,4,16
191127200,9,0,0,1,8,18
191127201,2,8,9,9,1,29
191127202,7,2,1,1,6,17
191127203,6,0,5,2,8,21
191127204,8,6,3,4,3,24
191127205,1,3,9,0,5,18
191127206,0,2,7,0,5,14
191127207,2,8,6,6,1,23
191127208,6,0,3,3,0,12
191127209,3,6,6,2,2,19
191127210,5,3,9,5,2,24
191127211,2,6,2,2,0,12
191127212,2,3,1,8,8,22
191127213,9,2,1,7,8,27
191127214,6,6,0,9,3,24
191127215,2,0,4,0,7,13
191127216,7,7,8,7,5,34
191127217,3,8,6,5,5,27
191127218,2,0,9,9,8,28
191127219,2,6,3,7,1,19
191127220,2,6,5,7,2,22
191127221,6,1,9,1,2,19
191127222,2,4,1,1,4,12
191127223,4,6,6,8,2,26
191127224,7,1,3,4,5,20
191127225,3,1,4,2,5,15
191127226,8,3,9,5,7,32
191127227,9,8,7,2,9,35
191127228,6,3,3,7,0,19
191127229,7,7,2,9,0,25
191127230,0,3,5,0,1,9
191127231,0,9,4,0,6,19
191127232,8,5,7,7,5,32
191127233,3,8,4,4,7,26
191127234,0,4,5,9,7,25
191127235,4,3,8,7,1,23
191127236,4,0,8,5,6,23
191127237,7,9,0,3,9,28
191127238,9,3,1,1,4,18
191127239,3,4,2,0,3,12
191127240,5,9,5,6,5,30
191127241,5,8,1,5,1,20
191127242,0,6,6,4,3,19
191127243,7,5,3,7,1,23
191127244,0,0,4,2,3,9
191127245,8,1,1,5,3,18
191127246,6,9,7,5,7,34
191127247,1,9,1,7,8,26
191127248,3,2,3,4,5,17
191127249,0,7,8,5,2,22
191127250,2,0,9,4,7,22
191127251,3,1,4,3,7,18
191127252,0,8,3,4,2,17
191127253,1,2,2,0,9,14
191127254,1,0,1,3,9,14
191127255,3,7,6,0,5,21
191127256,6,7,7,4,0,24
191127257,7,5,2,4,7,25
191127258,3,5,5,9,9,31
191127259,2,5,9,8,4,28
191127260,6,7,5,6,1,25
191127261,1,8,4,9,1,23
191127262,3,5,9,5,6,28
191127263,4,8,9,1,0,22
191127264,6,8,2,8,6,30
191127265,8,4,5,0,7,24
191127266,9,6,8,7,2,32
191127267,9,8,7,8,1,33
191127268,3,9,3,0,5,20
191127269,9,8,4,8,5,34
191127270,0,3,5,6,9,23
191127271,7,1,9,1,9,27
191127272,7,9,7,3,5,31
191127273,1,2,0,8,9,20
191127274,6,3,1,1,4,15
191127275,9,9,6,4,3,31
191127276,4,0,3,4,1,12
191127277,5,4,7,4,6,26
191127278,5,7,4,7,1,24
191127279,1,2,4,3,4,14
191127280,5,5,2,1,8,21
191127281,9,0,6,7,7,29
191127282,4,2,6,4,5,21
191127283,2,3,0,7,5,17
191127284,5,3,7,9,8,32
191127285,2,2,5,4,8,21
191127286,5,6,8,4,4,27
191127287,9,3,3,3,5,23
191127288,2,5,4,0,7,18
191127289,1,6,5,3,7,22
191127290,2,9,9,8,8,36
191127291,4,3,9,0,1,17
191127292,5,4,6,2,8,25
191127293,2,3,4,9,8,26
191127294,9,1,3,1,9,23
191127295,0,9,2,7,7,25
191127296,1,8,2,7,3,21
191127297,1,2,8,4,1,16
191127298,2,5,0,0,2,9
191127299,0,2,1,8,8,19
191127300,4,0,7,9,9,29
191127301,4,3,6,7,5,25
191127302,6,6,6,5,5,28
191127303,8,6,2,4,9,29
191127304,1,7,2,8,0,18
191127305,9,1,6,8,8,32
191127306,4,7,9,8,2,30
191127307,5,3,3,0,5,16
191127308,8,5,8,2,9,32
191127309,6,7,2,6,2,23
191127310,2,0,8,8,3,21
191127311,3,0,5,3,7,18
191127312,3,6,6,7,3,25
191127313,6,8,0,6,1,21
191127314,0,8,0,1,8,17
191127315,9,3,9,4,6,31
191127316,9,7,6,9,8,39
191127317,2,2,6,8,0,18
191127318,7,0,3,4,3,17
191127319,1,6,6,1,9,23
191127320,7,4,9,4,3,27
191127321,6,3,5,3,6,23
191127322,8,5,0,0,4,17
191127323,4,4,8,8,8,32
191127324,7,4,4,8,3,26
191127325,0,2,1,1,8,12
191127326,2,1,0,2,7,12
191127327,0,7,3,1,0,11
191127328,5,3,8,6,1,23
191127329,7,0,1,2,6,16
191127330,8,9,5,0,9,31
191127331,2,9,2,3,6,22
191127332,0,7,8,3,4,22
191127333,6,3,1,3,2,15
191127334,9,8,2,9,3,31
191127335,1,2,1,6,5,15
191127336,5,6,6,8,4,29
191127337,1,5,0,9,1,16
191127338,0,7,4,6,0,17
191127339,5,0,4,7,3,19
191127340,7,8,3,5,8,31
191127341,0,9,1,4,3,17
191127342,5,0,4,4,0,13
191127343,5,1,6,2,4,18
191127344,3,5,7,9,8,32
191127345,6,4,9,3,9,31
191127346,1,8,8,6,5,28
191127347,1,9,2,5,1,18
191127348,9,6,5,8,0,28
191127349,4,8,4,4,2,22
191127350,5,5,1,8,2,21
191127351,4,0,6,7,5,22
191127352,6,3,1,5,4,19
191127353,1,0,5,8,9,23
191127354,1,9,2,3,6,21
191127355,9,4,1,3,8,25
191127356,2,6,4,1,5,18
191127357,1,9,4,4,8,26
191127358,9,6,4,8,9,36
191127359,6,9,3,5,8,31
191127360,5,9,6,4,0,24
191127361,0,7,9,5,0,21
191127362,6,2,2,6,3,19
191127363,9,2,2,8,0,21
191127364,9,4,5,4,0,22
191127365,9,4,2,6,8,29
191127366,0,6,8,8,7,29
191127367,9,1,6,6,5,27
191127368,0,2,2,0,5,9
191127369,2,9,1,3,6,21
191127370,2,7,9,9,1,28
191127371,0,4,6,2,5,17
191127372,7,2,6,1,5,21
191127373,6,6,7,0,0,19
191127374,1,2,2,5,6,16
191127375,6,6,6,8,1,27
191127376,1,3,5,8,5,22
191127377,4,0,9,6,5,24
191127378,8,5,1,6,9,29
191127379,1,8,3,9,9,30
191127380,2,7,5,2,3,19
191127381,4,7,0,7,0,18
191127382,7,1,0,3,6,17
191127383,1,9,6,8,7,31
191127384,9,1,1,5,3,19
191127385,2,6,4,0,5,17
191127386,9,3,9,9,9,39
191127387,5,8,4,7,3,27
191127388,3,4,9,0,4,20
191127389,7,2,4,2,5,20
191127390,6,4,0,7,3,20
191127391,5,8,8,3,1,25
191127392,8,5,3,0,4,20
191127393,7,0,2,0,1,10
191127394,1,5,2,5,7,20
191127395,5,0,6,9,0,20
191127396,4,0,4,8,1,17
191127397,5,1,3,4,0,13
191127398,5,9,5,7,0,26
191127399,7,8,4,6,7,32
191127400,6,7,1,3,2,19
191127401,2,1,6,8,8,25
191127402,7,0,1,1,9,18
191127403,3,3,8,5,4,23
191127404,7,9,5,1,5,27
191127405,4,5,7,1,6,23
191127406,2,4,2,7,8,23
191127407,8,2,5,3,4,22
191127408,6,2,9,9,4,30
191127409,9,8,1,4,3,25
191127410,6,9,2,8,0,25
191127411,7,6,3,0,2,18
191127412,3,4,1,7,5,20
191127413,9,2,6,7,1,25
191127414,1,1,9,3,5,19
191127415,3,4,7,6,7,27
191127416,6,4,3,1,6,20
191127417,2,2,8,1,0,13
191127418,0,1,9,9,8,27
191127419,1,4,6,6,7,24
191127420,4,9,4,1,4,22
191127421,4,7,9,7,9,36
191127422,8,6,2,6,9,31
191127423,5,8,2,6,4,25
191127424,1,9,3,2,4,19
191127425,6,9,3,6,8,32
191127426,9,4,4,9,4,30
191127427,4,1,8,9,6,28
191127428,2,0,1,0,2,5
191127429,4,9,9,4,4,30
191127430,3,4,7,8,4,26
191127431,2,3,9,3,4,21
191127432,9,3,6,7,1,26
191127433,8,3,4,7,6,28
191127434,7,3,8,2,0,20
191127435,2,0,9,6,7,24
191127436,6,4,4,6,9,29
191127437,9,9,8,0,4,30
191127438,5,2,8,5,6,26
191127439,3,3,4,0,3,13
191127440,4,6,4,2,4,20
191127441,5,1,1,2,9,18
191127442,0,5,5,4,6,20
191127443,5,5,3,8,0,21
191127444,9,1,2,7,0,19
191127445,1,9,6,5,4,25
191127446,9,7,2,8,5,31
191127447,8,9,6,3,8,34
191127448,2,3,7,5,0,17
191127449,8,3,9,3,9,32
191127450,1,3,7,8,3,22
191127451,1,5,3,2,0,11
191127452,2,2,0,4,9,17
191127453,0,7,2,4,5,18
191127454,6,0,2,5,0,13
191127455,7,6,0,6,8,27
191127456,1,0,8,4,3,16
191127457,8,3,4,4,2,21
191127458,1,4,1,3,1,10
191127459,6,5,8,6,2,27
191127460,5,9,1,2,7,24
191127461,5,2,9,1,9,26
191127462,8,3,1,3,8,23
191127463,7,4,6,8,5,30
191127464,6,5,4,6,8,29
191127465,7,2,5,5,8,27
191127466,3,3,4,4,4,18
191127467,5,0,3,7,4,19
191127468,2,1,1,0,9,13
191127469,8,0,1,0,5,14
191127470,8,2,5,9,8,32
191127471,5,2,6,1,1,15
191127472,0,0,8,9,9,26
191127473,0,2,8,2,4,16
191127474,1,1,1,7,1,11
191127475,1,7,7,8,5,28
191127476,2,3,8,3,0,16
191127477,5,8,1,2,1,17
191127478,0,4,2,2,4,12
191127479,4,6,6,6,4,26
191127480,0,1,7,2,5,15
191127481,7,6,9,9,3,34
191127482,7,1,2,2,8,20
191127483,1,5,1,5,5,17
191127484,8,3,8,3,5,27
191127485,4,7,8,0,7,26
191127486,9,8,7,0,9,33
191127487,0,0,1,9,3,13
191127488,8,5,4,3,1,21
191127489,6,8,8,0,8,30
191127490,0,4,9,3,2,18
191127491,4,7,5,9,5,30
191127492,0,8,0,8,5,21
191127493,9,4,5,0,0,18
191127494,3,7,2,5,4,21
191127495,6,6,2,4,4,22
191127496,5,5,3,2,7,22
191127497,9,0,8,7,4,28
191127498,6,5,5,5,5,26
191127499,0,0,2,8,9,19
191127500,6,7,6,8,1,28
191127501,0,9,4,6,0,19
191127502,4,5,2,5,9,25
191127503,2,5,3,9,3,22
191127504,4,2,9,7,9,31
191127505,1,8,0,9,6,24
191127506,0,7,9,3,8,27
191127507,1,3,0,5,4,13
191127508,9,9,9,5,0,32
191127509,3,4,5,7,8,27
191127510,1,9,5,1,2,18
191127511,8,0,9,0,7,24
191127512,9,6,6,9,5,35
191127513,3,5,7,5,4,24
191127514,3,6,9,5,7,30
191127515,1,6,8,9,7,31
191127516,0,1,6,8,3,18
191127517,0,5,6,4,0,15
191127518,9,9,3,6,2,29
191127519,8,7,3,4,3,25
191127520,4,2,0,6,8,20
191127521,2,2,2,5,9,20
191127522,6,9,9,3,4,31
191127523,9,3,9,2,1,24
191127524,7,7,0,9,2,25
191127525,2,8,4,2,5,21
191127526,9,5,7,4,7,32
191127527,5,2,2,4,3,16
191127528,6,7,3,6,0,22
191127529,3,8,4,5,8,28
191127530,8,7,0,1,4,20
191127531,3,2,3,0,3,11
191127532,4,5,6,0,0,15
191127533,3,9,7,5,7,31
191127534,4,6,8,5,7,30
191127535,6,6,6,3,8,29
191127536,5,3,3,4,8,23
191127537,9,1,4,1,3,18
191127538,9,2,3,8,1,23
191127539,4,5,4,1,8,22
191127540,4,1,0,1,3,9
191127541,1,3,8,3,0,15
191127542,3,9,6,6,2,26
191127543,6,2,8,0,2,18
191127544,4,0,2,7,5,18
191127545,8,8,5,3,7,31
191127546,6,3,1,0,1,11
191127547,6,3,9,4,0,22
191127548,4,4,9,2,8,27
191127549,4,2,5,0,1,12
191127550,0,4,3,9,7,23
191127551,1,0,2,6,1,10
191127552,0,1,8,4,9,22
191127553,8,9,9,0,3,29
191127554,9,4,1,1,9,24
191127555,1,5,0,2,7,15
191127556,0,0,2,6,8,16
191127557,5,1,2,2,4,14
191127558,6,9,5,3,8,31
191127559,5,2,9,7,7,30
191127560,0,1,1,9,8,19
191127561,5,3,9,5,6,28
191127562,0,9,0,5,0,14
191127563,9,5,7,6,3,30
191127564,8,3,6,4,4,25
191127565,2,7,0,5,5,19
191127566,8,7,7,8,2,32
191127567,2,8,3,9,3,25
191127568,7,6,3,8,7,31
191127569,5,8,9,8,1,31
191127570,1,0,3,3,7,14
191127571,1,9,1,9,2,22
191127572,3,6,9,0,1,19
191127573,6,9,3,8,8,34
191127574,1,2,2,2,8,15
191127575,6,9,8,7,6,36
191127576,9,5,5,7,7,33
191127577,9,5,2,9,0,25
191127578,7,0,0,8,2,17
191127579,4,4,9,7,7,31
191127580,1,9,3,0,4,17
191127581,2,9,9,6,3,29
191127582,9,4,5,9,1,28
191127583,7,6,1,6,1,21
191127584,5,5,8,5,4,27
191127585,3,6,2,9,3,23
191127586,1,8,4,7,5,25
191127587,5,6,0,9,3,23
191127588,4,4,2,4,7,21
191127589,2,0,5,0,1,8
191127590,3,5,1,4,4,17
191127591,0,8,6,0,8,22
191127592,9,8,6,6,0,29
191127593,7,1,4,3,7,22
191127594,0,2,1,7,9,19
191127595,0,5,3,2,5,15
191127596,5,7,5,7,5,29
191127597,2,1,8,1,0,12
191127598,2,4,1,5,4,16
191127599,3,5,7,8,7,30
191127600,5,3,7,9,6,30
191127601,4,8,4,2,5,23
191127602,6,1,1,6,5,19
191127603,9,3,6,3,8,29
191127604,9,5,1,5,4,24
191127605,5,6,9,5,6,31
191127606,3,2,8,0,0,13
191127607,8,2,1,0,9,20
191127608,9,3,1,6,2,21
191127609,8,8,8,9,1,34
191127610,0,9,3,4,9,25
191127611,5,9,2,2,9,27
191127612,5,3,9,5,4,26
191127613,8,3,2,9,9,31
191127614,2,4,1,2,6,15
191127615,4,5,5,2,9,25
191127616,2,9,1,3,1,16
191127617,3,5,0,2,5,15
191127618,4,7,0,0,6,17
191127619,5,5,3,2,8,23
191127620,7,0,8,4,5,24
191127621,0,6,5,6,0,17
191127622,4,6,8,4,1,23
191127623,5,6,9,3,6,29
191127624,4,7,3,0,1,15
191127625,3,3,3,0,5,14
191127626,5,9,4,5,4,27
191127627,8,8,3,2,9,30
191127628,1,8,8,8,8,33
191127629,6,1,3,7,4,21
191127630,1,0,3,9,9,22
191127631,0,0,3,3,4,10
191127632,4,4,0,4,7,19
191127633,3,5,0,3,1,12
191127634,2,4,9,1,4,20
191127635,6,1,2,5,3,17
191127636,7,7,2,6,9,31
191127637,6,0,6,8,2,22
191127638,9,7,8,2,7,33
191127639,9,3,7,9,9,37
191127640,5,7,8,7,9,36
191127641,4,1,5,7,0,17
191127642,7,9,8,8,4,36
191127643,6,4,0,9,7,26
191127644,0,9,2,7,3,21
191127645,2,3,5,6,3,19
191127646,8,1,3,5,6,23
191127647,3,5,9,2,4,23
191127648,9,3,5,9,1,27
191127649,3,6,2,0,7,18
191127650,4,2,4,1,6,17
191127651,6,0,9,7,0,22
191127652,9,8,1,9,3,30
191127653,0,0,5,8,2,15
191127654,5,6,9,3,5,28
191127655,1,9,0,6,8,24
191127656,7,3,5,5,3,23
191127657,9,2,9,2,1,23
191127658,5,5,8,2,4,24
191127659,3,6,6,1,4,20
191127660,6,3,9,2,4,24
191127661,5,6,2,0,3,16
191127662,6,5,9,5,0,25
191127663,0,4,6,3,7,20
191127664,6,3,0,2,5,16
191127665,0,9,2,2,2,15
191127666,0,3,3,2,4,12
191127667,7,8,1,9,1,26
191127668,5,0,8,6,2,21
191127669,6,5,4,0,5,20
191127670,1,1,8,1,1,12
191127671,7,3,8,3,4,25
191127672,4,5,7,2,1,19
191127673,7,5,2,6,6,26
191127674,5,9,7,7,3,31
191127675,2,6,6,6,8,28
191127676,8,8,7,9,1,33
191127677,9,3,0,0,7,19
191127678,4,4,7,5,9,29
191127679,9,2,4,5,6,26
191127680,8,5,2,7,4,26
191127681,6,0,6,4,6,22
191127682,4,9,9,8,9,39
191127683,1,0,1,4,3,9
191127684,8,8,6,4,9,35
191127685,4,8,7,6,5,30
191127686,1,8,6,3,5,23
191127687,0,2,2,2,7,13
191127688,3,5,1,7,0,16
191127689,1,2,0,3,9,15
191127690,6,0,4,6,6,22
191127691,6,5,1,5,1,18
191127692,0,0,1,2,4,7
191127693,3,0,5,3,0,11
191127694,1,3,2,5,9,20
191127695,0,3,5,9,4,21
191127696,5,3,4,8,6,26
191127697,6,1,9,9,8,33
191127698,9,6,2,6,1,24
191127699,1,8,5,2,0,16
191127700,0,1,8,1,0,10
191127701,7,4,9,4,9,33
191127702,1,2,1,8,8,20
191127703,7,8,7,9,3,34
191127704,9,3,6,8,9,35
191127705,3,9,9,8,9,38
191127706,5,8,4,8,9,34
191127707,0,1,0,2,1,4
191127708,1,9,3,2,3,18
191127709,6,7,1,7,7,28
191127710,4,1,6,4,2,17
191127711,7,7,9,8,7,38
191127712,2,2,1,0,5,10
191127713,3,3,5,1,4,16
191127714,9,9,4,0,5,27
191127715,9,2,6,5,6,28
191127716,4,2,4,3,0,13
191127717,0,2,2,8,2,14
191127718,0,8,7,8,5,28
191127719,5,1,4,5,3,18
191127720,3,0,5,4,1,13
191127721,2,6,3,2,4,17
191127722,9,1,5,0,9,24
191127723,9,5,5,2,5,26
191127724,2,0,6,4,0,12
191127725,6,4,3,7,2,22
191127726,5,7,2,8,4,26
191127727,4,7,9,5,9,34
191127728,7,5,0,0,8,20
191127729,5,0,4,2,1,12
191127730,5,3,7,7,1,23
191127731,4,0,5,3,2,14
191127732,0,1,8,2,2,13
191127733,6,9,3,6,3,27
191127734,3,6,8,3,7,27
191127735,0,3,7,0,1,11
191127736,7,1,7,4,4,23
191127737,4,0,8,2,0,14
191127738,8,5,9,3,0,25
191127739,5,4,2,0,5,16
191127740,8,3,2,0,2,15
191127741,3,3,2,2,1,11
191127742,8,6,0,2,6,22
191127743,6,2,8,1,0,17
191127744,5,9,3,4,7,28
191127745,4,2,0,5,0,11
191127746,9,1,8,2,0,20
191127747,0,6,0,9,9,24
191127748,7,9,4,2,1,23
191127749,2,1,6,7,6,22
191127750,4,0,9,8,6,27
191127751,3,3,9,2,2,19
191127752,7,0,1,1,7,16
191127753,7,7,5,4,4,27
191127754,3,8,4,3,6,24
191127755,6,8,3,4,4,25
191127756,0,5,2,2,2,11
191127757,2,7,3,6,6,24
191127758,9,9,9,0,2,29
191127759,0,8,7,5,1,21
191127760,2,3,7,3,0,15
191127761,2,8,7,9,9,35
191127762,2,7,6,2,0,17
191127763,4,9,5,6,4,28
191127764,0,5,0,0,4,9
191127765,7,5,3,5,7,27
191127766,3,6,0,0,3,12
191127767,3,2,7,1,8,21
191127768,5,0,2,1,1,9
191127769,5,1,3,6,3,18
191127770,4,7,6,7,7,31
191127771,5,3,3,1,2,14
191127772,2,2,0,7,4,15
191127773,8,3,3,1,0,15
191127774,4,1,7,9,8,29
191127775,4,5,0,4,3,16
191127776,3,6,3,1,0,13
191127777,1,5,9,8,8,31
191127778,6,1,5,3,2,17
191127779,4,8,9,3,0,24
191127780,3,1,1,2,3,10
191127781,2,4,5,1,2,14
191127782,5,7,2,4,6,24
191127783,9,4,9,4,2,28
191127784,1,5,8,2,4,20
191127785,0,3,7,7,6,23
191127786,2,0,5,5,1,13
191127787,0,3,4,5,5,17
191127788,7,5,6,2,1,21
191127789,2,7,6,4,5,24
191127790,7,1,8,1,3,20
191127791,7,2,0,2,3,14
191127792,8,0,2,5,2,17
191127793,2,7,1,5,6,21
191127794,2,9,3,7,2,23
191127795,9,0,8,8,2,27
191127796,5,1,9,4,3,22
191127797,0,5,2,9,8,24
191127798,0,9,5,5,9,28
191127799,1,1,7,3,5,17
191127800,9,2,6,4,2,23
191127801,8,4,5,7,7,31
191127802,9,7,7,1,6,30
191127803,0,1,4,2,6,13
191127804,1,7,0,2,5,15
191127805,6,4,8,3,0,21
191127806,4,7,3,4,9,27
191127807,3,8,5,6,9,31
191127808,6,1,0,0,5,12
191127809,1,3,4,8,2,18
191127810,6,4,4,4,0,18
191127811,5,3,0,5,4,17
191127812,0,5,5,8,4,22
191127813,5,5,2,0,4,16
191127814,1,4,2,4,8,19
191127815,3,9,0,0,8,20
191127816,6,6,2,2,1,17
191127817,1,4,7,0,7,19
191127818,2,8,3,7,1,21
191127819,3,0,1,1,7,12
191127820,5,6,5,2,7,25
191127821,1,2,7,7,9,26
191127822,7,9,0,1,7,24
191127823,5,9,4,8,1,27
191127824,0,7,3,6,3,19
191127825,8,5,2,9,6,30
191127826,1,2,5,5,1,14
191127827,4,3,8,4,2,21
191127828,7,6,1,6,3,23
191127829,7,6,7,5,1,26
191127830,3,9,3,7,9,31
191127831,9,7,7,4,7,34
191127832,1,5,8,5,8,27
191127833,2,3,4,7,2,18
191127834,9,2,2,6,3,22
191127835,5,1,7,3,1,17
191127836,2,9,8,0,3,22
191127837,6,8,1,0,3,18
191127838,1,7,3,8,9,28
191127839,8,2,0,4,4,18
191127840,8,0,1,0,7,16
191127841,4,3,9,6,9,31
191127842,8,8,5,6,4,31
191127843,2,6,3,1,2,14
191127844,6,3,7,9,1,26
191127845,0,3,6,5,6,20
191127846,5,6,0,7,4,22
191127847,9,7,7,3,3,29
191127848,5,8,1,0,2,16
191127849,7,7,1,0,8,23
191127850,5,4,4,9,9,31
191127851,3,0,7,8,3,21
191127852,9,4,9,3,0,25
191127853,9,1,5,7,1,23
191127854,3,7,7,1,5,23
191127855,3,0,3,0,5,11
191127856,7,0,8,5,9,29
191127857,3,0,5,2,6,16
191127858,3,6,0,8,7,24
191127859,5,1,7,6,0,19
191127860,7,3,6,6,2,24
191127861,9,3,4,7,8,31
191127862,5,1,4,0,3,13
191127863,8,2,7,4,3,24
191127864,9,1,2,0,8,20
191127865,2,6,8,8,9,33
191127866,2,3,4,6,7,22
191127867,9,2,2,8,7,28
191127868,5,6,0,6,4,21
191127869,7,6,9,0,9,31
191127870,2,3,9,0,2,16
191127871,4,1,7,0,7,19
191127872,8,4,4,2,8,26
191127873,3,1,5,3,0,12
191127874,7,5,0,6,3,21
191127875,3,7,7,4,2,23
191127876,4,9,9,5,7,34
191127877,2,0,6,1,7,16
191127878,0,4,7,8,0,19
191127879,0,4,1,2,7,14
191127880,3,4,6,8,2,23
191127881,5,8,0,0,1,14
191127882,0,6,7,3,6,22
191127883,4,3,0,9,3,19
191127884,1,7,9,6,6,29
191127885,0,7,4,6,4,21
191127886,6,8,0,3,2,19
191127887,8,2,1,4,5,20
191127888,7,9,4,6,9,35
191127889,6,9,5,0,4,24
191127890,4,2,9,8,5,28
191127891,3,5,2,2,5,17
191127892,1,0,5,3,2,11
191127893,3,0,1,9,3,16
191127894,2,6,6,9,8,31
191127895,7,8,1,0,9,25
191127896,5,9,9,5,4,32
191127897,8,7,4,1,4,24
191127898,5,8,1,8,7,29
191127899,5,0,1,2,4,12
191127900,8,4,8,6,0,26
191127901,1,3,2,3,6,15
191127902,8,5,4,0,3,20
191127903,6,0,1,9,3,19
191127904,1,6,3,9,5,24
191127905,7,3,7,1,5,23
191127906,2,1,6,3,1,13
191127907,2,1,7,3,3,16
191127908,0,5,5,3,5,18
191127909,7,5,9,6,0,27
191127910,8,8,4,0,4,24
191127911,7,7,3,2,1,20
191127912,2,5,5,5,3,20
191127913,4,5,4,8,5,26
191127914,5,5,0,4,5,19
191127915,7,6,1,3,8,25
191127916,8,7,2,8,3,28
191127917,1,6,1,0,4,12
191127918,1,0,2,1,4,8
191127919,8,0,0,6,2,16
191127920,2,6,3,6,7,24
191127921,9,6,8,5,9,37
191127922,9,7,9,1,4,30
191127923,8,3,5,5,3,24
191127924,0,5,5,2,2,14
191127925,0,6,0,5,0,11
191127926,0,1,0,8,6,15
191127927,9,8,0,1,7,25
191127928,5,6,4,5,7,27
191127929,5,8,9,7,1,30
191127930,0,8,7,8,8,31
191127931,6,7,9,8,2,32
191127932,7,2,6,0,0,15
191127933,9,9,3,1,4,26
191127934,5,2,2,0,3,12
191127935,6,4,6,7,7,30
191127936,4,6,5,3,3,21
191127937,8,5,3,7,7,30
191127938,9,4,7,2,7,29
191127939,8,2,5,3,1,19
191127940,0,4,2,1,0,7
191127941,5,8,5,9,9,36
191127942,5,6,0,5,6,22
191127943,7,8,0,0,8,23
191127944,5,1,7,1,8,22
191127945,6,0,0,6,2,14
191127946,2,2,7,8,6,25
191127947,4,3,2,5,1,15
191127948,0,3,6,8,7,24
191127949,1,4,9,0,5,19
191127950,1,3,2,3,8,17
191127951,1,0,1,8,8,18
191127952,9,6,1,6,8,30
191127953,0,5,8,8,0,21
191127954,6,1,4,6,3,20
191127955,6,9,0,6,3,24
191127956,0,2,4,8,3,17
191127957,9,0,1,6,1,17
191127958,0,5,3,8,5,21
191127959,2,1,1,4,5,13
191127960,2,0,1,7,1,11
191127961,1,0,9,3,2,15
191127962,4,4,7,1,6,22
191127963,7,1,5,1,6,20
191127964,1,7,3,2,8,21
191127965,7,6,0,5,7,25
191127966,3,0,6,0,2,11
191127967,9,2,3,7,7,28
191127968,0,0,1,7,8,16
191127969,9,0,1,8,7,25
191127970,8,7,6,8,9,38
191127971,4,5,8,4,2,23
191127972,1,4,9,4,1,19
191127973,4,2,0,5,3,14
191127974,2,5,5,5,9,26
191127975,2,5,7,6,2,22
191127976,5,8,9,3,3,28
191127977,8,4,2,5,1,20
191127978,3,3,6,8,3,23
191127979,0,6,7,1,6,20
191127980,1,3,0,5,0,9
191127981,6,9,3,2,4,24
191127982,2,4,5,0,8,19
191127983,5,2,9,9,0,25
191127984,9,7,3,1,8,28
191127985,5,9,8,9,2,33
191127986,7,8,9,2,8,34
191127987,0,9,5,0,0,14
191127988,2,8,7,9,4,30
191127989,5,9,5,5,1,25
191127990,2,3,7,6,7,25
191127991,1,4,3,3,9,20
191127992,7,0,3,4,6,20
191127993,8,5,8,4,1,26
191127994,1,2,6,4,6,19
191127995,9,4,0,6,8,27
191127996,6,5,0,4,2,17
191127997,9,7,8,1,9,34
191127998,8,5,3,6,4,26
191127999,0,1,2,6,9,18
1911271000,7,6,9,5,6,33
1911271001,3,1,9,3,4,20
1911271002,2,2,5,1,7,17
1911271003,3,1,3,6,3,16
1911271004,8,1,2,9,4,24
1911271005,7,3,2,5,6,23
1911271006,0,3,9,3,2,17
1911271007,5,6,5,0,6,22
1911271008,2,0,3,9,4,18
1911271009,0,3,4,7,4,18
1911271010,4,7,7,5,1,24
1911271011,5,2,0,4,9,20
1911271012,1,5,6,5,2,19
1911271013,5,9,1,5,0,20
1911271014,2,3,5,9,3,22
1911271015,4,5,8,1,3,21
1911271016,5,1,8,7,8,29
1911271017,1,1,7,9,0,18
1911271018,9,5,1,5,8,28
1911271019,0,2,0,3,2,7
1911271020,4,7,6,4,5,26
1911271021,2,7,6,5,6,26
1911271022,1,8,2,9,9,29
1911271023,8,9,5,1,7,30
1911271024,0,0,9,6,7,22
1911271025,6,8,5,2,7,28
1911271026,0,9,0,2,0,11
1911271027,3,1,9,6,6,25
1911271028,1,4,0,2,5,12
1911271029,7,9,5,2,1,24
1911271030,3,8,7,6,9,33
1911271031,8,8,5,4,5,30
1911271032,0,2,3,2,6,13
1911271033,6,9,8,9,0,32
1911271034,8,4,3,2,7,24
1911271035,9,9,3,3,6,30
1911271036,7,2,7,7,6,29
1911271037,3,8,2,4,2,19
1911271038,4,9,1,6,6,26
1911271039,4,6,0,1,3,14
1911271040,1,3,7,3,8,22
1911271041,2,3,6,9,1,21
1911271042,5,8,3,5,4,25
1911271043,0,0,8,5,2,15
1911271044,6,0,0,3,3,12
1911271045,7,1,1,2,3,14
1911271046,3,1,6,1,9,20
1911271047,2,0,2,2,9,15
1911271048,4,0,0,5,0,9
1911271049,0,8,6,0,2,16
1911271050,7,7,8,5,6,33
1911271051,9,0,9,6,8,32
1911271052,9,4,0,4,0,17
1911271053,9,8,5,7,5,34
1911271054,6,3,6,8,7,30
1911271055,4,9,6,6,7,32
1911271056,8,0,1,4,9,22
1911271057,2,8,5,1,7,23
1911271058,2,3,1,9,5,20
1911271059,6,6,6,6,1,25
1911271060,0,3,6,8,4,21
1911271061,4,2,6,4,8,24
1911271062,6,6,3,1,6,22
1911271063,1,8,0,8,6,23
1911271064,6,7,2,8,1,24
1911271065,0,5,6,4,1,16
1911271066,2,1,7,3,6,19
1911271067,2,1,4,6,1,14
1911271068,1,7,1,5,4,18
1911271069,3,3,7,0,3,16
1911271070,8,8,5,5,4,30
1911271071,6,4,7,3,7,27
1911271072,5,5,0,9,8,27
1911271073,4,9,9,9,7,38
1911271074,9,0,8,4,0,21
1911271075,0,9,5,9,0,23
1911271076,4,6,6,5,9,30
1911271077,7,3,5,8,2,25
1911271078,3,1,8,8,0,20
1911271079,6,7,6,7,0,26
1911271080,2,5,3,9,0,19
1911271081,2,4,0,6,1,13
1911271082,5,3,2,0,7,17
1911271083,9,1,2,7,7,26
1911271084,9,2,0,3,0,14
1911271085,9,3,4,9,8,33
1911271086,3,6,0,2,9,20
1911271087,8,3,9,6,1,27
1911271088,3,9,3,5,7,27
1911271089,2,7,1,8,4,22
1911271090,0,8,7,5,7,27
1911271091,7,6,9,4,3,29
1911271092,4,2,0,1,2,9
1911271093,4,1,6,5,6,22
1911271094,1,7,1,3,5,17
1911271095,3,8,0,4,7,22
1911271096,9,7,1,8,4,29
1911271097,4,3,3,0,3,13
1911271098,4,8,4,8,2,26
1911271099,5,1,7,9,4,26
1911271100,1,7,2,3,3,16
1911271101,9,6,6,9,1,31
1911271102,3,5,6,9,1,24
1911271103,1,3,2,6,4,16
1911271104,6,9,4,4,0,23
1911271105,9,6,2,6,0,23
191128001,5,2,2,3,2,14
191128002,6,6,0,8,3,23
191128003,6,3,5,4,2,20
191128004,2,9,8,1,7,27
191128005,1,8,5,5,5,24
191128006,4,6,0,9,8,27
191128007,1,8,4,2,3,18
191128008,3,0,4,8,8,23
191128009,9,5,2,9,4,29
191128010,5,1,7,8,6,27
191128011,2,2,3,4,5,16
191128012,8,9,0,5,2,24
191128013,2,7,1,4,3,17
191128014,1,3,4,8,4,20
191128015,1,3,7,3,6,20
191128016,8,3,7,5,2,25
191128017,0,9,6,2,2,19
191128018,3,4,9,7,0,23
191128019,7,0,4,6,7,24
191128020,6,8,6,0,7,27
191128021,1,7,6,4,0,18
191128022,7,7,9,5,5,33
191128023,9,7,5,1,0,22
191128024,0,3,6,3,5,17
191128025,7,8,4,7,4,30
191128026,2,2,7,5,8,24
191128027,6,5,9,4,3,27
191128028,3,0,8,6,0,17
191128029,9,3,4,1,1,18
191128030,8,9,8,6,8,39
191128031,0,7,2,3,7,19
191128032,5,3,4,3,1,16
191128033,9,0,2,0,5,16
191128034,2,3,4,8,8,25
191128035,1,1,3,7,3,15
191128036,7,0,0,8,3,18
191128037,9,2,4,3,7,25
191128038,4,1,5,1,5,16
191128039,4,4,2,4,3,17
191128040,3,2,5,5,8,23
191128041,4,0,2,3,6,15
191128042,8,9,5,1,1,24
191128043,0,4,8,9,1,22
191128044,5,1,0,4,6,16
191128045,2,1,4,1,1,9
191128046,9,4,3,0,7,23
191128047,8,6,2,4,4,24
191128048,1,0,1,2,8,12
191128049,9,6,4,7,3,29
191128050,2,5,0,4,7,18
191128051,4,8,9,8,2,31
191128052,6,1,3,5,3,18
191128053,9,2,2,7,9,29
191128054,9,8,2,7,7,33
191128055,1,6,0,9,2,18
191128056,9,8,4,9,4,34
191128057,9,3,7,4,7,30
191128058,6,5,7,9,6,33
191128059,0,5,1,6,8,20
191128060,3,7,2,8,4,24
191128061,0,5,4,2,5,16
191128062,4,9,4,6,3,26
191128063,9,9,5,8,6,37
191128064,1,6,5,0,8,20
191128065,6,7,2,3,7,25
191128066,7,9,2,8,7,33
191128067,4,1,9,8,5,27
191128068,1,5,4,5,1,16
191128069,9,9,8,0,2,28
191128070,1,6,8,6,1,22
191128071,1,2,7,0,4,14
191128072,1,0,4,3,2,10
191128073,1,6,2,6,8,23
191128074,7,4,5,1,6,23
191128075,0,5,4,9,2,20
191128076,0,5,0,6,9,20
191128077,1,1,9,8,0,19
191128078,8,8,9,4,0,29
191128079,0,0,7,5,0,12
191128080,1,8,6,4,2,21
191128081,4,0,2,9,3,18
191128082,6,0,3,5,8,22
191128083,4,6,2,1,0,13
191128084,2,3,7,6,0,18
191128085,5,0,6,3,3,17
191128086,5,0,1,3,5,14
191128087,2,6,6,4,2,20
191128088,4,9,6,5,3,27
191128089,1,5,3,0,7,16
191128090,9,0,1,6,8,24
191128091,1,3,9,0,6,19
191128092,6,8,3,4,1,22
191128093,5,3,3,8,9,28
191128094,2,5,6,0,0,13
191128095,4,0,5,2,5,16
191128096,1,7,6,4,1,19
191128097,8,8,4,5,8,33
191128098,2,6,2,5,5,20
191128099,4,6,7,0,2,19
191128100,0,4,3,1,0,8
191128101,7,3,6,7,3,26
191128102,9,9,3,0,0,21
191128103,8,3,1,7,5,24
191128104,8,8,4,2,9,31
191128105,4,4,3,1,4,16
191128106,9,6,5,3,2,25
191128107,5,3,6,0,1,15
191128108,9,0,0,9,2,20
191128109,7,7,5,7,0,26
191128110,8,3,9,4,6,30
191128111,3,5,1,2,3,14
191128112,4,2,4,3,3,16
191128113,4,6,4,0,6,20
191128114,4,7,9,1,2,23
191128115,8,7,5,4,5,29
191128116,1,4,7,2,0,14
191128117,0,9,8,9,6,32
191128118,6,9,4,4,4,27
191128119,1,7,6,8,8,30
191128120,2,9,2,2,4,19
191128121,4,3,7,4,4,22
191128122,6,4,9,2,3,24
191128123,8,8,0,5,4,25
191128124,4,4,9,5,8,30
191128125,9,1,6,4,7,27
191128126,6,0,7,4,1,18
191128127,1,9,8,5,0,23
191128128,7,0,5,2,1,15
191128129,7,5,1,5,4,22
191128130,4,5,4,3,1,17
191128131,9,4,5,2,1,21
191128132,0,8,1,0,5,14
191128133,8,6,2,0,8,24
191128134,2,7,5,8,8,30
191128135,7,1,5,4,8,25
191128136,9,3,1,8,9,30
191128137,1,6,8,9,0,24
191128138,5,5,5,9,8,32
191128139,5,5,9,8,1,28
191128140,5,2,4,2,3,16
191128141,7,9,9,7,4,36
191128142,6,9,8,1,0,24
191128143,3,1,7,9,4,24
191128144,8,1,9,2,8,28
191128145,3,0,8,6,5,22
191128146,9,6,4,6,6,31
191128147,8,5,3,2,3,21
191128148,1,3,5,0,9,18
191128149,6,3,3,7,6,25
191128150,6,3,1,2,1,13
191128151,9,6,3,8,9,35
191128152,0,8,0,0,7,15
191128153,7,0,2,1,8,18
191128154,7,4,8,7,6,32
191128155,6,0,0,3,1,10
191128156,4,2,0,3,4,13
191128157,2,4,3,5,4,18
191128158,9,5,2,6,3,25
191128159,2,7,3,7,7,26
191128160,5,6,0,8,3,22
191128161,0,4,7,8,5,24
191128162,3,5,8,6,5,27
191128163,6,4,2,2,5,19
191128164,8,1,5,4,4,22
191128165,3,6,8,6,8,31
191128166,8,8,5,1,6,28
191128167,2,5,7,2,1,17
191128168,4,3,3,8,1,19
191128169,1,7,0,5,8,21
191128170,4,7,7,3,0,21
191128171,1,6,6,4,5,22
191128172,4,8,4,5,9,30
191128173,7,8,1,4,3,23
191128174,1,3,5,1,6,16
191128175,7,5,5,3,2,22
191128176,3,8,0,6,6,23
191128177,7,8,7,4,4,30
191128178,0,7,0,0,4,11
191128179,8,3,8,6,2,27
191128180,9,1,0,9,5,24
191128181,5,5,3,5,2,20
191128182,5,5,8,1,6,25
191128183,4,5,1,9,7,26
191128184,3,4,6,7,0,20
191128185,7,2,1,8,8,26
191128186,2,8,6,8,0,24
191128187,2,5,9,2,2,20
191128188,3,9,0,6,9,27
191128189,8,5,1,9,6,29
191128190,2,6,1,6,8,23
191128191,4,5,3,8,9,29
191128192,3,7,1,5,2,18
191128193,5,9,8,5,8,35
191128194,2,7,1,7,0,17
191128195,9,7,2,9,0,27
191128196,8,0,0,4,0,12
191128197,8,7,8,9,8,40
191128198,2,1,5,2,1,11
191128199,8,7,5,5,4,29
191128200,3,1,3,5,6,18
191128201,5,9,9,8,0,31
191128202,1,6,0,0,9,16
191128203,0,2,7,8,8,25
191128204,2,1,5,1,0,9
191128205,3,8,5,8,9,33
191128206,7,8,0,5,8,28
191128207,8,1,4,5,6,24
191128208,2,4,2,8,1,17
191128209,5,7,4,5,0,21
191128210,2,8,4,9,2,25
191128211,5,3,6,2,4,20
191128212,4,1,3,9,8,25
191128213,3,5,1,5,3,17
191128214,3,2,9,4,2,20
191128215,9,6,6,1,7,29
191128216,5,2,0,7,8,22
191128217,2,4,1,8,1,16
191128218,9,7,4,0,7,27
191128219,8,6,1,1,7,23
191128220,4,1,8,0,4,17
191128221,1,8,3,8,3,23
191128222,9,2,3,1,7,22
191128223,3,6,2,1,2,14
191128224,1,7,3,9,2,22
191128225,7,6,6,6,8,33
191128226,5,8,2,8,6,29
191128227,0,7,3,7,7,24
191128228,7,4,5,0,5,21
191128229,5,1,0,2,0,8
191128230,7,7,4,3,0,21
191128231,6,4,4,3,0,17
191128232,1,4,7,5,6,23
191128233,7,9,5,9,7,37
191128234,6,7,1,2,1,17
191128235,8,6,5,9,2,30
191128236,3,8,4,0,4,19
191128237,6,8,7,7,2,30
191128238,1,8,3,5,4,21
191128239,7,7,5,7,9,35
191128240,4,9,3,8,8,32
191128241,9,6,6,1,1,23
191128242,7,8,5,5,1,26
191128243,2,4,3,8,1,18
191128244,2,1,2,3,2,10
191128245,5,4,7,1,3,20
191128246,6,3,3,2,7,21
191128247,2,5,7,1,0,15
191128248,4,6,4,4,5,23
191128249,8,5,6,9,2,30
191128250,1,2,1,4,0,8
191128251,7,0,6,6,8,27
191128252,1,6,5,5,3,20
191128253,6,7,0,6,2,21
191128254,3,8,8,9,5,33
191128255,6,3,5,1,1,16
191128256,0,5,3,4,0,12
191128257,2,0,9,3,8,22
191128258,5,5,4,8,5,27
191128259,2,1,1,2,7,13
191128260,9,3,6,2,2,22
191128261,7,3,6,6,3,25
191128262,3,6,7,8,1,25
191128263,2,9,3,2,7,23
191128264,9,4,3,9,3,28
191128265,0,6,0,1,2,9
191128266,7,0,1,2,5,15
191128267,7,7,8,2,0,24
191128268,4,4,5,0,9,22
191128269,2,2,9,1,6,20
191128270,6,5,4,2,1,18
191128271,6,1,9,6,3,25
191128272,4,4,9,9,3,29
191128273,6,5,3,1,8,23
191128274,3,7,1,9,1,21
191128275,6,3,6,4,5,24
191128276,4,6,6,4,2,22
191128277,9,7,9,6,0,31
191128278,4,3,4,9,7,27
191128279,6,1,9,3,7,26
191128280,8,2,9,5,8,32
191128281,9,4,0,2,1,16
191128282,7,6,4,1,6,24
191128283,7,2,2,5,0,16
191128284,7,8,3,5,0,23
191128285,3,5,5,3,0,16
191128286,9,1,9,3,4,26
191128287,4,5,9,3,0,21
191128288,4,1,0,3,7,15
191128289,2,3,2,7,5,19
191128290,6,3,5,0,5,19
191128291,2,5,3,8,4,22
191128292,7,5,7,3,8,30
191128293,7,1,3,3,3,17
191128294,3,5,5,2,3,18
191128295,0,6,1,1,3,11
191128296,1,4,9,4,0,18
191128297,1,3,1,1,4,10
191128298,5,2,0,9,9,25
191128299,3,1,3,5,5,17
191128300,4,4,7,6,6,27
191128301,9,0,9,7,5,30
191128302,4,8,4,9,2,27
191128303,7,5,0,8,0,20
191128304,0,4,1,7,9,21
191128305,4,1,6,0,7,18
191128306,8,5,2,9,8,32
191128307,7,2,7,3,5,24
191128308,2,4,9,4,9,28
191128309,2,9,7,3,3,24
191128310,9,6,9,9,9,42
191128311,3,6,4,1,5,19
191128312,5,3,7,2,5,22
191128313,3,3,3,0,7,16
191128314,3,9,4,2,2,20
191128315,1,4,4,0,1,10
191128316,8,8,0,2,7,25
191128317,2,1,6,4,0,13
191128318,3,8,4,0,1,16
191128319,5,2,4,3,0,14
191128320,7,6,2,2,8,25
191128321,6,1,3,9,7,26
191128322,8,8,2,1,0,19
191128323,3,5,8,2,9,27
191128324,5,9,9,4,1,28
191128325,2,1,3,3,3,12
191128326,7,7,0,4,5,23
191128327,0,3,4,0,9,16
191128328,5,9,4,5,6,29
191128329,0,0,7,1,1,9
191128330,4,1,5,7,9,26
191128331,5,4,3,2,3,17
191128332,2,1,7,2,3,15
191128333,4,2,0,5,2,13
191128334,6,7,9,7,4,33
191128335,0,4,1,9,2,16
191128336,5,6,0,6,9,26
191128337,8,1,8,2,1,20
191128338,4,9,2,4,8,27
191128339,7,8,6,8,0,29
191128340,5,2,7,1,3,18
191128341,3,5,1,8,6,23
191128342,0,8,1,0,8,17
191128343,9,3,0,8,2,22
191128344,8,4,7,2,2,23
191128345,6,8,3,8,7,32
191128346,9,3,6,8,3,29
191128347,5,3,9,2,1,20
191128348,1,4,8,7,9,29
191128349,8,7,7,0,0,22
191128350,1,3,9,1,1,15
191128351,9,9,5,1,1,25
191128352,9,8,4,2,6,29
191128353,1,0,2,8,6,17
191128354,6,5,6,9,5,31
191128355,5,5,9,7,8,34
191128356,9,9,9,9,3,39
191128357,3,7,8,0,8,26
191128358,8,2,7,6,3,26
191128359,0,7,4,8,2,21
191128360,3,6,7,0,9,25
191128361,7,3,4,1,5,20
191128362,0,0,5,0,6,11
191128363,0,2,8,4,7,21
191128364,4,5,2,5,3,19
191128365,1,8,2,7,8,26
191128366,2,7,6,2,7,24
191128367,6,4,2,9,1,22
191128368,8,4,9,1,3,25
191128369,4,0,6,1,2,13
191128370,2,8,0,4,2,16
191128371,8,6,0,6,2,22
191128372,2,4,1,0,7,14
191128373,4,2,0,9,8,23
191128374,7,9,1,1,3,21
191128375,2,8,8,2,8,28
191128376,6,8,7,7,6,34
191128377,1,0,8,0,7,16
191128378,6,5,0,9,8,28
191128379,6,3,4,7,9,29
191128380,9,0,2,9,3,23
191128381,6,6,0,9,7,28
191128382,1,3,6,2,6,18
191128383,8,7,1,6,5,27
191128384,7,0,0,4,7,18
191128385,5,0,9,9,4,27
191128386,4,3,2,3,0,12
191128387,5,9,6,2,9,31
191128388,0,8,8,3,9,28
191128389,6,3,9,1,8,27
191128390,8,1,0,4,8,21
191128391,9,2,0,8,3,22
191128392,5,3,8,3,6,25
191128393,5,0,2,0,4,11
191128394,6,6,4,8,5,29
191128395,4,5,8,1,8,26
191128396,3,0,3,5,4,15
191128397,0,8,8,1,6,23
191128398,5,3,1,8,8,25
191128399,1,4,3,7,7,22
191128400,6,7,2,4,5,24
191128401,1,4,9,4,8,26
191128402,3,1,6,7,8,25
191128403,4,3,7,0,2,16
191128404,8,6,9,1,0,24
191128405,2,5,2,8,9,26
191128406,7,4,1,3,0,15
191128407,2,5,6,3,0,16
191128408,7,8,8,2,6,31
191128409,0,2,9,6,1,18
191128410,8,4,6,2,9,29
191128411,8,5,4,6,4,27
191128412,4,1,2,8,4,19
191128413,9,8,6,5,0,28
191128414,9,4,7,4,0,24
191128415,6,7,4,7,9,33
191128416,7,9,4,5,3,28
191128417,2,9,7,3,5,26
191128418,2,8,0,4,3,17
191128419,9,1,1,4,5,20
191128420,1,1,2,2,2,8
191128421,2,4,7,2,5,20
191128422,2,7,4,3,1,17
191128423,0,9,3,7,0,19
191128424,7,1,8,4,0,20
191128425,5,3,8,1,5,22
191128426,0,0,9,1,4,14
191128427,0,1,1,9,5,16
191128428,1,3,4,3,6,17
191128429,5,3,1,0,4,13
191128430,4,8,5,2,6,25
191128431,6,6,8,2,8,30
191128432,1,5,9,3,2,20
191128433,1,2,2,3,2,10
191128434,8,5,5,4,8,30
191128435,0,3,6,5,8,22
191128436,5,6,6,7,0,24
191128437,7,1,3,2,8,21
191128438,5,6,8,9,6,34
191128439,2,6,5,2,3,18
191128440,2,3,8,8,8,29
191128441,5,8,8,7,1,29
191128442,4,2,9,4,0,19
191128443,3,1,3,4,9,20
191128444,0,7,3,3,9,22
191128445,9,9,6,9,8,41
191128446,6,3,1,0,7,17
191128447,4,6,4,8,2,24
191128448,6,1,8,7,5,27
191128449,3,4,9,5,1,22
191128450,3,6,7,4,4,24
191128451,6,7,3,0,6,22
191128452,5,8,3,5,3,24
191128453,3,4,0,7,9,23
191128454,2,5,5,4,7,23
191128455,2,8,9,8,3,30
191128456,1,6,6,2,2,17
191128457,5,0,2,4,9,20
191128458,7,3,8,4,3,25
191128459,8,7,2,2,7,26
191128460,0,7,4,3,1,15
191128461,4,1,0,7,7,19
191128462,3,8,7,2,5,25
191128463,9,8,0,8,7,32
191128464,9,9,4,5,7,34
191128465,2,4,8,9,0,23
191128466,7,8,9,8,7,39
191128467,1,4,4,8,7,24
191128468,9,3,0,7,2,21
191128469,0,9,6,1,8,24
191128470,9,8,9,4,8,38
191128471,1,0,0,6,0,7
191128472,1,2,7,3,8,21
191128473,2,5,7,8,9,31
191128474,5,2,7,6,1,21
191128475,6,5,9,0,1,21
191128476,7,6,3,5,9,30
191128477,2,3,4,0,8,17
191128478,0,1,6,9,7,23
191128479,8,6,8,8,9,39
191128480,5,0,2,8,1,16
191128481,9,3,1,5,6,24
191128482,1,6,5,4,3,19
191128483,8,1,1,9,8,27
191128484,3,0,7,0,6,16
191128485,8,6,0,1,8,23
191128486,9,9,8,8,3,37
191128487,2,0,8,1,4,15
191128488,5,9,9,6,4,33
191128489,2,5,4,6,9,26
191128490,5,0,5,5,3,18
191128491,7,1,9,2,2,21
191128492,3,2,9,1,9,24
191128493,3,4,5,1,7,20
191128494,1,2,7,8,8,26
191128495,9,0,9,8,9,35
191128496,8,7,8,9,1,33
191128497,5,5,2,7,9,28
191128498,8,1,7,3,7,26
191128499,7,2,5,9,7,30
191128500,4,0,1,0,4,9
191128501,5,8,0,7,1,21
191128502,0,7,2,8,4,21
191128503,5,2,0,1,5,13
191128504,2,5,3,0,5,15
191128505,2,9,6,6,7,30
191128506,6,5,3,6,8,28
191128507,3,8,7,7,2,27
191128508,1,1,8,0,4,14
191128509,4,7,1,4,0,16
191128510,5,0,5,8,4,22
191128511,0,5,3,0,1,9
191128512,2,9,2,0,2,15
191128513,9,0,4,6,3,22
191128514,1,6,9,3,0,19
191128515,4,0,4,1,8,17
191128516,2,5,1,0,0,8
191128517,5,7,3,0,2,17
191128518,9,4,6,1,8,28
191128519,8,6,0,8,6,28
191128520,2,7,2,7,7,25
191128521,7,8,2,0,3,20
191128522,5,1,2,1,8,17
191128523,5,0,0,0,9,14
191128524,2,0,2,5,4,13
191128525,7,0,9,5,7,28
191128526,9,8,8,2,9,36
191128527,2,0,9,2,6,19
191128528,3,5,6,7,7,28
191128529,6,4,7,8,8,33
191128530,1,1,2,0,9,13
191128531,0,2,9,2,8,21
191128532,7,8,6,7,6,34
191128533,2,0,4,0,4,10
191128534,0,8,6,6,1,21
191128535,2,9,1,1,5,18
191128536,1,1,1,3,7,13
191128537,8,4,8,2,5,27
191128538,5,8,7,2,1,23
191128539,8,3,0,9,5,25
191128540,3,4,6,2,2,17
191128541,8,4,0,8,0,20
191128542,1,0,6,9,2,18
191128543,7,0,8,9,4,28
191128544,9,8,2,2,8,29
191128545,7,3,5,7,9,31
191128546,4,7,9,1,5,26
191128547,8,4,7,0,5,24
191128548,3,8,8,3,4,26
191128549,8,6,4,4,2,24
191128550,3,6,3,8,0,20
191128551,1,3,6,9,9,28
191128552,4,5,8,0,4,21
191128553,8,5,1,0,0,14
191128554,3,1,7,0,6,17
191128555,5,4,2,9,7,27
191128556,4,8,9,1,9,31
191128557,2,2,1,6,3,14
191128558,3,3,2,8,8,24
191128559,9,0,0,1,2,12
191128560,4,1,8,4,4,21
191128561,1,9,6,2,2,20
191128562,3,2,3,4,8,20
191128563,2,8,8,8,7,33
191128564,2,7,8,7,3,27
191128565,8,4,9,8,9,38
191128566,2,5,8,5,0,20
191128567,9,7,7,6,0,29
191128568,2,2,6,9,7,26
191128569,4,0,3,3,6,16
191128570,1,9,2,0,7,19
191128571,4,3,2,5,3,17
191128572,2,6,6,8,8,30
191128573,6,9,8,4,1,28
191128574,4,8,3,3,6,24
191128575,7,8,9,9,3,36
191128576,4,2,9,9,2,26
191128577,0,6,5,5,9,25
191128578,4,6,3,3,3,19
191128579,8,9,0,5,4,26
191128580,4,5,7,2,4,22
191128581,1,4,8,2,9,24
191128582,5,7,6,2,6,26
191128583,1,9,1,8,4,23
191128584,1,3,9,4,2,19
191128585,2,5,8,7,6,28
191128586,8,1,9,8,8,34
191128587,9,4,1,3,1,18
191128588,0,2,2,0,6,10
191128589,6,0,5,7,3,21
191128590,8,1,3,4,7,23
191128591,1,1,0,1,2,5
191128592,5,3,2,6,5,21
191128593,7,0,3,6,3,19
191128594,3,3,3,9,5,23
191128595,8,8,4,0,7,27
191128596,7,5,9,5,8,34
191128597,5,2,7,1,7,22
191128598,5,7,3,1,4,20
191128599,5,6,6,7,2,26
191128600,1,1,3,2,4,11
191128601,8,1,0,0,3,12
191128602,0,0,1,5,9,15
191128603,0,1,2,7,8,18
191128604,2,9,6,9,5,31
191128605,4,2,2,0,8,16
191128606,3,9,3,6,4,25
191128607,4,5,0,2,6,17
191128608,0,3,9,5,9,26
191128609,3,0,5,7,6,21
191128610,1,4,9,9,4,27
191128611,1,7,4,1,0,13
191128612,3,0,4,0,1,8
191128613,4,8,9,9,4,34
191128614,0,8,6,4,2,20
191128615,2,2,6,5,2,17
191128616,1,5,4,3,2,15
191128617,0,7,2,3,5,17
191128618,1,4,8,0,2,15
191128619,1,9,8,2,8,28
191128620,8,2,1,6,2,19
191128621,4,2,8,6,1,21
191128622,8,0,6,3,8,25
191128623,2,1,2,4,0,9
191128624,7,1,8,8,1,25
191128625,0,4,9,9,5,27
191128626,1,3,1,6,8,19
191128627,4,5,9,1,8,27
191128628,7,8,8,6,9,38
191128629,0,6,8,9,3,26
191128630,4,4,4,0,6,18
191128631,3,4,9,8,9,33
191128632,8,5,9,7,5,34
191128633,0,2,9,1,1,13
191128634,6,6,8,4,1,25
191128635,5,5,8,2,7,27
191128636,7,4,3,4,4,22
191128637,6,2,1,3,6,18
191128638,3,3,6,7,0,19
191128639,0,9,8,8,3,28
191128640,0,3,3,6,3,15
191128641,8,9,0,7,6,30
191128642,9,0,9,1,6,25
191128643,7,9,1,6,0,23
191128644,6,2,1,4,0,13
191128645,4,0,8,2,9,23
191128646,0,0,8,0,3,11
191128647,1,7,8,3,4,23
191128648,8,0,3,0,1,12
191128649,7,7,6,1,0,21
191128650,0,1,7,5,6,19
191128651,7,1,8,5,6,27
191128652,3,2,5,7,9,26
191128653,9,7,7,3,2,28
191128654,2,7,4,1,1,15
191128655,2,2,8,4,6,22
191128656,5,7,7,2,0,21
191128657,3,2,8,1,5,19
191128658,4,5,5,2,6,22
191128659,7,1,0,1,2,11
191128660,2,5,6,7,8,28
191128661,6,3,9,6,7,31
191128662,1,8,9,8,2,28
191128663,7,6,9,0,1,23
191128664,7,8,3,6,3,27
191128665,7,9,0,9,0,25
191128666,7,7,9,9,2,34
191128667,8,4,4,7,6,29
191128668,7,0,2,7,3,19
191128669,9,8,0,6,8,31
191128670,3,2,3,1,3,12
191128671,7,7,0,5,6,25
191128672,5,1,7,8,1,22
191128673,2,9,5,8,0,24
191128674,0,5,6,8,8,27
191128675,7,5,3,2,5,22
191128676,5,0,7,3,2,17
191128677,1,9,5,3,2,20
191128678,1,7,2,5,7,22
191128679,9,2,0,6,4,21
191128680,5,0,0,8,0,13
191128681,4,6,1,4,9,24
191128682,3,4,4,2,6,19
191128683,9,7,9,9,7,41
191128684,5,5,4,7,8,29
191128685,4,9,0,6,6,25
191128686,0,3,1,6,1,11
191128687,1,9,3,6,1,20
191128688,3,2,5,4,8,22
191128689,8,9,9,3,1,30
191128690,9,2,7,4,4,26
191128691,1,9,1,4,1,16
191128692,6,2,1,2,6,17
191128693,1,5,5,9,6,26
191128694,2,2,6,5,9,24
191128695,8,3,2,3,8,24
191128696,6,6,3,5,2,22
191128697,6,6,9,1,3,25
191128698,7,0,9,5,2,23
191128699,9,8,0,6,9,32
191128700,1,5,1,4,8,19
191128701,2,0,0,2,9,13
191128702,5,3,5,0,3,16
191128703,5,9,1,2,9,26
191128704,5,4,1,1,7,18
191128705,3,8,6,5,1,23
191128706,0,8,1,3,8,20
191128707,2,5,8,8,9,32
191128708,0,8,2,1,0,11
191128709,7,4,9,8,6,34
191128710,6,7,0,2,2,17
191128711,2,6,1,0,7,16
191128712,3,1,2,9,2,17
191128713,0,6,1,7,8,22
191128714,1,8,6,2,5,22
191128715,4,8,1,6,1,20
191128716,3,7,0,0,5,15
191128717,6,8,7,0,8,29
191128718,4,0,9,0,1,14
191128719,1,8,4,7,9,29
191128720,3,9,0,4,0,16
191128721,2,4,5,6,1,18
191128722,0,1,0,6,0,7
191128723,1,3,2,5,2,13
191128724,9,0,8,1,2,20
191128725,1,1,3,6,8,19
191128726,2,3,6,6,3,20
191128727,4,9,8,7,3,31
191128728,2,7,3,3,7,22
191128729,0,1,0,4,4,9
191128730,9,5,4,5,7,30
191128731,8,5,8,1,4,26
191128732,9,4,1,4,6,24
191128733,3,4,5,5,7,24
191128734,6,7,9,8,8,38
191128735,2,0,0,6,1,9
191128736,9,6,4,9,6,34
191128737,6,6,1,7,2,22
191128738,5,9,3,6,0,23
191128739,3,0,8,6,1,18
191128740,7,0,3,5,8,23
191128741,1,3,6,0,1,11
191128742,3,5,2,3,7,20
191128743,3,6,7,9,4,29
191128744,3,3,2,5,1,14
191128745,4,5,0,5,4,18
191128746,9,7,0,6,7,29
191128747,4,3,0,9,8,24
191128748,4,8,2,4,1,19
191128749,2,9,9,1,6,27
191128750,8,0,7,1,4,20
191128751,6,6,6,9,0,27
191128752,4,2,9,3,9,27
191128753,7,8,5,7,9,36
191128754,9,7,6,5,9,36
191128755,0,3,9,0,6,18
191128756,1,8,2,1,4,16
191128757,8,4,8,0,8,28
191128758,3,0,8,3,6,20
191128759,0,1,5,6,6,18
191128760,9,0,2,9,1,21
191128761,2,4,2,4,8,20
191128762,9,7,6,0,7,29
191128763,1,4,8,0,0,13
191128764,6,7,3,2,5,23
191128765,0,2,0,7,5,14
191128766,3,1,0,1,6,11
191128767,1,3,4,9,9,26
191128768,1,6,3,3,7,20
191128769,0,2,0,4,6,12
191128770,5,6,5,1,1,18
191128771,3,9,0,5,7,24
191128772,6,5,3,0,6,20
191128773,3,9,8,1,4,25
191128774,4,7,7,8,7,33
191128775,0,1,4,5,8,18
191128776,8,2,1,7,1,19
191128777,0,3,9,7,0,19
191128778,7,5,0,6,4,22
191128779,0,9,0,7,6,22
191128780,7,5,3,7,4,26
191128781,4,2,5,3,3,17
191128782,0,1,1,3,6,11
191128783,0,0,3,9,7,19
191128784,7,2,2,8,4,23
191128785,4,7,9,5,7,32
191128786,7,8,5,9,5,34
191128787,2,0,1,2,6,11
191128788,7,7,1,6,8,29
191128789,4,6,0,8,9,27
191128790,9,1,9,3,1,23
191128791,7,6,0,6,3,22
191128792,2,3,5,9,2,21
191128793,3,8,9,1,7,28
191128794,4,4,7,3,6,24
191128795,8,9,7,7,5,36
191128796,0,5,7,9,9,30
191128797,8,8,0,7,8,31
191128798,9,1,2,3,3,18
191128799,8,5,4,0,1,18
191128800,4,2,4,8,2,20
191128801,2,2,5,7,0,16
191128802,2,0,8,2,5,17
191128803,8,9,4,9,7,37
191128804,9,7,9,4,6,35
191128805,7,4,0,0,4,15
191128806,2,6,0,9,2,19
191128807,9,6,5,1,3,24
191128808,1,5,7,6,0,19
191128809,0,5,0,4,8,17
191128810,6,8,3,8,6,31
191128811,5,0,2,2,4,13
191128812,5,6,1,4,9,25
191128813,3,5,2,8,5,23
191128814,7,4,0,0,8,19
191128815,3,1,6,7,1,18
191128816,8,4,9,5,2,28
191128817,7,9,9,1,8,34
191128818,1,6,3,1,5,16
191128819,4,7,0,4,7,22
191128820,2,4,8,5,5,24
191128821,8,9,5,4,1,27
191128822,0,7,7,2,0,16
191128823,7,1,2,0,1,11
191128824,6,9,3,7,4,29
191128825,9,0,8,9,4,30
191128826,4,2,5,0,4,15
191128827,6,1,3,4,7,21
191128828,5,4,1,4,9,23
191128829,3,6,1,7,4,21
191128830,9,9,7,3,1,29
191128831,5,9,6,9,6,35
191128832,9,9,0,5,7,30
191128833,2,5,5,6,8,26
191128834,7,2,9,1,0,19
191128835,2,1,6,3,4,16
191128836,7,2,0,8,0,17
191128837,0,9,5,5,2,21
191128838,1,8,7,5,4,25
191128839,9,7,4,5,5,30
191128840,2,9,9,3,4,27
191128841,3,1,4,5,9,22
191128842,4,3,9,4,8,28
191128843,4,4,8,8,9,33
191128844,5,0,2,6,9,22
191128845,1,0,3,7,3,14
191128846,2,3,5,4,6,20
191128847,9,8,6,3,9,35
191128848,0,7,6,8,1,22
191128849,7,7,2,3,1,20
191128850,2,6,6,4,0,18
191128851,5,0,0,7,7,19
191128852,1,2,6,8,2,19
191128853,1,3,2,4,5,15
191128854,6,4,8,5,8,31
191128855,2,9,2,0,8,21
191128856,1,8,8,9,0,26
191128857,1,9,7,7,1,25
191128858,2,3,9,5,2,21
191128859,4,1,5,0,1,11
191128860,6,4,6,2,9,27
191128861,2,4,0,8,9,23
191128862,1,6,8,4,6,25
191128863,9,7,2,0,2,20
191128864,0,0,8,3,3,14
191128865,3,0,0,7,4,14
191128866,3,3,6,4,0,16
191128867,2,9,5,9,2,27
191128868,4,6,5,4,5,24
191128869,4,3,6,7,3,23
191128870,6,9,9,7,7,38
191128871,6,9,6,3,9,33
191128872,8,9,6,7,1,31
191128873,7,2,6,3,6,24
191128874,5,1,2,3,9,20
191128875,0,2,6,0,8,16
191128876,7,4,8,2,4,25
191128877,4,2,1,1,9,17
191128878,1,9,3,7,3,23
191128879,0,4,3,6,8,21
191128880,0,1,2,1,9,13
191128881,2,6,3,9,6,26
191128882,0,5,3,8,8,24
191128883,4,4,0,9,3,20
191128884,5,8,5,7,1,26
191128885,0,1,7,6,5,19
191128886,1,0,9,6,4,20
191128887,5,1,9,9,6,30
191128888,6,8,7,2,4,27
191128889,3,5,1,1,5,15
191128890,0,5,8,6,1,20
191128891,6,2,3,8,5,24
191128892,7,3,9,5,5,29
191128893,5,0,6,4,8,23
191128894,7,3,6,1,1,18
191128895,2,0,4,4,7,17
191128896,2,6,0,6,4,18
191128897,1,5,0,4,3,13
191128898,3,5,5,4,9,26
191128899,8,3,6,5,5,27
191128900,7,2,6,4,2,21
191128901,3,9,2,7,7,28
191128902,9,3,2,7,8,29
191128903,9,5,8,0,4,26
191128904,8,5,9,4,3,29
191128905,8,1,2,8,9,28
191128906,5,3,7,4,0,19
191128907,4,3,3,4,2,16
191128908,3,4,2,2,8,19
191128909,2,6,0,0,1,9
191128910,7,3,5,1,8,24
191128911,6,1,8,6,4,25
191128912,2,1,6,4,1,14
191128913,4,4,3,9,1,21
191128914,5,2,6,7,5,25
191128915,4,9,6,0,9,28
191128916,5,8,9,0,9,31
191128917,6,9,8,3,1,27
191128918,0,1,1,6,7,15
191128919,9,7,6,8,7,37
191128920,0,1,8,7,2,18
191128921,2,0,4,0,2,8
191128922,5,6,6,1,7,25
191128923,0,2,8,3,3,16
191128924,7,2,8,7,6,30
191128925,2,2,4,2,0,10
191128926,4,1,8,1,0,14
191128927,3,4,6,8,8,29
191128928,7,9,5,8,1,30
191128929,0,7,2,5,2,16
191128930,1,0,3,0,3,7
191128931,3,7,5,6,2,23
191128932,0,4,8,9,5,26
191128933,5,9,9,5,1,29
191128934,2,3,1,0,7,13
191128935,2,9,2,9,6,28
191128936,4,7,0,0,1,12
191128937,2,1,7,1,8,19
191128938,1,4,7,5,9,26
191128939,7,7,3,1,1,19
191128940,6,5,7,2,0,20
191128941,7,5,5,2,3,22
191128942,4,4,9,9,8,34
191128943,0,4,7,5,8,24
191128944,5,2,5,7,0,19
191128945,5,2,8,4,6,25
191128946,3,7,5,0,0,15
191128947,4,1,4,1,7,17
191128948,5,0,0,5,1,11
191128949,8,7,5,3,4,27
191128950,3,5,1,0,1,10
191128951,6,0,2,3,4,15
191128952,7,6,3,3,5,24
191128953,4,4,9,8,6,31
191128954,8,5,3,0,6,22
191128955,0,0,1,0,2,3
191128956,5,2,3,4,2,16
191128957,1,9,7,5,2,24
191128958,2,6,5,8,6,27
191128959,4,4,4,9,9,30
191128960,8,2,5,7,1,23
191128961,7,1,5,0,5,18
191128962,3,9,7,5,0,24
191128963,3,9,9,9,7,37
191128964,7,5,9,4,9,34
191128965,9,5,0,7,7,28
191128966,1,2,9,4,3,19
191128967,6,5,5,7,7,30
191128968,3,7,0,0,4,14
191128969,5,5,4,8,7,29
191128970,4,0,6,3,3,16
191128971,1,2,3,0,3,9
191128972,4,6,2,5,7,24
191128973,1,6,8,3,6,24
191128974,1,3,0,2,2,8
191128975,4,6,2,5,5,22
191128976,7,0,3,1,0,11
191128977,1,2,3,8,9,23
191128978,5,6,7,2,7,27
191128979,5,6,3,2,8,24
191128980,9,3,3,4,7,26
191128981,0,1,0,3,0,4
191128982,4,2,0,8,4,18
191128983,1,4,1,1,3,10
191128984,8,0,2,1,8,19
191128985,2,0,0,4,4,10
191128986,1,7,1,2,4,15
191128987,4,0,9,1,9,23
191128988,6,9,8,6,3,32
191128989,6,8,1,4,5,24
191128990,7,8,9,9,4,37
191128991,3,3,4,1,2,13
191128992,1,6,1,8,9,25
191128993,2,9,1,8,1,21
191128994,1,0,7,3,7,18
191128995,3,7,4,2,1,17
191128996,4,4,1,3,6,18
191128997,0,2,7,8,9,26
191128998,8,0,9,8,9,34
191128999,2,2,4,4,1,13
1911281000,7,8,2,1,1,19
1911281001,7,6,7,1,4,25
1911281002,1,0,1,8,1,11
1911281003,0,7,0,3,9,19
1911281004,5,8,8,8,9,38
1911281005,7,4,7,1,6,25
1911281006,9,6,6,3,7,31
1911281007,0,8,2,8,4,22
1911281008,9,4,7,5,3,28
1911281009,8,9,4,5,3,29
1911281010,0,4,1,1,8,14
1911281011,9,5,0,9,6,29
1911281012,6,9,6,8,4,33
1911281013,7,6,8,4,3,28
1911281014,2,4,6,1,8,21
1911281015,0,9,8,2,1,20
1911281016,0,6,9,9,3,27
1911281017,3,8,8,2,3,24
1911281018,7,8,7,0,7,29
1911281019,7,6,9,5,5,32
1911281020,6,8,8,1,8,31
1911281021,8,0,9,3,7,27
1911281022,9,8,6,0,1,24
1911281023,2,6,0,1,3,12
1911281024,2,7,4,3,7,23
1911281025,2,7,6,4,6,25
1911281026,0,2,2,2,9,15
1911281027,8,3,3,1,5,20
1911281028,3,1,8,2,4,18
1911281029,8,6,1,8,6,29
1911281030,4,0,0,0,3,7
1911281031,4,9,8,4,2,27
1911281032,1,1,8,1,9,20
1911281033,4,8,7,5,9,33
1911281034,2,1,9,5,0,17
1911281035,2,9,0,0,6,17
1911281036,1,2,4,5,3,15
1911281037,1,9,7,0,7,24
1911281038,7,5,2,0,4,18
1911281039,6,0,8,1,2,17
1911281040,6,7,3,1,8,25
1911281041,4,0,9,8,0,21
1911281042,9,8,7,5,1,30
1911281043,8,8,7,4,1,28
1911281044,8,9,6,4,9,36
1911281045,3,8,7,9,7,34
1911281046,8,5,7,2,0,22
1911281047,2,6,6,7,9,30
1911281048,0,8,2,5,2,17
1911281049,8,5,2,8,9,32
1911281050,8,0,4,3,0,15
1911281051,8,1,8,6,8,31
1911281052,2,7,3,9,1,22
1911281053,3,7,2,9,9,30
1911281054,6,1,7,8,0,22
1911281055,9,6,5,6,0,26
1911281056,3,1,5,7,6,22
1911281057,3,2,1,7,6,19
1911281058,0,7,8,6,9,30
1911281059,8,7,5,6,2,28
1911281060,9,3,5,5,9,31
1911281061,7,4,4,0,4,19
1911281062,4,9,5,0,7,25
1911281063,5,2,0,9,0,16
1911281064,7,5,8,4,1,25
1911281065,4,4,9,7,1,25
1911281066,2,5,4,3,2,16
1911281067,4,6,3,6,8,27
1911281068,5,5,6,3,6,25
1911281069,4,1,1,5,1,12
1911281070,4,2,4,0,6,16
1911281071,3,4,3,9,3,22
1911281072,8,3,5,0,6,22
1911281073,9,7,1,8,3,28
1911281074,0,0,7,9,8,24
1911281075,1,2,2,7,8,20
1911281076,2,4,8,8,2,24
1911281077,6,5,6,5,4,26
1911281078,6,3,4,4,2,19
1911281079,3,0,5,1,4,13
1911281080,2,2,9,8,0,21
1911281081,4,7,3,8,3,25
1911281082,6,9,3,5,7,30
1911281083,8,4,1,3,6,22
1911281084,2,4,6,2,8,22
1911281085,7,2,6,7,4,26
1911281086,1,0,4,2,7,14
1911281087,6,6,8,9,8,37
1911281088,1,7,5,9,9,31
1911281089,8,3,4,9,7,31
1911281090,9,9,2,0,3,23
1911281091,5,4,5,4,8,26
1911281092,9,3,0,5,2,19
1911281093,3,3,5,8,2,21
1911281094,8,3,3,6,2,22
1911281095,2,3,5,0,9,19
1911281096,5,9,6,3,0,23
1911281097,6,1,8,4,5,24
1911281098,6,0,2,5,1,14
1911281099,0,6,5,6,4,21
1911281100,1,7,6,5,8,27
1911281101,8,4,0,5,6,23
1911281102,3,8,9,9,6,35
1911281103,8,2,3,9,9,31
1911281104,5,5,1,6,0,17
1911281105,0,4,8,8,1,21
191129001,0,3,5,3,8,19
191129002,0,1,8,0,4,13
191129003,6,9,4,9,7,35
191129004,2,3,3,0,9,17
191129005,7,6,4,5,9,31
191129006,1,1,2,5,5,14
191129007,8,4,0,1,6,19
191129008,1,8,5,8,6,28
191129009,9,2,8,5,5,29
191129010,0,9,6,0,2,17
191129011,8,0,3,4,9,24
191129012,2,7,1,5,9,24
191129013,6,6,3,3,7,25
191129014,5,9,5,1,5,25
191129015,3,4,4,9,8,28
191129016,5,7,8,6,4,30
191129017,0,2,6,8,7,23
191129018,2,5,6,4,0,17
191129019,5,8,0,4,7,24
191129020,2,3,9,5,3,22
191129021,2,0,4,6,6,18
191129022,7,0,2,0,5,14
191129023,4,8,3,2,3,20
191129024,1,0,9,0,1,11
191129025,7,5,5,7,5,29
191129026,0,8,3,4,0,15
191129027,1,5,7,9,7,29
191129028,7,1,0,6,6,20
191129029,2,2,2,6,1,13
191129030,5,8,9,5,0,27
191129031,9,9,1,7,1,27
191129032,9,9,9,8,0,35
191129033,7,3,3,7,9,29
191129034,5,5,2,9,7,28
191129035,0,9,9,5,8,31
191129036,2,7,3,4,0,16
191129037,4,8,3,6,4,25
191129038,3,8,7,9,3,30
191129039,7,9,9,6,4,35
191129040,2,9,8,5,5,29
191129041,7,8,1,6,4,26
191129042,6,6,7,2,3,24
191129043,3,8,0,9,6,26
191129044,8,3,3,6,4,24
191129045,2,7,3,6,4,22
191129046,4,1,5,9,8,27
191129047,1,0,7,9,4,21
191129048,6,6,0,5,1,18
191129049,5,9,7,1,8,30
191129050,5,1,7,0,6,19
191129051,8,1,0,1,4,14
191129052,7,8,3,1,0,19
191129053,6,6,2,5,5,24
191129054,8,5,7,0,8,28
191129055,5,3,4,3,0,15
191129056,9,9,6,9,2,35
191129057,6,0,5,2,4,17
191129058,1,5,9,4,7,26
191129059,5,6,2,4,4,21
191129060,1,6,2,0,7,16
191129061,2,5,0,5,1,13
191129062,7,8,5,9,4,33
191129063,2,2,5,8,8,25
191129064,5,1,9,0,3,18
191129065,0,7,6,0,4,17
191129066,1,0,5,7,0,13
191129067,1,3,2,9,8,23
191129068,3,0,1,1,5,10
191129069,4,1,6,0,8,19
191129070,3,0,8,7,4,22
191129071,0,6,1,1,7,15
191129072,0,5,7,3,5,20
191129073,8,4,2,1,1,16
191129074,4,9,2,2,5,22
191129075,3,5,8,8,3,27
191129076,7,6,9,7,6,35
191129077,4,4,9,6,2,25
191129078,3,6,5,4,0,18
191129079,3,8,6,6,1,24
191129080,1,2,5,5,5,18
191129081,8,6,4,3,7,28
191129082,6,0,6,7,2,21
191129083,2,1,0,2,5,10
191129084,3,4,8,5,4,24
191129085,4,8,7,4,2,25
191129086,4,7,4,8,1,24
191129087,7,3,5,2,1,18
191129088,3,2,7,0,2,14
191129089,6,5,6,1,2,20
191129090,3,3,7,8,2,23
191129091,0,2,0,4,5,11
191129092,8,0,5,7,7,27
191129093,2,7,5,9,0,23
191129094,6,6,8,6,0,26
191129095,9,5,0,7,1,22
191129096,4,2,1,5,0,12
191129097,9,5,5,2,3,24
191129098,4,1,7,1,5,18
191129099,6,4,9,6,3,28
191129100,3,5,3,3,6,20
191129101,6,4,7,8,7,32
191129102,6,9,0,0,2,17
191129103,6,8,6,1,4,25
191129104,8,1,3,4,6,22
191129105,5,6,3,7,8,29
191129106,6,4,2,4,1,17
191129107,3,9,6,3,4,25
191129108,6,8,1,7,0,22
191129109,8,7,9,1,1,26
191129110,3,4,8,8,4,27
191129111,7,0,5,7,3,22
191129112,5,0,4,8,2,19
191129113,3,8,4,6,0,21
191129114,2,0,8,2,1,13
191129115,3,9,7,6,3,28
191129116,4,3,3,8,4,22
191129117,8,6,5,0,5,24
191129118,5,6,6,0,8,25
191129119,4,5,8,0,9,26
191129120,8,3,9,9,9,38
191129121,7,1,3,2,7,20
191129122,0,8,5,2,2,17
191129123,3,4,6,0,5,18
191129124,4,1,8,9,4,26
191129125,1,2,0,7,8,18
191129126,3,6,9,5,5,28
191129127,4,4,2,7,4,21
191129128,2,4,8,6,3,23
191129129,5,8,4,3,7,27
191129130,5,1,3,1,8,18
191129131,6,7,9,3,4,29
191129132,0,2,6,1,3,12
191129133,8,8,5,2,4,27
191129134,0,1,3,8,1,13
191129135,1,1,6,2,3,13
191129136,9,1,9,8,8,35
191129137,5,7,3,8,0,23
191129138,8,1,1,2,6,18
191129139,4,1,4,7,6,22
191129140,1,4,0,7,9,21
191129141,6,5,5,6,3,25
191129142,6,9,3,6,6,30
191129143,6,0,2,9,1,18
191129144,5,8,1,2,5,21
191129145,1,6,5,2,2,16
191129146,5,6,0,6,1,18
191129147,2,6,6,3,1,18
191129148,4,0,4,2,5,15
191129149,0,5,4,4,1,14
191129150,3,9,0,4,6,22
191129151,0,5,4,3,0,12
191129152,4,1,1,1,8,15
191129153,7,2,5,8,8,30
191129154,2,6,6,9,0,23
191129155,8,7,8,3,4,30
191129156,9,9,3,9,3,33
191129157,2,0,3,3,3,11
191129158,4,2,6,9,6,27
191129159,4,2,3,0,5,14
191129160,8,6,5,8,2,29
191129161,5,2,6,1,6,20
191129162,6,9,1,6,6,28
191129163,2,8,4,3,9,26
191129164,8,1,5,0,4,18
191129165,7,6,7,1,5,26
191129166,0,2,4,3,2,11
191129167,2,3,8,0,5,18
191129168,3,5,1,7,1,17
191129169,6,3,9,5,6,29
191129170,5,1,4,0,4,14
191129171,4,9,4,2,6,25
191129172,6,5,1,9,6,27
191129173,9,2,5,6,2,24
191129174,7,9,6,4,3,29
191129175,2,3,6,2,9,22
191129176,5,6,8,4,2,25
191129177,7,4,8,0,6,25
191129178,2,8,9,0,0,19
191129179,1,3,4,6,6,20
191129180,1,0,9,1,0,11
191129181,6,1,8,6,8,29
191129182,8,1,2,8,8,27
191129183,2,5,6,5,2,20
191129184,5,3,8,2,1,19
191129185,3,2,5,3,5,18
191129186,7,8,3,4,1,23
191129187,9,7,1,7,2,26
191129188,6,6,8,8,3,31
191129189,2,0,1,9,4,16
191129190,6,4,8,6,6,30
191129191,1,2,2,1,1,7
191129192,9,5,6,5,5,30
191129193,9,1,4,6,9,29
191129194,2,6,2,2,8,20
191129195,1,6,0,3,3,13
191129196,4,6,1,9,1,21
191129197,8,9,5,5,1,28
191129198,8,8,8,2,2,28
191129199,0,8,2,5,8,23
191129200,0,3,3,0,3,9
191129201,5,3,3,8,4,23
191129202,2,3,8,8,5,26
191129203,7,8,6,7,9,37
191129204,7,6,0,3,1,17
191129205,6,1,9,3,4,23
191129206,5,2,9,8,8,32
191129207,1,6,1,9,8,25
191129208,7,6,1,5,6,25
191129209,8,6,7,2,2,25
191129210,0,1,6,6,1,14
191129211,4,5,2,8,7,26
191129212,6,0,8,8,2,24
191129213,2,7,2,6,5,22
191129214,7,6,4,2,7,26
191129215,7,3,9,2,4,25
191129216,6,4,9,9,2,30
191129217,5,9,8,5,2,29
191129218,9,0,8,4,7,28
191129219,5,1,0,3,9,18
191129220,7,9,6,2,5,29
191129221,3,7,8,0,1,19
191129222,5,0,8,2,9,24
191129223,0,7,8,0,3,18
191129224,7,8,9,1,3,28
191129225,6,6,7,4,1,24
191129226,8,3,2,2,9,24
191129227,3,4,9,4,2,22
191129228,9,1,8,2,8,28
191129229,1,2,7,4,0,14
191129230,3,5,2,8,8,26
191129231,2,6,6,2,4,20
191129232,9,9,8,4,8,38
191129233,8,2,5,3,9,27
191129234,8,4,9,6,2,29
191129235,2,4,5,7,5,23
191129236,4,5,8,9,8,34
191129237,8,5,9,5,1,28
191129238,5,3,7,8,8,31
191129239,0,3,1,4,0,8
191129240,4,6,4,7,6,27
191129241,0,2,1,8,2,13
191129242,5,4,5,8,3,25
191129243,3,0,9,1,5,18
191129244,4,1,1,8,9,23
191129245,2,5,9,5,1,22
191129246,8,2,6,0,7,23
191129247,2,1,3,8,3,17
191129248,2,2,1,2,2,9
191129249,6,3,2,5,5,21
191129250,0,2,9,6,0,17
191129251,5,1,5,1,1,13
191129252,0,8,8,2,2,20
191129253,4,3,1,2,8,18
191129254,9,8,3,6,2,28
191129255,5,0,6,7,8,26
191129256,8,6,1,0,9,24
191129257,9,0,0,6,1,16
191129258,3,3,9,7,7,29
191129259,1,3,3,1,6,14
191129260,5,9,9,1,9,33
191129261,6,4,5,7,9,31
191129262,8,7,4,0,8,27
191129263,2,3,5,1,4,15
191129264,5,9,2,1,0,17
191129265,9,7,1,2,6,25
191129266,0,8,7,7,3,25
191129267,8,7,6,6,6,33
191129268,2,0,0,6,4,12
191129269,3,0,3,6,6,18
191129270,7,5,7,7,2,28
191129271,8,1,3,1,0,13
191129272,7,7,6,8,3,31
191129273,1,8,5,5,1,20
191129274,1,4,4,3,6,18
191129275,3,2,1,1,0,7
191129276,2,4,7,2,0,15
191129277,7,1,9,7,2,26
191129278,7,0,7,9,5,28
191129279,4,8,8,2,7,29
191129280,3,2,7,4,4,20
191129281,1,6,7,8,1,23
191129282,5,7,9,0,7,28
191129283,2,0,5,5,8,20
191129284,0,4,8,8,2,22
191129285,3,9,5,3,6,26
191129286,7,4,9,8,0,28
191129287,3,9,8,7,1,28
191129288,2,5,7,2,4,20
191129289,1,7,0,1,3,12
191129290,9,9,7,8,3,36
191129291,3,1,5,2,9,20
191129292,9,6,4,5,9,33
191129293,2,1,0,9,9,21
191129294,7,7,4,9,0,27
191129295,1,4,4,4,9,22
191129296,9,7,2,1,9,28
191129297,7,1,8,6,4,26
191129298,8,3,3,9,5,28
191129299,9,7,3,2,1,22
191129300,4,1,1,1,2,9
191129301,9,4,3,1,9,26
191129302,7,9,9,7,8,40
191129303,9,3,8,7,6,33
191129304,9,8,0,9,4,30
191129305,1,9,2,2,2,16
191129306,1,3,5,5,5,19
191129307,4,5,1,5,8,23
191129308,4,0,6,6,9,25
191129309,6,7,4,3,2,22
191129310,6,8,2,7,7,30
191129311,0,2,6,4,4,16
191129312,6,5,6,5,1,23
191129313,9,7,9,7,8,40
191129314,4,1,6,3,1,15
191129315,5,5,2,7,6,25
191129316,1,4,5,5,4,19
191129317,3,5,3,8,7,26
191129318,4,7,3,0,0,14
191129319,9,5,2,1,0,17
191129320,6,8,6,7,8,35
191129321,2,7,0,0,7,16
191129322,7,8,4,6,6,31
191129323,7,6,4,6,4,27
191129324,7,8,2,8,8,33
191129325,8,3,6,3,6,26
191129326,2,4,1,3,8,18
191129327,4,8,6,1,3,22
191129328,5,6,2,7,3,23
191129329,0,8,0,9,2,19
191129330,0,1,1,9,1,12
191129331,4,4,1,0,6,15
191129332,5,6,8,9,5,33
191129333,5,8,6,7,9,35
191129334,1,2,9,6,8,26
191129335,7,1,5,4,5,22
191129336,9,6,4,4,4,27
191129337,9,1,3,8,1,22
191129338,0,1,5,3,0,9
191129339,1,7,1,3,9,21
191129340,7,4,6,9,7,33
191129341,9,6,2,4,0,21
191129342,2,1,7,6,0,16
191129343,1,8,8,1,5,23
191129344,8,7,3,9,6,33
191129345,2,0,6,3,5,16
191129346,3,5,5,3,7,23
191129347,1,2,2,7,6,18
191129348,1,0,5,4,1,11
191129349,8,1,9,3,7,28
191129350,5,1,6,1,8,21
191129351,7,0,4,8,7,26
191129352,5,4,7,6,0,22
191129353,9,9,1,6,1,26
191129354,6,4,4,6,4,24
191129355,7,6,9,4,9,35
191129356,7,4,7,8,0,26
191129357,6,6,4,4,3,23
191129358,8,5,2,6,6,27
191129359,9,8,0,1,0,18
191129360,9,6,3,1,9,28
191129361,8,4,1,6,0,19
191129362,1,8,3,4,9,25
191129363,0,1,7,6,4,18
191129364,5,2,0,4,0,11
191129365,6,2,8,3,8,27
191129366,6,5,4,1,5,21
191129367,6,1,5,2,2,16
191129368,0,5,7,6,7,25
191129369,0,7,9,4,5,25
191129370,5,7,9,8,7,36
191129371,8,0,0,9,7,24
191129372,0,4,2,3,3,12
191129373,8,1,0,7,9,25
191129374,0,2,3,6,9,20
191129375,3,9,2,0,2,16
191129376,5,9,0,2,8,24
191129377,7,9,5,7,8,36
191129378,6,8,5,6,7,32
191129379,1,6,5,2,7,21
191129380,9,3,8,2,3,25
191129381,1,0,9,0,5,15
191129382,1,8,2,4,4,19
191129383,5,7,4,8,6,30
191129384,7,2,3,5,8,25
191129385,8,0,3,9,0,20
191129386,6,9,8,7,1,31
191129387,5,0,6,4,0,15
191129388,2,7,3,1,5,18
191129389,7,3,6,9,3,28
191129390,1,4,0,5,7,17
191129391,7,5,8,6,6,32
191129392,2,6,3,9,8,28
191129393,6,6,1,2,3,18
191129394,6,4,6,7,6,29
191129395,9,4,9,1,5,28
191129396,4,5,6,1,6,22
191129397,8,5,8,9,6,36
191129398,8,1,9,6,7,31
191129399,3,4,0,1,4,12
191129400,5,1,7,9,6,28
191129401,3,0,2,9,8,22
191129402,6,1,1,7,4,19
191129403,1,6,8,6,9,30
191129404,0,4,9,3,8,24
191129405,7,4,1,0,1,13
191129406,4,8,8,7,2,29
191129407,6,4,8,0,0,18
191129408,2,1,4,0,7,14
191129409,0,4,8,4,3,19
191129410,7,2,0,2,9,20
191129411,9,9,9,9,9,45
191129412,6,6,7,6,3,28
191129413,9,7,1,6,5,28
191129414,9,2,8,4,9,32
191129415,4,8,2,9,5,28
191129416,6,8,9,7,8,38
191129417,4,4,0,8,3,19
191129418,9,0,4,2,4,19
191129419,4,1,2,9,1,17
191129420,5,8,2,6,7,28
191129421,8,3,1,0,3,15
191129422,2,6,4,6,9,27
191129423,2,7,5,3,1,18
191129424,3,2,2,9,0,16
191129425,7,4,6,3,5,25
191129426,7,5,5,1,8,26
191129427,0,8,3,2,6,19
191129428,3,4,5,5,0,17
191129429,6,1,9,6,6,28
191129430,9,1,7,2,1,20
191129431,7,1,2,8,6,24
191129432,1,7,5,7,4,24
191129433,3,0,2,1,6,12
191129434,5,9,5,5,8,32
191129435,8,2,3,1,7,21
191129436,3,1,9,3,2,18
191129437,1,8,3,1,2,15
191129438,6,2,2,5,3,18
191129439,3,4,6,2,6,21
191129440,2,6,2,6,5,21
191129441,0,2,2,7,2,13
191129442,3,9,6,9,4,31
191129443,4,9,1,1,5,20
191129444,1,2,1,6,1,11
191129445,8,8,2,6,2,26
191129446,2,9,7,6,3,27
191129447,9,4,3,9,2,27
191129448,3,2,4,8,3,20
191129449,2,0,2,0,1,5
191129450,3,6,0,2,1,12
191129451,8,5,7,5,8,33
191129452,3,0,9,1,6,19
191129453,5,6,3,4,6,24
191129454,2,5,5,7,3,22
191129455,5,9,0,8,4,26
191129456,6,5,8,3,3,25
191129457,5,8,9,8,8,38
191129458,2,7,7,5,0,21
191129459,8,4,0,7,0,19
191129460,1,0,7,3,5,16
191129461,3,4,1,8,4,20
191129462,7,5,4,1,4,21
191129463,4,7,5,5,6,27
191129464,9,0,6,7,4,26
191129465,7,3,5,0,1,16
191129466,9,7,9,3,5,33
191129467,2,7,2,2,7,20
191129468,5,2,2,6,8,23
191129469,1,3,0,5,7,16
191129470,4,8,2,2,9,25
191129471,7,0,6,0,1,14
191129472,7,9,8,0,8,32
191129473,7,8,6,5,9,35
191129474,8,8,4,6,4,30
191129475,8,5,9,0,1,23
191129476,4,0,7,8,6,25
191129477,5,1,6,1,7,20
191129478,8,1,1,0,4,14
191129479,8,1,0,3,3,15
191129480,2,8,4,6,1,21
191129481,9,4,0,5,8,26
191129482,2,7,0,8,0,17
191129483,0,3,7,2,8,20
191129484,8,0,0,5,5,18
191129485,0,5,8,4,4,21
191129486,3,3,6,5,1,18
191129487,0,5,3,6,9,23
191129488,4,2,3,6,6,21
191129489,1,8,5,5,4,23
191129490,3,3,7,1,2,16
191129491,6,1,6,0,7,20
191129492,8,8,8,1,4,29
191129493,1,7,5,2,3,18
191129494,8,0,6,5,3,22
191129495,8,0,4,1,3,16
191129496,7,7,9,7,6,36
191129497,8,9,7,6,3,33
191129498,4,8,6,6,3,27
191129499,7,9,6,7,5,34
191129500,3,9,7,5,9,33
191129501,9,4,3,9,5,30
191129502,2,6,4,2,3,17
191129503,5,9,9,4,4,31
191129504,3,1,8,6,2,20
191129505,6,5,1,2,3,17
191129506,1,5,8,9,8,31
191129507,8,3,9,1,3,24
191129508,7,3,1,4,5,20
191129509,3,7,0,2,3,15
191129510,6,9,3,8,3,29
191129511,0,8,7,1,4,20
191129512,7,3,9,8,6,33
191129513,4,2,3,3,7,19
191129514,2,2,8,1,7,20
191129515,8,9,2,5,8,32
191129516,7,8,5,0,8,28
191129517,5,4,9,9,9,36
191129518,5,8,4,1,9,27
191129519,5,8,1,9,7,30
191129520,4,4,1,3,3,15
191129521,7,5,5,0,2,19
191129522,5,0,3,5,4,17
191129523,6,8,1,4,9,28
191129524,8,4,0,2,0,14
191129525,0,0,5,3,4,12
191129526,8,2,1,4,9,24
191129527,2,8,9,5,9,33
191129528,5,8,0,9,9,31
191129529,1,2,6,9,5,23
191129530,2,6,4,7,1,20
191129531,6,9,2,9,8,34
191129532,7,6,2,6,1,22
191129533,1,3,8,7,6,25
191129534,2,5,0,4,4,15
191129535,0,2,6,3,4,15
191129536,7,4,0,2,6,19
191129537,3,9,4,9,8,33
191129538,2,6,2,9,6,25
191129539,5,9,2,3,4,23
191129540,2,8,1,1,9,21
191129541,1,2,4,7,3,17
191129542,2,6,6,1,1,16
191129543,4,3,1,7,6,21
191129544,0,0,9,2,7,18
191129545,3,2,5,8,9,27
191129546,2,3,4,8,6,23
191129547,9,0,3,7,1,20
191129548,9,2,0,4,7,22
191129549,1,2,6,9,2,20
191129550,0,7,1,0,9,17
191129551,5,7,9,0,3,24
191129552,3,6,3,4,9,25
191129553,5,0,0,7,2,14
191129554,7,1,6,4,3,21
191129555,4,9,7,6,0,26
191129556,1,5,4,6,6,22
191129557,7,8,9,9,7,40
191129558,9,8,5,9,5,36
191129559,1,3,2,5,1,12
191129560,7,4,0,6,2,19
191129561,9,7,6,8,6,36
191129562,2,0,8,0,6,16
191129563,8,7,9,9,3,36
191129564,3,6,8,9,0,26
191129565,8,0,1,3,7,19
191129566,8,9,0,5,5,27
191129567,0,1,2,6,3,12
191129568,4,4,4,7,6,25
191129569,4,2,8,9,8,31
191129570,8,5,7,2,9,31
191129571,7,9,7,4,9,36
191129572,7,4,8,1,8,28
191129573,5,1,2,8,7,23
191129574,4,7,8,1,5,25
191129575,5,2,0,2,7,16
191129576,8,6,7,8,0,29
191129577,1,6,1,5,8,21
191129578,4,0,0,1,4,9
191129579,9,1,1,3,0,14
191129580,2,7,7,1,9,26
191129581,1,9,0,3,7,20
191129582,0,7,6,3,0,16
191129583,5,3,5,7,5,25
191129584,4,0,9,1,1,15
191129585,5,9,0,5,8,27
191129586,2,7,5,3,3,20
191129587,7,9,6,5,9,36
191129588,1,7,9,4,1,22
191129589,7,2,2,2,3,16
191129590,1,2,5,1,9,18
191129591,9,0,2,8,0,19
191129592,2,6,5,2,2,17
191129593,6,1,3,6,2,18
191129594,6,3,2,9,6,26
191129595,4,1,6,2,6,19
191129596,4,5,9,5,1,24
191129597,5,7,1,1,5,19
191129598,8,5,4,4,5,26
191129599,7,5,3,4,3,22
191129600,5,6,9,2,7,29
191129601,3,8,7,1,9,28
191129602,8,2,3,4,6,23
191129603,0,0,6,9,4,19
191129604,3,9,5,3,4,24
191129605,6,4,2,3,9,24
191129606,7,5,0,1,6,19
191129607,2,0,3,0,4,9
191129608,8,3,9,2,7,29
191129609,6,4,9,6,2,27
191129610,4,0,0,4,2,10
191129611,2,5,6,4,5,22
191129612,2,0,7,4,1,14
191129613,9,8,6,1,3,27
191129614,1,2,5,2,1,11
191129615,8,5,5,5,9,32
191129616,0,7,0,9,9,25
191129617,5,4,7,0,2,18
191129618,9,5,1,1,2,18
191129619,3,3,3,8,1,18
191129620,4,2,6,3,5,20
191129621,9,8,5,8,2,32
191129622,6,0,9,1,5,21
191129623,9,1,3,5,9,27
191129624,9,1,2,8,6,26
191129625,9,8,6,3,6,32
191129626,0,6,1,5,4,16
191129627,2,0,5,4,7,18
191129628,6,2,3,2,0,13
191129629,8,1,2,5,9,25
191129630,2,5,9,4,1,21
191129631,6,7,3,7,4,27
191129632,3,3,8,8,0,22
191129633,8,7,6,5,2,28
191129634,2,9,6,9,1,27
191129635,9,8,7,0,6,30
191129636,6,6,8,7,4,31
191129637,7,8,5,4,1,25
191129638,4,2,2,7,4,19
191129639,4,7,1,3,1,16
191129640,4,5,4,5,2,20
191129641,9,2,0,5,9,25
191129642,0,3,5,6,3,17
191129643,3,9,8,8,5,33
191129644,7,3,7,2,5,24
191129645,4,2,9,8,6,29
191129646,0,4,2,9,2,17
191129647,9,8,1,0,8,26
191129648,0,1,0,3,2,6
191129649,7,5,2,8,2,24
191129650,1,9,8,7,4,29
191129651,9,0,0,9,6,24
191129652,2,9,0,4,9,24
191129653,3,1,9,7,1,21
191129654,4,6,7,0,1,18
191129655,2,7,6,8,9,32
191129656,7,0,2,6,1,16
191129657,7,2,4,0,8,21
191129658,3,1,7,1,9,21
191129659,2,3,3,4,9,21
191129660,8,3,7,5,7,30
191129661,5,5,1,5,5,21
191129662,3,1,3,3,7,17
191129663,6,3,2,2,0,13
191129664,7,1,9,1,0,18
191129665,9,1,1,2,1,14
191129666,2,4,2,5,3,16
191129667,3,0,2,1,0,6
191129668,1,9,2,5,8,25
191129669,4,4,0,4,9,21
191129670,3,1,4,4,4,16
191129671,8,8,4,8,9,37
191129672,2,5,0,2,5,14
191129673,3,9,1,1,7,21
191129674,3,5,3,1,9,21
191129675,4,1,1,9,5,20
191129676,3,6,7,1,5,22
191129677,3,9,5,5,5,27
191129678,3,0,4,8,7,22
191129679,5,7,1,6,6,25
191129680,8,6,9,6,9,38
191129681,9,5,2,0,5,21
191129682,1,5,2,3,2,13
191129683,5,5,0,4,0,14
191129684,8,3,6,5,2,24
191129685,3,4,6,1,4,18
191129686,6,3,2,3,9,23
191129687,1,6,9,8,4,28
191129688,4,4,0,4,6,18
191129689,2,1,2,9,9,23
191129690,5,6,2,5,2,20
191129691,9,2,5,5,9,30
191129692,5,1,5,5,1,17
191129693,9,0,9,1,7,26
191129694,3,2,0,7,6,18
191129695,4,4,6,3,9,26
191129696,6,6,4,5,2,23
191129697,8,2,4,8,5,27
191129698,3,6,5,4,2,20
191129699,6,5,3,5,5,24
191129700,2,8,3,4,9,26
191129701,5,6,2,8,3,24
191129702,3,8,3,7,0,21
191129703,6,4,8,8,2,28
191129704,1,1,6,3,2,13
191129705,0,7,3,5,7,22
191129706,7,2,5,1,6,21
191129707,2,5,6,6,2,21
191129708,4,2,8,4,9,27
191129709,4,2,7,6,4,23
191129710,5,6,4,8,1,24
191129711,8,4,8,5,1,26
191129712,2,3,9,5,0,19
191129713,1,7,8,5,7,28
191129714,5,5,2,5,2,19
191129715,3,1,8,1,4,17
191129716,7,2,4,3,5,21
191129717,3,5,9,4,3,24
191129718,6,3,0,0,6,15
191129719,3,5,7,2,8,25
191129720,8,1,5,9,4,27
191129721,6,4,3,3,1,17
191129722,7,7,1,9,1,25
191129723,6,1,0,0,9,16
191129724,7,0,6,3,6,22
191129725,5,1,5,6,8,25
191129726,9,0,8,6,1,24
191129727,8,3,0,1,3,15
191129728,4,8,6,9,0,27
191129729,8,5,6,5,8,32
191129730,2,4,5,3,7,21
191129731,6,3,4,7,3,23
191129732,4,1,9,1,3,18
191129733,6,9,3,6,2,26
191129734,7,4,6,0,9,26
191129735,4,5,4,0,2,15
191129736,2,8,0,9,9,28
191129737,7,7,6,2,7,29
191129738,7,7,3,4,1,22
191129739,4,4,5,8,5,26
191129740,8,7,4,7,7,33
191129741,3,6,4,9,8,30
191129742,6,2,2,5,1,16
191129743,1,2,1,5,0,9
191129744,7,0,7,6,9,29
191129745,2,8,6,4,4,24
191129746,0,9,6,6,8,29
191129747,1,0,3,9,3,16
191129748,6,9,9,7,0,31
191129749,1,3,3,9,6,22
191129750,5,1,1,6,6,19
191129751,9,0,5,6,8,28
191129752,0,4,7,6,0,17
191129753,5,5,0,6,8,24
191129754,1,3,0,7,8,19
191129755,1,1,0,8,8,18
191129756,2,8,9,2,7,28
191129757,8,8,8,7,0,31
191129758,7,9,2,8,9,35
191129759,6,5,0,1,7,19
191129760,7,6,1,7,3,24
191129761,3,0,6,0,9,18
191129762,9,4,8,4,0,25
191129763,8,8,9,0,9,34
191129764,2,2,4,2,1,11
191129765,7,6,2,1,9,25
191129766,7,5,2,7,3,24
191129767,6,2,5,3,5,21
191129768,5,0,8,9,6,28
191129769,2,3,4,7,3,19
191129770,2,9,9,2,1,23
191129771,5,4,3,9,9,30
191129772,5,4,1,8,1,19
191129773,2,5,3,3,3,16
191129774,3,8,2,3,1,17
191129775,3,2,6,5,0,16
191129776,3,5,1,9,6,24
191129777,2,1,9,0,9,21
191129778,6,7,8,1,4,26
191129779,6,3,1,8,2,20
191129780,0,6,8,3,4,21
191129781,2,1,4,4,0,11
191129782,9,4,7,6,3,29
191129783,1,8,9,9,3,30
191129784,7,9,7,0,8,31
191129785,9,6,5,1,1,22
191129786,6,8,7,4,2,27
191129787,5,4,0,6,0,15
191129788,5,6,7,7,6,31
191129789,6,1,2,4,1,14
191129790,3,7,8,6,1,25
191129791,1,8,0,0,9,18
191129792,4,0,1,8,1,14
191129793,9,0,3,4,4,20
191129794,0,5,2,3,3,13
191129795,7,0,9,1,2,19
191129796,8,2,0,4,5,19
191129797,1,9,2,9,1,22
191129798,8,1,5,9,2,25
191129799,4,3,0,8,1,16
191129800,7,9,8,5,8,37
191129801,1,7,2,0,2,12
191129802,8,7,8,9,4,36
191129803,2,5,0,6,4,17
191129804,0,2,8,4,5,19
191129805,7,3,0,4,6,20
191129806,8,5,0,0,4,17
191129807,5,3,5,9,2,24
191129808,2,3,7,2,6,20
191129809,3,0,0,5,3,11
191129810,6,3,9,3,2,23
191129811,8,7,5,7,5,32
191129812,4,6,2,4,3,19
191129813,6,3,1,8,7,25
191129814,8,7,0,5,9,29
191129815,5,8,0,2,4,19
191129816,2,4,5,5,6,22
191129817,4,1,9,1,2,17
191129818,9,3,7,5,1,25
191129819,1,1,0,6,7,15
191129820,8,4,1,7,4,24
191129821,3,1,1,8,3,16
191129822,7,7,7,2,5,28
191129823,2,5,0,9,8,24
191129824,0,7,1,5,6,19
191129825,5,8,9,8,1,31
191129826,0,8,2,7,7,24
191129827,5,3,8,1,3,20
191129828,1,8,3,1,0,13
191129829,7,0,7,1,3,18
191129830,7,5,5,5,5,27
191129831,1,7,6,9,8,31
191129832,8,6,6,5,8,33
191129833,9,4,6,4,1,24
191129834,1,3,7,0,7,18
191129835,1,6,4,5,3,19
191129836,7,2,3,9,3,24
191129837,4,5,3,6,9,27
191129838,0,1,9,5,7,22
191129839,8,5,0,8,2,23
191129840,1,7,5,4,0,17
191129841,5,9,4,3,5,26
191129842,7,7,0,1,3,18
191129843,0,5,2,1,7,15
191129844,8,5,6,7,0,26
191129845,5,7,5,5,9,31
191129846,2,3,7,3,0,15
191129847,0,0,3,7,7,17
191129848,1,7,4,1,3,16
191129849,3,9,2,2,6,22
191129850,7,1,8,5,3,24
191129851,0,0,5,6,8,19
191129852,5,0,7,6,9,27
191129853,8,5,5,5,8,31
191129854,4,7,7,6,8,32
191129855,8,9,4,5,6,32
191129856,5,7,4,0,8,24
191129857,1,3,8,0,2,14
191129858,7,1,9,8,4,29
191129859,4,3,5,5,2,19
191129860,2,4,9,8,8,31
191129861,6,5,5,1,4,21
191129862,8,2,1,6,7,24
191129863,0,7,0,3,5,15
191129864,3,6,8,1,5,23
191129865,6,0,7,0,8,21
191129866,0,1,6,2,2,11
191129867,8,4,7,0,3,22
191129868,4,0,6,0,2,12
191129869,9,4,0,9,5,27
191129870,6,5,4,7,0,22
191129871,4,6,4,9,2,25
191129872,9,5,4,5,2,25
191129873,1,0,8,1,2,12
191129874,3,9,4,4,4,24
191129875,3,2,5,3,1,14
191129876,0,4,2,5,0,11
191129877,5,2,8,5,2,22
191129878,2,7,2,5,5,21
191129879,8,0,0,1,2,11
191129880,5,9,0,3,8,25
191129881,5,1,4,5,5,20
191129882,5,6,3,2,3,19
191129883,1,2,8,2,2,15
191129884,5,9,7,3,1,25
191129885,8,9,4,5,4,30
191129886,1,5,2,7,0,15
191129887,0,6,7,3,3,19
191129888,5,2,8,1,7,23
191129889,9,4,5,2,5,25
191129890,6,1,9,1,4,21
191129891,3,1,7,1,5,17
191129892,0,1,3,0,4,8
191129893,4,4,7,8,3,26
191129894,6,2,0,0,1,9
191129895,9,0,8,6,5,28
191129896,5,1,1,7,7,21
191129897,0,6,4,2,3,15
191129898,0,3,4,8,5,20
191129899,1,4,0,5,3,13
191129900,4,9,3,1,5,22
191129901,6,9,0,3,8,26
191129902,8,2,4,6,5,25
191129903,4,1,9,2,7,23
191129904,2,9,2,5,7,25
191129905,2,4,6,1,7,20
191129906,2,4,3,0,9,18
191129907,8,0,3,8,1,20
191129908,3,4,0,1,1,9
191129909,4,9,2,0,5,20
191129910,6,2,0,5,8,21
191129911,7,6,6,1,9,29
191129912,0,1,0,3,7,11
191129913,0,5,3,5,1,14
191129914,4,1,4,8,8,25
191129915,9,7,2,9,3,30
191129916,8,9,9,9,2,37
191129917,6,9,6,4,6,31
191129918,5,9,6,3,9,32
191129919,2,7,9,8,7,33
191129920,1,6,6,1,7,21
191129921,7,0,7,1,5,20
191129922,6,2,9,5,5,27
191129923,3,2,4,2,3,14
191129924,8,5,8,4,2,27
191129925,4,0,4,7,4,19
191129926,2,4,8,8,8,30
191129927,9,4,3,9,6,31
191129928,7,9,1,2,8,27
191129929,6,4,1,6,3,20
191129930,7,6,9,9,9,40
191129931,2,0,3,8,6,19
191129932,2,7,2,3,8,22
191129933,2,5,5,8,3,23
191129934,0,7,7,4,6,24
191129935,1,4,2,7,2,16
191129936,7,6,3,8,5,29
191129937,9,2,8,5,4,28
191129938,6,7,3,4,6,26
191129939,9,5,7,4,5,30
191129940,5,1,2,0,2,10
191129941,4,0,2,8,1,15
191129942,0,1,5,9,2,17
191129943,2,2,5,6,1,16
191129944,9,3,7,3,8,30
191129945,7,7,3,7,2,26
191129946,7,0,8,7,1,23
191129947,0,8,9,9,1,27
191129948,2,5,1,7,9,24
191129949,9,3,7,6,5,30
191129950,9,6,2,5,1,23
191129951,4,7,4,9,7,31
191129952,4,7,9,8,0,28
191129953,0,1,7,7,2,17
191129954,0,3,5,5,0,13
191129955,9,6,9,8,2,34
191129956,8,8,1,3,1,21
191129957,7,5,8,9,0,29
191129958,2,1,8,9,8,28
191129959,3,2,5,3,7,20
191129960,3,7,8,8,0,26
191129961,1,5,1,7,0,14
191129962,9,2,8,6,1,26
191129963,2,2,7,2,7,20
191129964,5,8,7,6,9,35
191129965,9,0,9,3,5,26
191129966,7,5,7,1,4,24
191129967,6,4,4,5,5,24
191129968,6,8,1,2,1,18
191129969,8,8,2,3,2,23
191129970,1,6,3,4,1,15
191129971,3,0,2,5,8,18
191129972,0,3,4,0,8,15
191129973,4,3,3,2,6,18
191129974,6,0,6,9,1,22
191129975,3,9,8,9,4,33
191129976,1,1,9,4,1,16
191129977,6,6,8,2,6,28
191129978,1,6,3,5,0,15
191129979,4,7,1,4,8,24
191129980,4,5,8,3,5,25
191129981,1,9,1,5,5,21
191129982,5,3,6,9,2,25
191129983,7,6,9,4,8,34
191129984,2,1,8,5,7,23
191129985,6,9,8,0,2,25
191129986,9,6,0,9,8,32
191129987,5,5,9,6,8,33
191129988,4,0,8,5,9,26
191129989,7,1,0,8,0,16
191129990,8,8,3,0,2,21
191129991,5,1,0,6,1,13
191129992,5,7,1,8,6,27
191129993,7,4,8,8,8,35
191129994,7,4,5,1,7,24
191129995,4,2,1,5,8,20
191129996,0,7,0,1,8,16
191129997,2,9,0,8,1,20
191129998,7,8,5,8,4,32
191129999,4,8,3,8,5,28
1911291000,6,9,2,5,3,25
1911291001,6,4,8,9,4,31
1911291002,2,3,4,8,9,26
1911291003,6,0,5,8,3,22
1911291004,1,8,7,4,9,29
1911291005,6,2,8,4,4,24
1911291006,2,7,5,1,4,19
1911291007,3,3,1,0,3,10
1911291008,4,1,7,4,7,23
1911291009,1,8,0,1,7,17
1911291010,5,7,5,8,5,30
1911291011,3,9,4,5,3,24
1911291012,2,4,9,1,8,24
1911291013,5,3,2,3,4,17
1911291014,4,8,0,2,7,21
1911291015,3,3,8,9,2,25
1911291016,4,2,3,7,0,16
1911291017,0,9,6,4,4,23
1911291018,8,5,2,7,9,31
1911291019,5,5,5,1,4,20
1911291020,4,7,6,8,0,25
1911291021,0,5,1,4,1,11
1911291022,3,9,8,7,5,32
1911291023,2,6,9,6,7,30
1911291024,2,5,6,2,6,21
1911291025,0,3,4,2,3,12
1911291026,2,4,9,9,2,26
1911291027,2,7,3,9,7,28
1911291028,4,1,7,2,5,19
1911291029,2,8,3,9,3,25
1911291030,9,9,8,7,2,35
1911291031,6,3,9,1,3,22
1911291032,0,9,5,9,6,29
1911291033,3,4,1,9,6,23
1911291034,9,6,4,2,8,29
1911291035,0,7,3,4,6,20
1911291036,1,0,4,2,4,11
1911291037,7,7,8,7,0,29
1911291038,1,2,4,0,0,7
1911291039,7,4,1,1,2,15
1911291040,4,9,1,4,4,22
1911291041,0,8,2,5,1,16
1911291042,5,8,4,9,9,35
1911291043,2,0,5,0,2,9
1911291044,5,7,5,6,2,25
1911291045,3,6,7,8,3,27
1911291046,9,8,5,4,7,33
1911291047,1,9,9,1,1,21
1911291048,3,5,1,8,5,22
1911291049,3,1,1,8,6,19
1911291050,7,5,1,4,4,21
1911291051,5,7,4,5,6,27
1911291052,0,0,3,1,0,4
1911291053,2,3,9,2,2,18
1911291054,4,5,1,2,0,12
1911291055,0,5,2,0,6,13
1911291056,8,3,1,7,9,28
1911291057,4,2,5,3,5,19
1911291058,8,3,4,7,7,29
1911291059,5,8,8,4,5,30
1911291060,7,1,3,6,7,24
1911291061,1,9,7,1,7,25
1911291062,2,3,2,2,5,14
1911291063,1,5,4,7,1,18
1911291064,4,1,6,2,9,22
1911291065,5,4,2,0,9,20
1911291066,5,0,9,4,5,23
1911291067,0,7,1,5,7,20
1911291068,0,3,8,2,9,22
1911291069,4,8,7,7,7,33
1911291070,9,6,1,8,3,27
1911291071,8,9,2,6,1,26
1911291072,5,9,8,5,3,30
1911291073,7,5,5,8,2,27
1911291074,1,6,9,5,4,25
1911291075,1,2,4,5,4,16
1911291076,3,8,8,3,7,29
1911291077,9,4,0,7,4,24
1911291078,1,2,7,0,3,13
1911291079,1,4,0,1,5,11
1911291080,6,0,5,4,3,18
1911291081,3,5,7,9,4,28
1911291082,5,5,7,2,7,26
1911291083,3,7,6,7,3,26
1911291084,0,7,1,1,7,16
1911291085,0,6,0,9,3,18
1911291086,8,3,1,8,9,29
1911291087,1,2,5,8,2,18
1911291088,5,6,4,6,7,28
1911291089,0,5,3,2,5,15
1911291090,8,2,1,1,0,12
1911291091,0,8,3,8,3,22
1911291092,9,0,8,8,7,32
1911291093,6,4,1,6,7,24
1911291094,9,7,7,1,3,27
1911291095,9,5,8,5,1,28
1911291096,9,3,8,4,9,33
1911291097,7,5,3,4,7,26
1911291098,2,0,2,6,1,11
1911291099,9,2,9,4,4,28
1911291100,3,9,1,7,1,21
1911291101,8,5,5,3,9,30
1911291102,8,7,3,1,3,22
1911291103,1,3,4,5,7,20
1911291104,1,3,1,5,3,13
1911291105,2,0,2,8,0,12
191130001,0,4,5,8,9,26
191130002,0,5,5,4,9,23
191130003,5,7,6,6,8,32
191130004,4,9,1,8,4,26
191130005,8,3,5,0,8,24
191130006,3,8,2,3,3,19
191130007,4,3,8,7,7,29
191130008,8,5,2,3,9,27
191130009,0,5,1,3,5,14
191130010,1,8,5,9,9,32
191130011,3,3,7,8,3,24
191130012,9,2,6,7,7,31
191130013,0,2,9,1,3,15
191130014,0,3,3,4,2,12
191130015,5,7,7,8,2,29
191130016,6,5,0,3,6,20
191130017,4,5,7,8,5,29
191130018,4,6,6,7,0,23
191130019,6,1,3,9,5,24
191130020,4,8,1,6,4,23
191130021,7,8,7,3,0,25
191130022,1,0,1,8,5,15
191130023,6,3,8,4,9,30
191130024,2,2,2,4,6,16
191130025,3,3,8,4,7,25
191130026,6,7,8,9,5,35
191130027,0,2,4,2,9,17
191130028,3,0,8,9,8,28
191130029,8,5,3,7,7,30
191130030,8,4,6,3,2,23
191130031,8,4,0,9,1,22
191130032,6,5,6,8,3,28
191130033,5,4,4,1,4,18
191130034,6,2,9,7,8,32
191130035,6,1,6,2,3,18
191130036,7,9,9,7,0,32
191130037,9,5,3,5,5,27
191130038,6,2,9,6,7,30
191130039,8,2,4,7,8,29
191130040,8,9,4,6,6,33
191130041,9,4,5,8,5,31
191130042,6,4,4,8,2,24
191130043,8,9,8,2,1,28
191130044,5,4,6,6,9,30
191130045,5,4,2,8,5,24
191130046,7,7,9,8,8,39
191130047,0,4,6,9,4,23
191130048,9,8,8,7,3,35
191130049,3,2,2,2,6,15
191130050,2,3,3,2,4,14
191130051,9,5,3,8,4,29
191130052,9,1,4,8,9,31
191130053,8,9,0,9,4,30
191130054,2,0,9,1,8,20
191130055,8,6,1,1,1,17
191130056,6,7,6,7,2,28
191130057,0,7,3,3,2,15
191130058,6,4,6,7,4,27
191130059,8,2,1,5,1,17
191130060,4,7,7,9,6,33
191130061,0,8,8,0,9,25
191130062,6,9,2,5,4,26
191130063,0,5,9,9,5,28
191130064,2,7,5,0,5,19
191130065,0,9,4,0,4,17
191130066,0,7,7,9,8,31
191130067,6,5,0,7,8,26
191130068,0,7,1,3,1,12
191130069,5,5,4,8,0,22
191130070,4,1,9,3,5,22
191130071,5,8,7,0,9,29
191130072,5,9,6,2,2,24
191130073,5,7,7,4,1,24
191130074,6,6,2,1,2,17
191130075,0,1,7,0,8,16
191130076,5,4,8,8,4,29
191130077,6,3,6,8,2,25
191130078,6,1,5,1,9,22
191130079,5,9,9,6,3,32
191130080,8,6,4,1,4,23
191130081,0,0,1,2,2,5
191130082,9,7,5,9,5,35
191130083,1,3,5,3,2,14
191130084,9,6,7,1,7,30
191130085,9,0,3,4,8,24
191130086,6,2,2,4,6,20
191130087,6,1,1,6,0,14
191130088,0,8,5,4,8,25
191130089,1,3,7,6,8,25
191130090,3,1,8,9,7,28
191130091,7,4,1,1,3,16
191130092,8,4,7,1,2,22
191130093,1,8,5,2,1,17
191130094,5,3,2,4,2,16
191130095,1,6,2,7,7,23
191130096,5,3,0,3,6,17
191130097,4,3,2,4,6,19
191130098,1,4,2,6,2,15
191130099,4,9,7,7,9,36
191130100,9,0,6,1,1,17
191130101,2,2,1,5,0,10
191130102,7,7,4,7,2,27
191130103,8,0,6,7,1,22
191130104,2,3,2,6,1,14
191130105,1,7,0,3,6,17
191130106,9,4,0,9,1,23
191130107,2,8,2,0,7,19
191130108,3,0,2,6,1,12
191130109,5,3,2,8,2,20
191130110,4,2,4,0,3,13
191130111,3,8,2,6,8,27
191130112,7,1,4,7,9,28
191130113,4,4,3,8,7,26
191130114,6,6,3,4,0,19
191130115,9,8,9,4,2,32
191130116,9,7,7,4,7,34
191130117,9,8,3,7,5,32
191130118,9,1,5,0,1,16
191130119,4,0,2,9,7,22
191130120,7,9,2,8,8,34
191130121,0,3,8,8,2,21
191130122,9,1,5,9,1,25
191130123,3,4,2,8,7,24
191130124,5,2,9,6,1,23
191130125,8,8,7,0,3,26
191130126,2,9,6,4,8,29
191130127,5,3,0,5,9,22
191130128,3,4,2,6,4,19
191130129,8,7,3,2,1,21
191130130,1,7,4,9,6,27
191130131,4,8,5,5,9,31
191130132,0,8,4,6,5,23
191130133,0,7,2,4,9,22
191130134,2,2,1,8,3,16
191130135,8,2,4,7,0,21
191130136,8,1,4,6,4,23
191130137,8,2,4,5,1,20
191130138,7,6,2,5,5,25
191130139,8,9,3,1,2,23
191130140,3,9,2,6,5,25
191130141,6,7,9,9,3,34
191130142,3,1,8,0,2,14
191130143,9,8,6,1,4,28
191130144,8,8,1,9,0,26
191130145,4,3,7,0,6,20
191130146,4,0,8,9,1,22
191130147,1,6,8,7,3,25
191130148,6,9,4,4,3,26
191130149,8,3,7,5,3,26
191130150,9,2,1,1,3,16
191130151,7,0,5,0,0,12
191130152,5,4,6,5,1,21
191130153,0,2,4,3,6,15
191130154,5,3,0,6,7,21
191130155,8,0,5,2,9,24
191130156,5,7,6,5,3,26
191130157,0,5,1,7,4,17
191130158,7,2,6,4,8,27
191130159,8,0,2,0,3,13
191130160,7,4,0,9,9,29
191130161,7,2,0,5,7,21
191130162,0,6,2,8,5,21
191130163,8,0,0,0,5,13
191130164,2,9,7,9,4,31
191130165,0,3,0,6,3,12
191130166,8,6,7,5,4,30
191130167,8,7,8,2,9,34
191130168,9,1,7,1,4,22
191130169,3,4,0,4,3,14
191130170,7,2,7,1,6,23
191130171,8,2,1,3,3,17
191130172,5,6,8,5,6,30
191130173,7,3,9,8,1,28
191130174,1,5,3,6,4,19
191130175,3,3,2,4,3,15
191130176,8,8,8,8,6,38
191130177,8,2,9,9,7,35
191130178,0,2,7,8,7,24
191130179,1,5,0,9,6,21
191130180,3,9,7,4,0,23
191130181,1,8,6,8,5,28
191130182,4,7,3,5,5,24
191130183,5,6,0,2,2,15
191130184,8,3,6,5,0,22
191130185,2,7,3,0,8,20
191130186,2,3,6,7,8,26
191130187,4,0,1,4,9,18
191130188,4,1,1,6,5,17
191130189,8,6,2,6,8,30
191130190,8,4,3,6,6,27
191130191,9,7,6,9,0,31
191130192,6,0,5,0,9,20
191130193,3,0,4,7,9,23
191130194,0,6,6,9,8,29
191130195,1,9,6,3,9,28
191130196,7,3,5,1,7,23
191130197,3,4,5,0,0,12
191130198,0,4,8,6,3,21
191130199,3,6,9,1,0,19
191130200,0,7,4,7,8,26
191130201,4,2,0,4,4,14
191130202,2,6,5,4,2,19
191130203,1,9,4,5,6,25
191130204,1,5,9,7,5,27
191130205,0,8,3,2,9,22
191130206,6,5,4,0,4,19
191130207,5,9,6,6,9,35
191130208,0,8,7,4,0,19
191130209,6,1,5,2,5,19
191130210,2,1,7,3,1,14
191130211,7,2,4,7,9,29
191130212,3,9,3,7,2,24
191130213,9,9,6,7,1,32
191130214,3,7,9,2,5,26
191130215,6,5,8,1,4,24
191130216,8,8,8,4,8,36
191130217,6,6,9,2,3,26
191130218,5,3,2,7,7,24
191130219,5,0,8,5,7,25
191130220,9,5,6,2,8,30
191130221,1,3,8,4,3,19
191130222,9,5,4,1,0,19
191130223,5,1,0,2,4,12
191130224,1,0,1,9,8,19
191130225,9,8,0,4,7,28
191130226,5,8,2,8,1,24
191130227,5,6,3,6,3,23
191130228,5,6,1,9,2,23
191130229,2,1,8,6,4,21
191130230,5,8,5,5,9,32
191130231,7,0,0,2,3,12
191130232,9,2,5,0,1,17
191130233,9,3,2,9,9,32
191130234,2,0,5,9,6,22
191130235,2,2,8,7,1,20
191130236,5,6,3,7,4,25
191130237,4,5,7,5,5,26
191130238,5,2,6,7,0,20
191130239,1,8,6,4,2,21
191130240,5,1,2,7,8,23
191130241,3,7,9,1,8,28
191130242,5,6,7,3,0,21
191130243,0,2,0,6,2,10
191130244,0,3,3,7,5,18
191130245,5,9,5,0,3,22
191130246,3,1,0,5,7,16
191130247,6,7,0,4,0,17
191130248,0,4,8,6,1,19
191130249,0,7,5,8,0,20
191130250,9,3,8,7,2,29
191130251,2,2,7,4,4,19
191130252,3,0,2,4,6,15
191130253,0,9,7,7,6,29
191130254,5,1,6,0,7,19
191130255,7,9,7,7,5,35
191130256,0,8,4,2,5,19
191130257,6,5,5,5,5,26
191130258,2,2,4,9,5,22
191130259,4,4,8,5,4,25
191130260,0,8,7,4,6,25
191130261,2,7,8,5,9,31
191130262,5,1,1,6,5,18
191130263,6,6,5,0,4,21
191130264,3,1,6,3,5,18
191130265,7,7,2,4,5,25
191130266,3,6,7,5,7,28
191130267,3,9,9,1,9,31
191130268,9,1,1,5,5,21
191130269,4,9,6,3,0,22
191130270,1,3,3,8,2,17
191130271,0,9,1,6,1,17
191130272,0,6,2,5,1,14
191130273,1,8,6,7,5,27
191130274,8,4,7,5,2,26
191130275,8,9,4,0,2,23
191130276,6,1,6,7,5,25
191130277,8,8,9,4,9,38
191130278,8,0,2,2,7,19
191130279,7,1,2,4,3,17
191130280,9,4,9,7,4,33
191130281,0,8,8,0,0,16
191130282,7,4,2,4,8,25
191130283,4,6,0,7,3,20
191130284,3,1,3,0,0,7
191130285,9,5,3,2,5,24
191130286,2,5,9,1,3,20
191130287,8,3,7,5,8,31
191130288,6,3,1,1,0,11
191130289,2,5,6,9,7,29
191130290,2,3,7,2,5,19
191130291,3,9,0,5,5,22
191130292,8,4,9,9,8,38
191130293,5,0,6,3,0,14
191130294,4,9,6,1,7,27
191130295,6,1,1,9,0,17
191130296,1,7,4,5,0,17
191130297,2,0,0,9,9,20
191130298,0,0,5,5,8,18
191130299,1,6,4,7,7,25
191130300,9,1,7,3,2,22
191130301,7,0,6,9,0,22
191130302,0,5,9,2,2,18
191130303,7,4,4,0,5,20
191130304,9,9,4,8,9,39
191130305,1,8,5,5,2,21
191130306,1,8,8,1,7,25
191130307,2,3,3,0,0,8
191130308,1,2,7,9,4,23
191130309,8,7,8,1,0,24
191130310,4,8,3,2,9,26
191130311,9,8,1,9,1,28
191130312,6,2,5,5,6,24
191130313,6,1,6,3,2,18
191130314,2,2,4,0,0,8
191130315,0,2,8,9,3,22
191130316,6,4,1,5,4,20
191130317,5,4,6,0,8,23
191130318,7,4,0,3,4,18
191130319,4,7,7,4,4,26
191130320,8,0,4,5,4,21
191130321,8,3,2,3,4,20
191130322,6,6,4,0,3,19
191130323,8,3,4,8,3,26
191130324,1,8,8,5,5,27
191130325,5,6,0,3,9,23
191130326,3,7,2,5,2,19
191130327,8,9,2,7,9,35
191130328,5,1,4,7,7,24
191130329,8,2,0,0,0,10
191130330,4,4,9,0,1,18
191130331,9,0,4,1,0,14
191130332,7,1,6,4,6,24
191130333,9,0,5,6,6,26
191130334,9,3,3,7,5,27
191130335,5,5,8,3,8,29
191130336,0,2,0,7,1,10
191130337,1,5,5,0,4,15
191130338,6,1,6,8,7,28
191130339,5,6,4,2,8,25
191130340,4,4,5,2,2,17
191130341,2,4,7,4,8,25
191130342,1,0,6,4,6,17
191130343,7,4,5,6,4,26
191130344,2,4,7,2,8,23
191130345,6,1,7,7,1,22
191130346,8,0,4,1,6,19
191130347,2,8,0,2,5,17
191130348,1,6,4,8,4,23
191130349,9,6,1,3,2,21
191130350,9,6,9,0,4,28
191130351,2,2,0,7,8,19
191130352,6,7,9,6,7,35
191130353,5,0,4,9,9,27
191130354,0,4,4,5,4,17
191130355,0,2,2,8,7,19
191130356,0,9,4,8,9,30
191130357,6,9,1,8,2,26
191130358,3,0,2,8,0,13
191130359,3,1,2,1,7,14
191130360,5,5,0,1,0,11
191130361,7,9,7,3,3,29
191130362,3,3,8,1,8,23
191130363,5,4,4,8,1,22
191130364,1,9,9,1,0,20
191130365,6,9,9,2,0,26
191130366,8,4,8,2,1,23
191130367,9,6,8,2,4,29
191130368,5,7,7,6,2,27
191130369,6,3,3,3,7,22
191130370,6,6,1,1,2,16
191130371,7,1,4,8,1,21
191130372,8,2,6,6,9,31
191130373,9,4,6,4,2,25
191130374,0,0,6,7,1,14
191130375,1,7,6,1,9,24
191130376,9,1,5,4,2,21
191130377,4,5,1,2,4,16
191130378,5,6,3,2,5,21
191130379,7,6,7,4,4,28
191130380,0,3,3,3,1,10
191130381,6,7,2,9,9,33
191130382,8,3,0,0,5,16
191130383,5,1,4,9,2,21
191130384,3,4,9,5,3,24
191130385,5,8,2,6,1,22
191130386,1,5,3,6,6,21
191130387,1,3,8,0,0,12
191130388,9,8,6,5,5,33
191130389,5,9,6,0,4,24
191130390,2,3,4,4,1,14
191130391,8,5,7,9,9,38
191130392,6,5,3,3,7,24
191130393,0,0,0,0,2,2
191130394,6,3,8,8,9,34
191130395,6,5,6,5,0,22
191130396,5,3,2,7,4,21
191130397,0,5,8,6,7,26
191130398,5,9,1,3,8,26
191130399,4,9,2,2,9,26
191130400,6,1,9,9,3,28
191130401,1,5,9,7,1,23
191130402,6,1,3,5,2,17
191130403,5,7,0,0,0,12
191130404,9,3,3,2,0,17
191130405,6,7,4,1,4,22
191130406,2,5,1,1,9,18
191130407,6,3,1,6,4,20
191130408,5,4,7,8,7,31
191130409,0,8,0,7,6,21
191130410,8,4,7,9,5,33
191130411,5,0,8,8,4,25
191130412,0,0,3,0,2,5
191130413,7,9,1,0,3,20
191130414,4,7,3,7,9,30
191130415,2,6,9,2,2,21
191130416,4,9,8,9,7,37
191130417,9,0,5,9,1,24
191130418,7,2,3,5,7,24
191130419,0,8,1,8,6,23
191130420,3,8,0,4,7,22
191130421,1,8,4,0,0,13
191130422,5,4,5,5,4,23
191130423,1,3,0,9,8,21
191130424,3,9,7,1,5,25
191130425,3,0,2,3,4,12
191130426,7,3,7,9,4,30
191130427,8,3,2,3,1,17
191130428,8,5,3,5,5,26
191130429,2,9,3,0,4,18
191130430,9,9,2,0,1,21
191130431,4,9,6,8,1,28
191130432,3,3,6,0,1,13
191130433,9,8,8,0,1,26
191130434,5,8,4,0,3,20
191130435,1,6,6,7,7,27
191130436,6,1,7,0,5,19
191130437,8,7,8,4,8,35
191130438,0,8,7,2,3,20
191130439,6,1,9,0,1,17
191130440,6,0,2,3,3,14
191130441,3,1,4,8,2,18
191130442,9,1,7,2,4,23
191130443,8,4,8,6,8,34
191130444,0,9,4,5,0,18
191130445,1,1,6,0,8,16
191130446,6,6,9,5,3,29
191130447,8,2,2,9,9,30
191130448,3,4,9,3,8,27
191130449,2,5,0,0,3,10
191130450,8,6,0,9,9,32
191130451,2,7,4,7,8,28
191130452,5,1,4,4,6,20
191130453,6,9,5,9,3,32
191130454,7,6,3,7,7,30
191130455,4,2,5,1,2,14
191130456,0,8,4,0,8,20
191130457,6,0,3,4,1,14
191130458,9,6,6,7,5,33
191130459,7,7,3,9,3,29
191130460,4,0,6,4,1,15
191130461,9,6,3,5,4,27
191130462,5,9,0,4,9,27
191130463,5,8,7,5,5,30
191130464,8,1,7,0,3,19
191130465,1,3,3,1,3,11
191130466,0,2,2,0,3,7
191130467,2,7,3,0,1,13
191130468,9,2,6,6,1,24
191130469,5,7,0,4,4,20
191130470,7,6,5,3,8,29
191130471,7,1,1,2,2,13
191130472,3,9,9,9,5,35
191130473,1,3,0,1,5,10
191130474,2,6,8,6,4,26
191130475,9,2,8,0,5,24
191130476,4,2,6,3,4,19
191130477,3,5,9,3,8,28
191130478,5,0,0,1,6,12
191130479,5,6,3,8,0,22
191130480,6,0,9,5,8,28
191130481,7,4,6,5,3,25
191130482,1,6,6,9,3,25
191130483,8,7,8,9,9,41
191130484,5,1,8,7,3,24
191130485,5,2,6,1,4,18
191130486,6,8,1,6,8,29
191130487,5,1,0,3,5,14
191130488,8,3,5,2,9,27
191130489,9,6,0,5,8,28
191130490,3,5,5,0,7,20
191130491,4,9,1,8,1,23
191130492,5,9,6,8,0,28
191130493,6,0,5,2,5,18
191130494,0,5,5,1,6,17
191130495,1,9,9,7,3,29
191130496,4,3,9,1,1,18
191130497,5,5,7,9,4,30
191130498,5,7,5,0,7,24
191130499,4,2,3,1,8,18
191130500,8,6,6,4,8,32
191130501,6,0,4,1,0,11
191130502,1,1,4,9,0,15
191130503,3,3,4,3,3,16
191130504,0,2,4,2,6,14
191130505,0,5,7,5,9,26
191130506,7,2,2,8,1,20
191130507,1,0,0,1,0,2
191130508,2,5,8,1,5,21
191130509,5,5,5,0,4,19
191130510,6,4,5,2,6,23
191130511,5,7,5,1,6,24
191130512,9,2,3,3,0,17
191130513,5,5,2,5,5,22
191130514,8,0,6,0,6,20
191130515,4,4,0,4,2,14
191130516,6,9,2,2,1,20
191130517,2,7,4,3,4,20
191130518,0,1,7,1,0,9
191130519,0,1,5,6,3,15
191130520,7,9,4,1,6,27
191130521,4,1,6,6,5,22
191130522,6,9,5,2,2,24
191130523,2,5,3,4,8,22
191130524,1,1,4,8,3,17
191130525,1,4,6,1,7,19
191130526,9,4,2,9,6,30
191130527,6,5,7,4,6,28
191130528,7,3,3,5,6,24
191130529,7,9,5,4,2,27
191130530,1,2,4,3,4,14
191130531,2,4,4,1,9,20
191130532,6,8,6,9,1,30
191130533,7,0,8,4,4,23
191130534,4,3,8,9,6,30
191130535,4,3,8,9,5,29
191130536,4,5,7,8,2,26
191130537,7,4,7,1,3,22
191130538,8,3,3,2,6,22
191130539,8,4,0,0,3,15
191130540,0,4,6,2,8,20
191130541,7,4,0,8,0,19
191130542,5,6,9,1,4,25
191130543,4,4,5,8,4,25
191130544,3,4,6,1,9,23
191130545,2,3,3,2,2,12
191130546,8,3,9,1,7,28
191130547,2,8,6,9,7,32
191130548,9,6,2,4,2,23
191130549,8,8,7,5,5,33
191130550,4,8,5,3,1,21
191130551,0,9,5,2,0,16
191130552,0,1,1,4,7,13
191130553,4,1,1,6,8,20
191130554,3,1,5,4,1,14
191130555,7,0,3,0,3,13
191130556,7,0,1,7,6,21
191130557,3,0,2,6,7,18
191130558,0,8,5,6,4,23
191130559,7,0,4,3,8,22
191130560,6,1,1,9,7,24
191130561,3,3,6,1,5,18
191130562,7,2,0,7,0,16
191130563,3,3,9,9,3,27
191130564,0,7,8,8,0,23
191130565,3,4,8,2,0,17
191130566,4,3,3,9,7,26
191130567,2,1,4,6,9,22
191130568,3,2,1,8,4,18
191130569,4,3,2,3,3,15
191130570,2,3,4,8,5,22
191130571,4,5,8,3,0,20
191130572,2,8,8,6,3,27
191130573,9,2,4,0,8,23
191130574,8,9,5,3,2,27
191130575,3,8,9,6,8,34
191130576,9,7,9,8,1,34
191130577,9,0,6,8,5,28
191130578,4,4,1,1,7,17
191130579,8,8,3,8,0,27
191130580,8,7,7,2,7,31
191130581,2,6,4,1,5,18
191130582,8,3,2,6,2,21
191130583,1,9,5,8,5,28
191130584,3,3,6,3,7,22
191130585,7,7,0,7,7,28
191130586,9,8,0,4,9,30
191130587,8,4,9,9,1,31
191130588,5,9,7,4,2,27
191130589,8,8,7,0,5,28
191130590,1,4,9,8,6,28
191130591,6,7,8,4,4,29
191130592,4,2,0,0,6,12
191130593,3,0,5,4,4,16
191130594,0,1,6,4,3,14
191130595,7,4,2,9,8,30
191130596,7,4,9,4,6,30
191130597,1,6,4,1,4,16
191130598,6,1,4,2,7,20
191130599,2,9,5,7,7,30
191130600,1,4,8,7,2,22
191130601,3,9,1,4,8,25
191130602,5,9,7,0,3,24
191130603,6,9,0,7,6,28
191130604,0,9,7,1,4,21
191130605,5,7,2,4,2,20
191130606,6,7,9,8,1,31
191130607,9,8,6,2,4,29
191130608,3,8,6,9,5,31
191130609,6,7,1,6,8,28
191130610,5,8,8,6,0,27
191130611,6,1,9,6,7,29
191130612,1,6,3,1,4,15
191130613,8,4,8,8,9,37
191130614,7,8,2,0,6,23
191130615,3,7,8,6,6,30
191130616,3,6,5,6,1,21
191130617,3,5,5,1,3,17
191130618,6,6,2,0,9,23
191130619,4,3,5,3,3,18
191130620,1,7,3,8,7,26
191130621,6,5,3,7,3,24
191130622,0,8,1,1,3,13
191130623,3,3,6,1,2,15
191130624,4,8,9,5,8,34
191130625,8,9,2,3,6,28
191130626,7,2,0,5,3,17
191130627,9,9,7,0,1,26
191130628,5,0,4,3,0,12
191130629,0,2,0,7,6,15
191130630,5,9,8,0,5,27
191130631,3,2,1,9,7,22
191130632,6,8,0,3,2,19
191130633,5,8,9,3,0,25
191130634,6,9,3,0,7,25
191130635,4,9,2,8,7,30
191130636,1,7,4,2,3,17
191130637,1,7,9,9,9,35
191130638,2,5,0,2,6,15
191130639,7,1,1,6,4,19
191130640,2,7,8,0,9,26
191130641,4,1,8,1,1,15
191130642,5,3,1,8,7,24
191130643,0,8,0,3,0,11
191130644,7,8,9,7,1,32
191130645,2,4,2,2,8,18
191130646,1,7,7,5,1,21
191130647,1,9,8,1,0,19
191130648,3,7,0,6,1,17
191130649,8,9,7,5,3,32
191130650,9,0,0,7,4,20
191130651,3,3,3,9,2,20
191130652,8,7,4,6,2,27
191130653,1,7,8,9,8,33
191130654,6,4,0,9,2,21
191130655,5,6,6,7,3,27
191130656,5,5,9,6,6,31
191130657,9,0,2,2,2,15
191130658,2,6,0,8,3,19
191130659,2,7,2,4,4,19
191130660,7,5,1,0,0,13
191130661,7,8,0,8,5,28
191130662,3,9,6,9,1,28
191130663,1,4,2,7,1,15
191130664,8,1,8,2,0,19
191130665,8,1,8,3,0,20
191130666,7,4,1,2,1,15
191130667,8,9,3,2,0,22
191130668,6,6,5,6,5,28
191130669,7,7,6,9,6,35
191130670,4,6,1,0,5,16
191130671,5,2,2,9,6,24
191130672,0,6,1,1,6,14
191130673,1,0,7,6,5,19
191130674,6,5,6,6,9,32
191130675,3,9,2,1,9,24
191130676,5,1,9,7,0,22
191130677,6,7,5,9,7,34
191130678,1,1,5,6,7,20
191130679,8,6,5,4,3,26
191130680,9,5,5,7,9,35
191130681,8,4,0,3,9,24
191130682,7,4,4,0,9,24
191130683,1,3,1,2,4,11
191130684,0,0,4,3,6,13
191130685,3,3,2,4,8,20
191130686,9,0,8,8,0,25
191130687,6,2,9,0,6,23
191130688,9,9,9,6,0,33
191130689,2,5,0,5,3,15
191130690,1,3,8,9,7,28
191130691,6,4,5,1,0,16
191130692,3,6,9,8,9,35
191130693,2,7,0,3,2,14
191130694,7,7,7,5,5,31
191130695,5,5,9,1,7,27
191130696,7,7,1,8,3,26
191130697,5,4,1,7,1,18
191130698,5,5,2,2,2,16
191130699,1,1,2,8,4,16
191130700,5,0,2,4,0,11
191130701,9,8,9,2,4,32
191130702,7,0,5,0,9,21
191130703,8,2,5,0,9,24
191130704,4,7,9,1,5,26
191130705,9,0,9,6,9,33
191130706,8,8,0,2,5,23
191130707,8,3,2,1,6,20
191130708,1,0,2,8,3,14
191130709,3,0,2,8,1,14
191130710,1,8,8,3,0,20
191130711,3,7,4,2,5,21
191130712,4,8,4,5,7,28
191130713,0,9,7,7,9,32
191130714,4,9,2,9,1,25
191130715,1,6,8,7,1,23
191130716,8,1,6,6,1,22
191130717,7,3,0,8,7,25
191130718,9,1,1,4,4,19
191130719,0,1,9,3,6,19
191130720,3,0,7,9,7,26
191130721,1,9,3,3,3,19
191130722,4,3,0,2,2,11
191130723,0,8,3,1,0,12
191130724,6,9,5,1,2,23
191130725,4,3,4,8,1,20
191130726,2,6,3,7,6,24
191130727,1,9,5,8,2,25
191130728,3,8,2,1,8,22
191130729,6,6,5,8,4,29
191130730,0,4,7,2,9,22
191130731,6,4,5,1,8,24
191130732,7,2,9,7,7,32
191130733,5,9,8,5,5,32
191130734,4,8,7,6,0,25
191130735,2,9,5,6,9,31
191130736,4,8,7,0,6,25
191130737,6,2,1,1,1,11
191130738,4,6,7,3,0,20
191130739,5,4,5,9,3,26
191130740,8,6,6,8,4,32
191130741,7,2,9,6,6,30
191130742,8,1,7,6,2,24
191130743,9,1,5,6,6,27
191130744,5,9,6,4,0,24
191130745,7,5,0,2,6,20
191130746,0,5,7,5,6,23
191130747,0,0,2,4,9,15
191130748,9,6,1,8,1,25
191130749,3,7,6,8,5,29
191130750,1,1,5,1,9,17
191130751,5,7,6,7,1,26
191130752,2,3,9,9,8,31
191130753,3,3,6,8,9,29
191130754,3,7,4,0,9,23
191130755,5,1,3,2,5,16
191130756,6,5,7,6,8,32
191130757,8,7,1,5,4,25
191130758,2,2,4,9,7,24
191130759,6,3,7,1,5,22
191130760,5,0,8,3,6,22
191130761,4,6,4,2,8,24
191130762,2,6,6,6,5,25
191130763,1,0,2,7,3,13
191130764,1,9,7,0,2,19
191130765,3,5,8,3,5,24
191130766,4,6,0,4,9,23
191130767,9,9,4,3,8,33
191130768,3,4,1,1,8,17
191130769,8,2,8,7,4,29
191130770,2,9,4,5,6,26
191130771,2,3,0,4,4,13
191130772,5,2,9,6,9,31
191130773,1,7,1,2,3,14
191130774,6,4,5,0,4,19
191130775,5,0,2,6,0,13
191130776,6,8,7,8,9,38
191130777,9,3,6,5,6,29
191130778,8,5,4,7,6,30
191130779,3,4,2,8,9,26
191130780,1,3,0,7,6,17
191130781,5,0,9,7,6,27
191130782,7,6,4,0,1,18
191130783,7,6,1,2,8,24
191130784,4,0,4,9,3,20
191130785,4,1,9,1,6,21
191130786,0,6,0,5,6,17
191130787,9,0,8,7,7,31
191130788,8,8,1,6,2,25
191130789,4,5,4,9,8,30
191130790,6,3,8,0,2,19
191130791,5,7,8,4,3,27
191130792,9,2,0,2,9,22
191130793,8,0,8,0,8,24
191130794,2,4,9,3,5,23
191130795,2,5,6,6,4,23
191130796,8,6,9,4,2,29
191130797,1,2,9,9,3,24
191130798,7,8,7,5,2,29
191130799,8,1,9,8,2,28
191130800,5,0,6,7,7,25
191130801,3,2,6,5,3,19
191130802,4,2,3,7,9,25
191130803,4,6,0,8,9,27
191130804,1,6,6,2,1,16
191130805,1,8,6,5,6,26
191130806,4,9,5,9,4,31
191130807,1,8,0,5,6,20
191130808,1,4,8,5,0,18
191130809,3,9,2,3,7,24
191130810,8,9,9,0,1,27
191130811,0,1,3,0,2,6
191130812,8,6,5,1,8,28
191130813,8,6,5,9,1,29
191130814,8,0,7,4,4,23
191130815,3,2,6,4,5,20
191130816,2,8,3,9,1,23
191130817,1,2,3,9,9,24
191130818,9,4,6,0,1,20
191130819,1,0,4,3,6,14
191130820,0,8,8,7,0,23
191130821,3,4,9,5,5,26
191130822,4,3,7,0,3,17
191130823,2,3,7,9,4,25
191130824,8,6,2,5,2,23
191130825,6,1,9,1,9,26
191130826,5,9,3,6,9,32
191130827,0,1,5,9,5,20
191130828,6,3,3,1,0,13
191130829,4,8,8,0,2,22
191130830,1,9,9,5,5,29
191130831,8,8,4,2,5,27
191130832,4,3,4,1,2,14
191130833,6,2,0,4,8,20
191130834,6,1,0,2,0,9
191130835,5,6,0,2,0,13
191130836,2,7,5,9,2,25
191130837,1,5,8,3,2,19
191130838,5,7,9,0,0,21
191130839,5,3,4,9,0,21
191130840,8,2,9,2,5,26
191130841,9,7,2,8,0,26
191130842,6,1,4,0,6,17
191130843,0,3,5,9,1,18
191130844,5,5,8,8,3,29
191130845,6,2,9,2,3,22
191130846,8,6,9,7,7,37
191130847,7,7,1,5,2,22
191130848,5,2,4,6,3,20
191130849,5,8,6,4,4,27
191130850,8,9,2,0,5,24
191130851,2,8,8,8,5,31
191130852,1,3,3,0,5,12
191130853,6,7,5,7,6,31
191130854,2,1,4,6,5,18
191130855,9,4,5,7,6,31
191130856,4,5,3,7,3,22
191130857,1,6,3,6,1,17
191130858,0,5,8,5,4,22
191130859,6,9,7,0,9,31
191130860,5,1,9,7,6,28
191130861,3,1,3,3,8,18
191130862,3,3,1,5,6,18
191130863,3,0,9,5,8,25
191130864,8,9,8,5,4,34
191130865,4,8,8,5,8,33
191130866,5,3,9,4,5,26
191130867,1,1,8,2,2,14
191130868,2,6,7,3,4,22
191130869,1,9,5,9,4,28
191130870,1,6,3,1,0,11
191130871,2,8,9,3,6,28
191130872,2,7,5,6,1,21
191130873,9,2,2,5,9,27
191130874,9,4,1,9,0,23
191130875,1,8,1,6,9,25
191130876,3,9,9,5,9,35
191130877,7,5,1,5,4,22
191130878,7,2,4,3,8,24
191130879,8,6,5,0,0,19
191130880,2,5,8,1,3,19
191130881,1,4,1,6,9,21
191130882,0,9,5,8,4,26
191130883,4,7,6,3,5,25
191130884,5,5,2,2,9,23
191130885,2,9,1,6,6,24
191130886,8,1,5,4,2,20
191130887,3,8,6,4,8,29
191130888,5,5,0,8,8,26
191130889,5,0,4,6,7,22
191130890,0,4,4,9,3,20
191130891,2,1,3,8,5,19
191130892,4,1,8,7,6,26
191130893,1,7,1,3,1,13
191130894,7,2,2,0,7,18
191130895,9,2,0,8,0,19
191130896,2,4,1,8,4,19
191130897,1,7,1,5,5,19
191130898,9,6,7,7,7,36
191130899,9,8,3,3,9,32
191130900,6,3,4,7,0,20
191130901,2,6,5,4,4,21
191130902,5,2,6,1,7,21
191130903,4,4,0,7,6,21
191130904,3,1,7,2,9,22
191130905,9,1,1,8,6,25
191130906,0,4,1,5,7,17
191130907,4,9,7,7,2,29
191130908,4,8,6,9,1,28
191130909,9,3,0,2,1,15
191130910,9,2,2,5,0,18
191130911,7,3,7,1,3,21
191130912,7,2,7,3,4,23
191130913,5,2,0,6,4,17
191130914,1,7,3,9,4,24
191130915,5,9,0,3,5,22
191130916,5,1,8,9,1,24
191130917,5,3,0,6,9,23
191130918,9,0,5,7,1,22
191130919,3,6,4,6,6,25
191130920,5,4,6,3,0,18
191130921,7,0,1,8,1,17
191130922,9,1,1,9,7,27
191130923,0,8,4,0,5,17
191130924,8,7,8,6,6,35
191130925,0,0,5,9,2,16
191130926,5,5,9,7,8,34
191130927,5,0,5,4,2,16
191130928,8,9,0,6,0,23
191130929,3,7,2,5,7,24
191130930,8,5,7,4,9,33
191130931,9,3,4,9,4,29
191130932,8,3,0,5,9,25
191130933,5,1,7,0,5,18
191130934,5,9,4,9,4,31
191130935,8,9,1,7,8,33
191130936,0,9,5,3,1,18
191130937,5,5,1,9,9,29
191130938,0,8,6,8,5,27
191130939,4,9,6,9,4,32
191130940,3,2,4,6,0,15
191130941,4,9,0,8,7,28
191130942,0,7,0,7,5,19
191130943,1,5,5,4,3,18
191130944,5,7,7,2,1,22
191130945,5,3,2,6,5,21
191130946,5,2,8,7,5,27
191130947,5,7,8,8,9,37
191130948,6,6,6,1,6,25
191130949,8,9,5,0,1,23
191130950,5,2,7,2,8,24
191130951,3,6,9,7,2,27
191130952,9,5,1,2,4,21
191130953,6,9,9,0,9,33
191130954,2,8,0,2,3,15
191130955,1,9,4,2,9,25
191130956,7,8,2,8,5,30
191130957,1,1,4,3,1,10
191130958,5,7,0,6,9,27
191130959,0,0,7,2,3,12
191130960,6,1,9,3,6,25
191130961,8,3,7,2,1,21
191130962,2,2,0,8,3,15
191130963,7,2,0,0,6,15
191130964,4,9,4,2,5,24
191130965,5,6,2,8,9,30
191130966,1,5,9,6,9,30
191130967,7,3,0,5,6,21
191130968,7,1,3,8,0,19
191130969,9,8,6,4,2,29
191130970,8,2,1,5,4,20
191130971,0,6,6,1,7,20
191130972,4,7,0,1,5,17
191130973,3,1,2,1,1,8
191130974,5,6,4,2,7,24
191130975,8,6,7,9,3,33
191130976,0,8,9,9,9,35
191130977,5,9,6,0,8,28
191130978,2,1,1,6,6,16
191130979,6,8,3,4,0,21
191130980,3,7,9,3,1,23
191130981,9,5,3,6,4,27
191130982,4,9,1,5,7,26
191130983,8,0,6,2,2,18
191130984,5,4,0,4,4,17
191130985,3,5,1,0,5,14
191130986,6,4,4,1,4,19
191130987,2,6,2,9,8,27
191130988,7,1,2,0,4,14
191130989,7,5,1,1,0,14
191130990,8,3,7,2,0,20
191130991,6,4,0,2,6,18
191130992,7,2,9,7,2,27
191130993,9,1,0,1,0,11
191130994,9,8,4,2,8,31
191130995,7,1,9,2,9,28
191130996,0,9,6,0,1,16
191130997,4,0,2,3,4,13
191130998,0,5,6,0,3,14
191130999,6,7,1,9,8,31
1911301000,7,2,3,4,5,21
1911301001,7,7,5,6,4,29
1911301002,3,2,4,5,4,18
1911301003,7,5,6,0,5,23
1911301004,2,6,0,2,4,14
1911301005,3,3,1,9,4,20
1911301006,6,6,9,8,9,38
1911301007,9,7,7,9,7,39
1911301008,8,0,0,8,9,25
1911301009,1,0,3,2,4,10
1911301010,7,4,3,1,0,15
1911301011,0,4,9,4,7,24
1911301012,2,3,2,8,2,17
1911301013,3,7,7,6,3,26
1911301014,2,8,0,8,5,23
1911301015,0,9,5,6,0,20
1911301016,5,8,9,9,5,36
1911301017,0,1,4,3,9,17
1911301018,0,2,6,0,1,9
1911301019,6,5,7,6,0,24
1911301020,2,6,3,2,0,13
1911301021,3,3,5,9,2,22
1911301022,7,9,6,9,9,40
1911301023,8,4,7,6,0,25
1911301024,5,2,8,4,6,25
1911301025,1,9,3,9,9,31
1911301026,7,4,3,7,9,30
1911301027,4,8,6,0,0,18
1911301028,3,8,4,8,3,26
1911301029,9,2,6,0,3,20
1911301030,3,8,3,3,5,22
1911301031,9,7,1,9,4,30
1911301032,3,5,3,6,3,20
1911301033,9,0,3,9,0,21
1911301034,3,0,1,6,1,11
1911301035,8,1,3,2,3,17
1911301036,0,5,2,5,1,13
1911301037,4,6,8,4,2,24
1911301038,8,7,3,7,0,25
1911301039,2,0,6,5,5,18
1911301040,2,1,1,0,6,10
1911301041,7,5,3,2,9,26
1911301042,7,7,9,3,0,26
1911301043,3,6,1,7,6,23
1911301044,4,2,6,6,4,22
1911301045,7,3,5,9,8,32
1911301046,2,7,9,2,9,29
1911301047,3,1,7,0,2,13
1911301048,5,9,9,9,7,39
1911301049,3,6,9,2,6,26
1911301050,1,1,4,4,3,13
1911301051,6,6,7,9,1,29
1911301052,9,9,2,9,1,30
1911301053,5,2,8,5,8,28
1911301054,3,6,4,4,5,22
1911301055,0,9,8,1,4,22
1911301056,8,4,0,4,2,18
1911301057,1,3,1,5,1,11
1911301058,6,3,6,5,2,22
1911301059,9,0,0,7,8,24
1911301060,5,0,5,6,9,25
1911301061,8,2,1,5,8,24
1911301062,1,1,1,5,5,13
1911301063,8,4,2,1,0,15
1911301064,8,5,2,5,3,23
1911301065,9,7,2,9,5,32
1911301066,3,2,1,0,9,15
1911301067,7,4,3,8,4,26
1911301068,7,4,9,7,4,31
1911301069,9,5,1,7,9,31
1911301070,0,4,3,9,0,16
1911301071,4,8,1,7,6,26
1911301072,0,1,6,5,3,15
1911301073,3,8,4,0,2,17
1911301074,4,3,4,1,8,20
1911301075,7,1,9,2,0,19
1911301076,4,9,5,7,9,34
1911301077,6,0,0,8,4,18
1911301078,9,7,6,8,8,38
1911301079,5,2,7,5,2,21
1911301080,8,4,0,9,4,25
1911301081,1,9,5,0,9,24
1911301082,1,6,6,0,0,13
1911301083,7,1,3,3,2,16
1911301084,3,3,7,5,0,18
1911301085,2,4,5,7,6,24
1911301086,0,6,4,8,1,19
1911301087,1,5,7,6,2,21
1911301088,0,1,4,9,1,15
1911301089,5,6,5,4,8,28
1911301090,8,2,4,6,3,23
1911301091,4,2,2,3,0,11
1911301092,9,7,1,1,0,18
1911301093,3,1,7,0,3,14
1911301094,8,7,0,8,5,28
1911301095,3,1,3,6,2,15
1911301096,0,8,7,3,4,22
1911301097,0,6,6,3,6,21
1911301098,9,8,7,6,6,36
1911301099,4,0,0,0,8,12
1911301100,0,6,9,1,7,23
1911301101,6,4,6,4,9,29
1911301102,4,2,4,0,8,18
1911301103,0,8,5,5,1,19
1911301104,0,7,1,3,3,14
1911301105,4,2,8,6,7,27
191201001,4,7,9,1,2,23
191201002,6,5,1,8,3,23
191201003,0,9,3,4,2,18
191201004,5,0,6,0,6,17
191201005,7,9,6,2,0,24
191201006,6,1,8,2,1,18
191201007,0,6,4,4,7,21
191201008,8,0,6,7,2,23
191201009,3,6,6,3,8,26
191201010,3,5,0,0,1,9
191201011,5,3,6,5,0,19
191201012,2,2,4,0,5,13
191201013,3,5,4,4,1,17
191201014,8,1,6,3,8,26
191201015,6,3,9,9,7,34
191201016,2,3,9,2,7,23
191201017,0,7,4,0,6,17
191201018,7,3,8,1,5,24
191201019,7,9,3,4,7,30
191201020,1,2,5,2,2,12
191201021,1,4,4,2,9,20
191201022,2,2,4,1,1,10
191201023,6,2,9,4,8,29
191201024,2,1,3,2,9,17
191201025,9,2,9,1,4,25
191201026,6,0,0,9,0,15
191201027,1,1,7,3,1,13
191201028,8,1,4,2,3,18
191201029,8,2,0,2,0,12
191201030,2,2,1,8,4,17
191201031,9,2,7,8,7,33
191201032,7,8,5,8,9,37
191201033,0,0,3,2,6,11
191201034,3,9,7,4,4,27
191201035,5,0,7,6,8,26
191201036,2,9,7,3,0,21
191201037,0,2,4,4,4,14
191201038,0,8,1,5,6,20
191201039,8,0,3,3,3,17
191201040,4,2,2,7,0,15
191201041,4,0,2,5,8,19
191201042,9,4,0,7,7,27
191201043,5,1,7,1,4,18
191201044,9,2,4,2,6,23
191201045,2,6,2,8,6,24
191201046,8,7,9,9,7,40
191201047,3,1,9,8,9,30
191201048,1,2,5,0,6,14
191201049,8,3,5,5,5,26
191201050,3,3,3,9,4,22
191201051,4,2,1,0,8,15
191201052,6,2,4,4,6,22
191201053,7,8,1,9,6,31
191201054,4,7,5,0,9,25
191201055,9,8,3,1,9,30
191201056,9,9,9,5,3,35
191201057,3,4,5,8,5,25
191201058,0,4,2,2,4,12
191201059,1,8,5,1,2,17
191201060,7,4,4,6,3,24
191201061,4,3,5,6,3,21
191201062,6,2,3,4,9,24
191201063,7,6,9,2,0,24
191201064,3,5,0,0,4,12
191201065,4,9,4,3,4,24
191201066,6,9,0,4,5,24
191201067,2,5,6,7,3,23
191201068,8,1,5,8,5,27
191201069,1,6,0,6,8,21
191201070,5,8,2,8,9,32
191201071,9,6,2,1,2,20
191201072,9,2,4,9,5,29
191201073,7,1,1,8,8,25
191201074,3,2,5,4,4,18
191201075,1,1,5,0,8,15
191201076,6,3,0,1,5,15
191201077,1,6,4,6,2,19
191201078,7,8,3,8,8,34
191201079,5,7,2,9,9,32
191201080,5,5,0,7,1,18
191201081,9,7,3,6,2,27
191201082,5,0,0,1,0,6
191201083,7,7,5,8,7,34
191201084,0,8,1,7,6,22
191201085,6,0,6,2,0,14
191201086,3,8,3,4,6,24
191201087,0,9,3,0,0,12
191201088,0,8,2,2,1,13
191201089,4,3,2,4,8,21
191201090,1,7,4,8,1,21
191201091,2,5,7,0,1,15
191201092,3,2,2,8,9,24
191201093,2,0,4,0,0,6
191201094,4,4,9,4,6,27
191201095,5,0,1,2,9,17
191201096,2,6,0,1,7,16
191201097,5,0,2,5,6,18
191201098,9,3,2,5,6,25
191201099,1,7,2,4,4,18
191201100,8,9,0,0,5,22
191201101,4,6,1,8,7,26
191201102,8,6,2,5,7,28
191201103,3,4,5,5,7,24
191201104,8,6,7,3,8,32
191201105,8,1,6,3,5,23
191201106,5,1,2,2,0,10
191201107,4,0,1,5,9,19
191201108,3,4,3,3,0,13
191201109,3,4,3,1,2,13
191201110,3,7,6,6,9,31
191201111,0,6,1,4,1,12
191201112,6,9,6,5,0,26
191201113,4,5,8,9,4,30
191201114,6,8,5,3,8,30
191201115,6,1,3,5,9,24
191201116,0,0,0,0,4,4
191201117,4,1,2,5,3,15
191201118,3,3,4,0,2,12
191201119,7,4,2,4,2,19
191201120,9,9,8,5,6,37
191201121,9,6,0,2,0,17
191201122,2,5,2,0,5,14
191201123,0,3,3,7,3,16
191201124,9,4,8,4,8,33
191201125,7,7,2,4,0,20
191201126,0,8,7,9,2,26
191201127,1,7,9,5,3,25
191201128,8,3,2,2,0,15
191201129,0,9,2,4,3,18
191201130,1,9,6,7,6,29
191201131,9,0,2,0,6,17
191201132,4,1,1,0,5,11
191201133,3,1,6,4,1,15
191201134,2,1,9,9,5,26
191201135,2,7,2,1,4,16
191201136,8,3,5,3,5,24
191201137,6,9,3,2,9,29
191201138,6,1,9,7,9,32
191201139,0,8,9,3,6,26
191201140,3,4,9,9,0,25
191201141,2,0,0,1,4,7
191201142,1,4,4,9,6,24
191201143,3,7,5,4,4,23
191201144,8,3,9,6,0,26
191201145,2,2,1,3,4,12
191201146,2,1,3,1,4,11
191201147,1,0,3,0,6,10
191201148,1,8,6,1,1,17
191201149,2,3,2,4,8,19
191201150,3,0,4,7,2,16
191201151,8,4,9,1,7,29
191201152,8,4,0,4,3,19
191201153,7,2,6,9,2,26
191201154,8,5,6,4,7,30
191201155,4,2,3,5,5,19
191201156,9,4,0,4,0,17
191201157,8,8,8,9,7,40
191201158,9,9,8,2,7,35
191201159,7,4,8,8,0,27
191201160,5,4,8,6,9,32
191201161,7,2,3,5,5,22
191201162,5,8,8,3,2,26
191201163,5,4,7,4,8,28
191201164,1,4,2,6,8,21
191201165,9,7,4,2,2,24
191201166,4,2,3,9,5,23
191201167,8,1,6,4,9,28
191201168,7,1,2,9,5,24
191201169,2,9,2,2,3,18
191201170,6,9,4,2,7,28
191201171,7,7,3,9,0,26
191201172,6,8,5,3,7,29
191201173,1,8,3,5,2,19
191201174,1,1,2,6,3,13
191201175,6,4,7,6,0,23
191201176,0,8,4,1,4,17
191201177,5,0,5,5,1,16
191201178,5,2,5,6,2,20
191201179,0,4,5,4,9,22
191201180,1,5,9,8,6,29
191201181,4,9,5,4,6,28
191201182,0,2,2,9,8,21
191201183,7,5,5,6,0,23
191201184,7,1,1,9,6,24
191201185,9,5,4,4,7,29
191201186,2,6,8,8,0,24
191201187,9,8,6,1,2,26
191201188,5,7,7,0,3,22
191201189,6,0,4,4,0,14
191201190,6,4,7,0,4,21
191201191,9,4,1,2,0,16
191201192,2,1,0,7,6,16
191201193,8,3,7,3,6,27
191201194,4,5,0,3,3,15
191201195,7,0,7,6,4,24
191201196,4,2,4,3,2,15
191201197,9,1,6,9,9,34
191201198,2,6,2,7,5,22
191201199,8,5,6,0,4,23
191201200,6,6,8,7,6,33
191201201,1,4,9,5,7,26
191201202,4,8,8,1,0,21
191201203,4,6,1,9,2,22
191201204,6,4,1,5,2,18
191201205,9,9,3,8,0,29
191201206,9,2,4,1,9,25
191201207,0,1,2,3,3,9
191201208,3,3,2,7,4,19
191201209,8,8,9,3,1,29
191201210,7,1,7,1,1,17
191201211,3,7,8,6,7,31
191201212,3,8,6,3,6,26
191201213,4,3,9,7,9,32
191201214,4,9,0,3,7,23
191201215,4,8,3,7,5,27
191201216,9,9,0,0,8,26
191201217,2,7,7,8,9,33
191201218,8,1,4,6,7,26
191201219,4,8,6,5,0,23
191201220,5,6,6,8,7,32
191201221,1,7,2,4,3,17
191201222,6,0,1,4,0,11
191201223,9,3,1,0,7,20
191201224,3,6,5,6,9,29
191201225,9,9,7,4,2,31
191201226,0,6,5,9,7,27
191201227,8,9,0,8,3,28
191201228,2,9,4,2,6,23
191201229,0,1,8,0,3,12
191201230,3,1,1,2,1,8
191201231,3,5,8,8,1,25
191201232,8,9,3,5,2,27
191201233,5,6,7,9,7,34
191201234,4,0,1,3,8,16
191201235,0,3,4,8,0,15
191201236,0,3,9,6,1,19
191201237,0,9,5,6,4,24
191201238,5,5,7,0,0,17
191201239,5,0,1,6,6,18
191201240,7,4,7,6,2,26
191201241,6,2,2,1,8,19
191201242,8,8,3,4,3,26
191201243,1,6,4,1,2,14
191201244,6,5,3,1,8,23
191201245,6,4,9,8,2,29
191201246,0,0,2,0,6,8
191201247,7,9,9,9,7,41
191201248,8,5,0,1,3,17
191201249,4,1,8,4,8,25
191201250,4,1,3,4,4,16
191201251,5,7,1,7,0,20
191201252,2,5,7,0,4,18
191201253,0,1,2,9,1,13
191201254,1,8,7,5,1,22
191201255,0,8,4,2,6,20
191201256,6,6,6,2,2,22
191201257,5,9,1,5,5,25
191201258,9,8,7,8,8,40
191201259,0,9,1,3,5,18
191201260,5,2,0,0,2,9
191201261,0,5,5,7,8,25
191201262,6,3,1,7,8,25
191201263,6,3,4,3,6,22
191201264,9,1,3,0,6,19
191201265,0,9,4,5,2,20
191201266,2,2,3,2,3,12
191201267,0,1,4,1,9,15
191201268,1,5,5,5,5,21
191201269,3,0,3,3,0,9
191201270,8,8,4,2,3,25
191201271,1,1,5,3,3,13
191201272,3,8,6,6,6,29
191201273,2,1,3,9,4,19
191201274,7,0,0,4,9,20
191201275,4,1,6,6,7,24
191201276,5,4,4,2,2,17
191201277,2,8,5,6,5,26
191201278,3,9,0,9,0,21
191201279,9,8,0,4,1,22
191201280,5,1,7,0,8,21
191201281,2,6,9,5,2,24
191201282,6,5,0,7,3,21
191201283,8,8,6,2,9,33
191201284,3,7,1,7,0,18
191201285,1,6,7,7,6,27
191201286,3,9,7,2,2,23
191201287,9,6,1,0,0,16
191201288,3,9,7,7,7,33
191201289,9,4,4,5,5,27
191201290,5,0,6,2,5,18
191201291,4,4,7,2,0,17
191201292,4,4,2,4,9,23
191201293,8,2,5,3,1,19
191201294,1,0,3,3,4,11
191201295,6,9,5,7,4,31
191201296,6,9,8,2,2,27
191201297,6,9,2,7,0,24
191201298,4,7,9,8,7,35
191201299,3,9,6,1,6,25
191201300,8,9,0,4,2,23
191201301,4,4,5,4,5,22
191201302,1,7,6,6,2,22
191201303,8,8,5,7,3,31
191201304,4,4,7,4,8,27
191201305,6,1,0,6,1,14
191201306,7,6,5,9,3,30
191201307,5,8,6,4,3,26
191201308,1,1,9,8,7,26
191201309,3,5,5,8,9,30
191201310,1,1,2,3,1,8
191201311,8,0,1,9,3,21
191201312,7,2,2,9,7,27
191201313,0,0,0,5,0,5
191201314,8,6,0,2,6,22
191201315,4,9,8,3,1,25
191201316,7,1,8,1,3,20
191201317,6,4,9,1,9,29
191201318,5,0,0,4,2,11
191201319,2,6,2,5,9,24
191201320,8,3,7,5,9,32
191201321,4,8,8,9,5,34
191201322,2,5,0,2,1,10
191201323,2,0,8,1,9,20
191201324,1,6,7,8,7,29
191201325,7,7,7,7,5,33
191201326,3,3,1,3,3,13
191201327,1,6,5,0,9,21
191201328,5,2,3,0,7,17
191201329,0,3,6,1,8,18
191201330,4,6,1,0,1,12
191201331,7,4,8,2,6,27
191201332,4,5,8,9,1,27
191201333,1,0,9,0,8,18
191201334,3,6,0,0,4,13
191201335,5,8,5,8,7,33
191201336,4,4,4,0,0,12
191201337,2,7,2,0,9,20
191201338,0,8,2,8,4,22
191201339,6,8,8,1,8,31
191201340,9,4,5,9,9,36
191201341,9,7,6,4,1,27
191201342,4,6,1,0,6,17
191201343,9,2,5,0,8,24
191201344,2,0,6,3,1,12
191201345,1,7,1,9,5,23
191201346,1,7,6,4,6,24
191201347,0,9,6,2,1,18
191201348,6,4,3,3,5,21
191201349,4,1,4,7,9,25
191201350,7,7,3,9,8,34
191201351,6,9,3,3,9,30
191201352,7,5,1,0,9,22
191201353,9,5,9,4,7,34
191201354,0,6,2,2,7,17
191201355,7,3,6,0,2,18
191201356,2,7,7,2,8,26
191201357,2,7,8,1,3,21
191201358,8,8,2,6,9,33
191201359,3,7,1,3,4,18
191201360,0,9,7,4,8,28
191201361,7,2,6,8,9,32
191201362,7,9,1,1,4,22
191201363,1,8,1,9,3,22
191201364,5,1,6,5,0,17
191201365,5,6,1,4,7,23
191201366,5,0,4,5,9,23
191201367,1,5,1,2,8,17
191201368,5,3,9,3,6,26
191201369,4,9,5,0,7,25
191201370,8,6,5,7,2,28
191201371,4,0,4,1,9,18
191201372,5,8,9,4,0,26
191201373,0,5,5,4,6,20
191201374,9,6,3,7,6,31
191201375,1,9,5,3,8,26
191201376,5,4,8,9,3,29
191201377,1,1,2,8,3,15
191201378,3,4,5,8,1,21
191201379,4,0,0,9,4,17
191201380,2,5,0,2,9,18
191201381,5,4,4,7,0,20
191201382,4,4,5,5,4,22
191201383,5,7,9,6,6,33
191201384,0,3,5,4,4,16
191201385,9,3,6,0,3,21
191201386,1,9,2,9,7,28
191201387,6,8,7,0,3,24
191201388,8,3,0,0,1,12
191201389,4,5,1,1,5,16
191201390,3,1,0,0,6,10
191201391,4,5,4,0,9,22
191201392,4,9,1,1,6,21
191201393,7,2,5,7,9,30
191201394,5,0,2,1,5,13
191201395,5,7,2,9,2,25
191201396,1,9,1,1,4,16
191201397,3,2,5,8,2,20
191201398,6,3,5,1,1,16
191201399,4,0,4,8,4,20
191201400,1,0,0,5,2,8
191201401,3,4,9,4,0,20
191201402,4,6,9,5,3,27
191201403,7,4,6,2,3,22
191201404,1,6,5,3,0,15
191201405,3,9,5,4,2,23
191201406,9,2,9,5,1,26
191201407,4,0,9,0,8,21
191201408,6,7,3,0,6,22
191201409,1,9,7,7,1,25
191201410,2,9,6,1,0,18
191201411,1,6,5,0,3,15
191201412,3,9,5,9,8,34
191201413,3,1,5,6,4,19
191201414,3,4,1,2,7,17
191201415,5,0,3,1,7,16
191201416,5,8,0,4,3,20
191201417,6,2,2,7,4,21
191201418,1,5,7,3,9,25
191201419,8,7,0,4,9,28
191201420,9,6,1,6,2,24
191201421,9,4,5,3,5,26
191201422,7,0,4,8,0,19
191201423,4,4,0,2,3,13
191201424,2,6,6,3,1,18
191201425,0,7,3,0,6,16
191201426,1,8,7,9,4,29
191201427,4,5,2,4,5,20
191201428,2,7,7,5,1,22
191201429,9,1,4,3,9,26
191201430,3,3,8,2,3,19
191201431,1,2,9,5,7,24
191201432,9,8,1,0,5,23
191201433,9,5,2,9,9,34
191201434,3,7,6,4,7,27
191201435,7,5,0,1,5,18
191201436,3,4,3,5,2,17
191201437,5,8,9,1,9,32
191201438,4,1,2,0,5,12
191201439,9,5,7,9,9,39
191201440,8,3,2,2,4,19
191201441,5,3,3,0,9,20
191201442,7,4,2,1,9,23
191201443,6,0,5,4,7,22
191201444,6,5,7,7,6,31
191201445,2,4,1,2,9,18
191201446,9,1,6,1,9,26
191201447,8,8,3,2,5,26
191201448,0,0,9,5,9,23
191201449,3,8,2,2,8,23
191201450,2,2,9,4,1,18
191201451,4,9,2,6,6,27
191201452,0,9,2,1,1,13
191201453,1,4,4,7,3,19
191201454,4,5,8,1,9,27
191201455,5,3,1,1,8,18
191201456,9,8,3,8,0,28
191201457,6,6,0,2,3,17
191201458,4,0,9,4,2,19
191201459,3,4,6,3,2,18
191201460,7,5,7,2,2,23
191201461,4,8,0,1,8,21
191201462,0,8,9,6,8,31
191201463,5,2,4,3,9,23
191201464,6,2,2,4,4,18
191201465,4,9,2,9,2,26
191201466,8,0,1,5,9,23
191201467,7,1,9,3,4,24
191201468,6,6,3,9,7,31
191201469,8,1,7,6,8,30
191201470,7,2,9,0,7,25
191201471,2,4,7,3,3,19
191201472,8,7,0,7,1,23
191201473,5,6,4,0,4,19
191201474,0,4,1,4,9,18
191201475,1,5,2,4,1,13
191201476,2,2,0,5,6,15
191201477,6,0,8,3,1,18
191201478,7,1,1,7,9,25
191201479,1,8,6,8,3,26
191201480,2,3,3,0,6,14
191201481,8,3,4,0,1,16
191201482,8,9,4,4,9,34
191201483,5,0,2,8,8,23
191201484,5,3,5,9,8,30
191201485,7,4,5,0,1,17
191201486,1,1,8,6,6,22
191201487,3,8,9,8,6,34
191201488,9,5,0,8,7,29
191201489,8,6,3,9,5,31
191201490,4,3,2,1,1,11
191201491,6,4,5,3,5,23
191201492,9,2,5,7,4,27
191201493,9,4,0,2,7,22
191201494,4,6,6,6,6,28
191201495,3,0,5,9,1,18
191201496,7,6,9,8,4,34
191201497,1,5,9,9,0,24
191201498,7,9,2,8,3,29
191201499,2,3,6,2,1,14
191201500,1,6,6,6,3,22
191201501,2,3,1,8,5,19
191201502,6,6,2,5,7,26
191201503,3,5,5,5,0,18
191201504,5,4,5,1,5,20
191201505,6,2,8,4,3,23
191201506,4,9,5,1,1,20
191201507,7,5,0,7,8,27
191201508,6,5,1,0,8,20
191201509,5,7,7,5,6,30
191201510,0,3,2,0,7,12
191201511,0,6,6,3,2,17
191201512,8,8,8,6,2,32
191201513,2,9,7,4,1,23
191201514,3,7,4,3,7,24
191201515,7,9,7,2,5,30
191201516,1,4,0,2,7,14
191201517,2,2,7,6,7,24
191201518,5,3,7,3,2,20
191201519,5,2,3,9,4,23
191201520,6,2,0,4,7,19
191201521,3,7,9,3,8,30
191201522,3,9,3,6,7,28
191201523,5,5,2,3,8,23
191201524,7,8,4,9,3,31
191201525,9,1,4,5,4,23
191201526,6,9,7,9,3,34
191201527,0,9,0,4,0,13
191201528,4,3,1,6,8,22
191201529,6,1,4,5,5,21
191201530,1,2,1,3,5,12
191201531,0,8,7,8,0,23
191201532,8,1,0,9,4,22
191201533,8,6,6,7,5,32
191201534,2,0,3,8,1,14
191201535,0,8,7,3,8,26
191201536,3,0,3,9,2,17
191201537,4,4,4,7,0,19
191201538,6,3,7,4,8,28
191201539,7,2,8,5,1,23
191201540,4,3,5,5,1,18
191201541,7,5,4,4,0,20
191201542,7,3,6,2,8,26
191201543,1,4,6,3,6,20
191201544,1,1,1,0,9,12
191201545,3,8,0,7,0,18
191201546,1,1,3,0,2,7
191201547,1,7,3,0,1,12
191201548,5,9,9,9,2,34
191201549,8,5,8,1,9,31
191201550,8,3,2,7,8,28
191201551,1,2,2,0,4,9
191201552,5,0,8,4,9,26
191201553,3,0,8,2,5,18
191201554,6,4,2,3,1,16
191201555,1,0,0,1,8,10
191201556,4,6,1,8,9,28
191201557,2,4,2,2,4,14
191201558,9,5,9,5,3,31
191201559,6,7,4,8,3,28
191201560,9,9,6,1,9,34
191201561,4,9,9,3,0,25
191201562,9,6,0,1,5,21
191201563,8,5,5,8,7,33
191201564,6,3,6,0,0,15
191201565,5,2,5,3,5,20
191201566,8,6,3,8,7,32
191201567,5,4,9,6,6,30
191201568,1,8,5,6,8,28
191201569,3,2,2,4,6,17
191201570,4,1,8,0,1,14
191201571,6,9,4,2,2,23
191201572,3,8,3,9,3,26
191201573,1,9,5,1,3,19
191201574,7,1,1,8,6,23
191201575,3,0,7,4,6,20
191201576,6,2,0,9,9,26
191201577,6,2,8,9,2,27
191201578,7,1,9,0,6,23
191201579,6,8,6,0,3,23
191201580,0,2,5,3,8,18
191201581,7,6,0,7,5,25
191201582,6,6,8,3,4,27
191201583,1,1,7,1,3,13
191201584,9,1,5,8,3,26
191201585,3,5,9,1,1,19
191201586,5,9,6,0,2,22
191201587,1,0,2,8,1,12
191201588,0,1,6,3,8,18
191201589,4,5,8,2,6,25
191201590,0,5,4,7,6,22
191201591,8,2,7,1,8,26
191201592,3,7,3,4,8,25
191201593,9,4,8,3,0,24
191201594,6,3,8,5,3,25
191201595,2,2,9,6,7,26
191201596,7,7,4,5,4,27
191201597,5,9,5,2,3,24
191201598,4,4,6,8,6,28
191201599,6,6,9,0,1,22
191201600,7,1,1,9,3,21
191201601,2,9,8,9,4,32
191201602,0,7,1,8,3,19
191201603,5,5,1,7,1,19
191201604,1,9,5,2,1,18
191201605,5,1,9,0,0,15
191201606,4,7,1,5,0,17
191201607,6,1,4,2,4,17
191201608,4,1,5,1,1,12
191201609,4,8,8,1,8,29
191201610,3,0,7,7,1,18
191201611,5,8,5,2,5,25
191201612,3,9,1,0,3,16
191201613,0,9,9,1,9,28
191201614,5,9,7,2,5,28
191201615,4,5,8,4,0,21
191201616,0,2,4,1,8,15
191201617,2,0,6,4,5,17
191201618,5,6,1,2,5,19
191201619,5,5,4,3,7,24
191201620,5,5,7,5,2,24
191201621,5,8,6,8,3,30
191201622,3,0,1,3,6,13
191201623,5,6,8,9,3,31
191201624,0,5,0,9,1,15
191201625,1,6,8,7,4,26
191201626,3,6,8,8,9,34
191201627,0,9,2,6,1,18
191201628,2,6,1,5,9,23
191201629,1,6,5,8,0,20
191201630,4,4,8,0,3,19
191201631,9,9,9,3,4,34
191201632,8,3,8,5,3,27
191201633,8,1,3,8,1,21
191201634,2,7,7,8,5,29
191201635,6,5,3,4,4,22
191201636,4,3,4,8,4,23
191201637,6,7,6,8,4,31
191201638,9,1,4,4,5,23
191201639,7,3,9,1,7,27
191201640,6,5,1,4,0,16
191201641,1,3,8,8,2,22
191201642,4,4,0,9,4,21
191201643,2,3,1,0,9,15
191201644,4,2,4,1,6,17
191201645,9,9,1,7,1,27
191201646,0,8,9,4,8,29
191201647,6,1,0,4,1,12
191201648,2,4,2,1,6,15
191201649,5,2,9,2,8,26
191201650,5,4,6,7,3,25
191201651,4,6,5,3,2,20
191201652,6,6,6,1,3,22
191201653,2,9,3,4,4,22
191201654,1,8,8,8,8,33
191201655,5,2,6,8,3,24
191201656,3,3,1,3,6,16
191201657,0,8,3,6,8,25
191201658,7,4,3,0,4,18
191201659,6,0,0,6,0,12
191201660,7,4,1,8,5,25
191201661,4,1,0,0,6,11
191201662,1,8,3,3,3,18
191201663,3,5,9,5,2,24
191201664,1,1,8,7,6,23
191201665,7,0,3,8,7,25
191201666,7,8,0,8,2,25
191201667,3,9,7,1,2,22
191201668,7,3,9,1,1,21
191201669,3,8,6,9,7,33
191201670,2,6,0,1,4,13
191201671,9,7,8,5,2,31
191201672,1,3,5,9,6,24
191201673,7,5,6,1,8,27
191201674,6,4,0,0,3,13
191201675,5,4,0,6,8,23
191201676,8,7,9,1,3,28
191201677,2,4,0,0,2,8
191201678,0,4,2,4,9,19
191201679,7,9,3,1,5,25
191201680,0,6,0,2,3,11
191201681,4,7,6,1,8,26
191201682,7,9,0,3,2,21
191201683,7,9,2,6,9,33
191201684,8,9,5,6,3,31
191201685,4,0,5,1,8,18
191201686,4,9,5,5,3,26
191201687,4,6,4,1,6,21
191201688,3,1,7,0,4,15
191201689,3,0,0,9,9,21
191201690,6,7,7,4,5,29
191201691,6,2,7,2,4,21
191201692,7,3,6,1,4,21
191201693,5,6,5,0,1,17
191201694,1,7,4,2,1,15
191201695,3,6,1,3,0,13
191201696,0,1,3,5,7,16
191201697,1,2,3,2,3,11
191201698,3,9,1,1,6,20
191201699,0,5,8,5,7,25
191201700,5,2,9,2,7,25
191201701,5,8,4,4,2,23
191201702,9,3,7,7,7,33
191201703,7,0,4,2,6,19
191201704,6,0,4,3,0,13
191201705,4,2,7,1,6,20
191201706,3,0,9,2,0,14
191201707,9,1,3,3,5,21
191201708,9,2,6,7,9,33
191201709,1,3,5,5,8,22
191201710,8,1,5,7,5,26
191201711,6,7,6,5,8,32
191201712,4,8,2,5,9,28
191201713,2,5,3,2,0,12
191201714,5,3,3,1,4,16
191201715,4,4,5,1,9,23
191201716,6,2,1,9,9,27
191201717,6,7,4,5,8,30
191201718,0,4,4,1,7,16
191201719,8,3,8,0,7,26
191201720,4,6,1,5,7,23
191201721,0,5,9,1,0,15
191201722,9,8,6,0,5,28
191201723,3,1,4,0,4,12
191201724,6,8,8,1,5,28
191201725,3,4,4,4,3,18
191201726,0,3,3,8,2,16
191201727,3,6,6,2,4,21
191201728,4,7,9,8,8,36
191201729,8,3,8,4,5,28
191201730,4,2,7,0,0,13
191201731,3,7,8,6,4,28
191201732,0,6,1,4,7,18
191201733,1,4,9,7,3,24
191201734,4,8,4,3,1,20
191201735,0,1,1,2,4,8
191201736,8,1,3,0,7,19
191201737,9,6,1,0,6,22
191201738,6,2,2,1,9,20
191201739,0,8,7,1,4,20
191201740,0,8,0,5,3,16
191201741,5,8,1,2,0,16
191201742,1,8,4,1,8,22
191201743,3,6,1,7,5,22
191201744,3,8,0,8,1,20
191201745,5,4,4,2,1,16
191201746,3,5,5,1,6,20
191201747,5,5,8,3,5,26
191201748,9,3,9,8,3,32
191201749,8,4,8,7,9,36
191201750,3,0,1,8,2,14
191201751,1,5,2,8,0,16
191201752,3,1,6,2,8,20
191201753,4,5,6,1,8,24
191201754,3,2,3,5,6,19
191201755,4,0,8,7,5,24
191201756,1,4,2,9,2,18
191201757,4,2,9,3,4,22
191201758,0,1,7,6,9,23
191201759,8,6,7,1,9,31
191201760,0,8,6,6,1,21
191201761,8,3,3,6,2,22
191201762,4,1,5,7,5,22
191201763,6,8,7,0,7,28
191201764,1,4,7,3,7,22
191201765,0,0,6,6,1,13
191201766,6,5,3,8,9,31
191201767,6,8,6,8,9,37
191201768,2,0,8,0,6,16
191201769,9,9,0,3,2,23
191201770,2,3,1,2,8,16
191201771,1,6,1,4,5,17
191201772,7,4,8,0,9,28
191201773,3,4,6,4,5,22
191201774,3,2,0,3,1,9
191201775,5,8,6,7,2,28
191201776,8,6,6,7,7,34
191201777,8,3,5,0,4,20
191201778,6,8,8,5,3,30
191201779,4,9,1,7,5,26
191201780,3,6,5,9,8,31
191201781,1,2,6,2,0,11
191201782,0,0,4,8,6,18
191201783,8,9,7,0,7,31
191201784,6,1,7,9,3,26
191201785,5,6,4,7,9,31
191201786,4,5,6,5,5,25
191201787,6,3,5,8,2,24
191201788,2,2,5,4,9,22
191201789,7,6,8,3,7,31
191201790,9,9,7,9,2,36
191201791,0,5,4,6,6,21
191201792,3,4,7,7,3,24
191201793,7,2,9,6,9,33
191201794,0,0,7,7,8,22
191201795,4,1,3,4,8,20
191201796,6,1,3,1,6,17
191201797,9,3,0,4,4,20
191201798,4,5,5,1,4,19
191201799,8,4,3,4,7,26
191201800,0,2,1,8,8,19
191201801,2,2,5,3,7,19
191201802,1,7,5,9,2,24
191201803,9,1,2,8,1,21
191201804,0,0,5,1,1,7
191201805,6,3,3,9,5,26
191201806,5,1,6,2,3,17
191201807,1,6,7,6,8,28
191201808,5,3,7,0,7,22
191201809,9,7,0,8,5,29
191201810,9,2,1,2,3,17
191201811,7,4,3,9,0,23
191201812,7,7,0,0,6,20
191201813,5,5,8,9,4,31
191201814,0,0,4,9,1,14
191201815,8,9,6,8,1,32
191201816,3,2,7,8,5,25
191201817,5,5,9,5,5,29
191201818,7,4,2,2,4,19
191201819,5,3,1,9,0,18
191201820,4,0,5,8,3,20
191201821,9,6,9,7,3,34
191201822,4,1,2,9,2,18
191201823,2,8,5,9,2,26
191201824,5,6,8,4,7,30
191201825,0,4,4,8,5,21
191201826,5,2,6,9,7,29
191201827,4,5,7,2,9,27
191201828,3,5,0,2,8,18
191201829,2,9,0,4,3,18
191201830,0,3,3,7,8,21
191201831,6,9,4,1,9,29
191201832,8,7,1,7,5,28
191201833,5,2,3,6,6,22
191201834,7,5,2,6,7,27
191201835,4,5,2,2,3,16
191201836,6,5,5,5,4,25
191201837,6,3,5,2,4,20
191201838,8,3,5,2,1,19
191201839,0,6,5,4,9,24
191201840,0,6,4,5,5,20
191201841,9,3,9,0,9,30
191201842,1,9,4,1,7,22
191201843,4,9,2,5,2,22
191201844,1,2,4,7,7,21
191201845,1,6,2,2,9,20
191201846,7,8,8,2,1,26
191201847,3,1,8,2,9,23
191201848,0,5,4,4,0,13
191201849,5,2,2,1,0,10
191201850,9,8,6,3,3,29
191201851,1,0,7,6,7,21
191201852,1,8,3,1,7,20
191201853,5,3,7,5,9,29
191201854,4,7,0,9,4,24
191201855,9,5,3,4,1,22
191201856,6,9,8,2,6,31
191201857,7,9,3,5,5,29
191201858,8,8,1,3,5,25
191201859,0,6,1,4,2,13
191201860,2,8,1,4,4,19
191201861,4,8,8,1,7,28
191201862,3,3,6,1,3,16
191201863,4,8,8,7,2,29
191201864,4,2,0,0,4,10
191201865,7,2,1,2,5,17
191201866,5,5,4,2,1,17
191201867,1,5,4,1,9,20
191201868,9,1,1,3,9,23
191201869,6,0,8,5,3,22
191201870,8,8,6,5,5,32
191201871,8,1,7,6,5,27
191201872,3,9,1,3,2,18
191201873,5,0,4,0,2,11
191201874,3,8,1,2,0,14
191201875,5,6,7,2,4,24
191201876,2,1,4,5,2,14
191201877,1,2,2,5,7,17
191201878,1,7,9,0,3,20
191201879,2,5,1,3,4,15
191201880,8,1,0,6,7,22
191201881,2,6,2,0,2,12
191201882,0,1,2,8,7,18
191201883,2,9,6,9,8,34
191201884,9,3,6,1,9,28
191201885,8,4,6,4,7,29
191201886,0,0,2,9,0,11
191201887,4,3,8,2,7,24
191201888,9,0,3,0,1,13
191201889,3,6,0,0,7,16
191201890,1,2,6,2,8,19
191201891,1,6,2,1,4,14
191201892,3,7,4,8,5,27
191201893,9,7,9,4,7,36
191201894,5,6,0,4,6,21
191201895,2,9,5,5,6,27
191201896,4,7,9,6,9,35
191201897,0,5,4,2,7,18
191201898,8,0,0,7,3,18
191201899,0,8,5,1,1,15
191201900,3,8,4,5,0,20
191201901,7,7,6,8,3,31
191201902,8,6,3,9,0,26
191201903,6,0,1,0,9,16
191201904,0,8,8,7,6,29
191201905,8,8,4,5,8,33
191201906,7,7,1,0,8,23
191201907,7,2,2,8,2,21
191201908,3,5,4,4,9,25
191201909,4,9,9,0,9,31
191201910,3,4,8,4,6,25
191201911,7,5,4,5,8,29
191201912,1,0,5,8,4,18
191201913,7,3,2,2,8,22
191201914,6,7,7,8,3,31
191201915,3,1,9,4,8,25
191201916,6,1,0,5,8,20
191201917,7,6,1,5,6,25
191201918,1,9,5,7,0,22
191201919,5,9,4,2,0,20
191201920,7,1,4,9,6,27
191201921,6,6,3,5,7,27
191201922,0,8,5,0,3,16
191201923,0,1,0,5,7,13
191201924,9,2,1,5,2,19
191201925,9,3,5,8,8,33
191201926,1,1,5,3,6,16
191201927,5,6,9,3,4,27
191201928,7,5,8,5,7,32
191201929,6,0,9,5,0,20
191201930,9,0,8,1,5,23
191201931,9,8,2,8,7,34
191201932,6,7,9,9,9,40
191201933,9,4,5,0,2,20
191201934,3,7,0,1,9,20
191201935,4,5,1,3,8,21
191201936,7,4,2,7,9,29
191201937,0,3,1,0,5,9
191201938,1,9,1,1,2,14
191201939,7,7,2,7,6,29
191201940,3,8,6,3,2,22
191201941,7,0,2,2,8,19
191201942,6,9,4,8,7,34
191201943,6,2,2,8,6,24
191201944,6,5,4,5,5,25
191201945,6,1,5,8,9,29
191201946,9,7,8,0,6,30
191201947,8,0,5,8,3,24
191201948,4,7,6,0,3,20
191201949,0,3,7,5,6,21
191201950,2,1,5,6,8,22
191201951,4,3,7,7,2,23
191201952,9,9,4,6,0,28
191201953,6,8,8,0,9,31
191201954,7,2,8,3,3,23
191201955,3,8,3,7,1,22
191201956,9,3,6,7,6,31
191201957,9,7,5,0,6,27
191201958,9,4,6,2,8,29
191201959,7,9,2,5,8,31
191201960,9,2,1,8,3,23
191201961,9,5,8,8,2,32
191201962,2,7,3,7,9,28
191201963,9,5,5,2,3,24
191201964,9,1,6,4,1,21
191201965,1,9,2,2,1,15
191201966,5,8,3,8,7,31
191201967,0,5,3,3,7,18
191201968,3,4,3,5,6,21
191201969,4,5,4,0,0,13
191201970,8,2,6,5,6,27
191201971,2,0,0,5,8,15
191201972,9,9,0,9,6,33
191201973,3,0,7,8,9,27
191201974,8,5,4,6,6,29
191201975,9,7,3,1,4,24
191201976,0,4,6,5,4,19
191201977,4,4,8,2,7,25
191201978,3,0,0,3,1,7
191201979,1,6,4,8,9,28
191201980,7,4,5,6,5,27
191201981,6,2,6,0,1,15
191201982,1,4,1,9,9,24
191201983,2,1,3,6,1,13
191201984,8,6,0,3,7,24
191201985,0,5,5,3,8,21
191201986,2,9,8,6,4,29
191201987,1,6,8,5,3,23
191201988,1,0,4,9,9,23
191201989,6,0,9,2,9,26
191201990,0,3,9,9,9,30
191201991,8,8,8,3,5,32
191201992,7,0,5,1,8,21
191201993,9,7,7,9,4,36
191201994,9,4,6,7,9,35
191201995,6,8,3,6,6,29
191201996,2,8,7,3,3,23
191201997,0,3,1,8,3,15
191201998,4,4,8,2,8,26
191201999,2,7,9,3,4,25
1912011000,0,9,2,2,8,21
1912011001,1,9,1,1,1,13
1912011002,0,0,4,4,0,8
1912011003,6,4,6,9,4,29
1912011004,5,4,6,7,1,23
1912011005,9,2,8,5,1,25
1912011006,9,1,0,4,9,23
1912011007,9,2,4,4,8,27
1912011008,1,5,8,2,4,20
1912011009,6,1,5,7,7,26
1912011010,8,8,5,5,1,27
1912011011,5,1,9,7,8,30
1912011012,3,6,4,5,8,26
1912011013,1,2,8,1,0,12
1912011014,5,9,2,3,3,22
1912011015,0,9,6,4,6,25
1912011016,8,1,5,6,9,29
1912011017,2,1,0,9,4,16
1912011018,3,6,6,2,7,24
1912011019,9,1,0,8,7,25
1912011020,3,3,5,4,3,18
1912011021,3,9,5,4,1,22
1912011022,9,4,1,5,9,28
1912011023,7,4,9,7,3,30
1912011024,7,9,3,2,2,23
1912011025,5,1,4,2,3,15
1912011026,9,9,5,5,7,35
1912011027,4,4,4,2,1,15
1912011028,8,4,0,6,6,24
1912011029,2,4,1,6,7,20
1912011030,1,2,7,8,3,21
1912011031,7,6,5,2,9,29
1912011032,9,7,3,4,2,25
1912011033,5,0,0,1,4,10
1912011034,6,7,6,2,8,29
1912011035,0,5,7,6,7,25
1912011036,6,7,7,6,1,27
1912011037,3,3,3,6,9,24
1912011038,6,4,7,1,4,22
1912011039,2,9,4,1,0,16
1912011040,2,1,0,2,5,10
1912011041,6,9,3,1,4,23
1912011042,5,0,2,7,5,19
1912011043,2,9,6,9,6,32
1912011044,6,0,7,1,9,23
1912011045,6,7,6,7,5,31
1912011046,3,1,0,1,6,11
1912011047,2,6,2,3,0,13
1912011048,0,0,6,8,4,18
1912011049,8,4,0,5,1,18
1912011050,7,3,6,4,6,26
1912011051,9,6,5,2,8,30
1912011052,2,5,2,2,1,12
1912011053,4,8,4,8,0,24
1912011054,5,7,2,5,1,20
1912011055,3,6,6,6,0,21
1912011056,7,1,9,4,6,27
1912011057,1,3,6,7,3,20
1912011058,4,5,6,1,6,22
1912011059,2,0,8,6,5,21
1912011060,8,6,8,7,5,34
1912011061,7,0,8,6,5,26
1912011062,3,3,5,6,1,18
1912011063,6,5,1,9,1,22
1912011064,5,2,9,7,7,30
1912011065,1,5,7,3,5,21
1912011066,1,7,0,9,5,22
1912011067,8,9,8,4,0,29
1912011068,0,0,6,0,2,8
1912011069,2,0,4,0,9,15
1912011070,9,9,3,0,2,23
1912011071,1,4,4,9,3,21
1912011072,5,3,6,4,0,18
1912011073,4,7,0,1,4,16
1912011074,8,6,6,9,8,37
1912011075,4,2,2,5,6,19
1912011076,2,7,0,4,7,20
1912011077,5,1,1,2,1,10
1912011078,1,3,4,8,7,23
1912011079,8,9,4,0,8,29
1912011080,5,8,5,4,1,23
1912011081,4,4,7,5,5,25
1912011082,3,0,5,3,8,19
1912011083,7,7,1,3,8,26
1912011084,8,2,4,0,9,23
1912011085,0,6,8,2,8,24
1912011086,5,7,8,5,2,27
1912011087,1,7,6,6,1,21
1912011088,5,2,0,1,0,8
1912011089,0,5,7,2,3,17
1912011090,4,5,4,9,7,29
1912011091,9,0,5,5,2,21
1912011092,6,0,0,2,7,15
1912011093,2,0,3,4,3,12
1912011094,8,0,5,5,9,27
1912011095,2,0,8,0,0,10
1912011096,6,4,2,1,6,19
1912011097,4,6,3,7,6,26
1912011098,9,2,1,6,0,18
1912011099,1,0,4,6,6,17
1912011100,6,3,5,7,7,28
1912011101,7,4,9,5,4,29
1912011102,4,1,1,1,1,8
1912011103,1,8,1,2,5,17
1912011104,7,0,6,2,7,22
1912011105,3,0,8,2,4,17
191202001,8,1,5,5,1,20
191202002,1,9,3,2,7,22
191202003,0,3,6,8,3,20
191202004,1,6,1,3,0,11
191202005,0,6,6,9,7,28
191202006,7,5,4,4,3,23
191202007,7,6,9,4,3,29
191202008,0,3,1,9,4,17
191202009,9,5,0,0,1,15
191202010,2,9,6,7,3,27
191202011,3,7,4,2,9,25
191202012,4,6,8,5,0,23
191202013,1,5,2,3,2,13
191202014,9,2,3,6,1,21
191202015,7,0,5,6,5,23
191202016,0,7,8,2,3,20
191202017,4,0,8,2,3,17
191202018,4,7,8,7,7,33
191202019,6,7,4,8,6,31
191202020,5,6,8,9,1,29
191202021,8,2,0,3,2,15
191202022,7,9,5,8,7,36
191202023,5,5,1,3,6,20
191202024,1,5,8,9,5,28
191202025,0,9,2,6,0,17
191202026,7,4,6,5,2,24
191202027,1,6,6,7,4,24
191202028,9,7,2,0,0,18
191202029,1,1,7,3,6,18
191202030,8,9,9,1,2,29
191202031,9,6,9,1,3,28
191202032,4,6,2,0,9,21
191202033,8,2,9,6,7,32
191202034,7,4,6,9,3,29
191202035,8,6,6,0,9,29
191202036,8,3,5,3,2,21
191202037,7,6,1,1,4,19
191202038,0,8,3,9,9,29
191202039,4,7,0,5,6,22
191202040,2,3,5,5,8,23
191202041,5,3,2,2,5,17
191202042,5,1,0,4,2,12
191202043,8,5,5,0,6,24
191202044,3,3,9,5,6,26
191202045,9,4,6,7,3,29
191202046,4,0,2,5,3,14
191202047,5,1,8,6,2,22
191202048,2,7,8,8,1,26
191202049,5,1,3,1,4,14
191202050,0,3,1,8,4,16
191202051,9,7,0,2,4,22
191202052,8,2,1,5,3,19
191202053,1,1,0,3,0,5
191202054,5,3,0,7,8,23
191202055,0,0,8,9,7,24
191202056,1,1,3,9,0,14
191202057,6,0,4,4,6,20
191202058,5,3,6,4,3,21
191202059,1,5,2,4,5,17
191202060,8,5,1,6,9,29
191202061,3,8,5,3,9,28
191202062,7,6,1,1,7,22
191202063,5,4,6,2,2,19
191202064,6,9,5,4,6,30
191202065,1,4,6,6,4,21
191202066,5,9,3,9,5,31
191202067,9,9,8,6,5,37
191202068,3,6,6,8,1,24
191202069,5,4,0,8,4,21
191202070,2,9,6,2,5,24
191202071,5,4,3,8,7,27
191202072,1,3,3,9,3,19
191202073,0,3,3,4,4,14
191202074,7,1,3,2,5,18
191202075,0,4,7,2,8,21
191202076,3,4,5,0,4,16
191202077,1,3,3,9,8,24
191202078,8,7,5,7,9,36
191202079,4,5,3,4,2,18
191202080,0,6,0,0,8,14
191202081,1,0,4,6,0,11
191202082,5,6,6,4,7,28
191202083,8,6,4,0,5,23
191202084,3,3,4,6,8,24
191202085,7,2,0,1,9,19
191202086,6,7,6,6,0,25
191202087,0,2,2,5,1,10
191202088,9,3,1,7,6,26
191202089,4,4,6,5,6,25
191202090,2,0,8,3,2,15
191202091,5,4,6,3,2,20
191202092,0,3,1,9,2,15
191202093,3,9,1,8,8,29
191202094,3,5,8,2,1,19
191202095,6,6,7,0,2,21
191202096,2,7,5,1,4,19
191202097,0,1,3,8,2,14
191202098,5,4,2,4,5,20
191202099,1,6,3,4,7,21
191202100,4,2,2,1,4,13
191202101,4,5,2,8,2,21
191202102,5,2,7,8,7,29
191202103,8,2,7,2,0,19
191202104,2,2,5,4,4,17
191202105,5,8,5,9,7,34
191202106,6,6,4,3,6,25
191202107,1,9,2,5,2,19
191202108,5,3,8,3,4,23
191202109,4,7,0,9,0,20
191202110,0,1,0,1,5,7
191202111,7,6,2,6,8,29
191202112,3,5,0,6,1,15
191202113,3,7,3,8,1,22
191202114,1,7,5,6,5,24
191202115,7,1,4,7,2,21
191202116,6,8,6,9,0,29
191202117,0,0,0,2,2,4
191202118,2,0,5,7,5,19
191202119,0,9,1,7,5,22
191202120,8,8,1,8,7,32
191202121,4,3,0,7,0,14
191202122,2,5,1,1,3,12
191202123,8,0,6,1,8,23
191202124,6,8,0,6,5,25
191202125,2,4,4,5,0,15
191202126,3,8,6,6,8,31
191202127,5,2,0,4,9,20
191202128,7,2,9,5,4,27
191202129,1,2,9,1,9,22
191202130,4,0,8,3,4,19
191202131,8,4,5,3,8,28
191202132,6,1,0,2,3,12
191202133,8,6,1,2,6,23
191202134,4,0,0,2,0,6
191202135,3,0,1,6,7,17
191202136,9,0,1,9,2,21
191202137,2,9,3,7,6,27
191202138,4,0,3,9,5,21
191202139,6,3,0,0,5,14
191202140,6,4,6,5,9,30
191202141,6,8,5,5,1,25
191202142,0,8,1,2,8,19
191202143,0,6,7,3,7,23
191202144,7,0,8,0,7,22
191202145,2,6,6,4,5,23
191202146,4,2,7,5,6,24
191202147,7,9,4,2,5,27
191202148,1,9,8,3,7,28
191202149,6,2,5,1,3,17
191202150,3,2,5,6,8,24
191202151,4,6,7,8,4,29
191202152,2,9,3,7,8,29
191202153,1,8,2,9,2,22
191202154,6,7,8,5,6,32
191202155,0,9,9,2,0,20
191202156,7,3,7,1,2,20
191202157,0,2,3,2,7,14
191202158,9,1,5,0,2,17
191202159,3,8,9,4,2,26
191202160,5,9,5,0,0,19
191202161,7,6,6,0,5,24
191202162,3,4,2,8,1,18
191202163,1,1,3,1,6,12
191202164,2,3,7,4,0,16
191202165,7,3,9,6,8,33
191202166,6,4,5,7,6,28
191202167,8,4,8,3,5,28
191202168,4,8,5,6,2,25
191202169,0,7,5,7,2,21
191202170,5,2,6,8,6,27
191202171,8,8,7,1,3,27
191202172,7,8,8,8,8,39
191202173,0,3,0,5,2,10
191202174,8,7,7,3,8,33
191202175,4,5,8,8,4,29
191202176,3,8,4,3,4,22
191202177,4,6,3,3,1,17
191202178,2,7,2,7,5,23
191202179,0,9,2,6,4,21
191202180,1,5,1,0,5,12
191202181,6,8,5,9,8,36
191202182,0,2,1,9,7,19
191202183,2,2,9,4,0,17
191202184,4,1,9,0,8,22
191202185,9,3,3,2,8,25
191202186,0,1,8,6,1,16
191202187,9,4,4,7,9,33
191202188,8,7,8,5,9,37
191202189,7,3,4,7,8,29
191202190,3,6,0,2,5,16
191202191,0,0,1,3,6,10
191202192,0,5,6,0,1,12
191202193,1,9,3,7,8,28
191202194,1,6,0,7,0,14
191202195,9,3,3,8,6,29
191202196,8,3,1,3,2,17
191202197,1,5,1,9,4,20
191202198,6,9,8,9,7,39
191202199,6,4,4,3,3,20
191202200,9,1,1,0,5,16
191202201,1,0,6,6,3,16
191202202,0,4,8,9,5,26
191202203,1,2,5,4,6,18
191202204,4,6,1,3,6,20
191202205,9,3,1,9,9,31
191202206,6,1,7,0,3,17
191202207,9,0,0,7,9,25
191202208,1,2,7,1,5,16
191202209,1,3,0,8,8,20
191202210,5,2,7,2,0,16
191202211,4,9,4,6,4,27
191202212,3,0,0,9,0,12
191202213,7,6,0,3,1,17
191202214,4,2,4,2,9,21
191202215,7,6,4,5,6,28
191202216,3,0,6,4,4,17
191202217,8,7,5,5,3,28
191202218,9,3,4,0,2,18
191202219,4,9,2,8,6,29
191202220,7,1,9,9,7,33
191202221,5,5,9,4,0,23
191202222,4,4,5,6,0,19
191202223,5,8,1,6,0,20
191202224,0,0,0,4,3,7
191202225,5,8,8,2,9,32
191202226,3,7,7,8,2,27
191202227,9,4,6,0,0,19
191202228,6,3,9,8,2,28
191202229,5,0,7,9,1,22
191202230,5,3,0,9,3,20
191202231,8,8,2,8,3,29
191202232,5,0,1,5,9,20
191202233,1,4,6,9,0,20
191202234,0,8,4,7,9,28
191202235,3,8,1,6,3,21
191202236,7,7,5,7,1,27
191202237,9,5,5,5,5,29
191202238,7,1,3,5,6,22
191202239,7,2,4,8,7,28
191202240,3,0,9,4,5,21
191202241,3,1,7,4,0,15
191202242,4,2,3,7,4,20
191202243,1,5,9,5,2,22
191202244,7,9,7,6,9,38
191202245,9,1,0,8,8,26
191202246,7,3,1,0,4,15
191202247,7,3,8,6,1,25
191202248,3,7,2,3,9,24
191202249,5,9,3,4,0,21
191202250,8,2,4,0,8,22
191202251,8,8,8,9,0,33
191202252,4,3,6,6,5,24
191202253,3,5,3,4,2,17
191202254,0,8,9,8,8,33
191202255,8,1,6,7,3,25
191202256,9,5,7,6,0,27
191202257,6,8,4,9,1,28
191202258,1,2,3,1,1,8
191202259,6,9,3,9,6,33
191202260,3,3,5,9,0,20
191202261,4,3,5,5,6,23
191202262,1,0,6,7,9,23
191202263,4,1,1,7,8,21
191202264,3,4,5,2,9,23
191202265,0,9,8,2,0,19
191202266,3,5,2,1,3,14
191202267,6,2,2,1,2,13
191202268,6,9,1,0,2,18
191202269,2,1,9,1,3,16
191202270,7,3,1,1,8,20
191202271,9,8,5,1,7,30
191202272,2,7,4,8,9,30
191202273,9,0,7,2,0,18
191202274,2,9,7,5,3,26
191202275,1,6,6,7,0,20
191202276,6,2,5,0,9,22
191202277,9,0,3,1,2,15
191202278,3,6,3,2,9,23
191202279,5,5,4,9,2,25
191202280,0,0,2,5,1,8
191202281,6,9,7,8,5,35
191202282,4,8,6,5,3,26
191202283,1,6,2,0,7,16
191202284,0,2,1,5,9,17
191202285,3,4,8,3,7,25
191202286,0,0,7,9,1,17
191202287,9,3,0,5,1,18
191202288,2,8,7,7,1,25
191202289,3,3,7,8,8,29
191202290,1,6,0,6,2,15
191202291,9,0,7,5,7,28
191202292,0,0,5,7,0,12
191202293,7,3,9,2,3,24
191202294,9,8,0,8,7,32
191202295,1,7,8,2,6,24
191202296,5,7,7,0,1,20
191202297,8,3,0,6,4,21
191202298,6,2,1,1,8,18
191202299,0,1,1,9,2,13
191202300,2,2,2,5,6,17
191202301,5,1,6,9,5,26
191202302,7,0,9,6,1,23
191202303,0,0,1,4,1,6
191202304,3,8,2,1,2,16
191202305,8,8,4,4,7,31
191202306,1,3,8,7,2,21
191202307,5,0,9,3,9,26
191202308,6,2,6,2,6,22
191202309,7,5,7,2,6,27
191202310,5,1,3,3,3,15
191202311,0,1,2,5,0,8
191202312,2,9,9,6,5,31
191202313,5,7,3,5,5,25
191202314,9,5,6,6,4,30
191202315,5,6,1,6,9,27
191202316,2,2,1,2,0,7
191202317,7,8,7,1,3,26
191202318,8,2,9,3,7,29
191202319,1,3,0,7,7,18
191202320,6,6,9,1,1,23
191202321,0,7,5,4,3,19
191202322,1,8,0,0,4,13
191202323,1,8,9,4,2,24
191202324,4,5,9,3,2,23
191202325,2,3,3,9,8,25
191202326,8,8,9,9,1,35
191202327,2,8,0,3,1,14
191202328,5,7,4,1,8,25
191202329,0,6,1,5,4,16
191202330,9,7,7,3,5,31
191202331,6,8,0,3,5,22
191202332,1,5,3,1,6,16
191202333,3,6,8,3,0,20
191202334,5,8,0,8,1,22
191202335,3,8,1,1,6,19
191202336,4,5,9,8,7,33
191202337,7,9,8,6,1,31
191202338,2,8,7,5,0,22
191202339,0,6,3,5,0,14
191202340,8,1,3,1,9,22
191202341,8,2,5,6,6,27
191202342,3,1,7,1,4,16
191202343,3,3,8,5,2,21
191202344,2,9,6,3,3,23
191202345,8,4,2,4,3,21
191202346,5,2,9,6,2,24
191202347,1,0,9,8,0,18
191202348,1,1,0,4,7,13
191202349,6,5,0,6,2,19
191202350,1,7,0,3,9,20
191202351,8,1,8,6,0,23
191202352,5,8,0,7,1,21
191202353,9,0,9,1,0,19
191202354,7,0,7,0,1,15
191202355,4,8,1,0,2,15
191202356,2,6,3,5,8,24
191202357,4,2,1,2,5,14
191202358,1,9,4,9,6,29
191202359,4,3,0,5,9,21
191202360,8,9,2,0,6,25
191202361,3,1,6,3,2,15
191202362,2,2,2,5,2,13
191202363,8,3,2,9,4,26
191202364,3,2,0,7,7,19
191202365,0,4,3,8,0,15
191202366,8,0,9,7,1,25
191202367,8,7,4,7,5,31
191202368,9,2,5,6,9,31
191202369,9,7,3,3,7,29
191202370,5,0,1,3,9,18
191202371,8,8,0,4,6,26
191202372,5,2,5,6,4,22
191202373,7,0,3,5,1,16
191202374,5,2,2,5,2,16
191202375,2,9,9,7,8,35
191202376,4,0,8,1,0,13
191202377,1,6,8,8,5,28
191202378,8,7,3,6,1,25
191202379,3,0,0,0,6,9
191202380,1,2,1,7,8,19
191202381,6,0,7,2,4,19
191202382,6,4,8,8,1,27
191202383,6,6,4,0,4,20
191202384,0,0,1,7,5,13
191202385,9,3,7,4,1,24
191202386,3,4,8,7,3,25
191202387,8,0,3,8,0,19
191202388,6,8,4,4,0,22
191202389,6,6,5,4,8,29
191202390,9,0,5,5,9,28
191202391,4,7,3,3,0,17
191202392,6,9,1,7,7,30
191202393,3,2,1,1,9,16
191202394,0,0,8,3,6,17
191202395,5,8,7,6,8,34
191202396,7,3,1,0,3,14
191202397,6,2,8,6,1,23
191202398,6,9,6,2,2,25
191202399,4,0,1,6,2,13
191202400,0,2,5,6,1,14
191202401,4,4,2,7,1,18
191202402,9,7,0,6,7,29
191202403,5,9,4,6,4,28
191202404,5,4,4,0,7,20
191202405,1,4,2,3,7,17
191202406,1,2,3,5,5,16
191202407,9,6,1,2,5,23
191202408,3,9,7,5,1,25
191202409,2,1,4,7,2,16
191202410,7,1,0,8,1,17
191202411,1,9,4,3,9,26
191202412,4,6,1,8,8,27
191202413,5,5,0,6,3,19
191202414,2,1,2,7,5,17
191202415,6,5,1,1,8,21
191202416,0,8,4,8,3,23
191202417,1,0,9,1,3,14
191202418,4,7,5,6,2,24
191202419,4,4,6,8,4,26
191202420,9,1,5,5,3,23
191202421,4,1,8,8,9,30
191202422,8,6,9,9,6,38
191202423,2,0,0,9,9,20
191202424,9,5,3,1,9,27
191202425,4,4,0,0,1,9
191202426,5,1,0,5,5,16
191202427,2,6,8,0,1,17
191202428,1,0,5,5,7,18
191202429,4,2,2,7,6,21
191202430,4,2,4,6,5,21
191202431,6,7,8,8,2,31
191202432,7,3,1,7,9,27
191202433,4,2,8,8,3,25
191202434,5,0,7,4,1,17
191202435,5,0,2,0,2,9
191202436,3,1,9,8,5,26
191202437,5,2,5,2,1,15
191202438,4,6,8,2,3,23
191202439,2,2,9,9,8,30
191202440,4,5,4,5,0,18
191202441,5,0,1,4,8,18
191202442,5,9,0,8,8,30
191202443,6,6,3,7,7,29
191202444,5,2,6,1,1,15
191202445,4,7,8,5,0,24
191202446,3,3,4,4,7,21
191202447,1,1,0,2,7,11
191202448,8,4,3,6,4,25
191202449,7,2,5,7,0,21
191202450,1,9,5,4,1,20
191202451,2,5,0,0,1,8
191202452,2,5,8,0,0,15
191202453,0,8,8,5,2,23
191202454,1,1,7,3,8,20
191202455,1,1,9,9,4,24
191202456,8,8,2,2,7,27
191202457,4,0,6,2,8,20
191202458,1,0,8,2,6,17
191202459,9,1,4,6,2,22
191202460,4,4,2,2,4,16
191202461,0,8,6,5,4,23
191202462,2,0,1,7,2,12
191202463,4,3,7,1,0,15
191202464,2,0,4,9,4,19
191202465,9,7,8,8,8,40
191202466,5,6,9,5,1,26
191202467,6,3,1,1,6,17
191202468,4,6,7,0,2,19
191202469,0,6,9,3,6,24
191202470,4,8,3,9,0,24
191202471,8,9,9,1,1,28
191202472,7,8,0,2,7,24
191202473,9,3,9,4,7,32
191202474,2,0,6,3,2,13
191202475,8,6,4,8,4,30
191202476,5,7,1,4,0,17
191202477,3,8,6,5,4,26
191202478,1,0,0,3,7,11
191202479,3,9,0,8,2,22
191202480,0,2,5,8,7,22
191202481,6,2,2,6,3,19
191202482,0,1,6,2,4,13
191202483,4,6,6,5,0,21
191202484,3,6,2,4,3,18
191202485,4,7,8,6,6,31
191202486,6,6,0,0,4,16
191202487,2,2,9,4,8,25
191202488,5,4,4,9,7,29
191202489,5,2,9,0,5,21
191202490,8,0,7,9,8,32
191202491,1,8,3,8,6,26
191202492,6,9,3,5,6,29
191202493,2,0,7,1,6,16
191202494,5,2,6,2,8,23
191202495,2,4,8,0,7,21
191202496,9,9,1,7,6,32
191202497,9,3,1,7,3,23
191202498,1,9,3,0,6,19
191202499,1,3,7,0,1,12
191202500,8,8,8,8,6,38
191202501,4,5,0,2,1,12
191202502,4,2,7,8,6,27
191202503,9,1,1,3,2,16
191202504,2,5,2,8,7,24
191202505,8,0,3,3,4,18
191202506,0,2,0,7,4,13
191202507,6,0,4,2,9,21
191202508,6,9,8,7,0,30
191202509,2,9,1,1,7,20
191202510,4,1,4,8,2,19
191202511,0,9,6,9,5,29
191202512,5,8,5,5,1,24
191202513,7,7,0,9,1,24
191202514,2,0,2,6,2,12
191202515,2,6,2,1,9,20
191202516,1,3,0,0,1,5
191202517,8,2,5,3,7,25
191202518,1,6,5,6,2,20
191202519,9,9,7,3,4,32
191202520,7,2,7,6,0,22
191202521,6,7,6,1,2,22
191202522,1,8,3,7,3,22
191202523,4,9,6,0,3,22
191202524,2,1,7,6,4,20
191202525,6,3,4,0,2,15
191202526,4,4,6,9,4,27
191202527,9,2,1,3,4,19
191202528,3,3,7,6,3,22
191202529,9,9,0,7,0,25
191202530,1,2,9,4,6,22
191202531,1,1,6,4,8,20
191202532,4,6,1,0,2,13
191202533,9,7,0,8,2,26
191202534,0,8,4,1,6,19
191202535,7,9,2,4,3,25
191202536,7,8,7,0,9,31
191202537,3,8,5,7,6,29
191202538,4,2,2,1,2,11
191202539,3,9,0,3,5,20
191202540,0,8,5,5,3,21
191202541,1,9,8,9,1,28
191202542,4,3,3,0,6,16
191202543,5,5,9,7,1,27
191202544,6,3,6,7,1,23
191202545,8,1,3,0,3,15
191202546,4,6,3,4,4,21
191202547,8,2,9,1,8,28
191202548,3,8,9,1,3,24
191202549,1,4,4,2,7,18
191202550,8,2,9,3,0,22
191202551,7,1,3,9,3,23
191202552,1,7,0,5,4,17
191202553,8,1,6,1,9,25
191202554,1,8,8,4,0,21
191202555,4,3,1,8,0,16
191202556,3,6,3,6,5,23
191202557,3,1,6,1,2,13
191202558,8,8,3,4,6,29
191202559,0,1,5,1,1,8
191202560,9,3,8,0,2,22
191202561,1,8,5,5,2,21
191202562,5,8,1,7,2,23
191202563,4,3,3,5,1,16
191202564,0,7,6,9,1,23
191202565,4,1,9,9,4,27
191202566,1,6,7,0,6,20
191202567,0,4,3,9,1,17
191202568,3,2,8,9,0,22
191202569,5,9,0,9,9,32
191202570,7,1,6,6,6,26
191202571,5,2,3,3,0,13
191202572,9,9,1,2,9,30
191202573,5,1,8,5,5,24
191202574,8,1,1,0,4,14
191202575,3,1,9,2,6,21
191202576,4,2,3,8,8,25
191202577,7,8,7,3,6,31
191202578,8,6,6,1,0,21
191202579,0,3,0,4,9,16
191202580,4,6,2,3,5,20
191202581,7,5,9,3,0,24
191202582,1,5,2,6,2,16
191202583,2,5,0,1,2,10
191202584,0,6,0,5,7,18
191202585,9,2,9,7,6,33
191202586,8,0,4,0,2,14
191202587,5,6,2,6,0,19
191202588,3,4,6,2,3,18
191202589,8,2,6,4,7,27
191202590,7,8,3,0,3,21
191202591,9,6,2,3,5,25
191202592,4,1,4,4,9,22
191202593,6,8,3,5,3,25
191202594,1,7,7,6,4,25
191202595,9,3,9,8,9,38
191202596,4,6,2,0,2,14
191202597,6,6,2,7,2,23
191202598,4,5,6,0,4,19
191202599,8,6,6,4,9,33
191202600,5,8,6,2,5,26
191202601,1,8,5,3,4,21
191202602,2,7,9,5,6,29
191202603,0,2,0,8,4,14
191202604,9,3,7,9,3,31
191202605,7,7,1,3,5,23
191202606,0,1,2,4,2,9
191202607,9,1,2,0,6,18
191202608,7,7,0,8,1,23
191202609,8,0,5,2,4,19
191202610,8,9,5,1,6,29
191202611,2,6,9,6,3,26
191202612,6,3,9,6,3,27
191202613,7,9,2,3,7,28
191202614,8,0,2,5,7,22
191202615,3,9,4,4,9,29
191202616,3,2,5,3,1,14
191202617,8,7,2,3,6,26
191202618,7,0,5,2,5,19
191202619,5,2,9,6,1,23
191202620,0,7,5,1,9,22
191202621,7,0,5,2,0,14
191202622,4,9,3,9,7,32
191202623,0,3,4,6,5,18
191202624,7,6,2,1,6,22
191202625,1,5,6,9,0,21
191202626,8,5,4,9,9,35
191202627,0,1,2,8,0,11
191202628,6,0,2,8,1,17
191202629,2,3,4,8,7,24
191202630,6,0,7,4,2,19
191202631,5,3,3,6,2,19
191202632,3,3,0,4,9,19
191202633,3,1,2,6,9,21
191202634,2,0,4,6,1,13
191202635,8,5,7,8,6,34
191202636,9,2,3,5,9,28
191202637,4,8,3,8,3,26
191202638,1,6,6,1,3,17
191202639,1,3,7,9,4,24
191202640,6,9,4,6,9,34
191202641,5,2,6,4,8,25
191202642,5,4,4,7,8,28
191202643,8,0,1,5,5,19
191202644,8,1,7,7,3,26
191202645,1,4,0,4,5,14
191202646,1,0,1,1,5,8
191202647,4,9,6,1,0,20
191202648,1,9,7,2,4,23
191202649,7,5,7,3,8,30
191202650,6,4,9,5,9,33
191202651,4,9,8,5,3,29
191202652,3,0,7,1,7,18
191202653,8,4,4,6,2,24
191202654,3,4,3,3,6,19
191202655,3,4,5,1,6,19
191202656,0,8,9,1,0,18
191202657,6,5,4,0,3,18
191202658,2,0,0,8,9,19
191202659,6,2,0,7,2,17
191202660,8,5,6,2,0,21
191202661,2,9,8,5,3,27
191202662,0,1,8,4,4,17
191202663,9,6,8,2,7,32
191202664,3,9,9,2,7,30
191202665,5,7,1,9,7,29
191202666,8,9,1,1,0,19
191202667,6,9,0,2,6,23
191202668,6,9,4,8,9,36
191202669,9,2,6,2,0,19
191202670,6,3,7,3,8,27
191202671,0,3,0,1,3,7
191202672,5,7,0,5,9,26
191202673,6,7,5,6,4,28
191202674,3,2,7,3,4,19
191202675,6,8,2,2,6,24
191202676,9,2,0,7,6,24
191202677,8,3,5,0,2,18
191202678,2,0,8,9,7,26
191202679,4,3,6,8,9,30
191202680,1,8,6,3,2,20
191202681,1,9,0,3,4,17
191202682,5,6,2,4,3,20
191202683,5,9,3,8,8,33
191202684,2,0,9,0,1,12
191202685,8,8,8,4,9,37
191202686,9,1,9,6,6,31
191202687,1,9,5,1,7,23
191202688,6,8,1,6,6,27
191202689,1,9,3,5,5,23
191202690,6,0,9,1,3,19
191202691,1,6,4,2,8,21
191202692,0,7,7,4,1,19
191202693,4,2,7,1,3,17
191202694,7,8,4,3,8,30
191202695,6,7,4,3,9,29
191202696,3,5,0,5,0,13
191202697,5,3,1,0,7,16
191202698,7,4,9,7,2,29
191202699,0,3,1,7,7,18
191202700,3,4,9,2,0,18
191202701,2,5,9,7,4,27
191202702,0,8,8,1,6,23
191202703,0,4,4,9,5,22
191202704,2,5,5,1,4,17
191202705,7,0,2,7,3,19
191202706,0,6,0,1,9,16
191202707,4,9,0,4,8,25
191202708,5,8,8,2,8,31
191202709,6,5,5,3,1,20
191202710,4,7,7,6,4,28
191202711,2,3,4,2,2,13
191202712,1,6,5,5,0,17
191202713,5,1,6,9,7,28
191202714,0,2,2,2,0,6
191202715,3,7,3,8,5,26
191202716,1,2,3,3,9,18
191202717,9,1,6,6,5,27
191202718,6,3,3,4,6,22
191202719,0,6,1,7,0,14
191202720,5,6,6,4,9,30
191202721,5,6,3,6,9,29
191202722,3,4,8,3,3,21
191202723,4,8,2,2,0,16
191202724,7,8,7,7,4,33
191202725,7,8,4,5,7,31
191202726,1,6,0,6,5,18
191202727,9,5,2,5,2,23
191202728,8,0,9,6,7,30
191202729,5,2,8,6,6,27
191202730,3,2,9,3,6,23
191202731,7,1,6,4,1,19
191202732,1,3,7,9,7,27
191202733,4,3,2,2,9,20
191202734,2,5,2,9,6,24
191202735,7,4,3,3,4,21
191202736,9,8,0,1,2,20
191202737,7,5,5,9,3,29
191202738,5,0,3,0,2,10
191202739,4,8,2,7,0,21
191202740,5,3,1,8,5,22
191202741,0,4,2,7,1,14
191202742,6,8,5,7,7,33
191202743,9,0,0,7,4,20
191202744,2,1,3,7,1,14
191202745,0,6,4,5,7,22
191202746,0,5,4,2,4,15
191202747,6,0,9,0,3,18
191202748,9,8,4,1,9,31
191202749,5,4,8,3,8,28
191202750,7,8,3,2,2,22
191202751,7,2,6,5,3,23
191202752,5,3,9,9,1,27
191202753,4,0,3,9,8,24
191202754,5,2,6,3,8,24
191202755,8,2,8,8,1,27
191202756,7,4,7,9,4,31
191202757,1,1,0,4,6,12
191202758,0,3,1,4,0,8
191202759,2,9,9,0,0,20
191202760,3,7,2,4,4,20
191202761,7,6,5,2,6,26
191202762,0,4,6,2,7,19
191202763,1,2,6,9,7,25
191202764,5,4,7,3,9,28
191202765,8,0,7,7,3,25
191202766,1,0,8,9,7,25
191202767,9,2,3,0,8,22
191202768,1,1,3,3,6,14
191202769,9,8,7,1,3,28
191202770,9,6,0,8,8,31
191202771,4,4,8,3,4,23
191202772,9,0,5,4,3,21
191202773,1,2,1,4,1,9
191202774,3,3,1,9,6,22
191202775,6,8,8,2,7,31
191202776,7,1,0,7,9,24
191202777,8,9,8,4,1,30
191202778,6,0,5,0,2,13
191202779,7,0,8,4,0,19
191202780,6,0,4,8,7,25
191202781,2,2,6,9,3,22
191202782,6,1,4,0,9,20
191202783,7,0,1,8,8,24
191202784,1,0,1,8,8,18
191202785,6,3,4,2,2,17
191202786,3,0,7,3,8,21
191202787,9,2,7,1,8,27
191202788,2,4,4,7,6,23
191202789,9,3,4,3,7,26
191202790,3,9,3,4,4,23
191202791,4,8,0,5,2,19
191202792,5,3,3,0,3,14
191202793,2,3,7,0,0,12
191202794,4,9,3,9,8,33
191202795,0,2,0,3,2,7
191202796,7,4,5,8,9,33
191202797,6,0,3,0,5,14
191202798,9,2,0,8,3,22
191202799,3,2,3,5,3,16
191202800,2,7,9,5,9,32
191202801,1,8,8,1,9,27
191202802,2,1,5,7,9,24
191202803,5,2,0,8,8,23
191202804,4,3,1,2,3,13
191202805,6,7,9,4,2,28
191202806,4,7,1,3,2,17
191202807,2,1,9,8,8,28
191202808,8,5,9,4,0,26
191202809,1,4,2,5,2,14
191202810,7,3,8,4,9,31
191202811,0,9,5,5,0,19
191202812,6,2,3,6,7,24
191202813,6,7,4,3,3,23
191202814,8,1,1,3,9,22
191202815,6,6,2,2,7,23
191202816,3,1,1,7,6,18
191202817,7,3,3,4,3,20
191202818,5,6,4,5,4,24
191202819,0,0,2,8,9,19
191202820,5,8,6,3,4,26
191202821,9,8,6,4,4,31
191202822,2,4,5,9,0,20
191202823,2,3,7,2,9,23
191202824,3,7,8,5,8,31
191202825,1,7,6,8,0,22
191202826,7,7,4,3,3,24
191202827,9,1,4,3,2,19
191202828,5,7,0,7,2,21
191202829,4,8,1,5,4,22
191202830,0,5,7,6,3,21
191202831,8,2,1,7,3,21
191202832,6,8,9,7,5,35
191202833,5,7,5,1,2,20
191202834,8,5,4,4,0,21
191202835,6,1,1,1,3,12
191202836,3,0,7,0,9,19
191202837,0,5,6,6,9,26
191202838,4,9,9,1,5,28
191202839,5,8,3,7,5,28
191202840,2,2,0,5,0,9
191202841,0,9,9,8,6,32
191202842,4,3,3,4,1,15
191202843,9,2,8,0,5,24
191202844,6,0,7,1,5,19
191202845,5,4,9,5,8,31
191202846,4,1,2,8,9,24
191202847,6,2,5,9,9,31
191202848,7,8,7,0,5,27
191202849,0,5,7,0,0,12
191202850,7,3,3,3,7,23
191202851,4,5,6,2,9,26
191202852,4,0,3,1,7,15
191202853,1,1,8,7,4,21
191202854,7,1,4,8,9,29
191202855,5,3,8,8,0,24
191202856,7,4,4,3,9,27
191202857,0,2,1,2,8,13
191202858,8,0,6,7,4,25
191202859,3,2,4,8,5,22
191202860,0,5,1,0,9,15
191202861,9,2,7,3,9,30
191202862,6,8,7,6,4,31
191202863,0,2,5,4,0,11
191202864,7,4,8,5,0,24
191202865,4,3,3,4,8,22
191202866,2,6,4,8,2,22
191202867,1,5,1,8,1,16
191202868,8,0,0,1,1,10
191202869,4,0,2,4,5,15
191202870,3,3,7,7,3,23
191202871,1,4,4,8,1,18
191202872,3,6,0,4,4,17
191202873,8,5,6,7,5,31
191202874,5,6,1,0,9,21
191202875,7,8,2,2,7,26
191202876,4,2,3,7,6,22
191202877,9,1,2,1,0,13
191202878,7,2,0,7,9,25
191202879,1,9,1,6,8,25
191202880,4,8,7,4,1,24
191202881,2,3,7,1,9,22
191202882,6,3,2,3,1,15
191202883,9,5,8,9,5,36
191202884,4,3,6,6,1,20
191202885,2,4,0,2,0,8
191202886,2,4,0,9,6,21
191202887,5,7,9,7,7,35
191202888,3,1,2,4,9,19
191202889,5,3,6,8,3,25
191202890,2,6,0,2,3,13
191202891,4,9,5,4,9,31
191202892,1,3,4,7,1,16
191202893,5,2,6,8,8,29
191202894,8,3,4,7,6,28
191202895,2,4,3,9,0,18
191202896,6,8,9,8,9,40
191202897,3,6,3,8,4,24
191202898,4,1,8,8,5,26
191202899,5,1,0,6,1,13
191202900,4,9,6,4,9,32
191202901,1,7,8,3,3,22
191202902,4,6,8,5,2,25
191202903,5,8,1,5,9,28
191202904,7,7,6,9,3,32
191202905,7,7,6,1,4,25
191202906,4,3,2,2,5,16
191202907,8,7,7,6,1,29
191202908,4,1,3,7,1,16
191202909,1,1,5,9,8,24
191202910,6,9,8,5,4,32
191202911,5,8,6,5,0,24
191202912,4,6,0,3,7,20
191202913,3,3,9,2,8,25
191202914,8,4,5,2,5,24
191202915,7,5,2,4,8,26
191202916,0,6,6,7,1,20
191202917,1,7,6,8,9,31
191202918,5,5,0,3,6,19
191202919,7,8,9,1,1,26
191202920,1,9,7,6,8,31
191202921,6,2,7,3,7,25
191202922,1,4,7,5,9,26
191202923,4,7,8,4,8,31
191202924,0,4,3,5,8,20
191202925,3,5,9,4,4,25
191202926,8,3,1,0,7,19
191202927,7,3,9,2,8,29
191202928,2,8,3,7,8,28
191202929,6,4,2,1,2,15
191202930,7,4,8,3,8,30
191202931,4,2,2,8,8,24
191202932,5,9,8,4,2,28
191202933,8,4,0,3,6,21
191202934,8,3,9,9,6,35
191202935,4,3,6,9,7,29
191202936,4,7,4,5,1,21
191202937,7,0,3,7,4,21
191202938,9,9,3,6,9,36
191202939,0,3,3,1,5,12
191202940,9,0,1,0,7,17
191202941,9,7,2,1,2,21
191202942,1,2,0,1,5,9
191202943,0,7,2,2,7,18
191202944,0,3,6,7,5,21
191202945,9,6,8,2,8,33
191202946,7,8,7,9,7,38
191202947,0,6,1,3,5,15
191202948,0,3,9,0,6,18
191202949,8,8,7,4,1,28
191202950,5,1,0,6,2,14
191202951,1,4,0,2,3,10
191202952,6,2,2,8,7,25
191202953,6,3,1,7,4,21
191202954,1,8,5,4,1,19
191202955,3,4,9,7,5,28
191202956,1,5,0,8,1,15
191202957,5,8,3,7,9,32
191202958,4,1,4,0,1,10
191202959,1,0,5,3,8,17
191202960,5,3,0,5,3,16
191202961,2,1,0,2,7,12
191202962,7,8,9,8,1,33
191202963,1,0,0,1,4,6
191202964,0,0,6,4,2,12
191202965,4,4,0,9,8,25
191202966,1,7,1,5,1,15
191202967,1,9,9,9,9,37
191202968,7,2,8,0,5,22
191202969,7,1,9,0,4,21
191202970,5,6,4,9,4,28
191202971,0,2,8,1,7,18
191202972,8,0,2,6,4,20
191202973,5,1,2,8,3,19
191202974,4,9,2,9,5,29
191202975,5,4,5,6,3,23
191202976,4,2,0,1,6,13
191202977,6,9,2,9,4,30
191202978,6,8,7,5,3,29
191202979,2,1,8,5,9,25
191202980,1,4,0,0,2,7
191202981,8,8,8,7,8,39
191202982,9,7,1,1,9,27
191202983,2,2,1,8,1,14
191202984,7,1,1,6,0,15
191202985,2,3,1,1,5,12
191202986,9,2,5,6,7,29
191202987,2,6,2,5,0,15
191202988,0,8,6,1,8,23
191202989,7,0,5,9,6,27
191202990,9,0,6,3,2,20
191202991,2,4,1,7,6,20
191202992,4,3,2,5,2,16
191202993,4,0,2,5,0,11
191202994,9,9,8,8,0,34
191202995,1,8,2,1,1,13
191202996,6,7,6,6,6,31
191202997,3,4,2,3,5,17
191202998,4,4,7,8,0,23
191202999,5,9,0,6,3,23
1912021000,5,7,5,8,0,25
1912021001,8,5,6,3,8,30
1912021002,5,5,2,2,1,15
1912021003,0,2,9,7,7,25
1912021004,9,2,9,4,8,32
1912021005,1,6,3,0,7,17
1912021006,5,9,1,8,8,31
1912021007,2,4,1,9,2,18
1912021008,2,2,0,1,4,9
1912021009,2,3,6,0,3,14
1912021010,9,3,5,3,4,24
1912021011,0,6,1,1,2,10
1912021012,9,9,2,5,9,34
1912021013,9,1,0,3,2,15
1912021014,8,8,8,4,8,36
1912021015,3,7,4,8,1,23
1912021016,9,3,4,6,1,23
1912021017,6,2,8,2,7,25
1912021018,6,8,9,4,5,32
1912021019,6,8,6,0,7,27
1912021020,1,3,6,8,8,26
1912021021,8,7,3,8,1,27
1912021022,5,3,8,2,5,23
1912021023,3,9,9,4,9,34
1912021024,2,7,2,8,3,22
1912021025,0,2,3,6,1,12
1912021026,8,5,5,6,3,27
1912021027,1,3,1,8,2,15
1912021028,6,6,6,2,0,20
1912021029,5,7,1,8,8,29
1912021030,0,5,9,7,7,28
1912021031,2,7,3,9,0,21
1912021032,0,8,3,0,7,18
1912021033,0,1,4,2,3,10
1912021034,9,6,7,9,2,33
1912021035,7,9,6,4,4,30
1912021036,0,9,6,3,4,22
1912021037,5,2,5,9,1,22
1912021038,2,8,7,8,4,29
1912021039,0,0,9,5,5,19
1912021040,5,6,7,4,8,30
1912021041,8,1,6,4,4,23
1912021042,4,4,4,7,1,20
1912021043,1,8,6,5,4,24
1912021044,7,0,3,5,5,20
1912021045,9,9,2,6,6,32
1912021046,5,4,1,7,4,21
1912021047,9,0,1,6,0,16
1912021048,6,0,3,7,8,24
1912021049,4,3,0,2,5,14
1912021050,3,1,3,7,0,14
1912021051,7,7,9,6,5,34
1912021052,9,7,9,5,7,37
1912021053,9,6,5,0,6,26
1912021054,3,8,7,0,3,21
1912021055,7,2,4,7,1,21
1912021056,3,8,1,2,5,19
1912021057,5,4,9,1,7,26
1912021058,3,8,5,5,9,30
1912021059,7,0,0,7,3,17
1912021060,4,5,1,2,6,18
1912021061,4,4,6,8,0,22
1912021062,5,7,5,5,3,25
1912021063,2,2,9,7,4,24
1912021064,9,1,0,4,0,14
1912021065,2,8,0,3,0,13
1912021066,0,1,9,1,8,19
1912021067,5,0,3,8,0,16
1912021068,6,1,7,1,2,17
1912021069,0,3,5,0,3,11
1912021070,8,9,5,7,9,38
1912021071,9,7,7,1,9,33
1912021072,2,3,1,7,6,19
1912021073,2,3,5,9,1,20
1912021074,8,7,6,4,0,25
1912021075,3,5,6,5,2,21
1912021076,2,5,8,6,2,23
1912021077,6,5,6,4,0,21
1912021078,1,6,8,6,2,23
1912021079,8,9,9,6,1,33
1912021080,2,0,6,1,1,10
1912021081,7,8,2,4,9,30
1912021082,3,1,0,7,8,19
1912021083,5,8,6,8,8,35
1912021084,8,8,1,5,8,30
1912021085,9,3,9,1,8,30
1912021086,8,3,8,8,4,31
1912021087,9,8,9,4,7,37
1912021088,8,7,8,9,8,40
1912021089,6,9,7,6,2,30
1912021090,5,7,8,4,7,31
1912021091,5,4,6,9,2,26
1912021092,2,7,5,9,9,32
1912021093,7,7,9,7,0,30
1912021094,2,3,5,1,1,12
1912021095,3,7,8,2,1,21
1912021096,2,4,4,3,6,19
1912021097,8,2,3,7,3,23
1912021098,3,7,4,1,0,15
1912021099,8,3,8,3,2,24
1912021100,6,6,4,9,2,27
1912021101,8,1,1,0,9,19
1912021102,5,9,0,8,0,22
1912021103,5,6,3,4,1,19
1912021104,0,5,4,0,5,14
1912021105,6,4,2,6,8,26
191203001,6,4,7,4,2,23
191203002,9,5,6,8,3,31
191203003,7,8,0,7,8,30
191203004,6,3,3,2,1,15
191203005,1,5,8,5,2,21
191203006,6,7,3,8,1,25
191203007,2,8,7,0,5,22
191203008,8,3,6,2,5,24
191203009,2,3,9,5,9,28
191203010,2,8,0,6,8,24
191203011,7,1,5,1,5,19
191203012,0,2,3,3,2,10
191203013,8,0,5,5,3,21
191203014,7,9,7,7,4,34
191203015,3,1,7,5,5,21
191203016,7,7,0,1,2,17
191203017,8,9,0,0,1,18
191203018,2,9,0,5,7,23
191203019,0,1,3,8,9,21
191203020,7,6,2,9,1,25
191203021,0,2,9,8,9,28
191203022,8,5,6,3,7,29
191203023,7,6,0,0,7,20
191203024,4,2,4,5,0,15
191203025,6,0,5,1,9,21
191203026,0,9,3,5,5,22
191203027,7,5,4,8,5,29
191203028,4,7,9,9,2,31
191203029,8,6,2,6,5,27
191203030,8,5,8,2,5,28
191203031,3,4,9,0,8,24
191203032,3,7,7,8,8,33
191203033,2,9,7,8,3,29
191203034,8,5,3,6,2,24
191203035,1,8,7,9,1,26
191203036,8,4,8,4,0,24
191203037,0,0,5,6,7,18
191203038,4,3,0,2,4,13
191203039,9,5,5,9,3,31
191203040,1,0,3,1,4,9
191203041,8,5,3,4,5,25
191203042,1,5,1,8,6,21
191203043,3,4,2,3,4,16
191203044,1,6,1,7,7,22
191203045,7,4,8,0,8,27
191203046,4,6,0,7,6,23
191203047,9,5,1,1,4,20
191203048,3,1,8,2,6,20
191203049,9,3,7,3,1,23
191203050,9,9,1,2,3,24
191203051,5,6,5,6,6,28
191203052,4,0,3,1,3,11
191203053,9,8,9,6,7,39
191203054,5,1,4,6,1,17
191203055,4,4,4,3,2,17
191203056,6,1,0,5,3,15
191203057,2,8,9,5,9,33
191203058,2,2,9,3,8,24
191203059,7,9,9,7,1,33
191203060,0,0,5,5,0,10
191203061,1,0,7,4,1,13
191203062,3,9,4,9,8,33
191203063,5,9,3,6,6,29
191203064,7,1,6,3,2,19
191203065,8,4,0,4,4,20
191203066,8,1,9,2,7,27
191203067,8,2,6,2,6,24
191203068,9,8,9,6,0,32
191203069,8,2,8,4,7,29
191203070,3,0,2,8,8,21
191203071,9,6,6,1,7,29
191203072,8,4,4,4,4,24
191203073,1,9,6,2,6,24
191203074,7,3,6,1,0,17
191203075,5,9,7,5,8,34
191203076,3,8,4,2,4,21
191203077,8,3,8,2,1,22
191203078,6,1,3,1,0,11
191203079,6,1,4,5,4,20
191203080,7,9,5,7,8,36
191203081,4,5,6,4,0,19
191203082,5,7,2,8,9,31
191203083,7,8,5,7,2,29
191203084,8,2,0,6,7,23
191203085,1,7,4,7,0,19
191203086,4,7,2,3,8,24
191203087,6,8,4,3,9,30
191203088,7,7,3,5,4,26
191203089,6,3,8,4,8,29
191203090,0,8,2,4,0,14
191203091,1,7,8,8,0,24
191203092,3,7,2,4,3,19
191203093,4,8,7,5,4,28
191203094,4,5,8,7,5,29
191203095,8,5,9,4,8,34
191203096,6,3,1,3,1,14
191203097,3,5,1,0,0,9
191203098,8,0,2,5,1,16
191203099,9,2,9,7,9,36
191203100,1,9,5,8,3,26
191203101,2,9,9,0,1,21
191203102,1,5,0,4,8,18
191203103,9,3,1,6,4,23
191203104,9,9,4,9,5,36
191203105,3,1,4,2,3,13
191203106,1,2,1,6,9,19
191203107,6,6,9,7,2,30
191203108,7,5,2,3,9,26
191203109,0,5,1,8,8,22
191203110,1,4,2,2,4,13
191203111,4,4,2,4,8,22
191203112,5,2,8,5,9,29
191203113,6,9,1,6,6,28
191203114,1,9,0,5,3,18
191203115,3,8,4,9,3,27
191203116,0,9,6,1,2,18
191203117,3,8,6,9,9,35
191203118,4,7,4,5,4,24
191203119,4,6,3,8,3,24
191203120,7,2,9,8,2,28
191203121,4,4,5,8,9,30
191203122,2,5,2,8,6,23
191203123,4,8,4,0,9,25
191203124,2,5,1,7,5,20
191203125,7,5,5,6,7,30
191203126,9,8,9,9,1,36
191203127,9,6,6,3,8,32
191203128,8,7,6,8,1,30
191203129,5,0,5,3,1,14
191203130,1,2,7,0,1,11
191203131,9,0,0,3,7,19
191203132,0,4,3,1,3,11
191203133,6,7,0,7,9,29
191203134,0,4,7,8,6,25
191203135,0,7,2,5,7,21
191203136,6,3,1,1,3,14
191203137,9,7,6,0,1,23
191203138,6,6,7,1,0,20
191203139,8,5,2,5,9,29
191203140,5,7,7,8,0,27
191203141,8,2,7,2,8,27
191203142,2,9,5,3,8,27
191203143,5,1,2,4,7,19
191203144,0,4,4,2,3,13
191203145,1,6,3,4,3,17
191203146,5,6,2,3,2,18
191203147,2,2,8,2,9,23
191203148,2,8,4,1,4,19
191203149,3,1,0,2,1,7
191203150,3,8,8,7,0,26
191203151,5,9,4,9,9,36
191203152,5,2,6,9,6,28
191203153,2,5,4,0,6,17
191203154,3,7,8,4,5,27
191203155,0,8,1,3,9,21
191203156,3,8,1,4,6,22
191203157,3,1,5,8,7,24
191203158,8,7,6,1,4,26
191203159,5,1,6,0,9,21
191203160,6,3,7,2,3,21
191203161,2,2,0,7,5,16
191203162,7,9,8,5,2,31
191203163,9,0,0,0,0,9
191203164,9,2,4,4,3,22
191203165,6,1,9,1,4,21
191203166,1,8,5,7,9,30
191203167,2,0,3,6,2,13
191203168,3,9,6,1,4,23
191203169,4,2,9,6,9,30
191203170,6,0,6,4,0,16
191203171,0,8,7,4,4,23
191203172,9,1,5,0,7,22
191203173,4,6,0,0,3,13
191203174,2,2,4,1,8,17
191203175,6,1,8,6,0,21
191203176,0,0,4,0,6,10
191203177,7,6,8,8,9,38
191203178,5,4,7,5,8,29
191203179,0,2,0,7,5,14
191203180,9,1,0,7,7,24
191203181,7,8,5,2,9,31
191203182,5,1,8,8,7,29
191203183,9,6,3,2,7,27
191203184,8,9,3,1,4,25
191203185,1,1,1,0,5,8
191203186,1,9,1,3,6,20
191203187,6,1,9,9,0,25
191203188,5,6,3,5,2,21
191203189,0,1,6,0,6,13
191203190,0,8,4,2,4,18
191203191,0,3,7,3,2,15
191203192,0,0,6,0,0,6
191203193,8,5,7,7,1,28
191203194,7,5,2,7,3,24
191203195,0,4,7,2,7,20
191203196,3,5,3,0,2,13
191203197,9,6,2,1,8,26
191203198,9,8,5,2,4,28
191203199,0,2,5,3,4,14
191203200,9,8,1,3,0,21
191203201,9,3,5,0,8,25
191203202,0,4,1,7,7,19
191203203,4,3,5,2,5,19
191203204,8,9,9,3,9,38
191203205,1,7,0,6,5,19
191203206,1,0,6,4,7,18
191203207,5,1,9,6,3,24
191203208,2,1,6,7,9,25
191203209,0,9,3,2,7,21
191203210,7,3,1,2,4,17
191203211,2,7,8,0,7,24
191203212,1,5,5,4,8,23
191203213,0,9,2,6,7,24
191203214,3,7,7,4,6,27
191203215,2,3,3,1,1,10
191203216,1,2,8,9,2,22
191203217,7,5,1,4,9,26
191203218,2,2,0,2,4,10
191203219,9,3,2,4,7,25
191203220,3,1,9,5,3,21
191203221,0,1,4,4,7,16
191203222,7,3,5,2,3,20
191203223,6,1,0,9,7,23
191203224,7,5,4,0,5,21
191203225,8,6,4,3,6,27
191203226,8,9,1,2,8,28
191203227,3,9,1,7,6,26
191203228,1,9,5,8,6,29
191203229,9,4,6,5,0,24
191203230,4,8,9,5,9,35
191203231,0,9,5,8,2,24
191203232,3,1,8,5,9,26
191203233,0,5,4,9,3,21
191203234,3,9,1,9,9,31
191203235,5,7,3,2,0,17
191203236,2,3,3,5,3,16
191203237,5,3,7,5,5,25
191203238,2,3,3,0,1,9
191203239,4,3,4,5,8,24
191203240,8,7,1,0,7,23
191203241,6,1,3,2,0,12
191203242,8,4,0,5,3,20
191203243,1,6,0,1,8,16
191203244,6,6,0,0,1,13
191203245,2,9,9,8,5,33
191203246,5,1,7,9,0,22
191203247,4,5,5,3,1,18
191203248,0,8,4,4,2,18
191203249,7,3,4,4,5,23
191203250,1,7,1,4,8,21
191203251,2,1,6,2,0,11
191203252,6,9,6,1,1,23
191203253,3,4,7,9,4,27
191203254,6,1,8,6,3,24
191203255,6,5,1,2,8,22
191203256,3,7,1,7,4,22
191203257,2,5,1,8,0,16
191203258,7,3,6,2,5,23
191203259,0,4,7,9,7,27
191203260,1,3,4,1,6,15
191203261,8,8,9,9,8,42
191203262,5,4,6,9,9,33
191203263,8,1,4,3,8,24
191203264,7,7,2,9,8,33
191203265,5,8,2,5,1,21
191203266,6,9,5,8,0,28
191203267,4,7,6,1,1,19
191203268,1,0,7,5,9,22
191203269,0,3,2,8,9,22
191203270,4,7,7,9,0,27
191203271,8,3,5,6,7,29
191203272,0,1,8,8,9,26
191203273,0,8,0,7,9,24
191203274,6,9,0,5,8,28
191203275,2,0,1,7,1,11
191203276,6,5,4,7,4,26
191203277,5,3,8,0,0,16
191203278,3,3,5,4,0,15
191203279,2,1,4,4,6,17
191203280,4,1,8,0,0,13
191203281,3,4,7,4,2,20
191203282,5,1,5,9,3,23
191203283,0,2,6,8,6,22
191203284,8,9,3,5,9,34
191203285,7,0,8,2,0,17
191203286,3,8,5,5,5,26
191203287,6,6,3,0,2,17
191203288,2,1,6,0,2,11
191203289,6,2,9,8,3,28
191203290,4,9,8,9,7,37
191203291,7,8,4,2,7,28
191203292,0,8,9,1,6,24
191203293,2,6,6,1,5,20
191203294,3,1,3,2,2,11
191203295,4,9,2,6,8,29
191203296,7,1,3,1,1,13
191203297,4,1,4,6,3,18
191203298,6,0,3,1,7,17
191203299,4,7,6,5,3,25
191203300,9,9,4,9,7,38
191203301,3,5,4,6,3,21
191203302,4,8,7,2,3,24
191203303,3,9,8,7,4,31
191203304,4,0,8,1,4,17
191203305,6,2,1,9,3,21
191203306,5,4,0,1,2,12
191203307,6,6,4,3,8,27
191203308,4,9,5,4,7,29
191203309,0,3,3,4,0,10
191203310,5,3,7,9,6,30
191203311,7,2,8,0,4,21
191203312,0,6,9,1,3,19
191203313,8,1,1,7,6,23
191203314,1,1,1,1,8,12
191203315,2,5,1,3,8,19
191203316,0,7,1,0,0,8
191203317,5,5,3,7,7,27
191203318,9,0,4,5,6,24
191203319,8,5,3,9,9,34
191203320,8,8,8,7,3,34
191203321,6,6,2,1,9,24
191203322,2,8,7,9,2,28
191203323,7,7,1,4,9,28
191203324,5,2,2,9,2,20
191203325,4,2,2,8,5,21
191203326,2,6,6,7,1,22
191203327,4,1,9,3,2,19
191203328,3,3,5,4,8,23
191203329,3,4,4,0,5,16
191203330,3,6,8,0,3,20
191203331,9,5,2,5,9,30
191203332,8,7,9,9,7,40
191203333,1,4,3,9,8,25
191203334,9,4,9,5,2,29
191203335,1,0,9,2,9,21
191203336,9,3,1,8,9,30
191203337,5,9,9,2,7,32
191203338,7,6,8,9,0,30
191203339,1,9,3,6,1,20
191203340,1,7,1,8,3,20
191203341,2,0,9,2,6,19
191203342,6,4,5,1,2,18
191203343,1,2,0,9,8,20
191203344,0,6,6,1,0,13
191203345,0,4,0,6,8,18
191203346,2,8,9,5,8,32
191203347,3,2,2,8,0,15
191203348,0,1,9,8,7,25
191203349,1,0,5,9,4,19
191203350,0,4,8,7,8,27
191203351,8,6,8,2,3,27
191203352,4,0,6,1,6,17
191203353,9,4,6,6,9,34
191203354,7,0,7,4,1,19
191203355,3,1,7,3,5,19
191203356,8,6,4,3,7,28
191203357,9,8,8,2,9,36
191203358,1,0,1,6,5,13
191203359,4,8,2,7,8,29
191203360,7,5,1,5,5,23
191203361,9,9,8,2,0,28
191203362,1,9,0,0,8,18
191203363,5,2,3,2,5,17
191203364,8,3,6,5,6,28
191203365,3,2,3,6,1,15
191203366,9,1,1,8,2,21
191203367,8,7,2,2,8,27
191203368,3,7,2,4,2,18
191203369,3,4,8,0,1,16
191203370,0,3,8,5,1,17
191203371,4,1,8,6,9,28
191203372,0,8,0,2,5,15
191203373,8,5,9,7,7,36
191203374,9,0,3,8,5,25
191203375,5,3,7,0,0,15
191203376,3,5,5,2,5,20
191203377,9,6,3,0,9,27
191203378,9,6,8,0,8,31
191203379,1,8,1,6,0,16
191203380,0,5,2,2,4,13
191203381,2,9,5,3,3,22
191203382,3,3,0,6,8,20
191203383,3,6,1,5,2,17
191203384,0,6,9,9,6,30
191203385,1,3,9,5,8,26
191203386,1,1,9,7,4,22
191203387,9,0,4,5,5,23
191203388,0,6,0,2,6,14
191203389,7,7,3,2,4,23
191203390,4,0,0,6,2,12
191203391,3,9,1,6,1,20
191203392,8,9,7,5,3,32
191203393,4,5,3,9,2,23
191203394,7,8,5,1,2,23
191203395,6,5,2,1,9,23
191203396,7,2,7,5,2,23
191203397,2,4,6,7,5,24
191203398,1,6,0,6,6,19
191203399,3,4,0,7,4,18
191203400,2,5,0,2,1,10
191203401,7,9,2,0,1,19
191203402,6,9,2,6,9,32
191203403,9,9,4,7,2,31
191203404,2,3,8,9,4,26
191203405,4,4,3,1,7,19
191203406,2,0,7,6,1,16
191203407,8,0,6,1,5,20
191203408,2,7,2,4,4,19
191203409,3,7,6,1,2,19
191203410,9,9,6,8,8,40
191203411,3,8,9,1,7,28
191203412,6,0,4,6,3,19
191203413,4,2,6,5,0,17
191203414,4,7,6,2,4,23
191203415,9,1,2,2,6,20
191203416,7,9,7,4,8,35
191203417,4,7,0,3,1,15
191203418,6,0,1,2,9,18
191203419,7,5,8,2,0,22
191203420,4,7,0,5,8,24
191203421,9,1,4,1,9,24
191203422,0,4,8,5,2,19
191203423,2,4,5,8,4,23
191203424,4,3,5,6,3,21
191203425,4,3,8,5,6,26
191203426,2,5,3,3,1,14
191203427,0,9,0,7,9,25
191203428,5,8,6,2,2,23
191203429,0,4,6,6,2,18
191203430,1,1,5,4,1,12
191203431,4,1,5,5,3,18
191203432,7,7,3,3,0,20
191203433,6,0,0,5,8,19
191203434,4,7,3,5,0,19
191203435,9,0,7,5,5,26
191203436,2,8,2,6,5,23
191203437,7,2,5,5,4,23
191203438,8,3,2,3,4,20
191203439,5,9,7,7,9,37
191203440,9,0,4,2,4,19
191203441,3,2,9,4,2,20
191203442,4,2,2,6,5,19
191203443,2,0,2,4,9,17
191203444,5,7,1,7,0,20
191203445,3,1,1,3,8,16
191203446,3,5,5,8,2,23
191203447,5,7,0,2,7,21
191203448,2,0,5,6,7,20
191203449,2,5,5,4,0,16
191203450,2,2,6,7,7,24
191203451,0,0,2,1,3,6
191203452,6,5,3,0,1,15
191203453,8,0,4,4,6,22
191203454,3,3,8,0,8,22
191203455,2,2,5,7,9,25
191203456,6,2,5,0,4,17
191203457,7,4,5,9,1,26
191203458,6,0,4,1,7,18
191203459,3,1,1,4,6,15
191203460,0,8,5,4,3,20
191203461,8,2,3,0,3,16
191203462,8,8,5,9,6,36
191203463,0,6,9,7,6,28
191203464,8,4,1,5,3,21
191203465,3,7,2,9,6,27
191203466,9,0,4,9,4,26
191203467,2,7,1,3,7,20
191203468,4,6,5,8,4,27
191203469,0,0,6,4,8,18
191203470,1,9,1,3,1,15
191203471,7,5,7,0,7,26
191203472,0,8,5,6,5,24
191203473,9,2,4,9,2,26
191203474,7,7,7,1,8,30
191203475,1,6,8,5,9,29
191203476,1,7,4,5,8,25
191203477,4,1,0,1,4,10
191203478,1,9,6,8,1,25
191203479,1,4,7,2,0,14
191203480,5,1,2,1,6,15
191203481,9,3,3,0,2,17
191203482,8,0,2,8,9,27
191203483,2,9,8,9,3,31
191203484,0,0,0,1,7,8
191203485,1,6,2,6,6,21
191203486,0,1,1,4,9,15
191203487,9,3,4,5,7,28
191203488,2,0,4,3,4,13
191203489,7,3,1,4,0,15
191203490,2,9,2,5,8,26
191203491,9,7,1,9,9,35
191203492,5,3,6,6,7,27
191203493,3,9,2,2,8,24
191203494,7,7,1,7,3,25
191203495,5,6,3,7,5,26
191203496,3,0,7,9,2,21
191203497,9,9,2,9,0,29
191203498,9,8,5,8,2,32
191203499,8,9,8,1,5,31
191203500,2,9,3,4,8,26
191203501,9,6,5,7,4,31
191203502,1,2,7,1,7,18
191203503,5,5,5,7,9,31
191203504,0,9,7,9,4,29
191203505,6,4,2,1,8,21
191203506,5,1,2,9,7,24
191203507,7,4,3,2,4,20
191203508,2,3,1,8,2,16
191203509,3,0,7,4,2,16
191203510,8,7,7,7,7,36
191203511,2,6,6,3,9,26
191203512,5,7,1,6,2,21
191203513,2,9,1,1,8,21
191203514,1,1,0,2,4,8
191203515,3,8,1,8,3,23
191203516,0,8,1,6,2,17
191203517,0,0,0,4,5,9
191203518,6,8,8,3,4,29
191203519,2,5,4,6,4,21
191203520,3,8,1,8,9,29
191203521,2,6,7,0,3,18
191203522,3,9,1,1,8,22
191203523,7,2,1,6,9,25
191203524,6,1,5,0,2,14
191203525,1,5,3,5,9,23
191203526,8,4,0,9,5,26
191203527,6,1,8,2,5,22
191203528,6,7,5,8,3,29
191203529,0,9,6,5,8,28
191203530,5,3,6,4,9,27
191203531,6,1,1,1,9,18
191203532,0,4,4,1,5,14
191203533,7,2,0,9,8,26
191203534,5,8,6,5,6,30
191203535,3,2,5,1,6,17
191203536,5,6,9,2,6,28
191203537,2,2,0,4,4,12
191203538,9,2,8,8,0,27
191203539,0,6,4,8,4,22
191203540,3,6,9,2,7,27
191203541,3,0,9,9,2,23
191203542,1,3,2,2,9,17
191203543,1,9,1,3,3,17
191203544,6,7,0,1,2,16
191203545,4,5,8,1,1,19
191203546,7,9,6,0,5,27
191203547,6,2,4,0,3,15
191203548,0,8,6,9,9,32
191203549,3,6,9,5,1,24
191203550,6,2,7,9,2,26
191203551,3,5,3,7,1,19
191203552,1,5,0,2,9,17
191203553,8,3,5,6,2,24
191203554,0,9,4,0,7,20
191203555,5,8,9,7,2,31
191203556,0,2,7,6,6,21
191203557,4,2,3,5,8,22
191203558,2,5,1,6,4,18
191203559,5,9,2,9,9,34
191203560,0,0,9,2,7,18
191203561,4,1,4,8,5,22
191203562,1,4,3,9,3,20
191203563,4,8,2,4,9,27
191203564,7,9,2,0,6,24
191203565,3,0,0,3,0,6
191203566,1,7,2,2,9,21
191203567,3,6,8,2,7,26
191203568,3,7,3,5,3,21
191203569,5,5,2,6,5,23
191203570,7,3,6,1,3,20
191203571,5,8,5,3,8,29
191203572,4,1,8,6,5,24
191203573,5,5,6,7,5,28
191203574,8,6,8,6,5,33
191203575,8,9,0,0,7,24
191203576,7,4,3,4,4,22
191203577,2,2,3,0,7,14
191203578,1,9,3,1,5,19
191203579,3,6,0,7,2,18
191203580,8,9,7,4,0,28
191203581,9,6,0,0,9,24
191203582,4,5,1,9,3,22
191203583,8,0,3,5,8,24
191203584,8,9,0,9,2,28
191203585,5,1,1,0,4,11
191203586,0,3,5,0,9,17
191203587,0,8,0,9,7,24
191203588,5,5,1,3,7,21
191203589,5,5,0,9,1,20
191203590,5,2,5,9,6,27
191203591,2,4,5,0,1,12
191203592,0,2,3,0,6,11
191203593,0,3,0,0,1,4
191203594,1,8,7,4,8,28
191203595,7,7,7,4,1,26
191203596,2,7,1,4,4,18
191203597,4,0,7,4,8,23
191203598,0,3,1,3,0,7
191203599,3,1,5,7,3,19
191203600,1,0,7,0,1,9
191203601,5,2,0,0,2,9
191203602,0,1,0,4,9,14
191203603,6,8,1,6,7,28
191203604,0,1,6,3,1,11
191203605,8,1,0,7,2,18
191203606,6,9,2,9,9,35
191203607,9,3,9,6,7,34
191203608,5,5,8,0,3,21
191203609,7,5,0,6,8,26
191203610,3,0,4,1,4,12
191203611,9,0,6,9,6,30
191203612,2,8,6,6,2,24
191203613,4,9,4,2,6,25
191203614,8,1,5,5,7,26
191203615,0,8,3,5,5,21
191203616,6,6,8,1,3,24
191203617,0,8,5,0,0,13
191203618,9,9,4,4,1,27
191203619,9,4,1,8,9,31
191203620,2,1,3,1,7,14
191203621,4,4,3,2,6,19
191203622,6,3,0,2,3,14
191203623,9,7,4,6,8,34
191203624,1,0,8,7,7,23
191203625,5,5,1,4,1,16
191203626,6,7,8,0,2,23
191203627,7,2,8,0,7,24
191203628,2,6,5,9,0,22
191203629,2,7,4,0,6,19
191203630,2,3,1,9,7,22
191203631,4,8,1,5,5,23
191203632,9,3,4,0,0,16
191203633,5,1,6,2,8,22
191203634,3,0,9,0,0,12
191203635,2,1,9,9,9,30
191203636,3,4,6,5,1,19
191203637,1,7,0,0,0,8
191203638,3,0,1,2,0,6
191203639,1,5,9,2,9,26
191203640,6,7,3,3,4,23
191203641,6,0,7,9,3,25
191203642,7,6,3,5,5,26
191203643,7,2,4,0,6,19
191203644,8,3,7,4,0,22
191203645,3,4,7,9,2,25
191203646,0,6,1,9,0,16
191203647,9,2,0,7,4,22
191203648,0,2,4,9,6,21
191203649,5,2,3,3,6,19
191203650,8,3,4,3,5,23
191203651,3,1,8,9,0,21
191203652,3,4,2,9,2,20
191203653,9,4,0,4,5,22
191203654,7,2,0,5,3,17
191203655,4,5,0,8,0,17
191203656,7,6,7,5,3,28
191203657,7,0,1,3,7,18
191203658,8,2,4,0,0,14
191203659,1,9,1,8,0,19
191203660,7,2,2,1,9,21
191203661,3,5,4,4,0,16
191203662,3,5,5,7,8,28
191203663,0,2,5,8,2,17
191203664,0,5,6,0,0,11
191203665,6,0,9,0,4,19
191203666,3,7,3,2,2,17
191203667,2,4,7,4,1,18
191203668,2,0,4,2,9,17
191203669,7,2,4,1,8,22
191203670,7,0,3,3,4,17
191203671,7,5,3,1,1,17
191203672,8,1,4,1,0,14
191203673,0,1,0,0,1,2
191203674,4,5,0,7,0,16
191203675,3,0,9,1,0,13
191203676,8,9,9,1,0,27
191203677,9,3,6,0,5,23
191203678,5,1,8,8,5,27
191203679,8,1,6,3,4,22
191203680,1,3,7,9,9,29
191203681,3,7,1,7,7,25
191203682,9,1,4,4,3,21
191203683,3,2,6,1,4,16
191203684,7,8,3,4,4,26
191203685,6,5,9,5,4,29
191203686,1,9,3,0,0,13
191203687,1,4,4,3,1,13
191203688,0,4,3,9,3,19
191203689,7,2,5,7,8,29
191203690,8,4,1,0,2,15
191203691,3,8,8,6,8,33
191203692,1,8,9,1,0,19
191203693,0,8,6,7,3,24
191203694,0,3,0,6,8,17
191203695,7,5,6,8,2,28
191203696,4,9,5,2,0,20
191203697,0,6,3,3,7,19
191203698,1,5,3,4,9,22
191203699,4,8,0,3,1,16
191203700,4,8,1,0,9,22
191203701,6,4,8,5,4,27
191203702,8,0,9,8,3,28
191203703,8,1,4,4,1,18
191203704,7,2,9,5,6,29
191203705,3,9,9,8,2,31
191203706,8,6,5,8,0,27
191203707,9,6,3,0,0,18
191203708,4,3,3,7,3,20
191203709,3,9,8,6,4,30
191203710,1,8,5,7,3,24
191203711,2,5,1,5,9,22
191203712,4,4,7,4,7,26
191203713,0,5,1,8,3,17
191203714,4,5,4,0,8,21
191203715,7,2,9,4,4,26
191203716,0,7,6,0,6,19
191203717,8,9,2,8,1,28
191203718,9,7,7,3,1,27
191203719,1,2,3,8,8,22
191203720,2,2,0,3,1,8
191203721,6,7,8,6,8,35
191203722,1,6,5,5,2,19
191203723,0,9,4,8,3,24
191203724,6,6,2,7,6,27
191203725,5,9,4,0,5,23
191203726,5,6,5,0,0,16
191203727,7,5,2,2,6,22
191203728,6,9,3,0,0,18
191203729,3,4,9,4,0,20
191203730,2,4,4,0,8,18
191203731,0,0,6,0,5,11
191203732,8,4,6,0,8,26
191203733,5,8,7,9,8,37
191203734,3,7,4,1,2,17
191203735,2,5,0,9,1,17
191203736,0,0,3,0,5,8
191203737,6,6,7,5,6,30
191203738,1,0,7,4,3,15
191203739,4,0,6,2,9,21
191203740,3,2,6,4,6,21
191203741,5,6,2,9,0,22
191203742,8,4,5,9,2,28
191203743,0,0,6,6,0,12
191203744,2,6,0,9,1,18
191203745,2,1,8,2,6,19
191203746,5,6,2,3,4,20
191203747,0,2,4,5,7,18
191203748,4,7,9,8,6,34
191203749,6,9,7,0,2,24
191203750,2,1,4,0,1,8
191203751,3,8,8,4,2,25
191203752,0,3,8,4,7,22
191203753,9,6,9,6,5,35
191203754,9,8,4,7,1,29
191203755,4,2,5,4,4,19
191203756,9,8,1,8,4,30
191203757,6,6,8,0,4,24
191203758,7,3,1,4,3,18
191203759,4,6,0,4,6,20
191203760,7,0,1,0,2,10
191203761,3,7,6,9,5,30
191203762,3,7,6,8,2,26
191203763,1,9,5,0,2,17
191203764,2,8,3,9,6,28
191203765,0,1,9,7,9,26
191203766,1,2,2,4,0,9
191203767,9,5,4,7,5,30
191203768,6,7,7,2,5,27
191203769,1,3,3,2,4,13
191203770,2,7,7,3,2,21
191203771,2,7,5,9,1,24
191203772,8,2,6,3,0,19
191203773,3,0,9,1,6,19
191203774,7,2,2,0,8,19
191203775,0,6,9,7,8,30
191203776,7,6,6,7,9,35
191203777,0,1,0,2,2,5
191203778,0,0,0,7,5,12
191203779,0,1,4,5,3,13
191203780,4,9,3,2,9,27
191203781,9,2,9,1,5,26
191203782,0,1,3,1,9,14
191203783,8,7,8,6,8,37
191203784,2,9,9,6,4,30
191203785,5,1,4,6,4,20
191203786,9,9,7,3,3,31
191203787,8,6,0,8,7,29
191203788,0,1,4,6,5,16
191203789,7,0,9,4,2,22
191203790,2,7,2,6,6,23
191203791,1,9,9,9,5,33
191203792,9,4,0,7,4,24
191203793,8,1,1,9,0,19
191203794,3,5,8,8,6,30
191203795,9,6,5,8,5,33
191203796,0,8,6,7,6,27
191203797,8,6,6,4,2,26
191203798,2,8,0,5,8,23
191203799,3,5,1,0,1,10
191203800,4,7,8,8,1,28
191203801,3,4,3,6,2,18
191203802,4,4,2,2,9,21
191203803,5,7,5,5,0,22
191203804,1,4,8,7,1,21
191203805,5,6,7,5,0,23
191203806,6,9,3,5,5,28
191203807,7,9,2,0,9,27
191203808,5,9,2,7,2,25
191203809,4,6,2,9,8,29
191203810,2,6,7,3,8,26
191203811,9,2,2,4,9,26
191203812,2,7,6,6,5,26
191203813,8,1,6,8,1,24
191203814,8,6,4,9,4,31
191203815,3,7,0,7,3,20
191203816,4,6,1,5,4,20
191203817,6,4,8,6,7,31
191203818,2,3,9,9,9,32
191203819,3,3,1,5,9,21
191203820,8,4,1,2,9,24
191203821,3,3,3,9,8,26
191203822,8,7,6,5,4,30
191203823,3,6,4,4,4,21
191203824,4,3,4,2,0,13
191203825,9,2,3,1,6,21
191203826,0,4,1,7,2,14
191203827,1,8,0,9,7,25
191203828,0,2,6,9,0,17
191203829,8,2,3,1,9,23
191203830,4,0,3,4,2,13
191203831,0,8,4,2,6,20
191203832,7,8,9,3,7,34
191203833,5,8,3,1,3,20
191203834,6,8,9,0,4,27
191203835,6,2,1,2,7,18
191203836,3,1,9,9,3,25
191203837,1,5,1,8,8,23
191203838,2,5,7,2,6,22
191203839,9,0,7,0,6,22
191203840,2,2,7,4,7,22
191203841,4,8,9,5,5,31
191203842,7,8,0,9,3,27
191203843,1,4,6,1,1,13
191203844,3,4,4,7,9,27
191203845,0,6,7,6,3,22
191203846,6,7,6,8,8,35
191203847,1,5,2,3,5,16
191203848,2,6,6,0,5,19
191203849,3,8,2,0,6,19
191203850,3,8,3,4,9,27
191203851,3,5,3,3,7,21
191203852,8,6,6,3,5,28
191203853,2,3,1,3,3,12
191203854,4,4,0,6,6,20
191203855,9,8,1,2,3,23
191203856,4,5,2,9,7,27
191203857,4,7,4,9,0,24
191203858,7,2,8,4,7,28
191203859,9,9,5,8,3,34
191203860,6,0,0,7,5,18
191203861,0,0,2,6,1,9
191203862,8,8,0,1,3,20
191203863,8,9,8,3,7,35
191203864,6,8,2,9,2,27
191203865,6,3,7,7,3,26
191203866,6,2,2,6,8,24
191203867,1,6,3,2,6,18
191203868,3,9,0,6,0,18
191203869,4,1,7,5,7,24
191203870,5,7,9,8,8,37
191203871,1,3,1,2,5,12
191203872,0,7,7,7,2,23
191203873,3,0,7,1,3,14
191203874,1,6,7,7,9,30
191203875,2,9,1,8,6,26
191203876,3,4,9,6,0,22
191203877,4,9,7,9,9,38
191203878,3,9,2,0,4,18
191203879,9,8,0,6,6,29
191203880,8,1,1,1,5,16
191203881,2,5,6,0,4,17
191203882,8,7,8,6,0,29
191203883,4,9,8,0,0,21
191203884,5,6,3,3,9,26
191203885,5,2,2,7,2,18
191203886,9,3,8,5,8,33
191203887,5,0,0,0,0,5
191203888,5,2,0,1,6,14
191203889,0,7,3,2,0,12
191203890,7,6,6,0,7,26
191203891,3,2,6,6,5,22
191203892,2,1,5,7,4,19
191203893,2,4,3,1,9,19
191203894,2,8,6,1,1,18
191203895,4,6,8,9,6,33
191203896,3,3,2,9,3,20
191203897,9,7,1,2,8,27
191203898,5,7,9,8,4,33
191203899,6,9,1,4,4,24
191203900,7,2,6,4,0,19
191203901,9,9,1,3,5,27
191203902,9,9,2,7,1,28
191203903,0,2,7,6,7,22
191203904,5,7,4,4,2,22
191203905,6,7,1,8,6,28
191203906,2,5,8,0,7,22
191203907,9,2,8,2,6,27
191203908,0,3,1,4,6,14
191203909,0,6,5,5,1,17
191203910,8,3,7,3,1,22
191203911,0,6,9,5,2,22
191203912,9,4,7,9,0,29
191203913,6,1,1,8,3,19
191203914,6,4,8,9,8,35
191203915,7,7,5,0,5,24
191203916,5,9,2,2,9,27
191203917,7,6,4,0,1,18
191203918,6,0,7,9,5,27
191203919,0,0,8,2,0,10
191203920,2,3,0,3,6,14
191203921,8,7,6,3,6,30
191203922,8,6,1,4,6,25
191203923,4,6,8,7,6,31
191203924,4,3,5,3,4,19
191203925,1,8,1,0,2,12
191203926,7,8,3,2,9,29
191203927,9,4,1,1,6,21
191203928,5,9,6,3,3,26
191203929,4,0,5,6,2,17
191203930,9,1,9,1,4,24
191203931,4,8,4,5,4,25
191203932,1,1,0,7,6,15
191203933,1,7,8,4,4,24
191203934,4,4,8,4,0,20
191203935,4,1,0,2,6,13
191203936,3,8,5,8,4,28
191203937,5,3,2,0,4,14
191203938,3,5,8,4,2,22
191203939,3,8,0,0,2,13
191203940,1,8,2,2,4,17
191203941,6,3,0,4,9,22
191203942,8,7,2,9,7,33
191203943,0,0,0,6,7,13
191203944,4,5,9,6,0,24
191203945,1,6,4,5,7,23
191203946,1,6,8,1,0,16
191203947,6,0,5,1,0,12
191203948,8,1,4,4,2,19
191203949,4,1,9,6,0,20
191203950,0,4,4,6,6,20
191203951,7,1,4,6,0,18
191203952,4,8,0,7,3,22
191203953,4,2,3,6,4,19
191203954,4,8,4,9,4,29
191203955,3,6,0,6,4,19
191203956,1,9,5,3,8,26
191203957,2,4,4,5,9,24
191203958,1,3,8,1,3,16
191203959,9,7,4,3,3,26
191203960,6,4,5,1,5,21
191203961,6,3,6,0,6,21
191203962,2,0,3,8,4,17
191203963,3,5,8,5,1,22
191203964,2,5,6,8,3,24
191203965,9,2,9,0,2,22
191203966,8,1,8,2,4,23
191203967,2,7,6,5,0,20
191203968,6,4,5,8,3,26
191203969,0,2,8,5,2,17
191203970,4,1,0,6,2,13
191203971,6,4,3,6,6,25
191203972,6,6,5,0,9,26
191203973,4,4,5,2,8,23
191203974,9,3,6,3,2,23
191203975,7,1,6,4,9,27
191203976,6,5,0,4,6,21
191203977,7,9,0,9,4,29
191203978,7,7,1,9,5,29
191203979,3,6,5,0,7,21
191203980,2,1,9,3,1,16
191203981,0,3,6,3,9,21
191203982,2,9,6,3,6,26
191203983,5,8,1,2,8,24
191203984,8,6,4,0,3,21
191203985,8,8,6,7,3,32
191203986,4,5,9,7,7,32
191203987,4,2,7,4,4,21
191203988,2,3,9,3,6,23
191203989,1,0,9,7,0,17
191203990,1,7,7,6,7,28
191203991,2,2,0,3,8,15
191203992,4,2,4,6,8,24
191203993,9,9,8,7,0,33
191203994,6,1,4,6,4,21
191203995,0,4,1,1,8,14
191203996,4,0,6,0,3,13
191203997,3,0,7,6,1,17
191203998,5,9,8,2,9,33
191203999,7,9,2,4,7,29
1912031000,7,3,7,4,5,26
1912031001,5,7,8,8,0,28
1912031002,7,9,4,9,5,34
1912031003,9,9,7,7,2,34
1912031004,2,9,9,2,9,31
1912031005,3,9,8,9,7,36
1912031006,5,4,8,7,2,26
1912031007,6,2,9,4,7,28
1912031008,4,9,0,8,1,22
1912031009,9,4,7,9,9,38
1912031010,5,4,8,2,9,28
1912031011,1,5,4,0,1,11
1912031012,6,6,8,3,0,23
1912031013,0,7,6,6,1,20
1912031014,7,6,5,1,9,28
1912031015,6,8,9,2,0,25
1912031016,0,7,5,4,5,21
1912031017,1,2,4,3,4,14
1912031018,0,0,0,1,5,6
1912031019,5,6,3,8,4,26
1912031020,3,3,1,0,7,14
1912031021,6,4,2,3,8,23
1912031022,5,1,3,0,5,14
1912031023,9,1,7,0,3,20
1912031024,4,3,0,4,2,13
1912031025,2,5,5,9,8,29
1912031026,9,7,6,3,2,27
1912031027,4,1,9,1,7,22
1912031028,3,1,7,7,6,24
1912031029,2,0,4,6,0,12
1912031030,6,1,3,9,8,27
1912031031,5,3,0,0,1,9
1912031032,0,7,0,5,1,13
1912031033,6,5,3,7,3,24
1912031034,7,1,4,4,7,23
1912031035,2,9,2,2,1,16
1912031036,7,9,2,1,5,24
1912031037,0,0,4,2,6,12
1912031038,8,6,0,2,4,20
1912031039,8,1,3,6,6,24
1912031040,5,4,5,2,8,24
1912031041,4,1,8,6,6,25
1912031042,9,5,2,5,7,28
1912031043,0,3,7,6,9,25
1912031044,5,7,6,6,8,32
1912031045,6,3,6,8,1,24
1912031046,4,3,2,7,8,24
1912031047,1,4,8,0,4,17
1912031048,6,3,7,2,4,22
1912031049,1,1,8,8,4,22
1912031050,0,7,0,2,0,9
1912031051,0,2,7,8,1,18
1912031052,8,7,0,4,8,27
1912031053,7,9,7,0,9,32
1912031054,9,9,5,2,6,31
1912031055,8,9,3,6,7,33
1912031056,3,3,8,3,2,19
1912031057,9,4,0,5,9,27
1912031058,3,2,0,9,2,16
1912031059,7,7,7,1,9,31
1912031060,6,7,3,7,1,24
1912031061,4,8,0,6,0,18
1912031062,6,3,7,2,8,26
1912031063,6,9,6,6,0,27
1912031064,3,1,9,7,1,21
1912031065,8,6,8,2,0,24
1912031066,0,3,0,8,6,17
1912031067,6,1,6,9,3,25
1912031068,2,3,2,2,8,17
1912031069,0,8,7,8,9,32
1912031070,6,0,0,3,4,13
1912031071,2,2,3,8,2,17
1912031072,3,0,6,1,7,17
1912031073,9,8,3,5,1,26
1912031074,0,0,8,6,7,21
1912031075,5,2,3,6,2,18
1912031076,7,2,6,7,0,22
1912031077,5,7,7,9,3,31
1912031078,8,4,3,8,7,30
1912031079,4,5,6,7,3,25
1912031080,4,3,4,4,7,22
1912031081,3,6,5,2,4,20
1912031082,2,0,5,5,7,19
1912031083,6,2,1,2,4,15
1912031084,0,1,8,2,6,17
1912031085,7,3,9,1,7,27
1912031086,9,6,8,6,6,35
1912031087,5,5,8,4,7,29
1912031088,5,5,5,6,9,30
1912031089,2,9,2,6,1,20
1912031090,5,1,0,4,3,13
1912031091,8,3,8,2,6,27
1912031092,3,1,2,8,9,23
1912031093,8,8,0,5,3,24
1912031094,4,1,9,5,0,19
1912031095,6,6,9,5,6,32
1912031096,8,8,0,3,9,28
1912031097,1,7,3,2,3,16
1912031098,0,8,3,9,6,26
1912031099,7,6,9,4,4,30
1912031100,8,0,9,0,4,21
1912031101,4,0,8,0,8,20
1912031102,7,7,5,9,0,28
1912031103,8,9,1,3,0,21
1912031104,8,8,0,5,5,26
1912031105,4,8,1,3,3,19
191204001,6,1,3,0,5,15
191204002,1,1,2,3,5,12
191204003,7,7,0,0,6,20
191204004,8,0,5,6,0,19
191204005,6,5,1,4,7,23
191204006,4,5,2,1,2,14
191204007,5,1,5,2,9,22
191204008,6,8,4,2,8,28
191204009,4,5,1,1,9,20
191204010,7,1,7,8,5,28
191204011,5,1,7,9,5,27
191204012,4,9,6,0,5,24
191204013,9,1,7,6,3,26
191204014,1,3,4,0,2,10
191204015,0,8,8,9,8,33
191204016,6,3,6,0,0,15
191204017,6,4,1,3,2,16
191204018,2,5,8,7,2,24
191204019,1,9,7,4,5,26
191204020,0,2,6,0,2,10
191204021,1,1,8,2,2,14
191204022,4,1,5,9,3,22
191204023,3,6,5,7,6,27
191204024,5,3,3,4,5,20
191204025,8,7,8,2,8,33
191204026,9,5,0,8,0,22
191204027,3,5,8,7,5,28
191204028,2,2,4,6,8,22
191204029,1,8,1,1,7,18
191204030,5,5,1,5,8,24
191204031,7,4,3,6,2,22
191204032,8,1,3,5,2,19
191204033,6,8,6,6,2,28
191204034,9,1,8,2,5,25
191204035,4,9,5,9,7,34
191204036,0,6,9,1,7,23
191204037,3,3,7,6,6,25
191204038,4,9,5,3,6,27
191204039,5,5,9,9,8,36
191204040,5,8,1,3,9,26
191204041,0,2,6,6,7,21
191204042,7,9,6,2,8,32
191204043,6,2,4,3,0,15
191204044,5,2,4,6,4,21
191204045,9,5,1,6,1,22
191204046,5,4,1,5,4,19
191204047,3,2,4,0,5,14
191204048,0,7,5,6,4,22
191204049,7,3,4,3,9,26
191204050,2,9,8,0,6,25
191204051,4,9,6,7,9,35
191204052,4,5,4,9,9,31
191204053,5,2,1,6,3,17
191204054,6,6,4,8,9,33
191204055,2,6,0,4,8,20
191204056,3,9,3,9,3,27
191204057,0,6,0,8,3,17
191204058,8,0,8,4,7,27
191204059,6,1,3,5,7,22
191204060,9,3,3,8,2,25
191204061,8,0,8,2,5,23
191204062,8,6,8,1,2,25
191204063,6,1,4,5,3,19
191204064,5,7,0,9,8,29
191204065,3,6,9,7,7,32
191204066,7,1,4,5,3,20
191204067,6,9,8,5,9,37
191204068,0,5,5,8,9,27
191204069,1,7,5,5,3,21
191204070,5,5,1,1,5,17
191204071,3,6,7,0,2,18
191204072,6,5,2,0,9,22
191204073,8,2,2,9,9,30
191204074,5,4,2,9,0,20
191204075,0,5,4,4,7,20
191204076,3,0,1,9,9,22
191204077,3,9,3,6,8,29
191204078,7,5,5,2,8,27
191204079,6,3,6,4,0,19
191204080,3,4,2,5,7,21
191204081,2,4,1,6,0,13
191204082,6,1,1,2,6,16
191204083,0,5,1,5,9,20
191204084,5,7,8,2,3,25
191204085,7,4,1,4,1,17
191204086,9,2,3,5,0,19
191204087,1,5,2,2,5,15
191204088,8,8,5,5,5,31
191204089,3,7,3,0,2,15
191204090,5,9,3,7,0,24
191204091,7,8,1,8,9,33
191204092,3,2,4,2,7,18
191204093,9,1,9,5,8,32
191204094,2,9,9,8,7,35
191204095,2,6,1,9,8,26
191204096,2,1,2,4,6,15
191204097,2,9,0,4,8,23
191204098,0,1,1,8,1,11
191204099,3,7,2,3,7,22
191204100,3,2,8,5,5,23
191204101,6,4,2,0,4,16
191204102,1,6,6,4,7,24
191204103,3,5,3,4,4,19
191204104,1,5,2,7,9,24
191204105,5,7,2,9,8,31
191204106,9,0,7,7,2,25
191204107,7,9,0,5,2,23
191204108,2,5,0,6,7,20
191204109,3,0,7,2,6,18
191204110,1,2,3,4,6,16
191204111,0,0,1,3,3,7
191204112,4,7,8,4,0,23
191204113,3,5,1,9,4,22
191204114,6,3,2,5,7,23
191204115,0,7,9,9,6,31
191204116,5,2,3,1,4,15
191204117,9,0,6,3,1,19
191204118,5,3,7,5,9,29
191204119,6,2,4,5,8,25
191204120,6,5,5,0,9,25
191204121,1,0,2,6,4,13
191204122,6,4,3,1,4,18
191204123,4,6,6,4,5,25
191204124,9,7,6,3,0,25
191204125,9,4,0,8,7,28
191204126,3,0,5,0,1,9
191204127,6,9,9,3,5,32
191204128,1,2,9,1,7,20
191204129,2,3,4,6,9,24
191204130,1,2,0,3,6,12
191204131,9,1,9,8,9,36
191204132,4,3,2,5,9,23
191204133,1,4,8,9,2,24
191204134,6,5,2,1,4,18
191204135,4,7,4,6,3,24
191204136,4,2,8,3,5,22
191204137,4,0,5,6,6,21
191204138,6,6,3,7,3,25
191204139,9,0,7,9,5,30
191204140,4,0,1,5,6,16
191204141,6,6,2,1,1,16
191204142,8,7,7,3,1,26
191204143,5,1,3,9,6,24
191204144,4,2,6,0,2,14
191204145,8,1,8,6,6,29
191204146,6,8,9,6,2,31
191204147,6,7,2,9,3,27
191204148,9,8,4,3,1,25
191204149,3,2,9,0,7,21
191204150,7,7,2,6,1,23
191204151,7,9,6,2,7,31
191204152,0,7,7,5,8,27
191204153,0,3,4,1,1,9
191204154,9,0,4,0,4,17
191204155,4,6,4,2,0,16
191204156,7,8,6,1,5,27
191204157,3,8,2,5,7,25
191204158,6,8,7,4,8,33
191204159,5,9,2,7,7,30
191204160,2,0,7,7,0,16
191204161,4,2,1,0,9,16
191204162,6,5,3,0,8,22
191204163,4,2,1,2,2,11
191204164,7,6,7,8,5,33
191204165,1,3,9,3,6,22
191204166,1,5,9,1,2,18
191204167,0,9,1,7,2,19
191204168,7,4,8,6,8,33
191204169,1,1,5,3,0,10
191204170,8,5,7,4,7,31
191204171,0,8,0,3,2,13
191204172,1,6,5,0,0,12
191204173,9,1,3,4,6,23
191204174,9,9,1,4,1,24
191204175,4,4,8,3,7,26
191204176,4,6,9,5,4,28
191204177,8,0,4,4,0,16
191204178,3,8,6,4,6,27
191204179,6,2,3,9,2,22
191204180,7,3,3,8,2,23
191204181,8,9,4,6,9,36
191204182,3,9,2,9,1,24
191204183,2,1,3,8,8,22
191204184,6,6,4,8,5,29
191204185,8,3,4,1,5,21
191204186,2,7,1,5,9,24
191204187,0,4,4,8,8,24
191204188,2,5,9,1,7,24
191204189,5,7,8,8,5,33
191204190,4,7,0,1,7,19
191204191,5,0,0,5,5,15
191204192,8,2,4,8,3,25
191204193,4,2,9,9,9,33
191204194,5,7,3,4,6,25
191204195,8,5,2,8,8,31
191204196,8,2,2,3,3,18
191204197,6,4,6,2,9,27
191204198,1,2,8,9,5,25
191204199,7,4,4,8,1,24
191204200,9,4,2,9,9,33
191204201,8,9,5,6,6,34
191204202,5,8,5,3,3,24
191204203,1,0,8,5,4,18
191204204,8,2,4,2,9,25
191204205,5,5,5,6,0,21
191204206,4,9,6,2,1,22
191204207,1,1,8,0,3,13
191204208,8,3,9,2,6,28
191204209,3,4,5,5,5,22
191204210,2,1,1,4,0,8
191204211,5,1,3,9,3,21
191204212,9,7,4,1,1,22
191204213,0,0,0,2,2,4
191204214,9,2,5,4,5,25
191204215,7,8,1,8,2,26
191204216,1,5,3,8,6,23
191204217,4,2,3,1,0,10
191204218,9,9,0,9,8,35
191204219,4,8,7,9,7,35
191204220,4,1,3,0,8,16
191204221,3,3,1,0,1,8
191204222,3,9,0,4,6,22
191204223,7,1,7,1,9,25
191204224,6,6,1,1,9,23
191204225,2,3,2,6,2,15
191204226,4,0,6,9,4,23
191204227,1,8,8,7,1,25
191204228,6,3,2,9,5,25
191204229,4,5,2,6,4,21
191204230,9,2,2,3,6,22
191204231,0,4,1,1,2,8
191204232,6,1,6,3,5,21
191204233,4,8,5,5,7,29
191204234,0,2,7,0,1,10
191204235,5,3,7,0,5,20
191204236,0,9,9,9,4,31
191204237,7,9,3,5,6,30
191204238,5,7,5,3,7,27
191204239,2,0,5,5,5,17
191204240,1,9,3,7,0,20
191204241,3,3,2,5,5,18
191204242,3,5,2,5,8,23
191204243,7,4,0,7,4,22
191204244,2,1,0,4,1,8
191204245,9,4,4,9,8,34
191204246,0,7,9,1,4,21
191204247,9,6,3,8,7,33
191204248,6,7,6,7,9,35
191204249,4,7,3,7,7,28
191204250,2,7,8,4,5,26
191204251,2,6,0,7,0,15
191204252,5,0,7,2,5,19
191204253,8,9,8,0,8,33
191204254,9,2,9,9,5,34
191204255,4,6,7,1,8,26
191204256,0,4,3,6,4,17
191204257,6,3,7,5,4,25
191204258,2,7,2,9,8,28
191204259,0,1,2,6,0,9
191204260,3,4,0,4,8,19
191204261,6,0,2,3,7,18
191204262,5,1,6,3,9,24
191204263,8,7,5,0,8,28
191204264,8,3,2,8,3,24
191204265,6,4,6,9,5,30
191204266,5,9,7,2,3,26
191204267,0,8,0,0,5,13
191204268,5,1,7,1,8,22
191204269,8,6,7,4,0,25
191204270,5,3,3,7,9,27
191204271,4,5,4,7,2,22
191204272,6,1,1,7,3,18
191204273,6,3,8,3,8,28
191204274,9,1,5,3,5,23
191204275,4,0,4,1,5,14
191204276,1,4,4,3,5,17
191204277,3,6,7,2,5,23
191204278,0,0,0,1,6,7
191204279,9,5,9,1,9,33
191204280,3,5,6,6,6,26
191204281,9,2,8,5,8,32
191204282,8,6,5,1,0,20
191204283,8,2,4,0,5,19
191204284,0,0,6,2,7,15
191204285,3,5,2,4,9,23
191204286,4,6,2,7,0,19
191204287,5,5,5,6,8,29
191204288,2,7,2,7,8,26
191204289,4,0,0,7,7,18
191204290,4,6,8,0,7,25
191204291,1,1,2,9,9,22
191204292,9,7,2,0,5,23
191204293,4,8,6,0,9,27
191204294,6,1,1,1,5,14
191204295,2,3,1,4,8,18
191204296,1,6,8,7,5,27
191204297,9,8,3,1,6,27
191204298,1,5,0,1,0,7
191204299,1,8,1,2,9,21
191204300,1,3,4,8,4,20
191204301,1,1,4,8,7,21
191204302,7,2,5,1,9,24
191204303,2,1,4,1,1,9
191204304,5,0,8,8,0,21
191204305,5,5,1,8,4,23
191204306,4,9,0,6,5,24
191204307,8,0,3,9,9,29
191204308,9,8,4,0,4,25
191204309,7,0,6,4,7,24
191204310,6,2,2,9,8,27
191204311,1,5,2,5,4,17
191204312,9,0,7,6,2,24
191204313,5,5,7,4,0,21
191204314,2,2,4,1,1,10
191204315,9,2,6,9,4,30
191204316,2,7,6,6,9,30
191204317,8,1,9,7,9,34
191204318,8,5,6,4,6,29
191204319,7,7,1,5,2,22
191204320,8,0,6,3,9,26
191204321,2,0,5,8,7,22
191204322,4,7,3,6,8,28
191204323,5,7,2,6,8,28
191204324,9,4,6,4,6,29
191204325,7,5,4,7,4,27
191204326,0,8,1,9,3,21
191204327,7,8,8,2,3,28
191204328,6,4,4,0,3,17
191204329,1,1,2,5,2,11
191204330,0,3,6,4,2,15
191204331,4,3,4,0,8,19
191204332,7,1,6,7,9,30
191204333,7,2,1,2,4,16
191204334,5,0,9,4,8,26
191204335,9,5,7,3,7,31
191204336,9,1,9,2,9,30
191204337,8,8,5,4,9,34
191204338,1,2,6,3,9,21
191204339,9,7,6,7,4,33
191204340,6,0,4,2,0,12
191204341,9,7,7,9,5,37
191204342,4,2,9,7,8,30
191204343,4,3,9,9,3,28
191204344,1,5,4,4,5,19
191204345,7,5,8,6,8,34
191204346,5,0,5,3,5,18
191204347,2,9,9,2,0,22
191204348,9,1,5,3,0,18
191204349,8,0,1,2,9,20
191204350,0,1,7,6,0,14
191204351,5,2,0,1,1,9
191204352,7,4,5,4,4,24
191204353,1,7,9,9,5,31
191204354,5,0,7,1,7,20
191204355,8,5,3,2,8,26
191204356,7,7,3,6,4,27
191204357,0,1,7,7,6,21
191204358,0,7,2,5,8,22
191204359,2,3,3,4,4,16
191204360,7,0,9,6,6,28
191204361,7,6,4,2,2,21
191204362,2,9,5,4,6,26
191204363,3,5,3,2,2,15
191204364,2,0,9,5,8,24
191204365,2,3,6,3,0,14
191204366,8,7,0,9,2,26
191204367,6,6,7,3,7,29
191204368,8,6,1,5,7,27
191204369,3,0,1,8,8,20
191204370,4,0,9,4,8,25
191204371,5,4,8,4,8,29
191204372,8,6,9,8,3,34
191204373,4,3,6,4,0,17
191204374,0,1,4,3,6,14
191204375,1,2,9,5,4,21
191204376,9,0,6,2,3,20
191204377,8,3,1,4,9,25
191204378,6,1,0,4,4,15
191204379,2,6,9,4,9,30
191204380,2,4,8,7,2,23
191204381,8,7,6,8,3,32
191204382,7,8,5,2,0,22
191204383,1,5,4,8,4,22
191204384,3,6,5,0,2,16
191204385,3,7,7,1,0,18
191204386,1,5,7,6,2,21
191204387,7,6,7,9,5,34
191204388,0,0,2,7,7,16
191204389,8,7,8,2,0,25
191204390,6,9,0,6,0,21
191204391,7,2,7,6,4,26
191204392,8,4,6,4,7,29
191204393,5,0,9,6,3,23
191204394,5,7,2,3,5,22
191204395,0,6,3,2,7,18
191204396,8,6,7,2,5,28
191204397,6,1,4,4,4,19
191204398,9,8,6,6,8,37
191204399,7,1,8,4,6,26
191204400,7,8,7,5,7,34
191204401,2,0,6,2,6,16
191204402,7,4,4,9,9,33
191204403,6,7,1,6,0,20
191204404,1,0,2,8,8,19
191204405,5,2,3,7,9,26
191204406,6,6,8,1,2,23
191204407,9,5,2,0,1,17
191204408,9,2,8,6,1,26
191204409,6,0,5,4,2,17
191204410,8,1,0,8,9,26
191204411,7,6,6,9,8,36
191204412,4,7,7,2,9,29
191204413,6,9,7,7,0,29
191204414,0,7,7,3,0,17
191204415,5,6,4,7,2,24
191204416,2,8,8,1,5,24
191204417,0,9,5,7,7,28
191204418,0,4,3,8,3,18
191204419,9,1,4,1,8,23
191204420,8,5,6,5,2,26
191204421,5,6,2,6,5,24
191204422,6,8,1,3,3,21
191204423,4,0,8,6,5,23
191204424,4,8,0,0,0,12
191204425,9,1,7,4,0,21
191204426,1,5,3,4,2,15
191204427,5,7,8,0,7,27
191204428,2,0,6,2,5,15
191204429,4,6,0,3,1,14
191204430,6,8,4,0,3,21
191204431,2,7,6,4,9,28
191204432,5,7,6,6,2,26
191204433,8,2,1,9,6,26
191204434,3,7,1,6,6,23
191204435,1,5,9,0,3,18
191204436,3,1,2,9,0,15
191204437,3,6,4,5,1,19
191204438,1,9,2,9,7,28
191204439,3,7,9,5,7,31
191204440,4,1,4,6,8,23
191204441,9,1,1,1,2,14
191204442,0,0,0,8,3,11
191204443,7,5,4,2,2,20
191204444,6,8,4,3,0,21
191204445,1,0,2,0,5,8
191204446,2,6,1,1,4,14
191204447,6,3,6,0,3,18
191204448,3,4,6,7,4,24
191204449,0,2,5,9,9,25
191204450,1,0,3,1,2,7
191204451,2,9,0,8,5,24
191204452,9,3,6,0,3,21
191204453,9,1,2,8,5,25
191204454,5,5,6,9,4,29
191204455,9,1,5,8,3,26
191204456,5,7,8,6,5,31
191204457,1,9,7,2,2,21
191204458,2,2,0,7,8,19
191204459,2,5,3,1,8,19
191204460,7,8,2,5,7,29
191204461,7,2,4,6,4,23
191204462,6,1,6,0,9,22
191204463,2,8,5,9,9,33
191204464,5,0,6,8,4,23
191204465,9,8,4,7,5,33
191204466,4,7,7,8,3,29
191204467,9,4,0,0,3,16
191204468,6,5,0,0,4,15
191204469,9,5,5,9,1,29
191204470,2,6,7,1,7,23
191204471,1,6,9,9,0,25
191204472,9,3,6,3,7,28
191204473,7,5,7,7,4,30
191204474,8,0,8,2,9,27
191204475,3,4,4,9,0,20
191204476,0,8,8,3,2,21
191204477,8,6,8,3,5,30
191204478,3,7,4,3,9,26
191204479,8,2,7,5,2,24
191204480,3,7,2,1,0,13
191204481,0,1,2,1,7,11
191204482,3,1,7,3,0,14
191204483,1,8,5,4,2,20
191204484,4,7,6,8,7,32
191204485,1,0,2,9,9,21
191204486,5,1,3,4,7,20
191204487,6,8,3,0,8,25
191204488,4,9,6,5,1,25
191204489,2,6,4,5,0,17
191204490,0,6,1,3,4,14
191204491,1,2,9,7,7,26
191204492,3,9,6,8,0,26
191204493,0,6,5,9,6,26
191204494,5,8,0,0,2,15
191204495,1,8,5,7,8,29
191204496,4,1,0,2,8,15
191204497,1,7,7,6,0,21
191204498,1,8,7,6,6,28
191204499,3,1,4,6,3,17
191204500,5,5,6,0,2,18
191204501,9,4,6,2,0,21
191204502,9,6,1,4,3,23
191204503,9,7,6,7,7,36
191204504,0,5,3,5,6,19
191204505,4,4,7,2,2,19
191204506,3,7,4,0,7,21
191204507,9,8,9,8,7,41
191204508,1,2,1,9,5,18
191204509,5,8,9,1,1,24
191204510,0,1,0,8,7,16
191204511,8,4,8,5,7,32
191204512,0,1,5,6,1,13
191204513,8,7,6,8,9,38
191204514,9,0,5,0,4,18
191204515,2,6,8,1,9,26
191204516,2,3,9,1,3,18
191204517,1,8,7,6,0,22
191204518,5,6,0,7,8,26
191204519,3,5,7,4,3,22
191204520,6,1,6,7,7,27
191204521,2,4,6,6,8,26
191204522,5,3,0,7,6,21
191204523,3,2,4,2,0,11
191204524,2,7,2,3,8,22
191204525,3,0,9,5,2,19
191204526,5,8,2,4,4,23
191204527,2,5,6,8,2,23
191204528,8,6,4,3,2,23
191204529,7,7,4,6,0,24
191204530,3,9,3,9,9,33
191204531,9,2,7,2,3,23
191204532,0,8,8,7,0,23
191204533,5,4,8,8,2,27
191204534,7,0,0,8,6,21
191204535,2,7,2,4,5,20
191204536,5,8,7,3,0,23
191204537,8,5,7,6,5,31
191204538,4,9,9,8,4,34
191204539,4,1,5,0,7,17
191204540,4,4,0,5,0,13
191204541,4,4,3,7,4,22
191204542,1,7,1,2,9,20
191204543,0,1,0,6,6,13
191204544,5,7,1,9,3,25
191204545,6,6,4,5,9,30
191204546,6,7,2,5,2,22
191204547,8,4,7,6,4,29
191204548,6,5,5,8,9,33
191204549,4,5,3,0,4,16
191204550,8,8,6,5,3,30
191204551,4,4,7,3,0,18
191204552,5,9,7,4,9,34
191204553,2,3,3,8,7,23
191204554,9,6,2,0,8,25
191204555,4,3,6,8,7,28
191204556,1,2,7,9,0,19
191204557,4,4,6,3,2,19
191204558,8,0,5,9,3,25
191204559,5,3,2,8,2,20
191204560,8,5,9,4,2,28
191204561,7,0,4,5,5,21
191204562,8,2,8,5,3,26
191204563,1,5,9,7,5,27
191204564,9,4,9,2,1,25
191204565,6,5,3,0,9,23
191204566,3,2,5,0,8,18
191204567,5,7,7,1,9,29
191204568,1,2,7,2,4,16
191204569,2,8,9,7,2,28
191204570,1,2,9,3,1,16
191204571,6,4,2,8,1,21
191204572,4,9,5,1,7,26
191204573,4,1,1,5,8,19
191204574,2,3,5,0,8,18
191204575,7,5,8,8,0,28
191204576,6,5,7,7,1,26
191204577,6,5,6,5,9,31
191204578,5,2,4,5,5,21
191204579,0,7,4,8,4,23
191204580,9,8,1,9,5,32
191204581,7,5,3,8,0,23
191204582,6,3,8,3,4,24
191204583,6,5,5,1,0,17
191204584,8,6,0,1,3,18
191204585,7,0,7,4,7,25
191204586,3,6,4,1,9,23
191204587,1,9,6,5,2,23
191204588,0,4,1,5,1,11
191204589,9,8,0,3,8,28
191204590,1,6,4,9,7,27
191204591,6,1,0,6,3,16
191204592,6,2,0,0,7,15
191204593,4,3,9,3,0,19
191204594,0,5,3,4,0,12
191204595,2,2,0,9,1,14
191204596,4,2,3,5,4,18
191204597,7,2,8,4,9,30
191204598,7,1,1,2,3,14
191204599,5,7,6,9,5,32
191204600,4,6,9,8,9,36
191204601,9,4,4,6,7,30
191204602,0,9,7,6,4,26
191204603,0,9,3,4,0,16
191204604,9,3,4,7,6,29
191204605,0,9,3,6,2,20
191204606,7,5,4,5,7,28
191204607,8,4,8,2,7,29
191204608,4,7,3,8,8,30
191204609,2,6,8,1,4,21
191204610,3,1,1,9,2,16
191204611,0,4,3,4,5,16
191204612,3,5,3,5,0,16
191204613,1,5,8,5,3,22
191204614,7,9,2,6,6,30
191204615,2,6,1,0,7,16
191204616,8,3,3,2,6,22
191204617,6,5,7,6,6,30
191204618,1,5,2,1,0,9
191204619,2,1,0,6,0,9
191204620,5,7,4,9,7,32
191204621,6,2,2,7,8,25
191204622,0,9,3,5,4,21
191204623,7,3,2,8,3,23
191204624,8,8,1,2,9,28
191204625,6,4,9,0,7,26
191204626,9,8,2,8,6,33
191204627,2,4,9,9,4,28
191204628,1,2,2,4,8,17
191204629,8,5,8,4,7,32
191204630,9,0,3,4,3,19
191204631,8,1,2,8,6,25
191204632,2,0,4,8,8,22
191204633,1,2,5,6,2,16
191204634,5,6,7,3,9,30
191204635,5,0,6,3,7,21
191204636,2,9,1,0,0,12
191204637,3,5,4,4,1,17
191204638,9,4,0,3,4,20
191204639,9,1,5,8,8,31
191204640,2,5,5,0,9,21
191204641,7,1,7,7,1,23
191204642,2,4,2,4,9,21
191204643,1,2,7,3,9,22
191204644,2,8,0,5,7,22
191204645,0,8,8,3,6,25
191204646,1,6,8,6,8,29
191204647,6,1,1,7,4,19
191204648,4,1,1,6,3,15
191204649,9,2,0,9,1,21
191204650,5,3,5,0,0,13
191204651,2,7,2,4,2,17
191204652,5,4,8,3,0,20
191204653,8,3,3,2,7,23
191204654,1,4,4,5,1,15
191204655,3,8,0,3,7,21
191204656,2,5,0,5,0,12
191204657,4,0,5,3,8,20
191204658,2,3,5,1,7,18
191204659,6,9,3,9,6,33
191204660,6,6,6,7,0,25
191204661,0,5,1,4,3,13
191204662,4,4,3,1,4,16
191204663,8,0,1,8,9,26
191204664,0,0,4,4,4,12
191204665,2,8,7,1,2,20
191204666,5,6,3,4,8,26
191204667,0,0,4,3,9,16
191204668,8,6,1,7,1,23
191204669,0,0,3,4,6,13
191204670,6,4,7,4,5,26
191204671,2,7,4,0,9,22
191204672,8,6,7,5,4,30
191204673,1,2,1,9,7,20
191204674,1,5,3,6,2,17
191204675,8,1,1,5,7,22
191204676,3,7,1,1,0,12
191204677,0,3,9,0,0,12
191204678,9,0,4,9,6,28
191204679,9,9,9,4,4,35
191204680,5,1,1,0,5,12
191204681,3,3,4,2,1,13
191204682,6,4,9,5,2,26
191204683,5,8,0,2,2,17
191204684,7,1,1,1,1,11
191204685,2,4,3,0,3,12
191204686,0,1,6,9,5,21
191204687,4,5,7,6,7,29
191204688,7,9,2,2,8,28
191204689,3,2,0,7,0,12
191204690,7,7,2,8,0,24
191204691,1,9,9,8,1,28
191204692,8,2,7,4,9,30
191204693,1,2,8,1,7,19
191204694,5,3,7,2,6,23
191204695,1,3,9,0,8,21
191204696,2,4,8,7,4,25
191204697,2,9,2,8,5,26
191204698,3,3,5,7,2,20
191204699,7,8,1,6,5,27
191204700,7,7,7,7,8,36
191204701,8,5,6,5,7,31
191204702,4,0,3,8,2,17
191204703,5,3,8,1,6,23
191204704,2,0,1,8,8,19
191204705,3,3,5,6,9,26
191204706,5,8,9,0,6,28
191204707,4,9,2,4,6,25
191204708,6,6,6,4,7,29
191204709,7,8,6,4,9,34
191204710,7,7,7,5,5,31
191204711,9,9,1,8,8,35
191204712,3,2,6,3,5,19
191204713,6,9,5,7,8,35
191204714,6,1,6,8,8,29
191204715,6,3,7,3,9,28
191204716,4,2,1,8,4,19
191204717,3,3,3,9,9,27
191204718,5,3,7,3,6,24
191204719,0,1,0,0,8,9
191204720,6,4,2,3,2,17
191204721,1,9,0,0,0,10
191204722,0,6,4,4,4,18
191204723,6,9,8,0,0,23
191204724,6,8,7,9,0,30
191204725,2,2,7,6,3,20
191204726,4,8,9,2,5,28
191204727,2,3,0,6,1,12
191204728,9,0,9,2,1,21
191204729,0,3,5,7,5,20
191204730,1,8,2,0,6,17
191204731,9,2,2,9,2,24
191204732,4,4,3,4,1,16
191204733,7,3,8,8,7,33
191204734,1,9,8,3,9,30
191204735,0,8,3,7,6,24
191204736,4,1,2,7,6,20
191204737,5,4,7,9,0,25
191204738,1,3,4,9,4,21
191204739,3,0,2,0,5,10
191204740,9,4,4,4,7,28
191204741,9,9,2,6,8,34
191204742,4,2,2,6,3,17
191204743,3,0,4,0,8,15
191204744,9,4,5,3,6,27
191204745,1,9,0,3,3,16
191204746,6,5,7,5,6,29
191204747,5,1,4,3,7,20
191204748,6,0,5,1,8,20
191204749,5,7,3,5,1,21
191204750,7,0,8,7,7,29
191204751,9,9,6,5,2,31
191204752,2,4,0,6,2,14
191204753,8,7,1,7,1,24
191204754,9,8,1,9,3,30
191204755,0,4,6,2,9,21
191204756,2,3,2,3,6,16
191204757,2,6,4,3,5,20
191204758,6,1,7,6,4,24
191204759,4,0,0,6,9,19
191204760,2,9,2,2,5,20
191204761,5,2,4,0,8,19
191204762,7,8,5,1,6,27
191204763,8,2,5,8,7,30
191204764,1,0,4,4,9,18
191204765,4,8,6,8,1,27
191204766,8,2,7,5,9,31
191204767,2,1,0,5,0,8
191204768,8,0,4,2,3,17
191204769,8,5,6,5,0,24
191204770,7,6,8,5,1,27
191204771,7,3,3,8,7,28
191204772,9,0,1,1,9,20
191204773,1,0,9,8,7,25
191204774,3,5,9,2,2,21
191204775,7,5,9,6,4,31
191204776,1,1,4,8,0,14
191204777,9,7,6,2,6,30
191204778,2,7,6,6,3,24
191204779,1,7,5,6,2,21
191204780,2,9,7,3,8,29
191204781,8,8,3,2,2,23
191204782,8,7,2,7,3,27
191204783,0,1,5,7,6,19
191204784,4,1,2,1,4,12
191204785,1,3,5,0,4,13
191204786,6,4,7,0,0,17
191204787,1,1,8,7,6,23
191204788,0,5,8,7,2,22
191204789,6,4,5,9,7,31
191204790,6,1,9,4,4,24
191204791,0,2,0,0,4,6
191204792,2,6,6,9,5,28
191204793,5,9,8,3,7,32
191204794,1,9,3,3,5,21
191204795,9,9,8,7,2,35
191204796,2,5,7,2,8,24
191204797,7,9,3,9,9,37
191204798,1,4,6,6,0,17
191204799,9,9,1,0,6,25
191204800,8,5,0,9,6,28
191204801,1,2,3,5,5,16
191204802,5,7,2,6,6,26
191204803,3,9,9,9,3,33
191204804,1,0,4,0,6,11
191204805,1,5,4,3,2,15
191204806,3,1,5,3,3,15
191204807,7,2,4,4,6,23
191204808,6,2,8,3,7,26
191204809,5,4,5,3,6,23
191204810,4,2,8,5,9,28
191204811,3,5,9,3,4,24
191204812,6,4,2,3,4,19
191204813,0,8,4,7,4,23
191204814,6,1,3,4,5,19
191204815,4,7,9,7,2,29
191204816,7,6,9,3,1,26
191204817,7,1,2,2,1,13
191204818,8,6,7,6,1,28
191204819,6,4,8,3,4,25
191204820,4,8,6,8,8,34
191204821,5,3,4,5,6,23
191204822,9,4,8,1,1,23
191204823,6,2,7,1,6,22
191204824,4,9,1,1,4,19
191204825,5,2,8,2,3,20
191204826,8,2,2,5,9,26
191204827,6,6,9,3,3,27
191204828,6,0,4,3,6,19
191204829,6,5,3,1,0,15
191204830,5,9,5,9,4,32
191204831,2,2,0,0,0,4
191204832,5,3,8,9,2,27
191204833,6,3,4,5,5,23
191204834,6,1,1,3,8,19
191204835,2,2,8,5,1,18
191204836,7,2,0,5,2,16
191204837,8,6,7,2,2,25
191204838,8,7,7,9,2,33
191204839,9,3,2,8,7,29
191204840,1,2,1,1,1,6
191204841,9,9,4,2,4,28
191204842,0,5,2,6,2,15
191204843,8,2,4,6,1,21
191204844,4,9,1,2,2,18
191204845,0,3,1,7,8,19
191204846,1,1,3,9,5,19
191204847,5,5,9,3,6,28
191204848,1,3,3,4,8,19
191204849,9,9,3,1,0,22
191204850,9,6,1,3,6,25
191204851,1,3,2,0,1,7
191204852,1,9,0,4,0,14
191204853,9,4,4,9,2,28
191204854,1,9,6,3,3,22
191204855,1,5,9,6,9,30
191204856,0,8,4,1,6,19
191204857,9,7,1,9,7,33
191204858,8,8,4,4,9,33
191204859,5,1,3,8,9,26
191204860,0,6,0,5,7,18
191204861,6,2,4,6,5,23
191204862,9,7,4,4,5,29
191204863,6,9,7,5,1,28
191204864,5,5,8,2,6,26
191204865,6,9,9,6,0,30
191204866,9,2,6,6,3,26
191204867,5,6,4,0,6,21
191204868,3,9,5,4,1,22
191204869,6,0,0,2,0,8
191204870,9,5,4,4,0,22
191204871,3,5,8,6,7,29
191204872,8,3,2,2,1,16
191204873,1,4,3,1,9,18
191204874,8,7,3,8,5,31
191204875,7,0,8,6,5,26
191204876,2,1,1,8,6,18
191204877,7,1,5,5,2,20
191204878,5,7,1,1,8,22
191204879,0,5,4,4,0,13
191204880,7,9,4,7,7,34
191204881,8,1,9,4,6,28
191204882,9,4,6,6,1,26
191204883,0,1,2,1,9,13
191204884,9,3,0,5,7,24
191204885,6,6,7,8,0,27
191204886,6,2,9,9,9,35
191204887,1,2,4,2,7,16
191204888,2,2,2,7,3,16
191204889,0,5,0,7,1,13
191204890,8,3,1,0,2,14
191204891,2,3,7,1,0,13
191204892,4,3,5,7,9,28
191204893,1,4,7,0,7,19
191204894,9,5,7,5,8,34
191204895,5,7,8,7,0,27
191204896,6,7,1,0,6,20
191204897,7,7,8,7,3,32
191204898,5,0,7,0,2,14
191204899,1,3,4,5,5,18
191204900,7,1,9,1,4,22
191204901,1,1,8,3,1,14
191204902,0,6,6,0,0,12
191204903,1,8,1,3,6,19
191204904,7,7,5,4,9,32
191204905,9,2,0,4,3,18
191204906,6,2,2,8,9,27
191204907,5,6,1,0,6,18
191204908,7,7,4,2,1,21
191204909,4,8,8,7,8,35
191204910,0,8,4,5,6,23
191204911,9,6,0,3,5,23
191204912,8,2,6,5,4,25
191204913,0,4,5,1,3,13
191204914,6,5,5,7,0,23
191204915,4,9,7,2,1,23
191204916,5,4,1,0,8,18
191204917,2,9,7,3,5,26
191204918,6,9,9,6,9,39
191204919,1,6,4,7,7,25
191204920,9,1,4,9,0,23
191204921,0,2,2,0,3,7
191204922,4,6,0,4,0,14
191204923,3,9,4,7,5,28
191204924,4,9,7,3,2,25
191204925,5,6,3,8,7,29
191204926,4,4,8,3,4,23
191204927,3,1,4,4,8,20
191204928,0,8,1,7,4,20
191204929,4,1,5,6,4,20
191204930,4,8,7,0,6,25
191204931,0,3,3,7,6,19
191204932,8,9,1,7,8,33
191204933,9,1,8,3,2,23
191204934,3,7,3,9,1,23
191204935,8,6,6,5,8,33
191204936,5,6,7,3,8,29
191204937,9,2,6,8,9,34
191204938,8,3,8,4,7,30
191204939,4,4,1,2,7,18
191204940,2,4,9,4,3,22
191204941,0,9,1,3,5,18
191204942,3,3,9,8,2,25
191204943,5,7,6,8,9,35
191204944,7,4,3,3,9,26
191204945,9,2,2,9,9,31
191204946,8,5,7,9,0,29
191204947,7,0,3,8,3,21
191204948,9,9,3,5,0,26
191204949,4,3,2,8,7,24
191204950,4,6,8,3,9,30
191204951,9,6,8,4,3,30
191204952,9,4,7,1,3,24
191204953,2,5,4,6,2,19
191204954,6,8,2,2,8,26
191204955,0,8,6,9,4,27
191204956,9,3,0,3,2,17
191204957,8,7,6,9,5,35
191204958,3,7,9,5,5,29
191204959,3,4,8,5,7,27
191204960,9,3,5,0,1,18
191204961,3,9,1,5,5,23
191204962,8,9,1,3,1,22
191204963,0,8,3,3,2,16
191204964,7,4,8,5,8,32
191204965,3,5,0,9,0,17
191204966,3,5,6,6,7,27
191204967,7,5,4,9,5,30
191204968,8,0,9,6,3,26
191204969,2,8,4,5,1,20
191204970,5,9,1,7,9,31
191204971,2,1,9,0,8,20
191204972,1,1,4,2,1,9
191204973,9,3,5,8,9,34
191204974,7,8,7,7,9,38
191204975,4,1,9,3,8,25
191204976,8,3,7,8,6,32
191204977,6,0,8,0,7,21
191204978,2,3,0,9,6,20
191204979,6,8,2,1,4,21
191204980,7,1,3,9,3,23
191204981,1,3,0,8,6,18
191204982,4,0,9,8,8,29
191204983,5,8,7,8,0,28
191204984,0,8,0,5,5,18
191204985,8,1,4,7,5,25
191204986,8,3,0,2,5,18
191204987,6,2,8,3,2,21
191204988,9,6,4,6,3,28
191204989,6,3,9,2,3,23
191204990,0,1,6,3,6,16
191204991,8,1,8,2,1,20
191204992,1,0,1,2,4,8
191204993,1,4,1,2,3,11
191204994,7,0,8,3,0,18
191204995,3,2,7,1,4,17
191204996,6,0,4,3,0,13
191204997,1,2,5,7,5,20
191204998,2,3,8,0,8,21
191204999,3,6,9,1,1,20
1912041000,1,7,8,9,7,32
1912041001,6,4,9,5,7,31
1912041002,9,3,3,0,3,18
1912041003,8,3,5,1,2,19
1912041004,7,3,1,6,5,22
1912041005,0,4,3,2,8,17
1912041006,3,3,4,9,7,26
1912041007,6,9,9,0,1,25
1912041008,5,3,0,5,1,14
1912041009,2,7,8,1,7,25
1912041010,9,2,3,1,2,17
1912041011,1,0,5,8,3,17
1912041012,4,0,5,1,7,17
1912041013,9,9,2,0,6,26
1912041014,4,0,8,9,9,30
1912041015,7,2,0,8,2,19
1912041016,0,4,5,7,7,23
1912041017,7,0,0,1,7,15
1912041018,8,2,2,5,7,24
1912041019,9,3,8,7,3,30
1912041020,5,4,0,5,5,19
1912041021,9,3,6,7,5,30
1912041022,7,2,1,1,0,11
1912041023,2,5,7,7,2,23
1912041024,2,8,1,6,8,25
1912041025,3,2,7,6,6,24
1912041026,3,3,7,3,6,22
1912041027,4,7,8,3,8,30
1912041028,3,9,3,4,2,21
1912041029,1,1,9,1,0,12
1912041030,9,1,0,9,8,27
1912041031,7,9,6,8,0,30
1912041032,1,1,6,2,5,15
1912041033,5,8,5,8,4,30
1912041034,8,9,6,5,2,30
1912041035,5,6,0,3,6,20
1912041036,6,4,7,8,9,34
1912041037,3,3,2,3,5,16
1912041038,0,2,0,8,7,17
1912041039,0,8,4,8,6,26
1912041040,1,6,5,3,5,20
1912041041,0,9,5,5,2,21
1912041042,1,2,0,3,0,6
1912041043,8,8,7,1,6,30
1912041044,0,5,6,6,7,24
1912041045,3,7,2,0,3,15
1912041046,7,1,4,2,8,22
1912041047,8,0,0,4,8,20
1912041048,2,9,9,4,2,26
1912041049,3,8,6,8,7,32
1912041050,5,0,5,0,1,11
1912041051,0,6,9,9,1,25
1912041052,5,3,1,1,4,14
1912041053,5,5,8,9,4,31
1912041054,0,0,4,9,6,19
1912041055,7,5,8,6,9,35
1912041056,3,4,9,3,5,24
1912041057,6,4,4,4,2,20
1912041058,8,6,4,0,6,24
1912041059,0,3,8,3,6,20
1912041060,3,3,9,7,1,23
1912041061,1,0,0,1,0,2
1912041062,5,7,4,2,5,23
1912041063,4,8,3,9,6,30
1912041064,7,8,6,7,3,31
1912041065,3,4,7,8,0,22
1912041066,6,3,6,7,0,22
1912041067,4,0,5,7,1,17
1912041068,5,1,3,3,0,12
1912041069,8,8,6,7,9,38
1912041070,6,8,5,0,0,19
1912041071,7,1,3,2,2,15
1912041072,3,0,9,8,6,26
1912041073,4,3,9,6,3,25
1912041074,7,3,1,1,5,17
1912041075,9,3,5,9,0,26
1912041076,7,3,3,9,9,31
1912041077,7,2,1,8,6,24
1912041078,6,2,9,7,2,26
1912041079,1,6,3,6,8,24
1912041080,6,5,3,1,7,22
1912041081,3,3,6,3,2,17
1912041082,9,0,0,2,7,18
1912041083,6,0,2,5,4,17
1912041084,8,7,3,9,1,28
1912041085,4,2,1,0,2,9
1912041086,1,3,0,4,7,15
1912041087,1,7,5,4,4,21
1912041088,7,6,7,8,6,34
1912041089,7,0,2,3,1,13
1912041090,8,3,1,9,7,28
1912041091,1,4,6,4,5,20
1912041092,8,7,8,1,4,28
1912041093,8,4,0,7,2,21
1912041094,7,5,0,3,2,17
1912041095,1,4,2,0,7,14
1912041096,0,2,3,5,6,16
1912041097,5,9,1,8,3,26
1912041098,2,8,1,7,2,20
1912041099,6,0,7,1,7,21
1912041100,0,3,4,0,7,14
1912041101,5,6,1,8,8,28
1912041102,3,1,9,2,3,18
1912041103,6,0,7,2,2,17
1912041104,6,9,9,8,2,34
1912041105,8,5,0,7,4,24
191205001,0,8,1,9,6,24
191205002,1,2,4,0,1,8
191205003,2,5,6,0,2,15
191205004,7,2,8,0,8,25
191205005,2,1,2,6,0,11
191205006,8,4,8,9,2,31
191205007,9,7,6,5,1,28
191205008,8,7,2,1,9,27
191205009,9,1,8,7,0,25
191205010,2,6,8,6,4,26
191205011,9,5,3,5,9,31
191205012,1,6,5,4,7,23
191205013,2,9,8,7,5,31
191205014,6,2,4,7,1,20
191205015,9,1,5,6,9,30
191205016,3,8,4,7,4,26
191205017,8,5,5,9,2,29
191205018,8,3,5,9,4,29
191205019,2,3,5,9,3,22
191205020,4,8,2,7,1,22
191205021,0,1,2,9,4,16
191205022,1,5,4,6,4,20
191205023,0,9,1,3,3,16
191205024,1,4,0,6,5,16
191205025,1,4,6,1,7,19
191205026,1,0,3,9,0,13
191205027,1,8,6,5,1,21
191205028,0,4,2,2,4,12
191205029,9,1,4,8,6,28
191205030,3,4,5,5,6,23
191205031,6,2,3,2,6,19
191205032,8,2,4,1,1,16
191205033,2,1,6,9,8,26
191205034,2,3,0,2,9,16
191205035,5,0,1,6,7,19
191205036,8,7,1,3,2,21
191205037,5,2,5,1,3,16
191205038,4,3,5,7,4,23
191205039,2,3,8,3,1,17
191205040,6,3,8,4,3,24
191205041,2,9,9,4,0,24
191205042,2,0,9,4,8,23
191205043,4,1,8,7,5,25
191205044,9,6,1,0,7,23
191205045,2,5,9,1,8,25
191205046,2,9,4,7,7,29
191205047,2,3,4,0,3,12
191205048,0,6,4,5,6,21
191205049,5,1,0,7,7,20
191205050,2,3,6,0,0,11
191205051,3,2,8,1,2,16
191205052,1,1,4,9,8,23
191205053,6,8,4,7,2,27
191205054,3,0,0,4,2,9
191205055,5,5,8,9,3,30
191205056,1,5,1,3,1,11
191205057,1,4,0,5,3,13
191205058,4,4,2,2,4,16
191205059,1,3,3,9,0,16
191205060,5,1,4,1,6,17
191205061,4,7,5,9,7,32
191205062,4,9,0,7,6,26
191205063,7,7,0,2,2,18
191205064,7,7,4,7,4,29
191205065,1,5,9,4,5,24
191205066,6,0,6,3,7,22
191205067,1,2,4,1,0,8
191205068,7,0,2,1,9,19
191205069,8,3,6,7,1,25
191205070,8,2,6,3,5,24
191205071,0,1,7,9,1,18
191205072,3,6,3,1,8,21
191205073,5,6,2,2,1,16
191205074,5,9,7,1,6,28
191205075,9,2,4,0,4,19
191205076,5,9,3,7,2,26
191205077,9,2,4,9,0,24
191205078,3,1,7,9,0,20
191205079,4,0,5,2,2,13
191205080,3,0,7,0,0,10
191205081,9,1,7,4,1,22
191205082,5,2,8,7,9,31
191205083,7,7,4,9,7,34
191205084,7,9,6,5,9,36
191205085,3,8,7,7,9,34
191205086,7,1,7,5,5,25
191205087,4,4,6,1,2,17
191205088,0,2,9,5,6,22
191205089,8,7,7,6,9,37
191205090,9,7,6,9,6,37
191205091,5,0,8,3,3,19
191205092,0,0,5,3,6,14
191205093,8,5,8,0,9,30
191205094,4,7,4,9,5,29
191205095,5,8,1,7,9,30
191205096,1,5,5,1,7,19
191205097,3,6,8,4,9,30
191205098,6,7,3,2,1,19
191205099,7,2,6,8,1,24
191205100,0,8,6,4,8,26
191205101,7,8,0,2,4,21
191205102,9,2,6,5,4,26
191205103,8,0,5,4,9,26
191205104,8,5,1,3,7,24
191205105,5,2,6,7,8,28
191205106,2,8,0,2,8,20
191205107,6,7,8,2,0,23
191205108,5,3,0,1,7,16
191205109,8,1,5,6,7,27
191205110,3,2,0,6,4,15
191205111,1,7,0,5,5,18
191205112,9,4,4,0,7,24
191205113,6,6,6,7,7,32
191205114,0,2,4,0,7,13
191205115,5,7,7,4,9,32
191205116,1,8,3,2,9,23
191205117,8,2,3,5,3,21
191205118,0,7,2,2,9,20
191205119,5,2,2,1,5,15
191205120,7,9,5,2,7,30
191205121,8,3,0,1,2,14
191205122,3,5,2,1,9,20
191205123,4,0,9,8,9,30
191205124,3,4,4,4,8,23
191205125,5,6,6,8,6,31
191205126,7,7,5,5,0,24
191205127,4,7,8,7,8,34
191205128,4,4,3,3,2,16
191205129,6,9,8,0,4,27
191205130,8,7,2,7,8,32
191205131,0,0,2,8,4,14
191205132,2,8,3,8,7,28
191205133,1,5,8,0,2,16
191205134,4,9,7,9,3,32
191205135,2,0,5,0,1,8
191205136,0,4,5,7,8,24
191205137,0,2,1,0,3,6
191205138,0,1,1,3,7,12
191205139,0,2,0,8,9,19
191205140,3,1,4,6,4,18
191205141,7,8,2,5,0,22
191205142,4,7,3,5,5,24
191205143,5,4,3,5,6,23
191205144,6,2,3,5,3,19
191205145,7,8,0,5,7,27
191205146,3,4,2,4,0,13
191205147,1,3,9,1,4,18
191205148,7,4,3,4,8,26
191205149,3,1,7,2,4,17
191205150,0,9,8,7,2,26
191205151,0,2,1,1,3,7
191205152,2,3,4,8,6,23
191205153,7,0,4,5,7,23
191205154,7,4,0,1,9,21
191205155,4,8,0,9,2,23
191205156,5,2,7,0,3,17
191205157,8,0,9,5,5,27
191205158,2,0,4,3,8,17
191205159,0,3,5,9,6,23
191205160,9,1,6,7,8,31
191205161,8,7,9,8,7,39
191205162,8,4,3,0,8,23
191205163,3,3,8,8,2,24
191205164,5,8,3,7,0,23
191205165,3,7,3,6,2,21
191205166,3,1,4,9,5,22
191205167,8,6,2,6,6,28
191205168,1,9,4,9,5,28
191205169,0,8,5,7,4,24
191205170,4,3,1,9,5,22
191205171,8,7,1,0,0,16
191205172,6,1,3,7,2,19
191205173,7,1,1,2,2,13
191205174,5,6,4,6,9,30
191205175,2,5,9,8,5,29
191205176,9,3,7,3,8,30
191205177,3,2,2,6,5,18
191205178,9,4,0,5,1,19
191205179,3,8,5,2,0,18
191205180,3,7,8,0,8,26
191205181,6,7,3,5,4,25
191205182,0,6,0,6,0,12
191205183,4,0,6,8,9,27
191205184,1,1,4,1,9,16
191205185,5,5,0,6,0,16
191205186,7,5,4,6,2,24
191205187,8,4,3,6,0,21
191205188,7,4,7,7,4,29
191205189,7,6,8,7,8,36
191205190,7,8,3,1,6,25
191205191,7,7,0,5,3,22
191205192,3,7,0,3,9,22
191205193,6,8,6,5,8,33
191205194,2,9,5,3,5,24
191205195,8,8,1,2,2,21
191205196,0,0,1,6,2,9
191205197,6,0,2,4,3,15
191205198,3,9,6,7,9,34
191205199,9,0,4,1,0,14
191205200,1,6,4,0,4,15
191205201,5,8,9,6,9,37
191205202,1,0,2,6,1,10
191205203,7,2,0,0,6,15
191205204,3,0,8,6,0,17
191205205,7,1,6,6,2,22
191205206,7,0,3,2,1,13
191205207,8,6,9,8,1,32
191205208,1,2,5,7,8,23
191205209,5,3,7,9,9,33
191205210,1,5,8,3,7,24
191205211,7,6,8,2,5,28
191205212,4,7,4,0,9,24
191205213,8,5,0,2,0,15
191205214,7,5,2,9,7,30
191205215,8,4,2,6,4,24
191205216,4,8,7,7,6,32
191205217,5,6,1,1,9,22
191205218,3,6,7,1,3,20
191205219,4,7,4,2,0,17
191205220,3,7,9,6,9,34
191205221,0,3,4,5,4,16
191205222,3,2,4,7,5,21
191205223,2,7,8,8,4,29
191205224,4,0,7,4,9,24
191205225,9,2,5,0,4,20
191205226,9,0,9,5,2,25
191205227,0,9,0,0,2,11
191205228,4,0,8,1,1,14
191205229,8,4,3,9,8,32
191205230,2,0,6,2,8,18
191205231,9,6,5,1,6,27
191205232,1,3,7,4,7,22
191205233,0,3,3,9,4,19
191205234,4,4,4,5,1,18
191205235,0,8,3,3,9,23
191205236,3,3,2,3,2,13
191205237,7,3,1,5,6,22
191205238,9,0,1,7,5,22
191205239,1,2,8,7,3,21
191205240,1,7,6,6,9,29
191205241,3,8,9,1,3,24
191205242,3,1,2,2,5,13
191205243,6,9,6,3,0,24
191205244,0,9,5,8,2,24
191205245,0,9,0,9,1,19
191205246,5,3,7,3,3,21
191205247,2,6,2,3,4,17
191205248,5,3,0,9,8,25
191205249,3,3,0,3,7,16
191205250,2,1,8,0,2,13
191205251,0,9,7,1,8,25
191205252,1,0,3,9,4,17
191205253,3,3,2,8,2,18
191205254,1,9,7,1,7,25
191205255,7,7,2,8,6,30
191205256,7,8,7,6,7,35
191205257,5,2,1,2,3,13
191205258,1,5,3,6,1,16
191205259,0,4,1,2,6,13
191205260,0,6,7,6,7,26
191205261,6,8,0,6,4,24
191205262,1,3,0,8,7,19
191205263,3,8,2,2,5,20
191205264,4,1,1,3,1,10
191205265,2,6,5,9,4,26
191205266,7,7,6,1,2,23
191205267,2,9,5,8,6,30
191205268,2,3,7,2,9,23
191205269,1,5,4,4,6,20
191205270,8,7,1,6,4,26
191205271,8,8,1,2,0,19
191205272,2,9,2,5,6,24
191205273,7,3,7,6,9,32
191205274,0,2,8,7,9,26
191205275,3,3,8,1,6,21
191205276,1,8,5,6,2,22
191205277,2,0,7,9,1,19
191205278,9,4,7,1,9,30
191205279,9,8,1,0,6,24
191205280,8,0,3,2,6,19
191205281,9,5,2,8,0,24
191205282,5,0,3,2,4,14
191205283,1,1,6,9,1,18
191205284,1,4,8,3,1,17
191205285,9,9,0,0,1,19
191205286,4,6,5,6,5,26
191205287,5,2,2,4,0,13
191205288,9,3,6,0,4,22
191205289,4,0,4,8,7,23
191205290,2,2,5,4,7,20
191205291,6,0,9,2,8,25
191205292,7,4,5,5,1,22
191205293,4,2,4,0,4,14
191205294,5,5,2,4,4,20
191205295,9,3,4,9,8,33
191205296,8,9,7,3,0,27
191205297,1,3,8,5,9,26
191205298,8,0,1,8,7,24
191205299,2,8,6,3,1,20
191205300,6,4,8,8,6,32
191205301,9,0,8,9,6,32
191205302,7,7,4,6,9,33
191205303,2,2,9,6,2,21
191205304,2,1,7,1,0,11
191205305,6,9,2,1,1,19
191205306,7,2,8,3,1,21
191205307,1,3,7,8,5,24
191205308,0,0,4,7,8,19
191205309,0,4,7,9,6,26
191205310,1,1,2,4,2,10
191205311,8,9,2,1,6,26
191205312,2,9,8,9,6,34
191205313,6,1,2,5,7,21
191205314,4,9,4,7,4,28
191205315,6,6,1,1,7,21
191205316,6,6,9,2,7,30
191205317,1,9,8,6,7,31
191205318,0,8,3,6,7,24
191205319,6,5,0,6,6,23
191205320,2,8,2,2,5,19
191205321,2,7,1,6,7,23
191205322,0,1,3,4,2,10
191205323,4,4,9,2,4,23
191205324,9,7,5,3,5,29
191205325,3,0,5,7,2,17
191205326,1,2,6,5,6,20
191205327,5,0,8,5,7,25
191205328,2,7,4,2,9,24
191205329,5,2,8,9,5,29
191205330,8,1,0,4,5,18
191205331,1,2,9,7,6,25
191205332,4,1,7,0,6,18
191205333,1,9,4,6,5,25
191205334,8,1,8,7,9,33
191205335,8,8,2,1,6,25
191205336,8,2,4,2,5,21
191205337,0,1,7,6,9,23
191205338,3,6,3,2,6,20
191205339,0,5,5,4,4,18
191205340,6,8,3,6,4,27
191205341,1,5,2,2,2,12
191205342,7,7,8,2,8,32
191205343,4,4,4,7,3,22
191205344,9,7,3,9,7,35
191205345,7,4,4,8,4,27
191205346,0,7,6,1,6,20
191205347,3,5,8,4,8,28
191205348,5,9,6,8,2,30
191205349,6,4,4,9,4,27
191205350,9,7,3,9,1,29
191205351,0,2,9,9,9,29
191205352,3,8,8,5,1,25
191205353,4,7,8,8,8,35
191205354,1,1,7,5,6,20
191205355,2,1,5,2,4,14
191205356,1,8,3,6,7,25
191205357,3,9,8,1,6,27
191205358,1,4,0,4,4,13
191205359,6,9,4,2,8,29
191205360,5,4,0,5,4,18
191205361,1,6,0,8,0,15
191205362,6,0,8,0,9,23
191205363,9,5,2,4,5,25
191205364,1,9,9,5,4,28
191205365,7,1,6,2,7,23
191205366,2,2,9,0,8,21
191205367,9,9,6,6,0,30
191205368,8,2,8,2,0,20
191205369,4,4,1,9,7,25
191205370,9,7,9,4,7,36
191205371,6,3,5,8,7,29
191205372,4,5,2,1,4,16
191205373,1,1,5,4,3,14
191205374,8,2,2,3,1,16
191205375,0,1,8,7,9,25
191205376,8,0,7,6,6,27
191205377,3,4,5,3,9,24
191205378,0,0,6,1,0,7
191205379,7,6,1,9,8,31
191205380,1,5,3,9,0,18
191205381,0,1,9,9,4,23
191205382,2,6,0,2,4,14
191205383,8,2,6,3,7,26
191205384,4,8,3,9,5,29
191205385,0,7,6,9,9,31
191205386,4,1,7,7,1,20
191205387,6,3,8,2,4,23
191205388,5,4,3,4,6,22
191205389,0,0,7,3,7,17
191205390,9,3,1,9,0,22
191205391,7,8,5,3,7,30
191205392,4,9,1,3,7,24
191205393,5,6,2,2,7,22
191205394,4,7,6,1,9,27
191205395,4,5,4,8,8,29
191205396,7,0,0,3,9,19
191205397,7,1,5,1,9,23
191205398,9,3,5,3,1,21
191205399,6,2,3,7,3,21
191205400,9,2,9,6,7,33
191205401,6,1,7,6,7,27
191205402,2,6,9,8,0,25
191205403,5,0,9,5,5,24
191205404,2,2,1,2,2,9
191205405,2,4,7,4,0,17
191205406,6,4,7,9,3,29
191205407,8,0,9,5,9,31
191205408,6,8,0,3,5,22
191205409,4,3,3,1,3,14
191205410,0,1,6,0,1,8
191205411,6,3,2,9,7,27
191205412,9,4,2,1,4,20
191205413,0,1,7,6,5,19
191205414,6,6,8,6,9,35
191205415,4,9,9,1,5,28
191205416,2,6,2,2,6,18
191205417,9,9,9,9,4,40
191205418,0,0,8,7,1,16
191205419,3,3,1,6,7,20
191205420,1,5,5,0,6,17
191205421,9,1,7,0,1,18
191205422,6,7,6,4,8,31
191205423,9,7,5,9,4,34
191205424,0,0,2,4,6,12
191205425,4,8,9,6,5,32
191205426,3,6,1,8,9,27
191205427,0,3,3,2,8,16
191205428,4,9,3,4,5,25
191205429,7,1,2,6,8,24
191205430,8,8,7,0,0,23
191205431,3,7,4,7,8,29
191205432,5,1,9,3,7,25
191205433,0,7,9,0,8,24
191205434,7,5,7,0,3,22
191205435,4,2,4,4,8,22
191205436,9,0,1,8,8,26
191205437,5,8,4,1,6,24
191205438,1,5,6,1,1,14
191205439,6,1,6,0,5,18
191205440,3,6,0,0,9,18
191205441,6,0,5,4,5,20
191205442,0,2,6,9,4,21
191205443,0,3,9,9,0,21
191205444,0,7,7,9,5,28
191205445,2,0,4,5,1,12
191205446,7,7,3,3,8,28
191205447,3,5,1,3,2,14
191205448,3,7,5,3,6,24
191205449,2,6,5,1,0,14
191205450,7,2,7,3,8,27
191205451,9,5,5,4,9,32
191205452,2,4,6,7,5,24
191205453,4,0,3,7,4,18
191205454,0,6,6,0,7,19
191205455,7,9,1,6,7,30
191205456,8,8,0,2,5,23
191205457,2,5,1,7,2,17
191205458,7,9,6,6,9,37
191205459,3,6,9,6,6,30
191205460,9,9,6,8,9,41
191205461,4,1,7,4,8,24
191205462,2,9,0,1,1,13
191205463,8,5,8,5,9,35
191205464,3,2,3,1,7,16
191205465,6,5,7,1,3,22
191205466,3,6,6,9,2,26
191205467,0,7,5,9,2,23
191205468,1,0,7,2,5,15
191205469,6,5,5,0,5,21
191205470,4,4,3,3,8,22
191205471,4,7,5,7,7,30
191205472,9,4,0,1,8,22
191205473,2,7,3,3,5,20
191205474,0,0,2,6,9,17
191205475,9,1,7,3,6,26
191205476,1,0,2,4,2,9
191205477,4,4,5,9,0,22
191205478,2,1,1,6,5,15
191205479,3,1,2,7,1,14
191205480,3,0,6,9,5,23
191205481,6,6,8,0,5,25
191205482,3,2,3,8,4,20
191205483,4,7,3,1,4,19
191205484,8,1,2,0,3,14
191205485,4,7,0,3,2,16
191205486,1,4,8,2,6,21
191205487,5,6,5,6,0,22
191205488,4,7,4,7,9,31
191205489,7,5,0,3,8,23
191205490,6,8,4,6,5,29
191205491,7,5,6,0,6,24
191205492,7,0,6,5,6,24
191205493,8,1,4,1,5,19
191205494,0,9,0,5,2,16
191205495,7,8,1,5,5,26
191205496,4,4,9,2,3,22
191205497,3,4,6,2,6,21
191205498,7,2,2,0,0,11
191205499,7,2,5,2,2,18
191205500,8,8,9,5,5,35
191205501,7,6,9,9,9,40
191205502,2,3,6,2,2,15
191205503,8,7,1,7,3,26
191205504,3,2,9,5,0,19
191205505,6,2,8,0,2,18
191205506,9,4,3,2,8,26
191205507,6,6,9,4,4,29
191205508,6,8,4,7,0,25
191205509,8,0,6,8,6,28
191205510,8,4,4,3,7,26
191205511,3,6,3,6,0,18
191205512,7,8,0,5,5,25
191205513,3,2,0,4,6,15
191205514,7,2,4,0,9,22
191205515,2,8,5,0,2,17
191205516,7,3,9,3,2,24
191205517,4,2,3,9,0,18
191205518,7,7,6,2,1,23
191205519,0,3,9,2,7,21
191205520,6,2,5,7,9,29
191205521,9,9,9,9,9,45
191205522,9,3,7,7,5,31
191205523,4,4,9,1,4,22
191205524,1,6,6,2,5,20
191205525,9,0,3,9,8,29
191205526,3,2,1,0,7,13
191205527,7,2,9,8,6,32
191205528,1,1,9,9,7,27
191205529,5,9,5,9,3,31
191205530,7,0,3,0,9,19
191205531,8,6,6,3,4,27
191205532,8,7,4,8,4,31
191205533,1,5,2,8,6,22
191205534,8,9,2,0,6,25
191205535,0,2,0,4,4,10
191205536,7,8,8,6,5,34
191205537,5,2,8,1,2,18
191205538,0,1,9,9,6,25
191205539,7,6,4,3,0,20
191205540,5,5,3,0,2,15
191205541,3,8,4,0,9,24
191205542,8,3,8,6,4,29
191205543,1,2,2,9,3,17
191205544,3,2,2,4,4,15
191205545,7,2,9,4,9,31
191205546,0,9,5,7,0,21
191205547,7,9,7,3,5,31
191205548,4,4,2,7,7,24
191205549,3,5,4,2,7,21
191205550,9,5,3,9,4,30
191205551,5,3,7,6,0,21
191205552,1,7,3,3,9,23
191205553,2,7,8,9,2,28
191205554,3,6,5,5,2,21
191205555,6,6,4,0,3,19
191205556,0,5,4,3,9,21
191205557,3,7,4,8,8,30
191205558,2,7,1,2,7,19
191205559,6,4,3,9,0,22
191205560,7,0,6,7,6,26
191205561,6,3,6,2,1,18
191205562,4,4,6,5,0,19
191205563,4,2,3,1,4,14
191205564,7,8,2,6,1,24
191205565,4,5,8,7,3,27
191205566,5,2,7,5,5,24
191205567,4,4,7,5,2,22
191205568,2,0,0,3,2,7
191205569,1,2,5,3,4,15
191205570,4,1,0,2,3,10
191205571,5,4,4,7,1,21
191205572,1,3,6,1,8,19
191205573,7,1,0,0,9,17
191205574,5,7,2,4,8,26
191205575,1,6,2,4,3,16
191205576,6,0,7,5,7,25
191205577,8,9,2,5,4,28
191205578,6,5,2,2,6,21
191205579,9,2,8,1,0,20
191205580,4,3,0,2,7,16
191205581,3,3,2,1,1,10
191205582,9,3,1,9,2,24
191205583,1,7,2,1,4,15
191205584,8,0,4,0,0,12
191205585,6,2,5,7,3,23
191205586,4,9,2,8,9,32
191205587,6,0,2,8,9,25
191205588,0,6,7,5,4,22
191205589,4,7,8,0,5,24
191205590,5,2,3,3,3,16
191205591,1,7,6,9,1,24
191205592,7,9,5,6,0,27
191205593,8,3,9,6,3,29
191205594,7,7,7,6,2,29
191205595,9,7,5,0,0,21
191205596,2,6,0,5,7,20
191205597,8,8,4,2,7,29
191205598,1,2,7,0,7,17
191205599,1,5,3,4,6,19
191205600,9,4,5,6,5,29
191205601,2,1,2,9,1,15
191205602,3,6,7,3,9,28
191205603,7,5,2,1,4,19
191205604,3,8,9,2,3,25
191205605,8,4,4,4,2,22
191205606,4,6,4,0,8,22
191205607,3,4,3,7,5,22
191205608,9,4,1,3,7,24
191205609,4,3,9,5,5,26
191205610,9,1,8,0,4,22
191205611,7,9,9,8,4,37
191205612,1,1,9,2,4,17
191205613,3,6,4,0,6,19
191205614,2,1,8,3,9,23
191205615,8,4,3,9,6,30
191205616,8,6,5,3,5,27
191205617,2,6,0,5,3,16
191205618,6,8,1,0,4,19
191205619,6,0,7,3,1,17
191205620,5,8,1,9,2,25
191205621,2,4,2,8,9,25
191205622,3,3,1,1,0,8
191205623,6,5,2,1,3,17
191205624,9,1,8,1,9,28
191205625,7,6,2,1,7,23
191205626,8,8,6,7,2,31
191205627,4,0,1,5,7,17
191205628,3,0,2,6,8,19
191205629,1,8,7,2,4,22
191205630,5,0,7,4,4,20
191205631,2,5,8,4,4,23
191205632,8,0,5,3,1,17
191205633,9,0,8,9,9,35
191205634,7,6,3,8,6,30
191205635,9,0,8,1,3,21
191205636,0,1,7,5,8,21
191205637,4,6,7,5,3,25
191205638,9,6,3,0,1,19
191205639,5,5,2,3,9,24
191205640,0,4,4,8,9,25
191205641,9,9,0,0,5,23
191205642,3,3,4,5,4,19
191205643,0,8,9,1,6,24
191205644,0,0,4,3,8,15
191205645,8,2,4,9,6,29
191205646,0,2,4,2,4,12
191205647,8,9,5,3,4,29
191205648,0,7,8,1,9,25
191205649,9,2,8,8,0,27
191205650,1,2,6,3,5,17
191205651,0,5,9,8,8,30
191205652,1,6,8,1,1,17
191205653,8,2,8,8,6,32
191205654,8,8,9,2,7,34
191205655,4,2,2,7,4,19
191205656,3,1,8,0,6,18
191205657,1,2,7,4,7,21
191205658,0,6,8,1,0,15
191205659,6,7,2,7,1,23
191205660,4,8,7,5,9,33
191205661,6,9,0,8,6,29
191205662,3,0,8,9,9,29
191205663,8,4,0,9,5,26
191205664,3,3,7,4,3,20
191205665,4,4,6,8,7,29
191205666,6,3,9,6,4,28
191205667,2,8,5,5,1,21
191205668,9,2,6,0,2,19
191205669,2,9,6,3,7,27
191205670,9,2,4,8,1,24
191205671,3,5,9,3,9,29
191205672,7,5,4,9,0,25
191205673,7,2,0,8,1,18
191205674,2,7,2,2,8,21
191205675,8,9,0,1,4,22
191205676,2,0,2,7,4,15
191205677,7,8,3,8,0,26
191205678,9,6,2,3,1,21
191205679,1,3,7,0,2,13
191205680,8,8,3,7,6,32
191205681,0,2,4,5,3,14
191205682,1,0,2,3,2,8
191205683,2,8,6,6,0,22
191205684,3,8,4,1,3,19
191205685,3,8,0,7,6,24
191205686,9,6,5,0,1,21
191205687,0,4,3,8,1,16
191205688,2,4,5,0,6,17
191205689,7,6,2,2,9,26
191205690,3,3,3,8,7,24
191205691,7,1,7,7,0,22
191205692,4,4,1,3,3,15
191205693,5,2,1,3,2,13
191205694,4,3,1,5,4,17
191205695,8,8,5,1,3,25
191205696,4,4,0,3,3,14
191205697,7,5,1,7,8,28
191205698,8,4,6,8,2,28
191205699,7,2,8,7,3,27
191205700,4,3,0,1,7,15
191205701,5,7,1,7,6,26
191205702,4,1,5,5,4,19
191205703,7,7,1,4,1,20
191205704,3,9,4,0,1,17
191205705,8,2,2,7,8,27
191205706,5,7,2,6,9,29
191205707,3,6,5,9,9,32
191205708,3,2,5,1,7,18
191205709,3,3,7,7,2,22
191205710,5,6,8,4,4,27
191205711,6,0,7,1,6,20
191205712,1,9,4,1,2,17
191205713,5,5,6,9,8,33
191205714,3,8,9,2,0,22
191205715,2,0,5,8,0,15
191205716,9,3,4,1,8,25
191205717,4,3,7,0,2,16
191205718,8,9,8,5,5,35
191205719,7,0,3,3,0,13
191205720,9,9,2,4,2,26
191205721,1,7,6,5,2,21
191205722,1,1,9,3,5,19
191205723,6,8,4,0,9,27
191205724,6,5,6,6,3,26
191205725,7,7,0,8,3,25
191205726,6,0,3,5,2,16
191205727,4,4,0,0,3,11
191205728,4,6,2,6,3,21
191205729,7,1,3,0,9,20
191205730,8,4,7,5,2,26
191205731,8,4,7,6,0,25
191205732,3,1,5,8,1,18
191205733,0,8,0,0,9,17
191205734,4,9,7,6,8,34
191205735,5,4,6,7,6,28
191205736,1,0,0,3,7,11
191205737,5,2,0,0,1,8
191205738,4,9,4,4,5,26
191205739,9,9,1,6,9,34
191205740,5,7,2,4,9,27
191205741,4,9,1,8,3,25
191205742,8,9,4,5,6,32
191205743,6,9,7,3,1,26
191205744,2,0,0,1,8,11
191205745,3,9,9,5,5,31
191205746,1,0,9,9,4,23
191205747,6,6,8,8,3,31
191205748,0,8,7,0,2,17
191205749,4,9,2,5,0,20
191205750,9,8,6,6,4,33
191205751,2,9,2,9,5,27
191205752,8,6,4,3,0,21
191205753,7,4,7,6,1,25
191205754,3,8,8,3,4,26
191205755,3,3,8,8,3,25
191205756,3,4,0,4,4,15
191205757,9,7,9,7,4,36
191205758,3,5,4,4,3,19
191205759,7,7,9,2,7,32
191205760,6,9,2,3,1,21
191205761,2,2,4,9,5,22
191205762,7,2,9,7,5,30
191205763,2,1,6,5,2,16
191205764,5,2,8,8,2,25
191205765,8,8,2,1,0,19
191205766,2,2,6,7,2,19
191205767,6,9,6,9,6,36
191205768,6,9,3,1,5,24
191205769,0,7,1,4,2,14
191205770,3,5,9,6,0,23
191205771,8,9,8,4,3,32
191205772,0,9,6,8,3,26
191205773,5,3,1,6,4,19
191205774,5,2,2,4,7,20
191205775,0,1,3,2,3,9
191205776,1,0,7,5,9,22
191205777,7,6,3,3,8,27
191205778,0,0,6,4,8,18
191205779,4,8,7,1,6,26
191205780,1,1,7,1,9,19
191205781,0,9,1,0,9,19
191205782,5,9,0,6,7,27
191205783,1,6,8,9,5,29
191205784,8,7,2,3,0,20
191205785,4,0,6,2,7,19
191205786,6,9,8,8,9,40
191205787,7,9,4,6,1,27
191205788,9,5,6,6,9,35
191205789,3,3,0,9,7,22
191205790,3,9,5,7,1,25
191205791,1,6,7,1,6,21
191205792,1,6,5,2,8,22
191205793,0,8,2,8,5,23
191205794,0,5,5,6,8,24
191205795,5,7,8,1,7,28
191205796,7,6,6,7,8,34
191205797,9,3,4,1,0,17
191205798,7,6,7,5,2,27
191205799,4,3,2,4,2,15
191205800,5,9,3,7,8,32
191205801,9,5,2,4,4,24
191205802,6,9,5,6,5,31
191205803,5,6,8,9,2,30
191205804,3,7,1,8,6,25
191205805,1,0,5,4,7,17
191205806,9,0,4,1,9,23
191205807,2,0,0,0,5,7
191205808,1,3,1,5,9,19
191205809,3,6,5,0,0,14
191205810,6,1,5,4,4,20
191205811,2,2,5,6,0,15
191205812,8,5,7,7,0,27
191205813,0,3,0,5,3,11
191205814,4,8,1,5,5,23
191205815,0,4,3,5,8,20
191205816,8,1,5,6,0,20
191205817,5,0,7,7,0,19
191205818,1,1,7,2,1,12
191205819,4,2,6,9,8,29
191205820,8,9,8,7,2,34
191205821,4,6,3,5,0,18
191205822,8,8,0,3,6,25
191205823,5,5,1,3,1,15
191205824,6,9,2,5,6,28
191205825,9,3,4,0,2,18
191205826,6,9,5,2,8,30
191205827,6,6,2,0,1,15
191205828,4,4,4,5,4,21
191205829,7,2,3,6,1,19
191205830,1,1,1,3,9,15
191205831,4,8,9,9,0,30
191205832,0,8,5,1,1,15
191205833,5,2,7,4,6,24
191205834,4,8,4,3,8,27
191205835,0,2,2,1,6,11
191205836,7,2,2,3,2,16
191205837,4,5,9,0,1,19
191205838,5,7,8,2,1,23
191205839,8,6,5,3,6,28
191205840,8,5,1,8,4,26
191205841,6,9,5,2,0,22
191205842,1,3,9,9,8,30
191205843,0,6,7,1,0,14
191205844,9,4,3,3,4,23
191205845,8,7,1,1,0,17
191205846,4,7,0,4,6,21
191205847,7,6,4,5,9,31
191205848,6,6,4,1,3,20
191205849,1,4,4,7,1,17
191205850,0,2,0,2,8,12
191205851,3,8,1,9,3,24
191205852,1,4,4,8,4,21
191205853,7,9,3,1,0,20
191205854,2,7,8,5,8,30
191205855,3,5,7,4,6,25
191205856,5,9,7,2,0,23
191205857,1,1,9,9,8,28
191205858,7,5,7,4,1,24
191205859,3,1,6,0,6,16
191205860,8,1,6,7,0,22
191205861,3,8,0,5,7,23
191205862,8,8,1,1,7,25
191205863,6,5,4,6,1,22
191205864,5,5,6,7,8,31
191205865,7,8,4,8,6,33
191205866,3,1,3,1,6,14
191205867,3,1,2,1,9,16
191205868,1,0,7,4,6,18
191205869,3,6,8,2,9,28
191205870,3,7,3,2,3,18
191205871,5,0,8,6,2,21
191205872,5,9,7,4,4,29
191205873,5,7,7,0,0,19
191205874,0,5,7,8,5,25
191205875,6,9,4,7,6,32
191205876,0,5,3,8,0,16
191205877,9,1,2,6,6,24
191205878,3,0,0,6,3,12
191205879,8,1,7,7,5,28
191205880,3,6,1,1,6,17
191205881,5,1,4,6,3,19
191205882,3,4,0,2,2,11
191205883,5,2,2,6,1,16
191205884,1,0,5,9,3,18
191205885,0,8,9,2,5,24
191205886,9,1,9,9,6,34
191205887,1,0,9,6,0,16
191205888,5,2,9,2,8,26
191205889,9,6,1,5,7,28
191205890,2,4,1,0,9,16
191205891,0,7,5,8,0,20
191205892,2,5,7,0,9,23
191205893,9,7,1,7,4,28
191205894,1,5,5,6,1,18
191205895,6,3,0,6,9,24
191205896,4,0,7,1,1,13
191205897,9,6,1,8,2,26
191205898,8,6,2,9,8,33
191205899,4,1,8,0,2,15
191205900,1,4,5,6,1,17
191205901,9,7,0,4,0,20
191205902,1,8,4,1,6,20
191205903,3,6,7,6,0,22
191205904,3,7,4,1,5,20
191205905,2,5,9,6,5,27
191205906,8,0,1,4,3,16
191205907,6,4,2,0,6,18
191205908,2,4,2,6,0,14
191205909,3,7,6,0,4,20
191205910,0,8,9,5,4,26
191205911,3,0,4,9,3,19
191205912,4,4,5,9,1,23
191205913,3,7,1,5,5,21
191205914,7,7,3,5,0,22
191205915,8,1,1,8,7,25
191205916,4,5,2,8,0,19
191205917,9,1,3,3,7,23
191205918,2,5,7,9,6,29
191205919,8,0,3,0,5,16
191205920,7,8,6,2,5,28
191205921,0,1,5,3,6,15
191205922,7,2,0,2,4,15
191205923,4,7,4,2,3,20
191205924,3,5,5,7,5,25
191205925,2,7,9,7,8,33
191205926,4,5,6,4,5,24
191205927,3,6,7,0,0,16
191205928,0,0,2,6,8,16
191205929,0,5,9,5,8,27
191205930,5,0,3,4,6,18
191205931,5,6,5,4,1,21
191205932,3,2,4,0,8,17
191205933,8,6,7,1,2,24
191205934,8,3,6,9,3,29
191205935,8,9,1,5,6,29
191205936,5,3,5,0,6,19
191205937,4,9,3,5,1,22
191205938,4,2,5,7,4,22
191205939,2,5,5,6,0,18
191205940,2,7,4,1,1,15
191205941,1,7,7,3,6,24
191205942,7,4,6,3,3,23
191205943,6,6,4,3,9,28
191205944,8,0,9,7,7,31
191205945,8,4,4,4,9,29
191205946,3,3,5,0,0,11
191205947,6,6,1,0,3,16
191205948,2,0,7,8,2,19
191205949,0,2,4,5,4,15
191205950,0,6,7,2,2,17
191205951,8,0,4,4,8,24
191205952,0,5,0,2,4,11
191205953,4,3,5,4,1,17
191205954,2,7,1,7,9,26
191205955,9,2,7,3,7,28
191205956,9,8,6,6,3,32
191205957,8,3,3,3,9,26
191205958,0,2,7,0,0,9
191205959,6,5,8,5,5,29
191205960,9,6,9,1,7,32
191205961,6,0,3,9,4,22
191205962,0,2,4,7,4,17
191205963,6,9,1,4,2,22
191205964,4,9,2,7,5,27
191205965,1,5,1,5,0,12
191205966,5,1,3,6,1,16
191205967,6,8,4,1,0,19
191205968,4,6,2,9,4,25
191205969,4,8,6,4,5,27
191205970,9,0,6,5,8,28
191205971,1,9,4,8,6,28
191205972,7,9,5,1,0,22
191205973,9,7,2,6,0,24
191205974,4,7,1,2,2,16
191205975,7,7,5,3,2,24
191205976,6,7,5,8,8,34
191205977,4,7,2,6,8,27
191205978,9,5,2,3,3,22
191205979,7,5,2,2,0,16
191205980,8,9,4,7,6,34
191205981,8,2,6,6,3,25
191205982,9,4,3,4,5,25
191205983,1,6,4,5,9,25
191205984,2,7,1,3,5,18
191205985,7,4,8,2,7,28
191205986,8,8,7,2,4,29
191205987,0,9,9,1,8,27
191205988,6,9,9,9,1,34
191205989,5,5,7,6,0,23
191205990,4,9,4,7,0,24
191205991,9,9,2,9,4,33
191205992,6,3,4,4,6,23
191205993,4,0,2,1,3,10
191205994,4,6,1,8,4,23
191205995,1,8,6,6,1,22
191205996,9,8,6,0,2,25
191205997,7,8,6,4,2,27
191205998,4,5,1,5,2,17
191205999,6,6,3,8,1,24
1912051000,5,4,6,8,3,26
1912051001,9,6,7,9,1,32
1912051002,6,9,0,6,8,29
1912051003,6,8,7,1,8,30
1912051004,5,8,0,7,9,29
1912051005,0,2,2,6,2,12
1912051006,3,8,7,1,3,22
1912051007,5,6,6,4,4,25
1912051008,8,8,7,7,4,34
1912051009,0,3,1,1,5,10
1912051010,5,6,6,2,6,25
1912051011,2,6,3,8,8,27
1912051012,7,4,1,5,2,19
1912051013,9,9,0,1,7,26
1912051014,4,1,7,2,4,18
1912051015,8,4,5,7,9,33
1912051016,2,9,6,0,5,22
1912051017,8,0,9,8,6,31
1912051018,0,5,8,6,4,23
1912051019,2,8,3,2,0,15
1912051020,6,0,7,0,4,17
1912051021,8,2,7,3,6,26
1912051022,6,0,6,9,0,21
1912051023,7,4,8,0,4,23
1912051024,7,5,2,3,4,21
1912051025,8,7,5,0,1,21
1912051026,0,6,1,8,2,17
1912051027,2,0,1,3,4,10
1912051028,6,9,2,9,5,31
1912051029,2,3,2,8,9,24
1912051030,0,9,5,2,6,22
1912051031,2,9,8,6,2,27
1912051032,2,2,8,1,7,20
1912051033,6,0,6,2,3,17
1912051034,8,1,9,0,3,21
1912051035,6,9,2,1,2,20
1912051036,5,2,1,1,2,11
1912051037,8,2,9,0,2,21
1912051038,2,3,0,7,4,16
1912051039,7,5,7,4,7,30
1912051040,6,9,5,5,7,32
1912051041,0,8,6,8,3,25
1912051042,7,5,6,8,6,32
1912051043,3,2,9,0,9,23
1912051044,5,2,7,0,4,18
1912051045,6,9,9,4,5,33
1912051046,6,3,4,8,5,26
1912051047,8,7,2,9,5,31
1912051048,5,1,0,4,1,11
1912051049,6,8,8,6,7,35
1912051050,3,1,7,5,9,25
1912051051,4,3,6,6,2,21
1912051052,3,6,1,3,8,21
1912051053,6,2,5,2,8,23
1912051054,3,0,4,8,3,18
1912051055,6,8,6,4,0,24
1912051056,2,1,2,6,5,16
1912051057,1,8,3,1,6,19
1912051058,6,0,0,8,9,23
1912051059,5,6,8,6,1,26
1912051060,3,9,5,0,6,23
1912051061,4,5,5,7,0,21
1912051062,4,7,0,0,2,13
1912051063,3,8,9,8,4,32
1912051064,0,5,2,0,9,16
1912051065,5,4,5,8,7,29
1912051066,8,8,5,6,3,30
1912051067,8,1,7,2,7,25
1912051068,5,1,6,5,4,21
1912051069,1,8,7,0,1,17
1912051070,7,9,2,2,9,29
1912051071,4,3,5,8,7,27
1912051072,7,2,5,6,2,22
1912051073,3,7,1,5,7,23
1912051074,2,5,8,3,2,20
1912051075,1,2,5,2,2,12
1912051076,9,6,0,7,7,29
1912051077,7,7,8,5,4,31
1912051078,2,6,3,0,5,16
1912051079,9,2,1,3,3,18
1912051080,8,1,4,3,7,23
1912051081,1,9,7,9,7,33
1912051082,2,2,3,5,0,12
1912051083,5,9,9,5,1,29
1912051084,8,6,7,1,0,22
1912051085,8,9,3,7,6,33
1912051086,9,3,7,0,9,28
1912051087,4,2,7,4,6,23
1912051088,6,8,4,1,5,24
1912051089,6,6,5,5,4,26
1912051090,2,0,9,7,7,25
1912051091,5,6,8,5,3,27
1912051092,8,4,8,2,1,23
1912051093,0,7,7,5,5,24
1912051094,8,4,9,2,6,29
1912051095,3,5,5,5,4,22
1912051096,7,8,3,2,2,22
1912051097,2,7,4,5,8,26
1912051098,5,4,5,4,5,23
1912051099,5,9,9,7,7,37
1912051100,2,6,7,1,5,21
1912051101,5,0,1,2,8,16
1912051102,3,1,1,6,5,16
1912051103,8,3,8,2,8,29
1912051104,8,0,8,9,2,27
1912051105,2,7,3,5,7,24
191206001,0,4,7,7,4,22
191206002,7,2,3,9,2,23
191206003,0,7,9,2,7,25
191206004,7,0,1,3,5,16
191206005,8,4,7,9,1,29
191206006,7,7,8,7,6,35
191206007,4,6,8,0,2,20
191206008,4,1,0,7,9,21
191206009,8,9,3,2,9,31
191206010,6,7,8,6,5,32
191206011,3,9,9,2,2,25
191206012,2,1,6,6,6,21
191206013,6,8,7,7,4,32
191206014,4,6,5,9,2,26
191206015,1,1,3,0,5,10
191206016,9,0,9,3,8,29
191206017,5,0,5,4,3,17
191206018,1,3,7,4,9,24
191206019,6,9,4,7,2,28
191206020,9,1,3,6,1,20
191206021,3,2,2,0,4,11
191206022,2,0,4,0,1,7
191206023,2,8,2,9,1,22
191206024,0,6,0,7,2,15
191206025,4,8,2,6,0,20
191206026,1,3,3,9,3,19
191206027,8,0,4,3,1,16
191206028,3,9,2,2,8,24
191206029,2,6,5,0,8,21
191206030,7,8,3,3,9,30
191206031,4,4,5,5,2,20
191206032,9,9,0,2,6,26
191206033,3,1,8,7,3,22
191206034,3,9,4,9,5,30
191206035,6,4,4,7,0,21
191206036,8,5,3,6,0,22
191206037,1,8,2,5,8,24
191206038,6,9,5,2,2,24
191206039,4,1,3,0,1,9
191206040,1,3,3,7,7,21
191206041,1,7,3,3,6,20
191206042,1,3,3,8,5,20
191206043,9,3,9,6,5,32
191206044,7,6,1,6,1,21
191206045,8,3,5,5,7,28
191206046,2,8,5,2,3,20
191206047,2,6,4,3,6,21
191206048,5,4,9,7,9,34
191206049,3,5,2,1,4,15
191206050,3,0,5,9,8,25
191206051,8,8,2,7,4,29
191206052,3,2,7,8,7,27
191206053,7,7,8,7,8,37
191206054,2,4,9,9,6,30
191206055,9,6,1,3,8,27
191206056,6,9,8,1,4,28
191206057,5,7,4,3,8,27
191206058,2,2,1,6,0,11
191206059,9,5,5,4,8,31
191206060,0,2,5,8,4,19
191206061,1,1,0,9,3,14
191206062,0,3,3,6,5,17
191206063,4,0,3,6,7,20
191206064,0,8,7,4,4,23
191206065,7,9,9,0,0,25
191206066,3,6,8,5,2,24
191206067,8,3,9,9,5,34
191206068,8,7,4,7,6,32
191206069,0,1,0,8,4,13
191206070,5,9,6,7,7,34
191206071,9,9,9,0,4,31
191206072,2,5,2,4,2,15
191206073,6,7,5,2,8,28
191206074,6,3,0,1,8,18
191206075,7,8,5,8,0,28
191206076,6,6,1,4,3,20
191206077,1,5,2,0,7,15
191206078,3,0,9,5,8,25
191206079,5,2,7,3,0,17
191206080,0,0,8,6,3,17
191206081,4,9,0,9,1,23
191206082,4,7,5,8,9,33
191206083,1,4,0,4,5,14
191206084,5,6,4,7,5,27
191206085,7,5,4,5,6,27
191206086,9,8,9,9,2,37
191206087,1,5,1,2,8,17
191206088,5,9,8,6,2,30
191206089,5,4,2,3,8,22
191206090,7,3,9,3,7,29
191206091,1,8,1,9,2,21
191206092,2,2,0,3,2,9
191206093,5,8,8,9,8,38
191206094,9,4,9,6,1,29
191206095,1,3,5,1,1,11
191206096,1,7,2,0,5,15
191206097,7,0,4,3,8,22
191206098,1,4,4,8,8,25
191206099,0,2,0,5,2,9
191206100,7,3,8,1,3,22
191206101,9,1,9,3,2,24
191206102,8,0,0,3,1,12
191206103,2,0,6,7,4,19
191206104,3,8,7,3,5,26
191206105,6,1,2,4,1,14
191206106,1,7,1,8,3,20
191206107,7,9,6,3,4,29
191206108,1,0,9,0,6,16
191206109,7,2,1,1,7,18
191206110,5,7,6,4,9,31
191206111,5,7,8,8,8,36
191206112,3,4,6,7,9,29
191206113,4,3,7,4,5,23
191206114,1,7,5,2,1,16
191206115,0,8,9,3,8,28
191206116,3,9,9,3,2,26
191206117,1,9,9,7,7,33
191206118,7,4,8,0,6,25
191206119,6,1,8,3,8,26
191206120,0,6,8,2,5,21
191206121,4,7,0,2,1,14
191206122,4,7,3,1,5,20
191206123,3,2,7,3,1,16
191206124,6,9,7,0,5,27
191206125,2,3,7,2,6,20
191206126,5,9,0,6,9,29
191206127,7,1,9,1,5,23
191206128,0,6,7,5,0,18
191206129,0,0,3,1,3,7
191206130,9,6,9,3,5,32
191206131,3,6,6,0,0,15
191206132,7,7,8,3,2,27
191206133,2,2,5,0,6,15
191206134,6,4,0,7,3,20
191206135,2,6,3,2,4,17
191206136,4,0,2,8,2,16
191206137,7,3,0,9,3,22
191206138,6,0,8,0,1,15
191206139,7,0,6,8,4,25
191206140,3,7,7,2,7,26
191206141,4,3,1,4,1,13
191206142,5,5,2,4,9,25
191206143,5,4,7,7,1,24
191206144,5,3,5,2,0,15
191206145,5,1,0,1,8,15
191206146,7,4,9,0,8,28
191206147,0,8,6,1,9,24
191206148,8,3,3,7,4,25
191206149,0,0,6,8,6,20
191206150,2,4,1,1,4,12
191206151,1,1,0,8,0,10
191206152,6,3,4,0,9,22
191206153,7,5,6,5,5,28
191206154,3,7,5,0,5,20
191206155,9,0,3,8,0,20
191206156,0,7,0,0,2,9
191206157,2,5,2,5,7,21
191206158,8,0,1,2,7,18
191206159,5,9,4,7,0,25
191206160,3,5,0,5,8,21
191206161,0,2,3,7,8,20
191206162,5,4,8,3,5,25
191206163,2,7,6,2,7,24
191206164,8,1,0,3,1,13
191206165,6,8,8,0,4,26
191206166,3,2,5,1,2,13
191206167,8,8,0,3,8,27
191206168,2,0,8,8,4,22
191206169,3,4,4,8,0,19
191206170,4,0,3,7,1,15
191206171,6,8,5,7,4,30
191206172,3,1,5,7,1,17
191206173,3,0,6,5,2,16
191206174,0,9,7,0,9,25
191206175,5,9,3,3,5,25
191206176,2,3,2,3,9,19
191206177,0,2,3,0,3,8
191206178,4,7,2,5,4,22
191206179,2,1,4,5,5,17
191206180,5,3,0,3,5,16
191206181,2,3,0,6,6,17
191206182,6,6,4,3,2,21
191206183,5,0,0,5,3,13
191206184,3,1,4,8,3,19
191206185,4,5,0,8,5,22
191206186,0,0,8,0,6,14
191206187,0,5,5,0,7,17
191206188,1,0,4,9,2,16
191206189,4,1,0,3,5,13
191206190,2,0,2,4,1,9
191206191,1,2,6,4,8,21
191206192,6,2,3,3,5,19
191206193,3,6,2,0,9,20
191206194,7,5,5,1,3,21
191206195,1,7,2,2,8,20
191206196,3,4,7,1,8,23
191206197,4,6,8,8,5,31
191206198,6,4,9,0,5,24
191206199,2,2,5,7,8,24
191206200,0,2,7,6,1,16
191206201,4,5,6,0,8,23
191206202,5,5,5,5,7,27
191206203,7,6,6,6,8,33
191206204,1,9,7,4,2,23
191206205,7,5,1,8,5,26
191206206,9,7,3,1,5,25
191206207,1,4,5,0,1,11
191206208,6,9,8,1,0,24
191206209,5,4,7,9,6,31
191206210,5,6,4,5,4,24
191206211,3,3,6,5,6,23
191206212,2,8,2,3,1,16
191206213,2,3,0,2,8,15
191206214,7,6,7,2,9,31
191206215,4,0,8,2,8,22
191206216,1,5,5,8,0,19
191206217,2,4,0,6,4,16
191206218,6,2,5,6,6,25
191206219,8,9,5,1,6,29
191206220,0,4,7,5,4,20
191206221,9,0,2,4,9,24
191206222,1,7,7,1,5,21
191206223,6,4,4,8,9,31
191206224,9,8,0,4,6,27
191206225,8,8,6,6,1,29
191206226,3,1,6,6,6,22
191206227,1,9,6,6,9,31
191206228,4,7,8,4,9,32
191206229,7,2,5,1,3,18
191206230,0,6,5,2,6,19
191206231,3,1,2,6,7,19
191206232,1,7,9,1,8,26
191206233,2,3,2,0,0,7
191206234,5,1,2,9,9,26
191206235,8,3,6,7,5,29
191206236,5,5,7,2,3,22
191206237,8,8,7,1,5,29
191206238,3,1,8,3,0,15
191206239,0,2,9,9,1,21
191206240,8,6,3,2,8,27
191206241,3,3,0,9,6,21
191206242,3,4,8,9,3,27
191206243,7,1,3,9,7,27
191206244,9,2,0,8,8,27
191206245,1,8,5,0,4,18
191206246,9,8,3,0,6,26
191206247,6,3,1,3,8,21
191206248,9,7,6,5,3,30
191206249,0,4,0,1,9,14
191206250,4,5,2,9,2,22
191206251,4,9,2,7,7,29
191206252,7,9,4,8,8,36
191206253,3,3,6,4,3,19
191206254,6,0,2,6,5,19
191206255,3,8,9,5,9,34
191206256,1,1,4,2,2,10
191206257,0,1,8,4,4,17
191206258,6,5,0,5,8,24
191206259,5,0,4,0,9,18
191206260,6,4,9,2,3,24
191206261,2,9,4,0,6,21
191206262,7,1,2,1,3,14
191206263,2,0,8,0,1,11
191206264,8,0,2,1,3,14
191206265,0,8,3,6,3,20
191206266,3,4,6,8,2,23
191206267,1,2,1,3,8,15
191206268,2,4,6,6,1,19
191206269,0,4,2,5,7,18
191206270,0,7,3,8,1,19
191206271,0,8,5,8,1,22
191206272,1,5,0,5,2,13
191206273,1,1,7,3,1,13
191206274,3,6,4,5,7,25
191206275,5,3,0,6,5,19
191206276,9,6,7,3,4,29
191206277,0,5,2,8,5,20
191206278,2,3,1,8,5,19
191206279,7,7,9,4,1,28
191206280,8,3,4,3,0,18
191206281,0,3,0,5,8,16
191206282,0,4,3,5,2,14
191206283,1,4,0,0,3,8
191206284,8,3,6,7,9,33
191206285,1,7,3,3,0,14
191206286,9,8,1,2,3,23
191206287,4,1,7,9,2,23
191206288,9,9,7,3,9,37
191206289,7,6,0,9,3,25
191206290,1,8,1,3,9,22
191206291,6,9,7,8,4,34
191206292,5,2,1,4,8,20
191206293,3,1,3,1,5,13
191206294,7,6,5,3,3,24
191206295,3,8,1,2,9,23
191206296,4,2,9,4,2,21
191206297,2,0,6,4,8,20
191206298,4,1,1,1,3,10
191206299,5,4,2,4,9,24
191206300,6,4,9,3,4,26
191206301,9,2,2,3,5,21
191206302,9,5,6,1,4,25
191206303,2,5,1,6,0,14
191206304,1,3,2,3,0,9
191206305,0,5,4,4,2,15
191206306,7,7,5,2,5,26
191206307,6,5,3,5,3,22
191206308,1,0,6,4,4,15
191206309,2,4,9,2,2,19
191206310,3,0,4,0,1,8
191206311,7,6,6,3,6,28
191206312,6,5,2,0,3,16
191206313,4,1,7,9,9,30
191206314,2,4,6,1,5,18
191206315,7,9,5,1,9,31
191206316,0,0,8,6,0,14
191206317,3,2,3,5,3,16
191206318,8,3,7,1,6,25
191206319,9,6,3,6,2,26
191206320,2,7,1,5,3,18
191206321,2,5,7,9,4,27
191206322,9,7,2,3,4,25
191206323,4,8,6,0,6,24
191206324,6,1,4,7,6,24
191206325,9,8,5,4,7,33
191206326,7,0,3,3,1,14
191206327,1,3,8,0,6,18
191206328,0,4,1,7,4,16
191206329,0,3,0,7,5,15
191206330,0,1,3,6,7,17
191206331,0,3,4,8,6,21
191206332,3,1,2,7,6,19
191206333,3,2,3,4,5,17
191206334,4,3,3,9,5,24
191206335,7,6,8,6,8,35
191206336,9,4,4,6,4,27
191206337,6,5,2,5,3,21
191206338,5,2,6,3,4,20
191206339,1,7,5,2,5,20
191206340,7,1,5,8,1,22
191206341,1,4,0,0,9,14
191206342,7,2,2,2,0,13
191206343,2,4,4,4,9,23
191206344,5,8,7,3,8,31
191206345,4,0,2,1,6,13
191206346,9,6,2,5,3,25
191206347,9,1,7,0,6,23
191206348,1,8,3,4,4,20
191206349,9,3,9,2,9,32
191206350,2,6,2,8,4,22
191206351,5,2,4,6,6,23
191206352,6,2,2,0,8,18
191206353,7,5,6,4,1,23
191206354,1,4,5,4,9,23
191206355,0,3,3,0,3,9
191206356,6,9,3,2,2,22
191206357,6,7,5,0,7,25
191206358,0,6,5,7,5,23
191206359,6,5,3,5,6,25
191206360,5,0,5,2,5,17
191206361,6,7,8,7,8,36
191206362,9,1,3,2,9,24
191206363,3,8,3,3,8,25
191206364,8,8,2,1,4,23
191206365,8,4,1,3,0,16
191206366,0,1,5,3,7,16
191206367,4,7,0,1,9,21
191206368,5,5,4,0,0,14
191206369,8,9,6,9,9,41
191206370,5,6,8,9,4,32
191206371,6,6,7,4,6,29
191206372,7,0,2,5,8,22
191206373,4,0,3,4,6,17
191206374,6,3,7,2,9,27
191206375,8,0,4,7,5,24
191206376,1,6,4,6,1,18
191206377,3,8,8,2,7,28
191206378,3,4,0,7,2,16
191206379,6,3,5,9,4,27
191206380,3,4,0,6,7,20
191206381,0,9,9,4,8,30
191206382,8,1,0,9,7,25
191206383,0,9,9,8,4,30
191206384,7,8,7,0,0,22
191206385,6,0,9,6,4,25
191206386,4,6,9,2,9,30
191206387,1,9,9,9,9,37
191206388,9,9,3,6,4,31
191206389,2,0,4,9,9,24
191206390,4,3,0,0,2,9
191206391,3,5,3,1,4,16
191206392,8,9,9,0,1,27
191206393,4,9,5,7,8,33
191206394,6,3,9,2,8,28
191206395,3,0,0,8,0,11
191206396,2,8,8,6,9,33
191206397,0,9,4,6,9,28
191206398,2,3,0,5,1,11
191206399,9,2,4,6,8,29
191206400,5,5,7,2,7,26
191206401,9,6,4,1,5,25
191206402,7,8,2,0,3,20
191206403,4,1,9,2,6,22
191206404,4,0,8,3,2,17
191206405,3,3,8,4,8,26
191206406,4,4,1,9,1,19
191206407,4,7,5,2,2,20
191206408,0,7,9,4,5,25
191206409,4,0,8,7,1,20
191206410,1,5,3,1,6,16
191206411,8,6,0,1,2,17
191206412,9,6,1,4,7,27
191206413,4,1,2,3,6,16
191206414,5,6,0,1,3,15
191206415,0,0,6,3,0,9
191206416,2,0,1,9,8,20
191206417,5,5,6,2,9,27
191206418,0,0,5,1,6,12
191206419,8,4,9,6,0,27
191206420,5,2,9,8,8,32
191206421,4,1,4,4,9,22
191206422,5,8,4,8,0,25
191206423,1,3,4,0,8,16
191206424,0,3,9,2,3,17
191206425,7,7,3,7,7,31
191206426,0,1,5,0,4,10
191206427,0,8,0,5,3,16
191206428,0,0,6,6,7,19
191206429,6,9,2,5,2,24
191206430,1,9,8,3,5,26
191206431,3,3,2,7,4,19
191206432,2,8,6,8,2,26
191206433,5,5,2,2,2,16
191206434,4,0,1,0,5,10
191206435,9,4,9,2,2,26
191206436,7,3,9,8,5,32
191206437,1,0,2,4,7,14
191206438,9,2,7,1,2,21
191206439,3,1,2,2,9,17
191206440,0,8,2,5,0,15
191206441,0,8,3,2,5,18
191206442,3,0,0,2,2,7
191206443,9,0,6,2,5,22
191206444,8,5,5,2,6,26
191206445,6,4,5,1,4,20
191206446,1,6,7,4,6,24
191206447,9,5,4,0,5,23
191206448,3,9,7,5,3,27
191206449,8,3,8,8,1,28
191206450,4,2,0,4,1,11
191206451,4,2,4,7,7,24
191206452,0,5,4,5,5,19
191206453,7,1,6,7,8,29
191206454,1,6,9,2,6,24
191206455,4,7,8,6,3,28
191206456,0,9,6,8,1,24
191206457,2,7,2,0,3,14
191206458,4,2,1,2,2,11
191206459,6,2,5,2,7,22
191206460,4,7,1,0,9,21
191206461,2,0,7,9,0,18
191206462,6,6,5,0,0,17
191206463,2,5,4,3,9,23
191206464,9,5,3,7,3,27
191206465,9,7,5,7,1,29
191206466,6,1,2,9,2,20
191206467,0,3,5,6,1,15
191206468,4,7,1,3,3,18
191206469,8,2,7,0,1,18
191206470,5,4,9,0,3,21
191206471,1,5,0,2,1,9
191206472,4,6,8,8,9,35
191206473,0,5,8,8,5,26
191206474,3,3,7,4,2,19
191206475,2,2,9,9,7,29
191206476,1,4,5,5,7,22
191206477,4,4,7,1,0,16
191206478,7,0,5,8,5,25
191206479,2,6,7,8,0,23
191206480,0,7,3,3,8,21
191206481,4,6,0,9,9,28
191206482,3,4,2,9,7,25
191206483,9,3,8,6,4,30
191206484,8,7,1,1,6,23
191206485,0,1,5,4,2,12
191206486,9,6,9,9,7,40
191206487,0,0,1,2,9,12
191206488,5,4,0,4,8,21
191206489,2,0,4,2,5,13
191206490,5,4,5,2,4,20
191206491,6,9,7,3,8,33
191206492,2,6,8,0,0,16
191206493,0,9,3,0,5,17
191206494,5,4,4,1,7,21
191206495,1,1,1,2,2,7
191206496,2,8,9,0,5,24
191206497,4,5,4,2,1,16
191206498,4,1,3,6,4,18
191206499,7,5,4,6,3,25
191206500,1,3,0,6,8,18
191206501,4,4,5,3,9,25
191206502,8,1,1,0,6,16
191206503,5,6,8,2,6,27
191206504,1,9,1,1,1,13
191206505,4,0,3,6,6,19
191206506,0,5,6,0,8,19
191206507,4,6,9,0,9,28
191206508,6,3,8,3,2,22
191206509,3,7,2,3,8,23
191206510,5,3,6,7,5,26
191206511,9,1,3,3,8,24
191206512,0,4,4,2,7,17
191206513,8,3,0,5,1,17
191206514,9,4,4,5,4,26
191206515,5,7,8,8,1,29
191206516,7,8,2,6,9,32
191206517,2,2,2,8,8,22
191206518,9,7,4,6,0,26
191206519,8,1,5,1,6,21
191206520,6,1,4,4,9,24
191206521,8,8,1,9,4,30
191206522,0,7,1,9,6,23
191206523,4,2,7,7,4,24
191206524,7,8,2,8,3,28
191206525,4,1,1,4,8,18
191206526,7,0,2,8,9,26
191206527,2,8,0,0,7,17
191206528,5,7,5,1,0,18
191206529,7,6,6,0,3,22
191206530,7,9,3,0,5,24
191206531,0,2,1,9,8,20
191206532,3,6,2,9,1,21
191206533,4,9,3,8,9,33
191206534,2,4,4,7,2,19
191206535,7,4,8,7,9,35
191206536,9,7,3,5,0,24
191206537,9,2,6,6,6,29
191206538,4,5,8,3,9,29
191206539,2,8,6,6,6,28
191206540,7,4,6,2,4,23
191206541,2,2,2,3,3,12
191206542,7,6,9,8,3,33
191206543,9,1,2,6,9,27
191206544,1,7,4,7,6,25
191206545,4,6,9,0,2,21
191206546,4,3,1,6,4,18
191206547,5,0,8,8,4,25
191206548,8,4,9,6,1,28
191206549,6,9,1,3,8,27
191206550,2,4,2,8,7,23
191206551,5,4,7,1,8,25
191206552,8,2,4,9,5,28
191206553,0,5,8,5,7,25
191206554,0,6,6,8,2,22
191206555,2,4,8,5,2,21
191206556,3,6,8,9,8,34
191206557,2,6,0,7,4,19
191206558,5,6,3,0,2,16
191206559,3,9,1,1,0,14
191206560,3,5,8,4,4,24
191206561,9,5,6,5,2,27
191206562,1,4,0,5,1,11
191206563,1,3,3,3,9,19
191206564,0,7,7,1,1,16
191206565,9,7,6,0,4,26
191206566,4,3,4,1,3,15
191206567,9,0,6,9,6,30
191206568,8,0,0,5,7,20
191206569,0,0,3,7,7,17
191206570,7,8,4,9,0,28
191206571,8,7,6,3,8,32
191206572,5,1,7,1,9,23
191206573,8,8,1,2,1,20
191206574,5,2,9,4,0,20
191206575,9,9,0,8,5,31
191206576,8,1,7,6,9,31
191206577,2,3,9,7,1,22
191206578,3,5,6,1,2,17
191206579,2,4,2,0,7,15
191206580,2,5,4,7,3,21
191206581,7,6,5,1,7,26
191206582,3,8,0,3,9,23
191206583,5,2,1,3,4,15
191206584,9,8,4,1,2,24
191206585,2,3,7,9,1,22
191206586,0,6,7,1,8,22
191206587,3,2,7,0,2,14
191206588,3,2,0,1,2,8
191206589,0,4,4,4,9,21
191206590,0,0,4,0,9,13
191206591,7,0,1,4,6,18
191206592,9,2,0,8,2,21
191206593,2,7,9,9,4,31
191206594,3,2,8,5,2,20
191206595,1,7,4,5,8,25
191206596,5,1,4,4,4,18
191206597,9,4,9,5,4,31
191206598,7,3,2,7,9,28
191206599,1,1,2,1,1,6
191206600,3,7,0,2,5,17
191206601,7,3,3,4,9,26
191206602,6,0,3,2,1,12
191206603,0,5,9,9,6,29
191206604,2,6,7,0,7,22
191206605,6,3,0,8,0,17
191206606,1,6,8,6,4,25
191206607,4,3,7,4,1,19
191206608,9,0,7,8,2,26
191206609,0,1,6,8,2,17
191206610,9,4,3,8,1,25
191206611,3,8,3,1,2,17
191206612,9,8,0,2,5,24
191206613,4,6,0,9,1,20
191206614,6,0,4,7,4,21
191206615,6,4,9,5,5,29
191206616,5,3,6,3,5,22
191206617,9,7,1,5,4,26
191206618,0,8,6,2,7,23
191206619,5,7,5,2,4,23
191206620,3,6,3,3,0,15
191206621,8,5,8,5,5,31
191206622,0,2,4,7,1,14
191206623,0,8,7,6,0,21
191206624,4,7,0,7,5,23
191206625,6,0,8,7,7,28
191206626,7,9,6,4,2,28
191206627,7,4,3,4,6,24
191206628,7,8,1,8,0,24
191206629,4,4,9,7,9,33
191206630,9,7,8,5,5,34
191206631,9,9,5,9,8,40
191206632,6,0,0,6,2,14
191206633,8,9,6,0,5,28
191206634,7,4,8,8,7,34
191206635,4,3,2,1,9,19
191206636,3,9,9,2,7,30
191206637,0,1,4,0,1,6
191206638,0,0,4,0,8,12
191206639,3,7,6,1,9,26
191206640,4,4,3,5,4,20
191206641,4,0,6,9,6,25
191206642,8,4,8,5,3,28
191206643,0,7,7,0,8,22
191206644,3,9,7,0,0,19
191206645,6,8,2,3,2,21
191206646,8,2,5,4,1,20
191206647,4,6,7,3,8,28
191206648,6,3,4,4,1,18
191206649,7,0,6,0,7,20
191206650,3,7,7,7,6,30
191206651,1,5,6,0,6,18
191206652,8,9,5,4,6,32
191206653,6,6,3,8,2,25
191206654,9,0,6,5,5,25
191206655,8,1,2,6,6,23
191206656,6,2,5,5,3,21
191206657,1,3,9,1,3,17
191206658,1,0,2,8,1,12
191206659,1,9,5,9,7,31
191206660,8,8,9,2,2,29
191206661,8,8,8,7,1,32
191206662,5,8,2,0,1,16
191206663,0,3,4,2,6,15
191206664,3,8,9,0,6,26
191206665,8,0,1,8,2,19
191206666,0,5,3,0,3,11
191206667,6,9,3,3,3,24
191206668,6,0,1,6,8,21
191206669,4,3,9,3,4,23
191206670,5,0,0,3,1,9
191206671,6,8,4,2,0,20
191206672,6,1,8,7,9,31
191206673,1,4,1,5,3,14
191206674,8,6,7,2,5,28
191206675,2,4,4,2,0,12
191206676,1,8,4,9,1,23
191206677,2,6,0,4,3,15
191206678,8,4,9,2,9,32
191206679,2,8,6,7,8,31
191206680,1,4,3,9,2,19
191206681,5,8,5,4,9,31
191206682,4,3,2,6,6,21
191206683,3,8,2,1,7,21
191206684,0,9,9,3,7,28
191206685,2,1,0,4,3,10
191206686,9,1,3,0,1,14
191206687,1,3,8,6,0,18
191206688,2,4,7,7,6,26
191206689,0,9,7,5,2,23
191206690,2,0,6,4,6,18
191206691,2,9,2,3,8,24
191206692,9,3,6,1,6,25
191206693,8,4,6,2,4,24
191206694,6,4,7,1,0,18
191206695,4,9,8,4,2,27
191206696,9,0,8,1,8,26
191206697,2,8,0,4,4,18
191206698,8,5,3,5,9,30
191206699,6,0,5,0,1,12
191206700,6,0,1,8,8,23
191206701,3,4,3,6,1,17
191206702,2,1,7,1,3,14
191206703,0,9,7,1,3,20
191206704,6,5,3,2,6,22
191206705,6,9,8,8,0,31
191206706,9,5,8,3,2,27
191206707,5,6,4,5,7,27
191206708,4,8,7,0,3,22
191206709,6,7,7,7,8,35
191206710,4,7,6,4,4,25
191206711,9,9,9,0,3,30
191206712,4,1,6,3,7,21
191206713,4,5,2,7,7,25
191206714,0,2,6,1,5,14
191206715,8,4,1,5,5,23
191206716,5,8,2,2,6,23
191206717,1,6,1,3,2,13
191206718,8,9,5,2,1,25
191206719,8,4,8,3,3,26
191206720,0,3,4,2,9,18
191206721,2,2,7,7,0,18
191206722,5,2,4,6,2,19
191206723,2,1,7,9,4,23
191206724,5,0,6,9,7,27
191206725,5,8,5,4,7,29
191206726,1,1,1,0,0,3
191206727,5,0,1,3,7,16
191206728,6,9,9,9,2,35
191206729,4,3,6,8,6,27
191206730,8,8,9,1,1,27
191206731,9,5,6,0,6,26
191206732,5,4,3,2,7,21
191206733,0,6,3,0,8,17
191206734,7,4,7,8,8,34
191206735,9,2,5,4,2,22
191206736,7,6,6,1,2,22
191206737,2,8,1,9,1,21
191206738,9,2,9,0,9,29
191206739,9,1,8,5,8,31
191206740,6,8,8,3,8,33
191206741,5,9,1,7,8,30
191206742,4,1,2,2,8,17
191206743,1,0,1,6,4,12
191206744,7,7,1,7,3,25
191206745,2,9,0,7,8,26
191206746,1,9,2,0,3,15
191206747,3,1,9,5,9,27
191206748,5,1,4,2,1,13
191206749,3,5,7,7,5,27
191206750,2,8,9,3,4,26
191206751,4,2,6,4,1,17
191206752,1,9,3,9,6,28
191206753,6,2,3,3,7,21
191206754,5,8,7,4,7,31
191206755,2,2,2,5,1,12
191206756,8,5,4,7,8,32
191206757,7,9,5,7,3,31
191206758,9,2,4,2,7,24
191206759,4,5,8,3,2,22
191206760,5,7,9,4,4,29
191206761,0,5,5,5,5,20
191206762,6,3,8,5,2,24
191206763,2,2,4,2,8,18
191206764,7,0,4,1,4,16
191206765,2,1,4,0,9,16
191206766,7,5,3,0,8,23
191206767,2,2,2,6,1,13
191206768,6,8,6,0,6,26
191206769,0,1,2,3,5,11
191206770,2,8,8,7,4,29
191206771,2,9,4,9,6,30
191206772,6,3,3,4,1,17
191206773,6,9,4,8,4,31
191206774,5,1,9,7,3,25
191206775,7,8,1,6,5,27
191206776,6,6,6,4,7,29
191206777,4,6,3,3,9,25
191206778,6,7,3,9,3,28
191206779,7,3,9,4,3,26
191206780,8,1,6,8,4,27
191206781,9,1,5,2,6,23
191206782,5,4,6,9,9,33
191206783,8,1,9,6,7,31
191206784,4,1,5,3,4,17
191206785,3,0,1,2,5,11
191206786,5,0,7,5,7,24
191206787,7,5,3,3,3,21
191206788,5,5,2,9,4,25
191206789,6,5,3,3,1,18
191206790,4,7,8,2,7,28
191206791,0,9,1,5,3,18
191206792,7,2,8,6,4,27
191206793,4,3,3,1,8,19
191206794,0,6,1,6,4,17
191206795,3,5,8,6,4,26
191206796,9,1,2,8,1,21
191206797,5,4,1,8,7,25
191206798,5,8,1,6,6,26
191206799,4,9,6,1,1,21
191206800,3,7,9,1,7,27
191206801,2,3,5,6,7,23
191206802,6,7,4,9,3,29
191206803,4,5,8,1,3,21
191206804,8,2,5,9,9,33
191206805,2,5,3,8,9,27
191206806,4,6,4,2,4,20
191206807,9,6,1,6,1,23
191206808,5,9,6,9,9,38
191206809,7,8,2,7,5,29
191206810,0,0,4,1,4,9
191206811,1,6,6,3,7,23
191206812,9,4,7,7,2,29
191206813,3,0,9,6,7,25
191206814,9,1,2,8,8,28
191206815,9,9,1,8,3,30
191206816,0,2,0,6,2,10
191206817,9,5,5,3,4,26
191206818,9,0,4,7,1,21
191206819,2,2,4,7,8,23
191206820,7,2,0,9,6,24
191206821,2,2,5,0,2,11
191206822,8,3,5,7,0,23
191206823,3,4,6,1,5,19
191206824,2,5,5,5,4,21
191206825,6,4,2,0,9,21
191206826,2,0,6,9,6,23
191206827,5,2,0,8,8,23
191206828,3,4,7,5,4,23
191206829,9,8,6,2,5,30
191206830,8,2,7,7,9,33
191206831,6,5,8,0,5,24
191206832,7,3,7,1,8,26
191206833,9,7,3,7,3,29
191206834,2,9,9,4,9,33
191206835,5,6,5,4,3,23
191206836,8,9,6,5,7,35
191206837,9,2,7,3,1,22
191206838,0,0,6,8,0,14
191206839,1,7,4,0,1,13
191206840,9,2,5,3,9,28
191206841,0,7,3,1,9,20
191206842,3,4,7,2,3,19
191206843,0,0,8,1,8,17
191206844,8,9,2,3,0,22
191206845,9,7,4,2,5,27
191206846,5,8,4,5,9,31
191206847,6,1,1,9,6,23
191206848,5,3,0,1,2,11
191206849,9,3,4,7,8,31
191206850,7,2,6,7,9,31
191206851,7,3,5,2,5,22
191206852,4,8,8,9,1,30
191206853,1,3,0,5,2,11
191206854,2,5,9,7,4,27
191206855,2,2,7,9,6,26
191206856,7,7,4,4,8,30
191206857,8,8,5,9,5,35
191206858,8,1,1,4,4,18
191206859,1,0,1,0,3,5
191206860,0,8,8,4,9,29
191206861,7,9,2,7,7,32
191206862,8,8,3,1,7,27
191206863,8,1,7,5,3,24
191206864,7,5,1,5,1,19
191206865,2,8,5,1,0,16
191206866,6,3,2,1,9,21
191206867,9,3,5,7,4,28
191206868,5,3,9,0,7,24
191206869,0,0,1,0,8,9
191206870,1,7,3,9,5,25
191206871,4,5,3,7,5,24
191206872,1,5,8,7,5,26
191206873,1,1,7,3,5,17
191206874,8,5,4,5,6,28
191206875,4,8,2,2,1,17
191206876,6,2,0,3,8,19
191206877,8,3,8,5,8,32
191206878,7,2,7,0,9,25
191206879,5,4,6,5,1,21
191206880,7,7,5,7,5,31
191206881,9,4,1,5,2,21
191206882,7,1,8,8,6,30
191206883,4,4,9,8,0,25
191206884,0,5,0,1,6,12
191206885,3,4,6,3,0,16
191206886,1,4,3,6,9,23
191206887,9,8,7,9,1,34
191206888,8,9,8,1,3,29
191206889,0,5,9,8,0,22
191206890,7,7,5,3,5,27
191206891,1,4,1,2,0,8
191206892,7,0,9,4,1,21
191206893,9,3,8,7,5,32
191206894,2,6,0,3,5,16
191206895,0,1,7,3,1,12
191206896,3,5,4,8,5,25
191206897,1,6,3,8,5,23
191206898,8,6,4,6,2,26
191206899,9,9,0,5,2,25
191206900,4,6,5,3,8,26
191206901,4,2,8,8,8,30
191206902,4,0,3,4,5,16
191206903,3,8,9,8,8,36
191206904,9,2,5,4,5,25
191206905,4,1,5,2,0,12
191206906,7,4,3,7,0,21
191206907,5,9,4,5,3,26
191206908,5,4,9,2,3,23
191206909,3,5,3,5,3,19
191206910,7,0,9,5,4,25
191206911,3,0,2,5,8,18
191206912,9,9,0,8,0,26
191206913,8,1,7,1,4,21
191206914,5,7,5,9,1,27
191206915,7,6,4,9,2,28
191206916,7,1,8,3,5,24
191206917,0,0,1,6,6,13
191206918,2,5,5,3,1,16
191206919,6,7,7,0,7,27
191206920,0,5,6,8,2,21
191206921,0,1,0,8,6,15
191206922,0,1,4,1,8,14
191206923,2,7,6,8,0,23
191206924,1,6,1,6,3,17
191206925,7,0,6,7,4,24
191206926,0,6,9,1,8,24
191206927,3,3,2,0,9,17
191206928,8,7,1,0,4,20
191206929,0,5,5,8,1,19
191206930,1,6,7,3,0,17
191206931,0,8,9,9,1,27
191206932,0,5,9,0,0,14
191206933,9,8,2,4,2,25
191206934,0,9,3,0,3,15
191206935,8,9,7,8,6,38
191206936,9,6,3,0,8,26
191206937,9,1,3,7,6,26
191206938,9,8,9,2,1,29
191206939,1,3,7,2,9,22
191206940,7,6,0,7,5,25
191206941,8,0,8,1,1,18
191206942,9,2,0,0,7,18
191206943,8,6,1,1,9,25
191206944,6,1,6,7,8,28
191206945,1,7,1,2,3,14
191206946,1,0,6,4,1,12
191206947,5,8,2,8,3,26
191206948,2,7,7,7,1,24
191206949,7,3,8,7,2,27
191206950,1,9,1,5,0,16
191206951,1,6,9,2,4,22
191206952,5,1,0,4,3,13
191206953,5,2,8,5,7,27
191206954,3,4,3,7,7,24
191206955,8,2,6,7,3,26
191206956,1,1,3,4,2,11
191206957,5,1,6,2,0,14
191206958,1,2,9,1,6,19
191206959,5,6,3,9,5,28
191206960,2,0,5,4,4,15
191206961,1,5,9,2,5,22
191206962,7,0,8,3,8,26
191206963,6,2,4,2,2,16
191206964,8,7,3,4,3,25
191206965,3,5,4,5,2,19
191206966,5,9,5,0,4,23
191206967,7,8,8,8,9,40
191206968,8,3,9,4,9,33
191206969,7,5,4,6,7,29
191206970,8,1,7,3,3,22
191206971,8,9,2,5,8,32
191206972,9,7,5,0,7,28
191206973,8,0,1,5,3,17
191206974,9,0,3,5,6,23
191206975,4,3,9,5,2,23
191206976,5,6,7,2,6,26
191206977,7,5,1,9,1,23
191206978,1,3,5,3,5,17
191206979,9,0,2,4,1,16
191206980,5,9,3,1,8,26
191206981,4,6,4,0,9,23
191206982,0,4,4,8,1,17
191206983,4,3,7,7,7,28
191206984,8,0,1,9,8,26
191206985,1,5,1,1,3,11
191206986,8,7,6,8,1,30
191206987,9,7,3,1,0,20
191206988,9,2,1,5,4,21
191206989,9,6,0,5,2,22
191206990,6,2,3,6,7,24
191206991,2,2,7,7,8,26
191206992,1,1,3,9,5,19
191206993,2,0,3,2,5,12
191206994,6,8,2,9,9,34
191206995,1,5,5,4,0,15
191206996,7,2,0,5,8,22
191206997,4,4,9,0,9,26
191206998,2,2,9,5,6,24
191206999,5,8,7,0,2,22
1912061000,2,7,5,9,8,31
1912061001,1,3,6,5,6,21
1912061002,3,3,8,8,1,23
1912061003,5,4,6,0,4,19
1912061004,2,5,3,0,8,18
1912061005,8,8,5,6,4,31
1912061006,3,4,0,4,9,20
1912061007,4,5,7,5,2,23
1912061008,5,3,9,7,8,32
1912061009,3,7,8,7,5,30
1912061010,7,0,8,5,6,26
1912061011,7,6,0,5,1,19
1912061012,5,1,5,6,6,23
1912061013,4,6,4,4,7,25
1912061014,4,2,9,4,9,28
1912061015,0,6,6,5,6,23
1912061016,8,7,0,3,3,21
1912061017,4,6,0,1,8,19
1912061018,6,6,2,5,5,24
1912061019,8,5,2,5,2,22
1912061020,3,6,4,1,9,23
1912061021,3,4,2,9,6,24
1912061022,3,3,8,8,4,26
1912061023,0,9,2,3,9,23
1912061024,0,8,1,8,1,18
1912061025,3,1,6,1,0,11
1912061026,2,7,7,9,1,26
1912061027,5,7,4,8,8,32
1912061028,8,2,3,9,4,26
1912061029,6,1,1,8,5,21
1912061030,0,7,2,7,9,25
1912061031,0,3,2,8,4,17
1912061032,5,0,5,8,1,19
1912061033,3,8,4,8,7,30
1912061034,3,5,7,0,0,15
1912061035,2,9,5,4,0,20
1912061036,7,0,9,3,3,22
1912061037,0,6,3,4,1,14
1912061038,7,9,8,0,2,26
1912061039,1,3,2,5,0,11
1912061040,2,4,5,7,2,20
1912061041,8,4,3,7,8,30
1912061042,9,4,7,8,1,29
1912061043,9,0,1,2,4,16
1912061044,4,3,2,1,0,10
1912061045,9,2,8,9,1,29
1912061046,0,0,9,0,0,9
1912061047,2,6,8,0,5,21
1912061048,2,1,1,4,0,8
1912061049,7,6,5,7,6,31
1912061050,4,6,7,9,6,32
1912061051,6,3,0,2,7,18
1912061052,2,3,3,2,3,13
1912061053,9,5,8,9,5,36
1912061054,2,0,7,2,8,19
1912061055,8,4,2,2,4,20
1912061056,2,7,6,0,4,19
1912061057,1,2,0,5,7,15
1912061058,2,7,3,9,6,27
1912061059,2,0,6,9,1,18
1912061060,2,6,1,2,9,20
1912061061,8,3,5,6,5,27
1912061062,7,8,9,0,1,25
1912061063,4,4,6,7,8,29
1912061064,7,6,1,6,6,26
1912061065,0,7,6,1,8,22
1912061066,8,1,9,7,7,32
1912061067,1,8,1,4,0,14
1912061068,1,3,8,8,1,21
1912061069,6,9,0,5,8,28
1912061070,4,8,0,7,5,24
1912061071,8,6,1,8,9,32
1912061072,4,6,6,8,1,25
1912061073,8,1,7,7,2,25
1912061074,3,2,9,0,4,18
1912061075,2,9,1,5,6,23
1912061076,6,3,0,0,5,14
1912061077,7,9,6,1,4,27
1912061078,1,9,1,8,6,25
1912061079,7,6,4,9,1,27
1912061080,8,3,4,1,6,22
1912061081,3,4,1,1,6,15
1912061082,9,1,1,4,4,19
1912061083,9,2,3,9,0,23
1912061084,2,1,9,5,2,19
1912061085,7,8,4,2,9,30
1912061086,8,1,0,9,1,19
1912061087,3,1,0,4,7,15
1912061088,5,5,6,5,0,21
1912061089,9,0,2,7,0,18
1912061090,4,2,5,9,8,28
1912061091,0,9,7,0,0,16
1912061092,8,1,9,8,8,34
1912061093,2,8,8,3,9,30
1912061094,8,0,1,0,8,17
1912061095,9,7,8,9,4,37
1912061096,8,9,6,5,2,30
1912061097,2,3,8,7,7,27
1912061098,3,3,8,0,8,22
1912061099,9,2,6,8,7,32
1912061100,4,3,7,8,1,23
1912061101,5,1,9,1,6,22
1912061102,1,2,4,9,1,17
1912061103,7,1,7,3,6,24
1912061104,4,1,6,5,5,21
1912061105,2,2,3,2,2,11
191207001,3,4,9,6,8,30
191207002,5,9,2,8,4,28
191207003,8,4,2,1,0,15
191207004,4,0,9,3,8,24
191207005,0,3,4,5,5,17
191207006,9,3,3,3,6,24
191207007,8,0,8,8,9,33
191207008,9,2,9,6,4,30
191207009,1,6,9,1,6,23
191207010,3,5,3,3,5,19
191207011,2,8,9,7,3,29
191207012,9,4,7,0,1,21
191207013,0,1,2,7,6,16
191207014,9,7,4,9,0,29
191207015,6,0,6,1,4,17
191207016,8,2,3,3,5,21
191207017,1,1,2,1,0,5
191207018,5,4,7,5,3,24
191207019,3,6,4,2,3,18
191207020,0,2,8,6,5,21
191207021,3,0,5,9,5,22
191207022,9,4,3,6,0,22
191207023,9,9,9,4,6,37
191207024,0,8,2,6,9,25
191207025,5,8,2,5,9,29
191207026,9,4,4,3,6,26
191207027,7,3,4,0,9,23
191207028,9,4,3,9,6,31
191207029,1,4,3,7,4,19
191207030,1,1,8,6,1,17
191207031,1,1,1,5,4,12
191207032,7,1,5,2,3,18
191207033,9,3,2,5,0,19
191207034,1,1,9,6,5,22
191207035,1,2,6,7,3,19
191207036,3,7,3,8,7,28
191207037,4,9,7,9,7,36
191207038,9,6,7,4,1,27
191207039,3,1,7,1,3,15
191207040,9,7,3,9,8,36
191207041,0,0,1,0,0,1
191207042,4,3,0,1,3,11
191207043,1,3,4,5,7,20
191207044,1,6,7,4,7,25
191207045,6,6,3,5,9,29
191207046,9,0,6,8,6,29
191207047,7,6,7,6,9,35
191207048,4,4,7,1,5,21
191207049,1,8,9,7,1,26
191207050,5,4,9,9,2,29
191207051,3,9,9,1,7,29
191207052,4,5,3,1,8,21
191207053,8,5,7,1,4,25
191207054,6,7,2,1,3,19
191207055,8,0,8,6,0,22
191207056,2,2,6,3,8,21
191207057,1,6,4,4,7,22
191207058,3,5,9,4,6,27
191207059,2,9,3,1,4,19
191207060,9,9,6,9,3,36
191207061,7,8,8,0,3,26
191207062,3,8,8,4,6,29
191207063,8,1,3,7,3,22
191207064,7,6,5,9,6,33
191207065,2,8,9,3,1,23
191207066,0,7,4,0,1,12
191207067,9,1,1,9,7,27
191207068,3,3,8,9,8,31
191207069,2,1,6,6,2,17
191207070,3,8,4,0,5,20
191207071,9,6,3,1,3,22
191207072,4,9,4,5,9,31
191207073,1,7,7,0,1,16
191207074,5,1,3,4,9,22
191207075,9,4,0,0,1,14
191207076,8,0,3,4,7,22
191207077,8,3,7,3,7,28
191207078,4,1,4,9,7,25
191207079,4,9,7,3,8,31
191207080,1,7,7,3,8,26
191207081,0,3,1,0,1,5
191207082,9,1,4,8,1,23
191207083,8,6,2,7,8,31
191207084,7,0,5,5,5,22
191207085,4,1,8,3,1,17
191207086,9,0,4,4,5,22
191207087,3,1,8,2,1,15
191207088,8,5,9,9,7,38
191207089,1,1,1,8,1,12
191207090,0,0,3,2,7,12
191207091,1,0,5,8,3,17
191207092,8,4,4,1,5,22
191207093,1,7,6,3,2,19
191207094,9,4,7,3,5,28
191207095,0,4,7,0,8,19
191207096,9,5,5,5,1,25
191207097,5,8,3,9,2,27
191207098,0,1,9,3,9,22
191207099,3,2,3,1,6,15
191207100,6,7,8,5,5,31
191207101,4,5,9,3,3,24
191207102,3,6,4,9,6,28
191207103,2,3,2,4,1,12
191207104,1,2,8,9,7,27
191207105,2,3,7,1,3,16
191207106,2,6,5,4,1,18
191207107,2,6,4,7,5,24
191207108,5,5,2,9,6,27
191207109,6,8,2,1,9,26
191207110,0,9,2,7,7,25
191207111,3,8,6,0,9,26
191207112,6,3,3,3,1,16
191207113,3,3,1,8,5,20
191207114,1,3,4,4,8,20
191207115,4,4,7,3,0,18
191207116,9,7,0,7,8,31
191207117,4,4,6,1,6,21
191207118,5,7,1,5,7,25
191207119,4,3,4,6,5,22
191207120,3,8,7,7,8,33
191207121,4,9,8,1,6,28
191207122,3,1,9,5,6,24
191207123,0,6,5,3,9,23
191207124,6,6,9,6,1,28
191207125,8,1,3,3,6,21
191207126,4,4,7,7,7,29
191207127,8,6,7,9,8,38
191207128,8,8,5,2,7,30
191207129,4,5,6,6,3,24
191207130,5,8,5,3,6,27
191207131,1,2,0,0,3,6
191207132,1,0,1,4,8,14
191207133,6,2,5,7,7,27
191207134,2,0,5,6,1,14
191207135,4,0,8,7,0,19
191207136,6,8,1,8,9,32
191207137,5,2,0,7,8,22
191207138,8,4,4,0,1,17
191207139,7,3,5,3,5,23
191207140,7,9,6,0,2,24
191207141,9,1,8,7,1,26
191207142,9,2,3,8,6,28
191207143,2,7,7,8,0,24
191207144,1,4,9,8,9,31
191207145,0,8,5,4,1,18
191207146,0,7,0,2,5,14
191207147,6,4,7,7,5,29
191207148,1,6,0,0,7,14
191207149,3,3,3,6,0,15
191207150,3,4,0,7,3,17
191207151,4,8,4,1,6,23
191207152,6,5,8,2,5,26
191207153,0,5,3,2,0,10
191207154,9,3,3,4,6,25
191207155,7,4,6,6,4,27
191207156,6,1,3,2,9,21
191207157,4,0,3,8,1,16
191207158,6,1,5,6,7,25
191207159,6,2,2,7,0,17
191207160,6,6,8,0,0,20
191207161,2,3,6,2,1,14
191207162,2,9,9,5,1,26
191207163,3,6,3,5,8,25
191207164,2,9,5,9,0,25
191207165,9,3,9,9,3,33
191207166,5,8,8,8,9,38
191207167,1,6,9,9,6,31
191207168,1,1,5,3,1,11
191207169,8,9,2,9,5,33
191207170,4,3,4,7,2,20
191207171,1,9,3,5,0,18
191207172,7,7,0,6,9,29
191207173,2,0,7,5,2,16
191207174,2,9,4,8,1,24
191207175,3,3,5,1,2,14
191207176,9,8,1,2,7,27
191207177,7,9,1,1,3,21
191207178,3,0,9,8,0,20
191207179,6,2,9,5,8,30
191207180,0,0,7,7,1,15
191207181,9,8,6,7,2,32
191207182,7,3,9,3,5,27
191207183,0,9,0,2,8,19
191207184,9,9,5,9,5,37
191207185,0,1,1,8,5,15
191207186,5,8,1,5,1,20
191207187,4,5,9,6,4,28
191207188,0,8,2,0,5,15
191207189,0,9,8,9,1,27
191207190,5,9,7,5,4,30
191207191,9,6,7,5,0,27
191207192,2,1,9,6,3,21
191207193,5,2,7,9,0,23
191207194,6,6,2,0,3,17
191207195,3,1,2,3,7,16
191207196,7,4,8,4,1,24
191207197,0,6,3,9,2,20
191207198,9,5,3,1,0,18
191207199,8,6,5,2,4,25
191207200,3,4,9,8,8,32
191207201,8,1,1,7,4,21
191207202,2,9,5,8,9,33
191207203,5,8,5,2,2,22
191207204,6,2,7,2,0,17
191207205,1,8,3,0,7,19
191207206,7,1,4,9,9,30
191207207,7,7,5,8,2,29
191207208,5,4,2,8,8,27
191207209,4,9,2,6,3,24
191207210,6,4,3,8,2,23
191207211,8,9,2,4,7,30
191207212,7,0,5,7,7,26
191207213,0,1,3,0,4,8
191207214,3,0,9,9,7,28
191207215,1,2,2,0,2,7
191207216,7,4,4,0,8,23
191207217,7,6,3,2,3,21
191207218,1,5,6,9,2,23
191207219,1,0,2,2,1,6
191207220,4,1,7,6,0,18
191207221,0,5,4,9,9,27
191207222,0,2,6,2,7,17
191207223,2,5,7,3,2,19
191207224,7,0,1,8,9,25
191207225,8,3,2,9,9,31
191207226,8,9,5,9,3,34
191207227,7,8,5,9,3,32
191207228,3,7,1,0,4,15
191207229,3,5,1,4,2,15
191207230,7,0,3,1,2,13
191207231,5,7,6,7,8,33
191207232,7,3,8,0,0,18
191207233,9,8,3,7,2,29
191207234,2,0,8,0,6,16
191207235,1,2,5,5,9,22
191207236,1,2,9,5,4,21
191207237,7,7,1,9,7,31
191207238,5,6,4,5,0,20
191207239,9,9,6,7,2,33
191207240,4,8,4,7,5,28
191207241,5,1,8,0,9,23
191207242,3,7,1,4,0,15
191207243,3,8,2,3,1,17
191207244,8,8,6,6,3,31
191207245,4,6,7,4,0,21
191207246,0,7,1,4,7,19
191207247,5,3,6,1,0,15
191207248,2,1,9,9,5,26
191207249,3,3,5,1,3,15
191207250,3,8,0,3,4,18
191207251,8,2,4,3,0,17
191207252,7,2,7,7,9,32
191207253,0,3,2,5,3,13
191207254,5,1,8,1,1,16
191207255,4,1,6,7,3,21
191207256,2,6,1,0,2,11
191207257,7,3,1,8,4,23
191207258,8,4,6,6,5,29
191207259,7,3,0,8,0,18
191207260,1,9,7,4,3,24
191207261,3,3,1,9,5,21
191207262,9,8,9,3,7,36
191207263,3,6,1,8,7,25
191207264,3,7,7,2,8,27
191207265,1,6,3,3,0,13
191207266,5,9,6,5,6,31
191207267,4,3,4,0,5,16
191207268,6,7,4,3,8,28
191207269,5,8,7,5,4,29
191207270,3,0,4,1,0,8
191207271,7,0,5,1,7,20
191207272,4,1,1,4,1,11
191207273,9,2,1,6,5,23
191207274,1,8,6,9,5,29
191207275,6,2,8,0,3,19
191207276,4,7,2,1,9,23
191207277,2,4,5,8,0,19
191207278,5,8,8,3,1,25
191207279,6,6,0,3,0,15
191207280,6,5,2,8,5,26
191207281,0,8,9,1,7,25
191207282,2,5,7,7,6,27
191207283,1,7,3,4,4,19
191207284,3,5,2,1,8,19
191207285,4,2,6,8,9,29
191207286,5,1,1,5,3,15
191207287,2,6,1,5,0,14
191207288,4,8,4,8,3,27
191207289,1,9,0,1,1,12
191207290,8,7,9,2,3,29
191207291,8,1,7,4,9,29
191207292,1,8,5,1,2,17
191207293,7,4,0,3,0,14
191207294,9,4,6,2,7,28
191207295,1,1,3,7,9,21
191207296,3,3,8,5,1,20
191207297,3,5,7,4,5,24
191207298,5,0,6,4,1,16
191207299,5,9,7,7,9,37
191207300,9,3,3,4,7,26
191207301,8,0,8,5,7,28
191207302,1,7,1,7,4,20
191207303,0,1,0,8,8,17
191207304,7,6,9,3,1,26
191207305,1,7,3,5,5,21
191207306,8,3,4,8,7,30
191207307,3,5,3,2,7,20
191207308,1,9,9,5,6,30
191207309,6,8,1,4,8,27
191207310,2,4,5,5,6,22
191207311,6,0,2,6,9,23
191207312,9,8,9,7,0,33
191207313,1,1,5,1,3,11
191207314,9,3,0,5,2,19
191207315,2,6,8,3,3,22
191207316,5,6,0,2,6,19
191207317,1,4,3,9,4,21
191207318,1,1,3,5,7,17
191207319,1,0,5,0,9,15
191207320,0,9,8,4,5,26
191207321,4,8,2,0,4,18
191207322,3,8,2,5,1,19
191207323,3,1,4,0,0,8
191207324,4,0,0,5,7,16
191207325,4,7,4,1,4,20
191207326,4,1,1,1,5,12
191207327,4,0,6,6,1,17
191207328,2,8,2,5,6,23
191207329,1,9,8,5,2,25
191207330,5,6,3,5,8,27
191207331,3,1,8,4,8,24
191207332,4,0,9,8,3,24
191207333,8,1,9,6,0,24
191207334,1,6,4,5,0,16
191207335,1,1,4,1,8,15
191207336,3,9,0,4,6,22
191207337,4,8,8,0,9,29
191207338,5,1,4,6,7,23
191207339,2,5,9,2,8,26
191207340,4,0,9,4,3,20
191207341,5,0,5,4,5,19
191207342,3,9,6,3,9,30
191207343,8,3,0,1,3,15
191207344,1,7,0,0,5,13
191207345,0,3,4,6,4,17
191207346,6,6,0,5,0,17
191207347,4,1,8,9,8,30
191207348,8,6,1,5,3,23
191207349,2,1,8,0,7,18
191207350,2,2,9,7,1,21
191207351,0,4,5,5,6,20
191207352,4,8,5,9,1,27
191207353,6,8,1,7,1,23
191207354,0,7,5,2,7,21
191207355,2,0,2,2,1,7
191207356,1,5,3,8,0,17
191207357,1,3,4,0,9,17
191207358,4,1,5,4,0,14
191207359,4,5,8,6,8,31
191207360,7,5,9,3,5,29
191207361,4,2,9,5,5,25
191207362,6,8,9,5,2,30
191207363,2,0,3,1,7,13
191207364,6,1,6,1,3,17
191207365,0,8,5,0,7,20
191207366,1,3,0,6,4,14
191207367,3,2,6,8,8,27
191207368,6,0,5,3,3,17
191207369,1,0,5,0,4,10
191207370,9,2,9,3,0,23
191207371,5,6,5,1,9,26
191207372,2,8,4,5,1,20
191207373,6,4,5,5,6,26
191207374,6,0,9,7,8,30
191207375,1,4,2,7,2,16
191207376,2,4,6,7,1,20
191207377,3,5,5,7,9,29
191207378,1,1,3,7,6,18
191207379,1,4,1,9,0,15
191207380,9,7,7,0,2,25
191207381,2,6,8,5,8,29
191207382,3,3,8,0,5,19
191207383,3,0,9,6,5,23
191207384,1,8,0,7,1,17
191207385,0,8,9,9,0,26
191207386,3,2,7,5,4,21
191207387,5,3,1,4,3,16
191207388,3,6,9,2,0,20
191207389,0,8,4,0,2,14
191207390,4,5,4,1,5,19
191207391,0,6,4,5,6,21
191207392,6,7,9,9,5,36
191207393,1,6,4,2,1,14
191207394,1,8,1,7,9,26
191207395,6,6,8,4,5,29
191207396,3,1,4,8,5,21
191207397,4,5,2,1,2,14
191207398,2,3,7,1,6,19
191207399,0,6,6,7,5,24
191207400,1,7,4,4,4,20
191207401,6,1,2,4,7,20
191207402,2,1,3,0,9,15
191207403,1,9,5,9,0,24
191207404,1,1,7,9,8,26
191207405,5,8,2,6,1,22
191207406,1,6,8,4,6,25
191207407,0,9,0,6,0,15
191207408,8,1,2,5,0,16
191207409,4,8,7,4,6,29
191207410,8,8,2,9,5,32
191207411,2,6,3,4,5,20
191207412,1,4,6,4,5,20
191207413,0,6,6,3,2,17
191207414,9,0,5,5,5,24
191207415,3,5,1,7,7,23
191207416,2,8,0,8,0,18
191207417,5,9,1,4,2,21
191207418,8,5,4,6,6,29
191207419,1,3,3,8,6,21
191207420,4,5,7,8,3,27
191207421,5,9,7,6,3,30
191207422,3,3,8,2,3,19
191207423,5,4,6,4,9,28
191207424,9,6,9,8,9,41
191207425,9,8,6,8,3,34
191207426,5,0,3,0,6,14
191207427,0,3,8,7,3,21
191207428,8,7,7,1,9,32
191207429,1,6,8,6,2,23
191207430,4,6,6,7,6,29
191207431,1,7,4,3,2,17
191207432,8,6,6,5,6,31
191207433,2,0,9,2,9,22
191207434,4,4,4,5,5,22
191207435,4,0,5,4,1,14
191207436,8,7,9,2,1,27
191207437,0,8,9,6,7,30
191207438,7,2,3,6,6,24
191207439,2,8,9,4,1,24
191207440,4,4,0,2,2,12
191207441,9,9,7,1,2,28
191207442,3,4,5,2,0,14
191207443,6,2,3,5,1,17
191207444,6,4,6,5,5,26
191207445,2,0,9,7,8,26
191207446,0,1,3,0,5,9
191207447,5,8,1,2,0,16
191207448,4,0,2,5,1,12
191207449,2,9,0,1,2,14
191207450,1,6,9,3,4,23
191207451,9,8,9,1,4,31
191207452,5,5,5,6,4,25
191207453,1,2,9,6,2,20
191207454,7,0,0,1,7,15
191207455,7,0,5,6,4,22
191207456,4,2,2,9,3,20
191207457,3,0,7,0,3,13
191207458,3,3,4,9,0,19
191207459,9,7,0,7,9,32
191207460,2,6,4,7,6,25
191207461,0,0,5,8,9,22
191207462,8,5,6,9,0,28
191207463,4,6,8,9,3,30
191207464,6,2,3,4,5,20
191207465,3,5,2,5,0,15
191207466,6,0,3,9,9,27
191207467,5,8,0,6,2,21
191207468,3,9,5,0,9,26
191207469,3,7,8,0,9,27
191207470,9,8,9,4,8,38
191207471,6,5,9,0,6,26
191207472,0,7,2,0,1,10
191207473,5,3,6,3,8,25
191207474,8,3,9,0,8,28
191207475,6,0,2,7,2,17
191207476,9,3,7,3,2,24
191207477,5,6,8,5,8,32
191207478,0,9,2,6,1,18
191207479,7,7,1,3,3,21
191207480,8,0,8,6,3,25
191207481,6,8,7,6,0,27
191207482,9,7,7,8,9,40
191207483,6,7,1,3,5,22
191207484,7,6,3,7,9,32
191207485,9,5,1,6,0,21
191207486,2,4,0,2,3,11
191207487,6,2,7,5,4,24
191207488,1,3,7,3,2,16
191207489,4,0,0,8,0,12
191207490,4,9,4,6,5,28
191207491,0,1,1,9,3,14
191207492,5,9,4,1,6,25
191207493,0,6,2,3,1,12
191207494,3,0,6,6,7,22
191207495,7,2,9,8,0,26
191207496,3,4,4,8,1,20
191207497,4,6,8,3,8,29
191207498,3,8,5,4,1,21
191207499,9,3,5,7,5,29
191207500,9,4,3,8,2,26
191207501,1,5,4,4,6,20
191207502,3,3,9,1,6,22
191207503,1,2,2,6,2,13
191207504,7,8,9,7,2,33
191207505,7,6,1,7,4,25
191207506,5,1,0,0,6,12
191207507,7,3,0,0,3,13
191207508,0,1,2,6,8,17
191207509,6,1,9,6,9,31
191207510,6,9,2,8,3,28
191207511,5,6,9,9,4,33
191207512,3,4,3,4,5,19
191207513,5,6,1,2,5,19
191207514,5,0,4,6,5,20
191207515,6,3,7,8,3,27
191207516,7,2,9,4,1,23
191207517,2,8,7,0,6,23
191207518,6,1,8,3,2,20
191207519,4,2,8,4,8,26
191207520,1,7,2,4,1,15
191207521,6,4,5,3,4,22
191207522,0,7,5,8,4,24
191207523,8,8,4,6,0,26
191207524,5,3,3,6,5,22
191207525,5,7,6,5,5,28
191207526,4,8,7,4,5,28
191207527,7,2,1,5,7,22
191207528,6,5,3,3,7,24
191207529,2,3,3,6,2,16
191207530,5,1,2,9,3,20
191207531,4,9,5,2,6,26
191207532,6,0,2,0,9,17
191207533,5,7,1,3,1,17
191207534,9,9,4,8,7,37
191207535,9,9,8,2,2,30
191207536,0,8,4,5,5,22
191207537,9,9,0,5,0,23
191207538,6,4,1,0,8,19
191207539,5,7,0,3,3,18
191207540,1,0,5,7,1,14
191207541,2,1,6,8,1,18
191207542,0,7,2,6,0,15
191207543,0,6,2,1,6,15
191207544,3,6,5,0,8,22
191207545,6,8,0,2,9,25
191207546,6,7,7,0,8,28
191207547,3,2,5,5,7,22
191207548,7,6,6,1,4,24
191207549,0,7,8,1,6,22
191207550,6,1,6,2,8,23
191207551,3,4,6,0,6,19
191207552,4,7,8,1,2,22
191207553,1,7,8,9,9,34
191207554,8,1,0,2,0,11
191207555,8,4,4,6,8,30
191207556,1,6,2,3,2,14
191207557,8,1,8,1,2,20
191207558,1,6,9,0,1,17
191207559,2,9,0,3,4,18
191207560,0,9,9,5,2,25
191207561,0,6,9,6,3,24
191207562,1,2,3,2,1,9
191207563,7,7,8,2,0,24
191207564,2,6,1,0,8,17
191207565,9,1,5,6,0,21
191207566,8,9,9,4,1,31
191207567,3,1,2,0,6,12
191207568,5,6,9,1,6,27
191207569,8,1,8,1,9,27
191207570,4,9,7,1,0,21
191207571,5,5,3,8,3,24
191207572,2,2,3,1,3,11
191207573,7,7,3,7,6,30
191207574,7,8,7,7,7,36
191207575,2,3,6,6,8,25
191207576,9,1,4,3,0,17
191207577,4,8,1,3,1,17
191207578,1,9,3,3,4,20
191207579,8,2,0,9,9,28
191207580,9,9,1,8,4,31
191207581,5,5,6,4,0,20
191207582,5,9,0,0,7,21
191207583,9,9,8,9,8,43
191207584,2,6,6,4,1,19
191207585,7,5,9,5,7,33
191207586,7,7,5,1,9,29
191207587,7,1,5,0,6,19
191207588,7,8,6,0,4,25
191207589,1,8,7,9,8,33
191207590,1,8,9,4,7,29
191207591,2,3,9,5,4,23
191207592,5,7,5,3,0,20
191207593,7,8,5,5,7,32
191207594,8,9,9,1,8,35
191207595,1,9,8,9,9,36
191207596,4,7,2,5,7,25
191207597,7,6,2,5,9,29
191207598,5,7,4,2,1,19
191207599,7,6,9,1,7,30
191207600,9,6,2,9,4,30
191207601,2,6,3,4,2,17
191207602,8,1,9,4,2,24
191207603,0,4,2,4,6,16
191207604,7,8,1,7,6,29
191207605,4,9,1,3,1,18
191207606,4,2,9,3,6,24
191207607,8,7,7,9,1,32
191207608,6,8,2,2,6,24
191207609,9,8,4,3,8,32
191207610,8,5,0,8,4,25
191207611,3,1,9,1,0,14
191207612,1,8,3,3,4,19
191207613,0,6,8,6,4,24
191207614,5,2,6,1,8,22
191207615,7,1,3,6,0,17
191207616,9,1,6,8,5,29
191207617,1,2,5,0,6,14
191207618,2,3,1,1,4,11
191207619,0,3,9,5,6,23
191207620,9,5,9,4,6,33
191207621,4,9,1,2,2,18
191207622,6,2,3,1,3,15
191207623,6,6,4,8,1,25
191207624,1,2,2,1,7,13
191207625,7,1,2,9,3,22
191207626,4,3,3,7,8,25
191207627,3,2,1,8,7,21
191207628,6,3,5,8,7,29
191207629,1,7,2,8,2,20
191207630,9,5,6,9,4,33
191207631,7,8,0,6,0,21
191207632,6,8,3,9,5,31
191207633,9,8,2,4,5,28
191207634,5,0,7,5,2,19
191207635,9,7,2,0,3,21
191207636,1,7,8,1,5,22
191207637,1,2,0,6,9,18
191207638,8,0,2,8,0,18
191207639,5,3,2,4,9,23
191207640,2,0,4,9,1,16
191207641,1,1,5,2,9,18
191207642,3,6,0,0,6,15
191207643,3,1,2,0,9,15
191207644,5,9,2,8,2,26
191207645,0,1,0,0,0,1
191207646,5,5,8,2,5,25
191207647,6,7,3,8,1,25
191207648,3,2,7,7,1,20
191207649,3,2,6,9,1,21
191207650,9,1,1,3,8,22
191207651,3,1,2,9,0,15
191207652,1,8,9,1,6,25
191207653,2,4,8,9,9,32
191207654,9,4,1,6,1,21
191207655,0,1,3,4,9,17
191207656,8,0,0,8,2,18
191207657,7,1,2,7,8,25
191207658,5,0,6,8,1,20
191207659,1,2,1,9,1,14
191207660,5,0,4,5,6,20
191207661,9,5,3,0,6,23
191207662,5,9,5,3,7,29
191207663,4,7,1,9,5,26
191207664,5,1,1,6,1,14
191207665,1,6,5,7,3,22
191207666,0,5,3,1,9,18
191207667,4,7,7,3,0,21
191207668,2,0,0,0,2,4
191207669,6,5,0,0,2,13
191207670,4,1,6,4,6,21
191207671,0,1,6,6,5,18
191207672,1,2,7,1,5,16
191207673,3,8,3,9,4,27
191207674,7,7,3,3,6,26
191207675,4,8,9,8,1,30
191207676,6,4,7,8,2,27
191207677,9,4,8,4,4,29
191207678,7,9,3,9,6,34
191207679,9,7,7,6,2,31
191207680,5,7,5,6,9,32
191207681,4,8,0,4,4,20
191207682,0,3,0,4,6,13
191207683,5,4,8,6,8,31
191207684,0,6,8,8,0,22
191207685,6,8,4,7,8,33
191207686,3,4,2,9,1,19
191207687,8,1,4,6,0,19
191207688,3,9,5,9,9,35
191207689,8,6,1,0,2,17
191207690,8,2,1,8,2,21
191207691,5,1,2,1,6,15
191207692,9,7,8,5,0,29
191207693,1,0,1,1,4,7
191207694,5,8,6,0,8,27
191207695,6,9,1,7,9,32
191207696,0,1,2,1,6,10
191207697,0,9,0,5,2,16
191207698,5,3,5,3,0,16
191207699,5,7,3,3,6,24
191207700,0,8,3,1,7,19
191207701,5,9,6,5,3,28
191207702,9,7,8,7,8,39
191207703,8,7,9,9,3,36
191207704,9,2,0,7,0,18
191207705,1,8,0,7,2,18
191207706,0,0,9,7,2,18
191207707,2,9,3,0,7,21
191207708,0,5,6,7,9,27
191207709,8,0,2,2,5,17
191207710,8,2,6,4,8,28
191207711,6,1,9,9,4,29
191207712,2,7,9,0,2,20
191207713,9,4,1,2,5,21
191207714,0,9,7,6,2,24
191207715,9,6,9,2,4,30
191207716,9,8,2,4,6,29
191207717,2,2,0,2,2,8
191207718,0,6,4,0,0,10
191207719,9,0,8,5,3,25
191207720,3,2,7,9,7,28
191207721,6,6,4,3,8,27
191207722,3,7,5,0,6,21
191207723,2,1,3,4,1,11
191207724,2,3,0,4,7,16
191207725,7,9,1,1,0,18
191207726,4,0,1,9,6,20
191207727,6,6,6,0,9,27
191207728,1,9,1,2,2,15
191207729,1,6,8,2,3,20
191207730,6,6,4,5,5,26
191207731,6,1,2,1,1,11
191207732,6,6,7,6,9,34
191207733,2,3,4,8,4,21
191207734,6,8,2,1,8,25
191207735,7,9,8,4,5,33
191207736,9,7,1,8,8,33
191207737,6,0,9,0,6,21
191207738,6,7,3,8,6,30
191207739,6,1,4,4,4,19
191207740,3,9,4,2,2,20
191207741,3,3,3,3,4,16
191207742,6,3,1,0,5,15
191207743,2,2,1,1,3,9
191207744,7,4,4,1,4,20
191207745,6,3,1,7,8,25
191207746,2,3,0,0,2,7
191207747,9,4,9,9,8,39
191207748,0,6,9,8,0,23
191207749,3,4,6,7,5,25
191207750,5,1,6,4,2,18
191207751,9,2,4,2,2,19
191207752,0,4,7,6,5,22
191207753,6,3,8,2,6,25
191207754,5,2,1,8,3,19
191207755,7,6,7,1,8,29
191207756,8,3,8,4,5,28
191207757,0,3,6,3,5,17
191207758,9,4,8,2,4,27
191207759,2,7,3,5,3,20
191207760,7,2,1,9,9,28
191207761,1,6,7,8,2,24
191207762,5,2,7,8,1,23
191207763,3,8,5,2,7,25
191207764,4,5,6,4,7,26
191207765,3,6,6,7,5,27
191207766,0,6,6,4,5,21
191207767,3,3,5,6,1,18
191207768,9,1,2,3,7,22
191207769,5,7,8,2,7,29
191207770,2,1,9,4,6,22
191207771,1,6,0,3,3,13
191207772,1,8,6,8,2,25
191207773,1,4,5,2,9,21
191207774,4,9,9,3,4,29
191207775,9,4,2,3,0,18
191207776,0,5,1,0,8,14
191207777,3,2,8,1,3,17
191207778,7,4,8,5,8,32
191207779,2,0,7,7,9,25
191207780,5,0,6,1,6,18
191207781,7,4,7,3,1,22
191207782,1,4,1,1,4,11
191207783,5,8,6,3,4,26
191207784,3,5,8,8,9,33
191207785,3,0,8,8,3,22
191207786,5,2,7,3,2,19
191207787,9,3,8,9,5,34
191207788,0,8,5,5,6,24
191207789,7,1,4,3,0,15
191207790,5,5,7,2,5,24
191207791,9,6,5,2,4,26
191207792,7,6,8,2,9,32
191207793,7,4,6,4,3,24
191207794,1,0,8,7,0,16
191207795,5,1,4,0,9,19
191207796,0,4,9,8,3,24
191207797,3,7,7,3,9,29
191207798,3,0,4,4,5,16
191207799,4,8,6,3,8,29
191207800,3,4,1,3,9,20
191207801,6,7,7,0,5,25
191207802,7,9,7,1,2,26
191207803,5,5,1,8,5,24
191207804,4,5,8,9,5,31
191207805,1,5,1,9,2,18
191207806,2,0,4,4,6,16
191207807,5,9,8,3,4,29
191207808,7,3,5,9,4,28
191207809,9,6,2,4,1,22
191207810,5,2,3,2,1,13
191207811,3,8,0,3,5,19
191207812,6,0,1,7,8,22
191207813,7,0,0,2,9,18
191207814,2,3,9,1,4,19
191207815,5,4,6,5,0,20
191207816,8,9,4,1,8,30
191207817,4,1,0,9,6,20
191207818,9,0,1,4,7,21
191207819,1,3,6,3,0,13
191207820,5,8,6,3,2,24
191207821,8,0,2,4,8,22
191207822,1,0,5,2,0,8
191207823,0,1,0,8,3,12
191207824,4,2,0,5,6,17
191207825,7,5,0,6,1,19
191207826,2,9,0,3,2,16
191207827,6,5,0,5,5,21
191207828,7,1,0,3,9,20
191207829,7,3,1,3,2,16
191207830,1,6,2,9,6,24
191207831,9,8,7,9,3,36
191207832,4,2,3,4,3,16
191207833,0,1,7,9,7,24
191207834,9,3,0,1,2,15
191207835,5,5,5,3,4,22
191207836,0,6,1,2,7,16
191207837,1,6,3,8,1,19
191207838,2,2,4,8,1,17
191207839,6,2,8,9,6,31
191207840,0,3,2,1,1,7
191207841,5,4,8,6,1,24
191207842,1,8,4,0,9,22
191207843,0,6,8,2,3,19
191207844,2,4,5,4,5,20
191207845,5,7,2,1,1,16
191207846,3,2,5,1,8,19
191207847,4,9,8,0,7,28
191207848,4,3,4,0,2,13
191207849,8,8,6,5,1,28
191207850,7,8,4,6,0,25
191207851,1,5,3,1,3,13
191207852,2,0,1,8,2,13
191207853,5,9,3,5,7,29
191207854,5,4,5,4,8,26
191207855,5,0,6,3,4,18
191207856,5,7,1,3,2,18
191207857,6,0,5,9,2,22
191207858,7,5,1,2,2,17
191207859,9,9,8,4,7,37
191207860,0,0,7,5,0,12
191207861,8,7,6,6,3,30
191207862,7,9,4,5,3,28
191207863,4,5,9,0,0,18
191207864,2,7,0,6,8,23
191207865,9,8,1,3,5,26
191207866,6,1,5,3,0,15
191207867,2,8,4,0,3,17
191207868,2,4,0,6,6,18
191207869,0,1,4,7,0,12
191207870,6,8,8,3,6,31
191207871,5,2,8,4,0,19
191207872,8,0,0,2,6,16
191207873,7,0,2,5,3,17
191207874,8,6,0,1,5,20
191207875,5,9,3,0,0,17
191207876,0,1,8,4,1,14
191207877,1,4,2,9,1,17
191207878,4,4,4,8,2,22
191207879,6,9,1,5,2,23
191207880,3,9,9,4,2,27
191207881,9,7,0,9,6,31
191207882,4,8,7,7,3,29
191207883,5,8,3,7,5,28
191207884,5,4,5,9,8,31
191207885,8,5,6,5,5,29
191207886,4,2,0,6,1,13
191207887,5,0,8,3,1,17
191207888,3,0,8,1,7,19
191207889,1,5,0,6,1,13
191207890,0,4,0,5,4,13
191207891,6,7,9,7,8,37
191207892,3,7,2,1,1,14
191207893,8,4,6,8,0,26
191207894,2,4,5,3,4,18
191207895,3,7,1,4,8,23
191207896,1,3,0,7,3,14
191207897,2,4,7,7,0,20
191207898,4,3,6,7,8,28
191207899,5,9,4,6,7,31
191207900,1,0,1,7,8,17
191207901,0,4,2,3,2,11
191207902,0,5,0,9,9,23
191207903,8,7,5,8,0,28
191207904,2,2,9,5,1,19
191207905,2,3,8,7,2,22
191207906,5,8,3,5,2,23
191207907,8,1,6,4,6,25
191207908,2,8,3,2,4,19
191207909,9,5,8,3,5,30
191207910,3,1,5,3,4,16
191207911,6,5,9,0,5,25
191207912,5,2,1,3,8,19
191207913,3,0,4,8,0,15
191207914,4,4,2,7,9,26
191207915,3,9,6,7,6,31
191207916,5,4,7,2,4,22
191207917,7,5,4,4,4,24
191207918,3,0,3,8,6,20
191207919,7,8,8,1,7,31
191207920,8,7,8,2,9,34
191207921,8,6,3,7,0,24
191207922,9,0,7,7,5,28
191207923,4,8,1,0,2,15
191207924,3,4,9,8,6,30
191207925,4,6,7,2,0,19
191207926,2,9,4,7,8,30
191207927,9,9,9,4,5,36
191207928,1,2,3,0,2,8
191207929,5,9,0,7,4,25
191207930,5,3,9,9,7,33
191207931,4,7,5,5,4,25
191207932,9,0,6,5,2,22
191207933,9,8,8,5,2,32
191207934,9,0,2,2,1,14
191207935,5,1,1,7,3,17
191207936,3,8,6,1,4,22
191207937,8,9,2,4,4,27
191207938,3,6,1,0,3,13
191207939,1,5,4,6,9,25
191207940,8,2,0,4,4,18
191207941,6,7,7,2,3,25
191207942,7,6,1,1,9,24
191207943,1,3,1,2,9,16
191207944,9,0,1,7,5,22
191207945,6,6,7,1,7,27
191207946,2,6,2,3,4,17
191207947,2,7,2,1,9,21
191207948,1,5,3,8,8,25
191207949,4,6,7,2,9,28
191207950,0,4,3,8,8,23
191207951,3,2,3,6,3,17
191207952,4,5,0,4,7,20
191207953,1,3,4,9,5,22
191207954,3,7,7,7,9,33
191207955,1,5,7,7,4,24
191207956,3,3,5,6,6,23
191207957,7,7,3,6,9,32
191207958,0,2,2,5,8,17
191207959,9,3,2,2,5,21
191207960,2,4,0,0,8,14
191207961,6,8,5,1,2,22
191207962,6,4,4,4,1,19
191207963,2,5,5,3,2,17
191207964,8,4,4,6,2,24
191207965,0,6,7,8,4,25
191207966,0,6,6,2,0,14
191207967,9,1,8,7,2,27
191207968,5,0,2,8,0,15
191207969,1,3,3,9,2,18
191207970,1,9,7,1,4,22
191207971,7,3,5,5,0,20
191207972,7,0,9,4,0,20
191207973,1,1,6,3,9,20
191207974,3,0,0,6,5,14
191207975,1,1,7,4,0,13
191207976,5,3,8,3,9,28
191207977,5,0,8,9,2,24
191207978,9,8,7,8,7,39
191207979,6,0,1,9,1,17
191207980,3,6,9,7,2,27
191207981,6,6,7,8,0,27
191207982,8,0,2,7,6,23
191207983,7,6,4,5,3,25
191207984,9,7,7,3,8,34
191207985,2,4,1,7,2,16
191207986,8,6,8,4,4,30
191207987,1,9,7,5,7,29
191207988,7,8,1,0,1,17
191207989,6,9,7,9,4,35
191207990,7,3,9,3,3,25
191207991,9,4,5,0,1,19
191207992,0,0,0,9,7,16
191207993,9,6,8,1,3,27
191207994,4,6,0,1,9,20
191207995,1,4,0,5,7,17
191207996,0,6,7,5,5,23
191207997,4,2,9,8,9,32
191207998,2,9,1,2,0,14
191207999,9,7,5,0,6,27
1912071000,8,3,2,7,7,27
1912071001,9,4,2,0,8,23
1912071002,4,3,7,6,1,21
1912071003,9,0,3,9,0,21
1912071004,3,3,4,6,3,19
1912071005,4,6,1,3,3,17
1912071006,5,6,9,7,9,36
1912071007,1,8,2,6,3,20
1912071008,1,8,7,6,8,30
1912071009,9,9,0,5,8,31
1912071010,3,0,3,4,5,15
1912071011,6,4,7,6,3,26
1912071012,5,2,1,1,7,16
1912071013,7,1,9,9,6,32
1912071014,9,5,4,0,1,19
1912071015,9,8,5,3,6,31
1912071016,4,8,2,6,9,29
1912071017,3,8,4,9,7,31
1912071018,9,2,3,7,9,30
1912071019,8,7,3,1,1,20
1912071020,6,0,5,9,7,27
1912071021,9,2,7,4,0,22
1912071022,3,3,4,2,0,12
1912071023,6,1,3,7,4,21
1912071024,4,8,4,0,5,21
1912071025,0,1,0,1,5,7
1912071026,9,3,6,0,6,24
1912071027,5,3,1,2,3,14
1912071028,1,5,0,4,5,15
1912071029,6,8,6,7,2,29
1912071030,3,1,3,2,6,15
1912071031,4,8,9,7,4,32
1912071032,9,8,8,8,6,39
1912071033,0,2,7,5,3,17
1912071034,0,2,5,2,0,9
1912071035,6,2,3,3,3,17
1912071036,1,4,2,3,6,16
1912071037,9,8,7,1,0,25
1912071038,3,7,7,4,3,24
1912071039,4,7,5,4,0,20
1912071040,8,1,4,4,9,26
1912071041,3,5,3,6,0,17
1912071042,8,9,3,2,7,29
1912071043,5,5,9,7,8,34
1912071044,0,1,4,1,4,10
1912071045,1,0,3,1,3,8
1912071046,2,2,3,5,7,19
1912071047,4,7,0,4,7,22
1912071048,7,9,1,7,9,33
1912071049,7,3,6,5,9,30
1912071050,5,7,4,3,4,23
1912071051,1,0,4,5,0,10
1912071052,2,6,1,9,1,19
1912071053,6,6,7,2,6,27
1912071054,1,0,5,1,9,16
1912071055,1,7,1,6,8,23
1912071056,4,3,7,4,2,20
1912071057,1,2,7,7,7,24
1912071058,0,6,2,9,1,18
1912071059,5,0,8,3,8,24
1912071060,1,0,5,3,7,16
1912071061,2,5,8,6,4,25
1912071062,2,8,8,2,2,22
1912071063,9,8,8,8,5,38
1912071064,8,1,5,7,6,27
1912071065,3,1,6,3,5,18
1912071066,5,4,4,8,0,21
1912071067,5,5,4,9,9,32
1912071068,3,7,0,2,7,19
1912071069,7,4,5,5,1,22
1912071070,2,1,3,5,5,16
1912071071,6,6,7,2,7,28
1912071072,4,3,7,9,1,24
1912071073,6,9,2,5,6,28
1912071074,8,6,1,7,3,25
1912071075,5,4,0,1,6,16
1912071076,8,5,9,2,4,28
1912071077,8,5,7,0,8,28
1912071078,1,5,0,8,7,21
1912071079,9,9,1,5,8,32
1912071080,6,2,2,1,0,11
1912071081,7,5,9,4,9,34
1912071082,6,2,9,3,4,24
1912071083,3,9,8,7,1,28
1912071084,9,1,8,4,7,29
1912071085,8,3,3,0,6,20
1912071086,8,3,1,6,2,20
1912071087,5,4,5,0,4,18
1912071088,7,2,5,3,9,26
1912071089,5,9,6,7,4,31
1912071090,7,2,0,9,1,19
1912071091,5,0,1,1,1,8
1912071092,3,9,1,4,6,23
1912071093,7,1,9,6,8,31
1912071094,0,9,4,9,5,27
1912071095,4,8,0,8,8,28
1912071096,2,0,6,1,7,16
1912071097,8,2,0,8,9,27
1912071098,6,2,5,9,2,24
1912071099,4,3,0,7,2,16
1912071100,1,1,9,8,1,20
1912071101,6,5,0,7,8,26
1912071102,2,3,4,2,4,15
1912071103,7,6,4,6,8,31
1912071104,5,8,4,9,5,31
1912071105,8,3,4,2,1,18
191208001,7,5,1,3,8,24
191208002,7,1,3,6,6,23
191208003,9,1,2,7,7,26
191208004,4,4,3,5,0,16
191208005,1,6,6,7,9,29
191208006,9,8,4,5,5,31
191208007,1,5,4,3,1,14
191208008,3,3,8,5,5,24
191208009,8,7,2,7,3,27
191208010,4,8,3,6,6,27
191208011,8,6,7,8,9,38
191208012,3,1,0,9,7,20
191208013,6,5,0,4,5,20
191208014,0,2,4,1,8,15
191208015,5,5,3,2,6,21
191208016,2,5,5,1,9,22
191208017,2,6,7,5,1,21
191208018,2,4,8,8,2,24
191208019,8,2,6,8,0,24
191208020,2,0,9,0,2,13
191208021,6,7,8,9,3,33
191208022,5,7,2,3,7,24
191208023,7,0,1,2,2,12
191208024,2,4,2,3,8,19
191208025,0,0,8,8,5,21
191208026,6,6,4,1,6,23
191208027,6,1,2,2,4,15
191208028,9,7,9,7,7,39
191208029,7,7,0,2,5,21
191208030,9,3,8,7,9,36
191208031,3,2,6,6,8,25
191208032,1,8,7,2,3,21
191208033,7,1,6,4,5,23
191208034,9,0,3,1,0,13
191208035,1,6,5,1,0,13
191208036,8,3,1,3,4,19
191208037,5,3,4,1,5,18
191208038,2,5,6,5,9,27
191208039,5,0,2,2,1,10
191208040,5,2,8,7,7,29
191208041,6,2,0,6,3,17
191208042,1,2,5,8,4,20
191208043,6,9,4,4,5,28
191208044,8,4,1,0,9,22
191208045,6,0,2,2,2,12
191208046,7,0,3,9,8,27
191208047,7,1,6,5,6,25
191208048,4,3,3,7,9,26
191208049,5,6,3,2,4,20
191208050,7,1,3,8,6,25
191208051,1,5,5,7,9,27
191208052,5,4,2,1,6,18
191208053,6,6,4,5,2,23
191208054,7,2,4,8,0,21
191208055,4,1,1,8,5,19
191208056,5,6,7,6,2,26
191208057,5,0,7,5,9,26
191208058,1,6,0,1,7,15
191208059,4,2,6,0,3,15
191208060,4,1,5,6,0,16
191208061,5,0,4,6,9,24
191208062,0,8,8,5,3,24
191208063,4,7,4,1,7,23
191208064,0,8,3,5,5,21
191208065,1,6,1,7,5,20
191208066,6,3,7,2,0,18
191208067,5,8,0,3,2,18
191208068,9,3,6,7,2,27
191208069,3,9,2,8,5,27
191208070,4,6,4,5,1,20
191208071,3,0,1,3,4,11
191208072,3,0,1,1,4,9
191208073,4,9,0,1,5,19
191208074,4,8,8,0,1,21
191208075,6,1,9,6,8,30
191208076,0,9,0,1,8,18
191208077,0,5,8,8,9,30
191208078,3,6,1,8,5,23
191208079,2,6,0,9,9,26
191208080,7,5,7,9,2,30
191208081,7,5,8,0,1,21
191208082,6,1,5,9,5,26
191208083,0,4,1,4,9,18
191208084,1,0,3,3,7,14
191208085,8,0,2,8,8,26
191208086,4,2,6,3,5,20
191208087,0,8,1,2,4,15
191208088,0,9,0,3,4,16
191208089,0,8,4,9,9,30
191208090,6,8,5,8,2,29
191208091,8,2,8,2,0,20
191208092,7,5,3,1,5,21
191208093,0,5,7,3,9,24
191208094,3,6,9,8,3,29
191208095,6,3,6,5,3,23
191208096,4,5,4,2,6,21
191208097,7,0,8,0,5,20
191208098,0,7,4,7,7,25
191208099,6,6,7,5,4,28
191208100,5,5,3,5,4,22
191208101,1,5,8,4,4,22
191208102,9,0,5,7,8,29
191208103,9,3,7,7,2,28
191208104,5,5,8,9,0,27
191208105,5,7,0,6,0,18
191208106,4,0,6,6,0,16
191208107,3,5,5,1,1,15
191208108,0,5,4,5,8,22
191208109,6,8,1,1,4,20
191208110,6,3,3,0,7,19
191208111,2,9,9,8,6,34
191208112,4,5,4,1,0,14
191208113,7,3,5,1,0,16
191208114,6,3,1,9,4,23
191208115,0,7,6,3,3,19
191208116,7,0,3,0,2,12
191208117,2,7,5,5,8,27
191208118,1,8,4,8,8,29
191208119,8,7,6,6,4,31
191208120,7,0,9,2,2,20
191208121,7,0,3,9,6,25
191208122,9,6,6,4,7,32
191208123,9,6,8,5,5,33
191208124,8,2,6,6,0,22
191208125,5,3,4,6,0,18
191208126,6,8,6,0,2,22
191208127,9,1,3,2,4,19
191208128,8,7,9,2,9,35
191208129,1,8,7,6,6,28
191208130,7,4,1,1,3,16
191208131,4,4,8,8,1,25
191208132,5,9,0,3,5,22
191208133,8,1,5,9,0,23
191208134,2,0,3,8,3,16
191208135,9,9,3,5,7,33
191208136,8,3,6,8,0,25
191208137,8,8,3,7,5,31
191208138,2,7,9,5,8,31
191208139,3,8,3,4,4,22
191208140,8,7,8,2,8,33
191208141,9,5,6,2,5,27
191208142,4,0,6,4,0,14
191208143,2,1,5,9,6,23
191208144,7,8,7,7,4,33
191208145,5,4,4,1,6,20
191208146,6,0,9,0,0,15
191208147,1,7,3,2,6,19
191208148,5,4,6,9,7,31
191208149,1,8,1,3,8,21
191208150,5,1,3,6,9,24
191208151,6,6,9,1,5,27
191208152,7,4,4,5,6,26
191208153,4,9,3,5,1,22
191208154,4,0,0,9,1,14
191208155,9,8,4,5,7,33
191208156,1,6,5,3,5,20
191208157,1,6,1,4,2,14
191208158,2,1,9,9,9,30
191208159,8,0,8,3,8,27
191208160,3,0,0,9,0,12
191208161,2,4,0,7,9,22
191208162,3,4,4,9,9,29
191208163,7,2,1,0,3,13
191208164,5,3,4,3,9,24
191208165,8,4,3,6,1,22
191208166,0,8,6,5,8,27
191208167,2,4,6,2,0,14
191208168,4,8,1,9,9,31
191208169,8,7,7,1,6,29
191208170,7,2,5,2,4,20
191208171,0,4,4,0,1,9
191208172,2,5,9,8,2,26
191208173,8,9,6,8,0,31
191208174,2,7,9,2,9,29
191208175,0,7,3,9,8,27
191208176,2,6,2,8,1,19
191208177,3,1,0,2,6,12
191208178,9,3,1,3,1,17
191208179,0,5,3,3,5,16
191208180,8,4,2,9,1,24
191208181,8,7,6,6,6,33
191208182,5,8,1,4,8,26
191208183,5,1,8,0,1,15
191208184,7,2,3,5,2,19
191208185,2,7,2,3,7,21
191208186,8,2,0,9,5,24
191208187,4,2,1,2,0,9
191208188,2,7,4,8,1,22
191208189,4,2,1,1,8,16
191208190,9,0,0,7,8,24
191208191,2,2,6,9,6,25
191208192,6,7,2,5,8,28
191208193,8,2,8,3,7,28
191208194,9,3,8,2,1,23
191208195,1,8,6,0,9,24
191208196,2,0,5,5,5,17
191208197,6,3,1,6,8,24
191208198,1,8,5,9,5,28
191208199,9,7,6,5,0,27
191208200,4,0,7,4,5,20
191208201,4,2,6,2,9,23
191208202,7,2,1,4,5,19
191208203,6,8,1,6,0,21
191208204,7,0,3,6,5,21
191208205,6,9,4,4,8,31
191208206,6,0,4,5,7,22
191208207,1,5,6,3,7,22
191208208,2,8,6,9,6,31
191208209,6,8,3,8,9,34
191208210,0,7,3,5,7,22
191208211,4,1,0,8,8,21
191208212,9,7,6,7,5,34
191208213,1,7,1,7,5,21
191208214,1,1,5,7,9,23
191208215,8,6,1,1,6,22
191208216,1,0,6,6,5,18
191208217,5,1,8,5,7,26
191208218,2,3,3,2,1,11
191208219,6,7,2,7,2,24
191208220,6,1,7,8,8,30
191208221,1,5,8,0,2,16
191208222,1,8,1,5,9,24
191208223,4,2,3,9,3,21
191208224,9,7,1,4,6,27
191208225,3,2,3,6,6,20
191208226,3,2,9,4,9,27
191208227,0,7,2,6,2,17
191208228,1,4,7,2,1,15
191208229,7,2,0,1,6,16
191208230,6,6,0,7,7,26
191208231,4,4,8,3,8,27
191208232,5,8,4,1,0,18
191208233,8,9,0,3,4,24
191208234,7,3,9,0,5,24
191208235,1,1,0,6,7,15
191208236,5,0,4,9,0,18
191208237,4,2,1,6,6,19
191208238,8,2,4,2,3,19
191208239,8,4,4,6,4,26
191208240,2,6,4,5,1,18
191208241,4,7,9,3,0,23
191208242,2,2,4,0,6,14
191208243,1,3,4,3,4,15
191208244,5,5,0,5,0,15
191208245,1,5,0,0,1,7
191208246,5,1,8,5,6,25
191208247,8,0,8,2,1,19
191208248,7,0,4,5,4,20
191208249,0,7,7,1,9,24
191208250,1,7,3,8,5,24
191208251,1,9,4,9,3,26
191208252,7,2,2,7,2,20
191208253,3,4,6,9,4,26
191208254,8,2,6,5,7,28
191208255,4,6,0,0,2,12
191208256,4,0,3,6,9,22
191208257,7,6,4,0,9,26
191208258,5,7,4,4,8,28
191208259,3,2,6,2,1,14
191208260,3,8,2,4,1,18
191208261,1,4,0,8,4,17
191208262,7,3,4,6,8,28
191208263,7,9,8,1,5,30
191208264,4,8,0,7,1,20
191208265,9,8,8,6,3,34
191208266,2,5,9,3,2,21
191208267,7,2,8,6,6,29
191208268,3,0,4,5,3,15
191208269,3,2,9,1,1,16
191208270,5,4,1,9,8,27
191208271,2,2,5,0,0,9
191208272,8,4,5,7,1,25
191208273,7,1,0,8,3,19
191208274,6,8,4,2,9,29
191208275,3,3,6,1,0,13
191208276,7,7,3,6,5,28
191208277,5,7,8,8,8,36
191208278,8,0,1,0,4,13
191208279,9,7,5,3,4,28
191208280,0,1,2,4,7,14
191208281,2,8,3,9,2,24
191208282,5,7,9,6,7,34
191208283,4,5,1,5,5,20
191208284,9,1,5,7,1,23
191208285,0,9,0,2,9,20
191208286,7,3,3,1,5,19
191208287,3,4,8,4,4,23
191208288,3,0,1,2,1,7
191208289,8,1,1,5,4,19
191208290,7,9,8,5,6,35
191208291,1,9,0,2,3,15
191208292,1,4,8,9,5,27
191208293,4,0,0,2,8,14
191208294,6,7,3,2,0,18
191208295,2,9,0,8,4,23
191208296,7,4,8,1,3,23
191208297,5,9,1,4,7,26
191208298,7,9,1,6,0,23
191208299,1,0,7,7,1,16
191208300,7,3,8,0,3,21
191208301,8,0,8,2,2,20
191208302,3,9,2,0,2,16
191208303,2,2,3,7,0,14
191208304,2,7,5,7,3,24
191208305,3,0,8,1,5,17
191208306,9,5,3,9,2,28
191208307,7,0,2,8,4,21
191208308,5,7,4,6,4,26
191208309,1,1,6,6,1,15
191208310,4,7,6,9,7,33
191208311,5,8,2,2,7,24
191208312,5,2,1,5,4,17
191208313,1,0,9,3,3,16
191208314,8,1,3,5,1,18
191208315,8,6,8,0,0,22
191208316,3,1,2,1,2,9
191208317,7,4,7,5,2,25
191208318,9,7,6,1,8,31
191208319,5,0,5,9,3,22
191208320,7,7,5,0,8,27
191208321,5,9,5,0,1,20
191208322,9,1,3,8,4,25
191208323,9,6,6,8,4,33
191208324,3,3,2,3,4,15
191208325,1,2,9,1,1,14
191208326,6,1,9,4,5,25
191208327,7,1,5,5,3,21
191208328,9,3,3,0,6,21
191208329,2,7,8,9,4,30
191208330,4,3,4,5,7,23
191208331,7,1,1,9,3,21
191208332,6,3,6,8,9,32
191208333,8,0,9,5,2,24
191208334,6,8,2,1,4,21
191208335,9,5,8,1,1,24
191208336,1,6,9,2,8,26
191208337,9,2,0,6,1,18
191208338,2,0,2,7,2,13
191208339,0,7,0,9,1,17
191208340,0,5,1,6,4,16
191208341,0,5,1,4,6,16
191208342,7,0,3,1,4,15
191208343,7,1,0,6,6,20
191208344,6,3,1,6,0,16
191208345,9,7,5,0,9,30
191208346,2,9,9,2,9,31
191208347,0,6,8,7,2,23
191208348,8,6,2,2,2,20
191208349,6,1,8,5,9,29
191208350,1,9,8,9,8,35
191208351,4,7,1,3,0,15
191208352,2,2,2,7,6,19
191208353,2,8,1,2,7,20
191208354,1,7,6,6,9,29
191208355,1,3,6,4,1,15
191208356,7,6,7,5,2,27
191208357,0,9,8,1,7,25
191208358,9,6,5,5,6,31
191208359,0,0,0,0,0,0
191208360,6,3,8,5,9,31
191208361,5,3,3,0,2,13
191208362,1,3,1,2,4,11
191208363,3,8,5,0,9,25
191208364,7,9,4,6,1,27
191208365,5,3,0,7,6,21
191208366,7,1,6,5,5,24
191208367,9,9,4,6,1,29
191208368,7,1,7,7,5,27
191208369,0,3,8,1,0,12
191208370,4,6,2,3,8,23
191208371,4,1,9,6,9,29
191208372,7,7,6,5,7,32
191208373,9,3,9,2,4,27
191208374,7,0,7,2,7,23
191208375,5,9,0,4,1,19
191208376,7,3,4,9,8,31
191208377,1,0,1,2,8,12
191208378,3,1,6,4,0,14
191208379,8,7,3,0,3,21
191208380,7,9,0,0,1,17
191208381,4,4,4,7,9,28
191208382,5,9,5,0,7,26
191208383,0,7,3,7,9,26
191208384,4,8,6,8,5,31
191208385,1,3,8,7,6,25
191208386,8,9,6,8,1,32
191208387,1,6,1,6,5,19
191208388,4,5,4,6,1,20
191208389,5,1,2,1,4,13
191208390,1,1,4,0,4,10
191208391,3,9,3,5,6,26
191208392,5,8,1,8,5,27
191208393,3,7,3,0,5,18
191208394,0,5,9,8,1,23
191208395,0,8,9,1,3,21
191208396,2,8,8,8,6,32
191208397,8,4,0,1,1,14
191208398,2,0,0,7,2,11
191208399,2,7,1,0,7,17
191208400,7,9,7,4,5,32
191208401,4,8,4,2,7,25
191208402,8,2,0,0,4,14
191208403,2,9,1,4,6,22
191208404,9,7,3,5,5,29
191208405,1,9,9,2,1,22
191208406,8,6,7,2,6,29
191208407,8,0,1,7,3,19
191208408,1,9,6,0,7,23
191208409,7,7,9,3,1,27
191208410,0,7,7,6,6,26
191208411,8,8,3,9,4,32
191208412,2,8,0,6,4,20
191208413,8,7,3,6,6,30
191208414,3,1,0,2,0,6
191208415,0,9,4,4,8,25
191208416,6,1,8,1,4,20
191208417,7,3,3,6,2,21
191208418,9,4,0,0,0,13
191208419,5,9,3,5,1,23
191208420,0,2,8,4,2,16
191208421,3,6,9,3,1,22
191208422,0,2,9,2,0,13
191208423,9,1,1,7,9,27
191208424,0,7,3,5,2,17
191208425,5,9,6,6,5,31
191208426,1,7,9,5,4,26
191208427,4,5,8,9,1,27
191208428,4,3,1,2,9,19
191208429,8,5,4,2,2,21
191208430,9,0,8,5,9,31
191208431,5,9,7,2,9,32
191208432,1,8,9,6,0,24
191208433,8,9,4,2,6,29
191208434,7,6,0,9,0,22
191208435,6,7,7,0,0,20
191208436,0,3,7,0,3,13
191208437,1,2,8,2,3,16
191208438,7,5,2,9,5,28
191208439,6,5,2,2,6,21
191208440,1,5,7,0,0,13
191208441,1,5,9,2,7,24
191208442,8,9,7,1,2,27
191208443,7,9,5,7,4,32
191208444,5,9,8,0,9,31
191208445,0,2,1,4,3,10
191208446,9,7,4,0,7,27
191208447,3,8,1,1,3,16
191208448,1,1,0,5,7,14
191208449,5,4,2,5,4,20
191208450,4,5,7,0,5,21
191208451,8,5,8,2,6,29
191208452,5,7,4,3,1,20
191208453,9,3,6,1,9,28
191208454,7,3,1,5,4,20
191208455,7,2,5,0,6,20
191208456,4,3,4,1,8,20
191208457,6,6,6,6,1,25
191208458,6,2,5,1,0,14
191208459,8,0,8,3,7,26
191208460,7,2,0,7,0,16
191208461,0,1,0,7,1,9
191208462,1,8,9,3,9,30
191208463,7,6,4,7,5,29
191208464,2,3,5,6,4,20
191208465,8,2,3,3,7,23
191208466,2,6,2,7,8,25
191208467,1,8,4,2,5,20
191208468,8,0,8,0,3,19
191208469,6,2,0,5,4,17
191208470,0,8,7,3,8,26
191208471,5,6,7,1,7,26
191208472,0,4,0,3,0,7
191208473,1,4,7,2,3,17
191208474,9,7,4,5,1,26
191208475,7,5,6,1,1,20
191208476,7,5,2,5,4,23
191208477,7,2,7,9,8,33
191208478,2,8,2,4,5,21
191208479,5,7,2,5,4,23
191208480,6,3,1,0,6,16
191208481,0,4,5,4,9,22
191208482,9,1,2,3,3,18
191208483,3,6,8,4,7,28
191208484,5,2,3,4,5,19
191208485,1,9,6,7,3,26
191208486,1,5,6,0,1,13
191208487,4,9,6,6,5,30
191208488,3,3,7,6,9,28
191208489,8,4,9,2,2,25
191208490,1,6,0,2,1,10
191208491,4,1,5,9,8,27
191208492,7,8,5,2,7,29
191208493,9,9,1,6,2,27
191208494,5,9,7,7,5,33
191208495,2,9,5,8,0,24
191208496,9,1,2,5,8,25
191208497,8,7,6,4,6,31
191208498,9,3,8,5,3,28
191208499,1,3,6,1,1,12
191208500,2,4,5,0,8,19
191208501,8,2,3,8,6,27
191208502,5,9,7,9,9,39
191208503,0,2,8,4,6,20
191208504,7,2,5,0,4,18
191208505,0,0,7,8,5,20
191208506,4,0,9,9,4,26
191208507,8,4,2,7,6,27
191208508,7,8,6,6,7,34
191208509,6,1,4,5,8,24
191208510,5,2,7,5,9,28
191208511,9,1,2,0,8,20
191208512,1,9,9,6,2,27
191208513,0,2,0,1,4,7
191208514,5,8,8,0,0,21
191208515,0,0,3,7,1,11
191208516,3,9,3,3,8,26
191208517,0,5,0,3,8,16
191208518,9,4,0,2,9,24
191208519,3,1,1,5,9,19
191208520,9,1,9,0,3,22
191208521,0,4,4,5,3,16
191208522,1,1,7,7,2,18
191208523,7,2,5,4,1,19
191208524,3,6,7,0,0,16
191208525,7,9,8,3,5,32
191208526,3,9,1,7,0,20
191208527,2,3,4,8,7,24
191208528,9,1,2,3,1,16
191208529,2,7,2,7,5,23
191208530,9,6,7,2,5,29
191208531,7,7,2,3,0,19
191208532,9,1,0,0,6,16
191208533,6,6,0,1,6,19
191208534,1,1,8,5,5,20
191208535,4,2,4,4,3,17
191208536,1,4,8,9,3,25
191208537,8,7,0,1,7,23
191208538,2,3,6,1,5,17
191208539,4,7,1,0,2,14
191208540,1,9,5,1,7,23
191208541,6,3,9,8,8,34
191208542,1,2,5,0,8,16
191208543,0,6,2,6,9,23
191208544,3,0,1,1,8,13
191208545,0,6,7,3,7,23
191208546,9,8,4,7,5,33
191208547,1,5,9,9,3,27
191208548,6,9,7,6,0,28
191208549,7,9,4,4,5,29
191208550,1,9,0,2,9,21
191208551,3,6,6,1,2,18
191208552,0,2,4,3,9,18
191208553,0,1,4,3,3,11
191208554,6,4,3,6,9,28
191208555,7,9,2,8,0,26
191208556,7,8,2,1,6,24
191208557,0,3,6,1,6,16
191208558,6,0,8,4,1,19
191208559,8,3,4,4,4,23
191208560,9,5,2,7,0,23
191208561,4,7,8,3,0,22
191208562,4,4,5,2,8,23
191208563,4,3,5,3,2,17
191208564,7,1,6,6,3,23
191208565,6,0,5,5,9,25
191208566,2,6,3,3,8,22
191208567,8,7,7,8,8,38
191208568,6,6,5,4,1,22
191208569,4,1,3,9,3,20
191208570,0,6,5,9,7,27
191208571,5,1,4,2,8,20
191208572,4,4,2,4,0,14
191208573,3,6,0,4,5,18
191208574,2,2,9,6,4,23
191208575,0,6,2,9,8,25
191208576,2,4,1,6,6,19
191208577,1,9,0,6,1,17
191208578,9,4,4,2,6,25
191208579,2,6,2,0,5,15
191208580,3,7,1,2,3,16
191208581,4,2,4,4,4,18
191208582,5,3,6,0,3,17
191208583,6,7,0,8,6,27
191208584,5,3,4,2,5,19
191208585,0,3,2,9,2,16
191208586,6,7,8,2,3,26
191208587,1,3,7,4,9,24
191208588,6,7,6,4,2,25
191208589,5,3,5,6,6,25
191208590,5,7,2,7,9,30
191208591,4,6,3,6,1,20
191208592,1,6,8,5,1,21
191208593,3,0,7,7,6,23
191208594,3,6,1,1,2,13
191208595,2,3,3,7,8,23
191208596,1,7,1,2,1,12
191208597,9,3,1,6,7,26
191208598,6,7,0,5,9,27
191208599,2,4,4,6,9,25
191208600,6,3,7,4,2,22
191208601,9,6,0,8,3,26
191208602,1,4,4,6,1,16
191208603,4,2,2,2,2,12
191208604,3,7,1,5,6,22
191208605,1,7,7,5,7,27
191208606,7,7,0,5,2,21
191208607,3,9,6,5,6,29
191208608,5,4,9,8,3,29
191208609,7,9,3,7,2,28
191208610,4,4,0,4,3,15
191208611,2,7,0,3,6,18
191208612,2,0,6,6,9,23
191208613,2,4,9,4,2,21
191208614,1,8,4,0,3,16
191208615,9,6,4,5,6,30
191208616,2,5,5,9,3,24
191208617,7,2,0,9,3,21
191208618,1,2,8,5,8,24
191208619,3,0,9,9,3,24
191208620,0,2,0,7,7,16
191208621,6,0,4,4,1,15
191208622,2,0,7,9,9,27
191208623,0,8,2,3,0,13
191208624,1,0,3,4,6,14
191208625,8,3,1,7,9,28
191208626,6,9,5,1,6,27
191208627,3,0,8,9,0,20
191208628,3,6,7,8,6,30
191208629,3,6,8,6,9,32
191208630,0,1,1,8,0,10
191208631,2,4,0,9,0,15
191208632,3,2,6,6,7,24
191208633,9,4,4,2,5,24
191208634,1,6,5,4,9,25
191208635,5,4,2,3,4,18
191208636,1,2,7,8,8,26
191208637,2,9,2,8,6,27
191208638,8,4,3,6,6,27
191208639,5,8,0,2,5,20
191208640,4,2,0,5,4,15
191208641,3,9,0,5,4,21
191208642,1,4,7,1,8,21
191208643,5,0,8,4,9,26
191208644,2,7,7,8,8,32
191208645,9,6,1,4,3,23
191208646,5,9,4,7,7,32
191208647,2,3,3,0,9,17
191208648,0,8,5,1,3,17
191208649,4,5,7,6,8,30
191208650,3,1,9,8,5,26
191208651,8,8,3,8,1,28
191208652,1,7,0,8,9,25
191208653,6,6,6,9,3,30
191208654,1,7,6,3,9,26
191208655,6,6,1,2,0,15
191208656,9,0,8,9,9,35
191208657,0,0,5,2,4,11
191208658,5,9,8,9,6,37
191208659,8,9,7,5,4,33
191208660,5,5,3,4,6,23
191208661,0,5,8,3,9,25
191208662,4,8,2,9,8,31
191208663,9,9,0,9,1,28
191208664,8,8,6,3,7,32
191208665,9,7,8,7,5,36
191208666,1,1,2,9,5,18
191208667,1,1,9,3,8,22
191208668,9,7,8,3,6,33
191208669,7,6,7,4,8,32
191208670,1,9,2,3,8,23
191208671,1,4,0,6,2,13
191208672,7,0,1,9,1,18
191208673,9,8,0,2,7,26
191208674,9,9,4,7,9,38
191208675,8,4,6,1,0,19
191208676,8,7,9,5,0,29
191208677,8,4,5,9,9,35
191208678,0,3,7,2,3,15
191208679,2,4,5,2,4,17
191208680,6,1,9,8,3,27
191208681,4,4,9,8,3,28
191208682,0,7,5,7,5,24
191208683,6,2,8,3,7,26
191208684,5,0,6,6,3,20
191208685,5,0,8,8,5,26
191208686,6,3,1,5,2,17
191208687,1,3,3,3,6,16
191208688,8,5,5,9,8,35
191208689,6,8,1,9,8,32
191208690,8,2,2,3,2,17
191208691,9,5,4,5,4,27
191208692,5,6,5,6,8,30
191208693,4,5,6,5,9,29
191208694,2,6,6,6,8,28
191208695,8,0,2,0,5,15
191208696,9,3,8,9,0,29
191208697,3,2,7,0,8,20
191208698,9,8,5,5,6,33
191208699,5,2,7,6,2,22
191208700,1,4,8,5,3,21
191208701,6,7,3,6,5,27
191208702,6,3,5,5,7,26
191208703,8,4,1,4,1,18
191208704,9,7,0,9,3,28
191208705,6,9,3,7,7,32
191208706,5,5,7,7,0,24
191208707,5,0,4,1,6,16
191208708,0,1,5,1,9,16
191208709,4,3,4,8,2,21
191208710,3,9,1,1,8,22
191208711,3,4,8,0,3,18
191208712,3,9,1,0,9,22
191208713,8,0,9,6,0,23
191208714,6,6,8,0,2,22
191208715,7,9,7,2,9,34
191208716,3,6,9,6,5,29
191208717,8,7,8,7,8,38
191208718,2,2,4,6,6,20
191208719,8,8,7,1,9,33
191208720,8,8,7,5,7,35
191208721,5,1,3,8,8,25
191208722,1,2,0,1,7,11
191208723,6,7,0,5,6,24
191208724,3,3,4,9,3,22
191208725,2,3,0,2,6,13
191208726,6,7,5,6,5,29
191208727,3,0,5,2,8,18
191208728,3,9,1,9,5,27
191208729,3,8,1,5,3,20
191208730,8,0,2,8,3,21
191208731,4,2,7,6,3,22
191208732,2,7,9,8,4,30
191208733,0,5,7,0,1,13
191208734,0,7,6,5,6,24
191208735,6,9,0,4,4,23
191208736,5,9,4,9,7,34
191208737,4,6,1,1,3,15
191208738,4,9,7,3,2,25
191208739,2,8,5,7,2,24
191208740,3,3,7,0,6,19
191208741,7,8,1,0,9,25
191208742,5,3,0,9,1,18
191208743,3,6,2,4,2,17
191208744,8,3,4,7,7,29
191208745,9,5,1,7,1,23
191208746,7,6,3,3,0,19
191208747,4,0,2,0,3,9
191208748,4,5,0,2,1,12
191208749,4,7,4,6,4,25
191208750,2,9,9,2,4,26
191208751,5,1,2,8,2,18
191208752,3,1,0,4,3,11
191208753,8,4,3,8,2,25
191208754,9,5,5,3,1,23
191208755,6,8,8,1,2,25
191208756,4,0,2,7,4,17
191208757,4,8,7,1,3,23
191208758,6,8,8,5,3,30
191208759,5,5,6,9,5,30
191208760,9,0,6,3,7,25
191208761,9,7,5,7,6,34
191208762,0,0,4,5,4,13
191208763,0,2,2,4,0,8
191208764,9,4,1,2,0,16
191208765,4,4,3,0,1,12
191208766,8,5,6,5,0,24
191208767,7,3,9,0,2,21
191208768,9,6,7,3,0,25
191208769,3,4,5,6,2,20
191208770,0,5,7,3,0,15
191208771,7,9,5,5,8,34
191208772,7,8,1,7,2,25
191208773,4,4,7,5,9,29
191208774,3,8,7,6,0,24
191208775,3,8,2,7,5,25
191208776,2,0,7,5,1,15
191208777,7,6,6,4,4,27
191208778,4,8,7,2,3,24
191208779,6,4,1,0,1,12
191208780,9,0,7,5,2,23
191208781,9,2,8,5,1,25
191208782,7,7,0,1,0,15
191208783,5,3,6,7,4,25
191208784,6,1,5,2,1,15
191208785,9,7,3,1,3,23
191208786,7,1,1,7,9,25
191208787,0,0,2,2,9,13
191208788,8,2,5,5,9,29
191208789,7,1,6,9,9,32
191208790,7,6,6,7,2,28
191208791,9,7,3,7,6,32
191208792,2,0,1,7,1,11
191208793,8,3,6,6,1,24
191208794,1,1,9,1,9,21
191208795,8,2,4,0,0,14
191208796,7,0,6,3,5,21
191208797,7,2,9,2,9,29
191208798,5,6,2,2,4,19
191208799,7,5,4,7,3,26
191208800,6,4,3,6,3,22
191208801,4,9,7,7,0,27
191208802,9,6,6,3,2,26
191208803,0,0,1,9,2,12
191208804,6,0,0,7,0,13
191208805,1,5,2,6,5,19
191208806,2,9,0,6,1,18
191208807,2,2,4,5,3,16
191208808,7,4,1,8,7,27
191208809,9,2,6,0,6,23
191208810,1,9,8,7,0,25
191208811,4,0,1,7,4,16
191208812,2,7,6,8,7,30
191208813,3,8,3,1,7,22
191208814,5,9,7,6,0,27
191208815,4,7,5,0,2,18
191208816,9,8,2,6,3,28
191208817,3,0,3,1,8,15
191208818,5,6,4,7,5,27
191208819,9,4,2,5,0,20
191208820,3,3,3,0,9,18
191208821,0,6,3,2,9,20
191208822,7,5,0,5,8,25
191208823,9,1,7,1,0,18
191208824,3,5,3,0,6,17
191208825,5,5,5,1,4,20
191208826,8,0,9,5,7,29
191208827,2,0,5,2,7,16
191208828,4,6,9,4,8,31
191208829,4,2,1,3,8,18
191208830,8,7,5,6,6,32
191208831,4,3,6,2,8,23
191208832,3,8,0,2,8,21
191208833,3,8,4,4,4,23
191208834,1,9,2,0,0,12
191208835,4,3,5,4,5,21
191208836,1,5,0,3,4,13
191208837,0,1,1,3,8,13
191208838,1,6,5,9,0,21
191208839,4,8,9,6,1,28
191208840,6,8,5,1,1,21
191208841,4,7,0,7,5,23
191208842,0,7,6,2,0,15
191208843,7,9,1,7,7,31
191208844,7,1,7,1,5,21
191208845,8,7,5,6,3,29
191208846,2,4,4,7,2,19
191208847,5,0,6,3,9,23
191208848,7,4,7,5,0,23
191208849,4,4,7,7,3,25
191208850,1,1,9,9,5,25
191208851,1,6,6,9,7,29
191208852,4,9,2,3,7,25
191208853,6,0,6,9,1,22
191208854,1,5,1,7,5,19
191208855,0,8,7,7,3,25
191208856,0,6,0,8,4,18
191208857,7,1,5,4,0,17
191208858,2,4,5,7,8,26
191208859,2,6,9,0,9,26
191208860,2,1,5,4,5,17
191208861,3,1,9,8,1,22
191208862,4,7,5,8,8,32
191208863,0,7,4,4,7,22
191208864,3,7,5,9,4,28
191208865,4,1,6,6,5,22
191208866,5,8,8,3,5,29
191208867,6,5,6,4,8,29
191208868,0,1,2,7,0,10
191208869,1,6,4,7,8,26
191208870,4,5,6,8,2,25
191208871,4,3,8,4,5,24
191208872,5,1,5,9,5,25
191208873,0,6,7,5,6,24
191208874,9,0,9,1,5,24
191208875,8,1,8,7,6,30
191208876,6,0,9,5,8,28
191208877,2,1,1,1,6,11
191208878,2,2,5,1,6,16
191208879,2,0,2,0,6,10
191208880,4,2,4,9,9,28
191208881,4,2,2,1,7,16
191208882,6,9,9,3,4,31
191208883,8,9,8,7,8,40
191208884,9,0,9,7,4,29
191208885,9,7,0,5,3,24
191208886,6,6,2,0,7,21
191208887,6,5,9,7,3,30
191208888,1,0,9,5,9,24
191208889,9,9,4,9,1,32
191208890,8,5,5,1,6,25
191208891,4,6,5,1,1,17
191208892,4,2,9,2,0,17
191208893,2,6,8,9,1,26
191208894,5,5,4,2,6,22
191208895,2,5,7,3,3,20
191208896,8,9,0,5,4,26
191208897,9,8,3,0,9,29
191208898,6,5,9,7,7,34
191208899,7,0,0,9,5,21
191208900,8,4,0,7,9,28
191208901,3,6,0,9,0,18
191208902,8,6,8,1,9,32
191208903,0,3,1,3,1,8
191208904,3,6,6,1,9,25
191208905,7,2,3,6,1,19
191208906,5,9,4,8,2,28
191208907,4,8,1,4,7,24
191208908,6,6,9,8,6,35
191208909,1,9,1,0,8,19
191208910,1,3,0,9,5,18
191208911,3,2,4,6,5,20
191208912,5,5,7,8,8,33
191208913,1,6,3,8,8,26
191208914,3,7,3,7,2,22
191208915,3,9,9,3,2,26
191208916,0,5,9,5,8,27
191208917,4,9,7,4,7,31
191208918,9,0,2,9,8,28
191208919,5,6,3,1,2,17
191208920,7,3,8,7,6,31
191208921,0,2,4,8,3,17
191208922,1,9,3,5,4,22
191208923,0,3,8,1,6,18
191208924,3,7,5,3,3,21
191208925,1,7,9,3,9,29
191208926,8,4,2,5,5,24
191208927,8,3,6,5,2,24
191208928,0,1,8,9,6,24
191208929,7,2,4,2,9,24
191208930,1,1,2,1,4,9
191208931,4,9,9,4,4,30
191208932,5,2,2,0,8,17
191208933,7,3,8,2,0,20
191208934,2,0,1,2,0,5
191208935,8,8,6,2,5,29
191208936,5,2,5,3,2,17
191208937,7,2,8,1,8,26
191208938,4,9,0,9,9,31
191208939,2,8,1,1,8,20
191208940,4,0,0,2,1,7
191208941,5,1,3,9,3,21
191208942,2,7,8,0,2,19
191208943,6,5,8,5,4,28
191208944,0,1,2,4,9,16
191208945,8,9,6,7,0,30
191208946,3,0,6,8,0,17
191208947,4,0,2,6,2,14
191208948,7,1,7,0,4,19
191208949,0,8,9,7,1,25
191208950,0,7,0,6,1,14
191208951,8,6,9,0,1,24
191208952,9,9,2,8,7,35
191208953,6,7,6,5,1,25
191208954,1,8,7,5,0,21
191208955,3,5,9,0,9,26
191208956,2,7,4,8,4,25
191208957,0,0,7,1,2,10
191208958,7,7,5,8,7,34
191208959,7,5,2,8,3,25
191208960,7,6,3,0,7,23
191208961,3,7,9,3,6,28
191208962,0,3,8,2,3,16
191208963,8,9,1,8,0,26
191208964,3,7,0,7,4,21
191208965,0,0,8,6,5,19
191208966,6,6,0,5,1,18
191208967,4,5,9,1,5,24
191208968,4,9,0,0,4,17
191208969,5,5,6,6,4,26
191208970,8,8,8,5,9,38
191208971,8,4,6,0,3,21
191208972,2,5,1,1,8,17
191208973,3,9,3,1,3,19
191208974,1,8,6,8,8,31
191208975,7,4,2,2,2,17
191208976,7,6,0,8,1,22
191208977,5,6,5,8,3,27
191208978,5,7,3,9,8,32
191208979,7,4,3,4,7,25
191208980,4,9,1,5,5,24
191208981,6,4,3,7,0,20
191208982,2,6,2,8,3,21
191208983,3,1,8,4,6,22
191208984,8,3,3,6,7,27
191208985,5,1,4,7,6,23
191208986,2,5,4,9,3,23
191208987,5,0,4,0,2,11
191208988,2,0,2,1,8,13
191208989,1,4,1,9,1,16
191208990,0,5,7,5,1,18
191208991,1,2,9,9,9,30
191208992,3,5,6,7,8,29
191208993,3,0,3,3,3,12
191208994,1,9,9,4,2,25
191208995,5,3,3,1,3,15
191208996,6,1,8,6,3,24
191208997,9,8,6,1,0,24
191208998,7,6,5,2,2,22
191208999,4,2,6,5,0,17
1912081000,1,5,0,9,8,23
1912081001,9,6,2,0,6,23
1912081002,4,6,0,9,7,26
1912081003,5,0,0,6,7,18
1912081004,0,0,1,3,9,13
1912081005,9,5,1,1,6,22
1912081006,8,7,8,7,2,32
1912081007,9,9,6,3,4,31
1912081008,0,4,5,5,8,22
1912081009,5,4,9,2,4,24
1912081010,4,4,7,1,1,17
1912081011,1,2,7,1,7,18
1912081012,5,5,0,6,9,25
1912081013,7,3,4,0,5,19
1912081014,1,4,3,0,9,17
1912081015,7,4,8,0,7,26
1912081016,6,0,1,6,0,13
1912081017,6,1,4,3,8,22
1912081018,8,6,7,0,5,26
1912081019,0,8,8,8,5,29
1912081020,2,4,9,5,0,20
1912081021,9,2,0,7,5,23
1912081022,4,2,5,2,3,16
1912081023,6,9,1,9,6,31
1912081024,3,6,0,4,4,17
1912081025,4,8,9,8,8,37
1912081026,6,4,6,8,5,29
1912081027,1,6,8,3,5,23
1912081028,7,6,6,2,2,23
1912081029,0,7,4,8,5,24
1912081030,3,6,6,0,8,23
1912081031,0,7,1,9,7,24
1912081032,9,7,7,3,7,33
1912081033,6,4,7,3,2,22
1912081034,1,0,8,9,6,24
1912081035,4,8,7,0,0,19
1912081036,6,3,9,5,4,27
1912081037,3,1,1,0,4,9
1912081038,0,7,9,3,8,27
1912081039,3,1,5,0,5,14
1912081040,2,2,3,3,2,12
1912081041,0,9,7,0,5,21
1912081042,2,2,4,3,3,14
1912081043,8,1,6,7,4,26
1912081044,8,9,2,5,4,28
1912081045,5,4,3,7,5,24
1912081046,8,5,0,8,6,27
1912081047,8,2,3,3,4,20
1912081048,1,3,4,8,6,22
1912081049,9,0,4,7,0,20
1912081050,8,2,8,8,7,33
1912081051,8,5,1,9,6,29
1912081052,4,6,6,3,8,27
1912081053,0,3,0,4,5,12
1912081054,2,6,0,3,0,11
1912081055,2,4,9,0,1,16
1912081056,1,7,6,4,7,25
1912081057,8,0,2,3,3,16
1912081058,1,9,1,9,1,21
1912081059,4,0,2,6,0,12
1912081060,6,1,8,1,1,17
1912081061,8,5,7,2,8,30
1912081062,9,3,8,9,2,31
1912081063,0,5,9,2,4,20
1912081064,2,5,9,0,7,23
1912081065,7,5,5,8,3,28
1912081066,5,6,8,4,3,26
1912081067,0,5,4,4,0,13
1912081068,8,7,7,5,4,31
1912081069,0,2,0,5,3,10
1912081070,7,6,8,0,6,27
1912081071,1,3,1,6,3,14
1912081072,5,6,3,7,4,25
1912081073,5,3,0,8,9,25
1912081074,1,1,1,8,3,14
1912081075,0,4,7,8,3,22
1912081076,4,4,0,6,4,18
1912081077,1,7,0,8,8,24
1912081078,5,2,3,6,0,16
1912081079,3,6,5,1,8,23
1912081080,9,3,8,2,9,31
1912081081,1,6,9,4,1,21
1912081082,4,1,6,7,1,19
1912081083,2,9,5,9,2,27
1912081084,7,6,3,7,4,27
1912081085,3,5,4,1,8,21
1912081086,6,0,1,9,7,23
1912081087,2,5,0,2,4,13
1912081088,3,2,2,3,1,11
1912081089,3,5,3,6,7,24
1912081090,4,8,4,6,7,29
1912081091,1,7,5,6,1,20
1912081092,5,8,5,4,2,24
1912081093,8,2,4,6,3,23
1912081094,7,4,8,8,1,28
1912081095,1,1,6,8,6,22
1912081096,9,7,1,5,0,22
1912081097,8,6,3,1,7,25
1912081098,0,0,4,6,7,17
1912081099,4,3,2,7,9,25
1912081100,0,1,6,5,1,13
1912081101,5,4,0,0,6,15
1912081102,1,4,8,6,2,21
1912081103,8,9,0,9,4,30
1912081104,5,7,0,4,8,24
1912081105,9,8,6,3,7,33
191209001,7,7,6,6,0,26
191209002,4,3,3,9,1,20
191209003,6,6,1,8,5,26
191209004,1,9,6,0,9,25
191209005,5,0,9,0,4,18
191209006,0,9,9,6,7,31
191209007,8,6,4,9,5,32
191209008,9,2,9,9,4,33
191209009,1,1,3,8,2,15
191209010,0,8,0,3,4,15
191209011,5,2,7,7,0,21
191209012,0,8,7,5,7,27
191209013,0,2,1,3,5,11
191209014,5,4,1,5,8,23
191209015,3,9,2,6,2,22
191209016,0,7,1,6,1,15
191209017,2,4,4,1,9,20
191209018,7,9,6,2,7,31
191209019,9,4,5,1,6,25
191209020,1,4,7,0,6,18
191209021,8,4,6,3,2,23
191209022,7,3,8,4,9,31
191209023,4,8,7,1,8,28
191209024,0,6,6,5,3,20
191209025,7,8,9,9,2,35
191209026,5,6,9,4,4,28
191209027,9,8,1,3,2,23
191209028,7,4,1,2,4,18
191209029,4,1,5,5,3,18
191209030,4,8,8,7,1,28
191209031,6,2,4,3,1,16
191209032,9,9,5,2,7,32
191209033,6,2,1,7,2,18
191209034,0,9,1,8,2,20
191209035,8,2,2,2,1,15
191209036,8,8,1,0,7,24
191209037,6,1,5,8,2,22
191209038,3,0,6,2,4,15
191209039,3,8,0,1,6,18
191209040,5,0,5,9,8,27
191209041,5,8,0,9,8,30
191209042,1,7,0,4,1,13
191209043,4,6,5,5,9,29
191209044,3,2,1,3,8,17
191209045,6,6,7,1,4,24
191209046,4,0,4,0,5,13
191209047,9,3,9,5,5,31
191209048,9,2,7,9,6,33
191209049,6,1,1,0,6,14
191209050,5,5,9,1,4,24
191209051,3,2,1,7,7,20
191209052,1,2,5,1,5,14
191209053,3,9,8,8,1,29
191209054,8,8,5,2,3,26
191209055,8,6,4,8,3,29
191209056,9,0,5,2,1,17
191209057,3,4,3,1,4,15
191209058,2,0,7,4,5,18
191209059,7,6,4,4,4,25
191209060,2,2,7,3,0,14
191209061,9,8,9,8,5,39
191209062,3,7,8,9,1,28
191209063,7,7,6,6,6,32
191209064,5,7,4,2,0,18
191209065,2,6,7,8,6,29
191209066,7,9,0,8,8,32
191209067,9,5,1,6,4,25
191209068,1,4,0,0,6,11
191209069,2,7,0,3,0,12
191209070,7,6,1,7,3,24
191209071,6,0,7,3,5,21
191209072,2,1,4,2,5,14
191209073,2,5,4,2,8,21
191209074,2,8,6,8,6,30
191209075,8,2,8,0,8,26
191209076,4,7,1,5,3,20
191209077,7,8,9,7,7,38
191209078,2,9,4,6,5,26
191209079,3,3,3,2,8,19
191209080,2,4,1,3,7,17
191209081,9,2,6,0,1,18
191209082,9,5,9,4,7,34
191209083,2,7,0,1,4,14
191209084,0,7,2,9,9,27
191209085,3,1,5,4,7,20
191209086,1,5,0,4,4,14
191209087,4,7,4,0,8,23
191209088,8,7,3,2,7,27
191209089,7,3,1,4,5,20
191209090,1,7,6,0,5,19
191209091,6,6,2,5,5,24
191209092,9,5,4,1,1,20
191209093,0,4,0,5,5,14
191209094,6,4,7,7,8,32
191209095,3,1,9,0,6,19
191209096,5,0,5,7,5,22
191209097,1,5,9,1,3,19
191209098,4,9,8,2,7,30
191209099,7,3,4,6,4,24
191209100,2,7,0,6,0,15
191209101,5,3,0,3,2,13
191209102,2,8,1,8,9,28
191209103,9,3,8,1,4,25
191209104,1,0,3,7,3,14
191209105,0,8,6,2,9,25
191209106,9,8,1,0,3,21
191209107,1,0,7,7,7,22
191209108,8,4,3,7,9,31
191209109,8,1,4,7,6,26
191209110,7,3,4,5,5,24
191209111,8,4,5,8,5,30
191209112,6,9,0,7,7,29
191209113,3,2,6,3,1,15
191209114,8,3,9,0,7,27
191209115,8,4,3,9,5,29
191209116,1,0,1,5,5,12
191209117,1,4,6,3,2,16
191209118,9,2,9,9,9,38
191209119,6,7,2,4,9,28
191209120,8,5,9,7,2,31
191209121,0,4,5,0,3,12
191209122,6,8,6,7,8,35
191209123,1,6,8,3,8,26
191209124,6,3,7,6,7,29
191209125,5,4,5,7,1,22
191209126,1,1,3,2,3,10
191209127,9,5,9,8,6,37
191209128,3,6,7,3,6,25
191209129,7,7,6,2,7,29
191209130,9,7,9,4,3,32
191209131,1,1,9,0,3,14
191209132,2,8,3,1,8,22
191209133,7,7,1,5,8,28
191209134,7,8,7,9,1,32
191209135,9,4,8,8,4,33
191209136,9,4,1,8,5,27
191209137,3,5,4,8,9,29
191209138,9,6,1,4,8,28
191209139,1,8,7,0,7,23
191209140,4,7,0,5,9,25
191209141,1,7,8,7,8,31
191209142,4,2,3,6,4,19
191209143,4,8,6,7,2,27
191209144,8,4,2,6,4,24
191209145,5,2,6,4,4,21
191209146,9,2,1,4,1,17
191209147,7,5,6,5,6,29
191209148,1,0,7,1,3,12
191209149,9,8,7,0,2,26
191209150,3,7,4,8,7,29
191209151,6,3,7,5,1,22
191209152,1,7,5,1,2,16
191209153,5,4,3,2,2,16
191209154,6,9,5,4,5,29
191209155,7,2,2,4,2,17
191209156,2,9,3,5,8,27
191209157,4,7,3,3,1,18
191209158,7,5,5,9,7,33
191209159,5,1,6,9,0,21
191209160,9,9,5,6,8,37
191209161,3,0,5,3,9,20
191209162,0,8,9,1,6,24
191209163,4,3,2,5,4,18
191209164,2,4,6,7,0,19
191209165,2,7,3,5,0,17
191209166,9,5,3,6,1,24
191209167,2,0,9,1,6,18
191209168,5,1,7,1,3,17
191209169,7,8,8,0,1,24
191209170,2,5,7,6,1,21
191209171,0,3,6,5,6,20
191209172,1,4,6,0,5,16
191209173,9,1,2,2,8,22
191209174,0,3,2,5,5,15
191209175,4,4,9,4,8,29
191209176,0,0,3,7,4,14
191209177,1,3,1,7,2,14
191209178,2,0,0,9,7,18
191209179,2,6,0,8,0,16
191209180,6,7,1,8,5,27
191209181,8,8,9,5,8,38
191209182,0,9,5,4,7,25
191209183,2,8,2,1,1,14
191209184,1,0,1,0,1,3
191209185,6,6,4,7,8,31
191209186,5,8,7,2,8,30
191209187,5,7,0,6,2,20
191209188,9,6,0,6,5,26
191209189,8,2,0,6,1,17
191209190,2,6,5,7,4,24
191209191,5,7,0,9,8,29
191209192,8,1,5,9,7,30
191209193,7,5,3,1,3,19
191209194,7,2,1,4,4,18
191209195,8,4,6,1,4,23
191209196,6,6,2,9,0,23
191209197,5,4,0,2,3,14
191209198,5,5,5,1,6,22
191209199,7,2,6,2,8,25
191209200,4,0,4,6,4,18
191209201,7,0,8,5,9,29
191209202,4,0,2,4,4,14
191209203,9,2,9,6,6,32
191209204,8,4,6,7,1,26
191209205,1,2,1,0,3,7
191209206,2,0,3,0,1,6
191209207,8,3,5,4,8,28
191209208,8,1,3,4,6,22
191209209,0,8,0,0,8,16
191209210,5,2,7,4,9,27
191209211,2,6,9,1,2,20
191209212,9,0,4,9,6,28
191209213,7,6,6,9,2,30
191209214,8,1,4,1,0,14
191209215,8,7,1,0,5,21
191209216,9,9,0,5,4,27
191209217,5,5,5,8,7,30
191209218,2,5,2,6,0,15
191209219,5,9,7,3,8,32
191209220,4,2,7,9,6,28
191209221,2,5,4,1,7,19
191209222,0,6,1,9,1,17
191209223,8,1,0,1,1,11
191209224,3,3,1,8,7,22
191209225,2,9,6,5,4,26
191209226,3,1,4,7,0,15
191209227,4,4,0,8,5,21
191209228,2,4,0,5,1,12
191209229,4,7,0,3,8,22
191209230,4,7,6,8,5,30
191209231,4,9,8,0,1,22
191209232,5,2,2,2,5,16
191209233,7,6,7,6,5,31
191209234,1,9,1,1,8,20
191209235,8,4,9,5,5,31
191209236,8,6,0,6,6,26
191209237,9,8,2,8,6,33
191209238,9,6,3,2,2,22
191209239,4,9,0,1,1,15
191209240,0,2,4,8,4,18
191209241,9,5,5,5,9,33
191209242,4,4,9,3,4,24
191209243,6,9,4,3,5,27
191209244,0,1,2,8,3,14
191209245,4,0,2,9,2,17
191209246,7,7,6,4,6,30
191209247,5,2,0,4,7,18
191209248,0,2,3,3,8,16
191209249,5,3,4,9,9,30
191209250,4,8,1,3,5,21
191209251,0,4,1,9,0,14
191209252,0,5,9,2,0,16
191209253,0,9,4,9,0,22
191209254,1,2,3,4,7,17
191209255,1,2,5,4,2,14
191209256,2,4,9,0,3,18
191209257,6,8,9,3,6,32
191209258,1,7,6,2,2,18
191209259,6,0,8,7,4,25
191209260,6,3,4,6,4,23
191209261,8,8,4,4,6,30
191209262,2,3,1,2,8,16
191209263,4,9,0,8,9,30
191209264,0,6,4,7,5,22
191209265,8,1,1,8,0,18
191209266,2,6,9,6,8,31
191209267,1,0,6,1,2,10
191209268,1,3,6,4,0,14
191209269,5,0,3,6,9,23
191209270,7,4,2,6,1,20
191209271,1,5,7,9,3,25
191209272,2,0,7,4,2,15
191209273,2,9,1,6,6,24
191209274,5,0,1,9,8,23
191209275,2,8,9,3,3,25
191209276,4,4,8,4,9,29
191209277,4,0,7,9,3,23
191209278,3,5,4,0,2,14
191209279,5,3,6,4,0,18
191209280,9,9,8,7,1,34
191209281,4,5,8,6,5,28
191209282,1,0,3,1,4,9
191209283,0,6,4,2,8,20
191209284,6,6,3,5,0,20
191209285,6,8,3,0,1,18
191209286,1,9,6,3,0,19
191209287,7,4,6,1,4,22
191209288,0,9,0,8,4,21
191209289,8,2,9,2,2,23
191209290,7,6,5,1,9,28
191209291,9,0,9,6,1,25
191209292,1,7,7,8,5,28
191209293,1,7,5,5,2,20
191209294,7,7,9,2,6,31
191209295,3,8,1,2,6,20
191209296,8,3,4,5,2,22
191209297,9,0,3,7,5,24
191209298,3,1,2,7,4,17
191209299,5,2,7,1,2,17
191209300,5,4,8,0,2,19
191209301,8,0,8,8,3,27
191209302,0,9,4,1,0,14
191209303,2,2,4,1,6,15
191209304,1,4,3,3,3,14
191209305,3,7,0,9,8,27
191209306,7,4,2,4,8,25
191209307,0,1,2,0,9,12
191209308,4,9,8,2,6,29
191209309,2,8,2,4,9,25
191209310,2,7,7,9,2,27
191209311,7,4,5,5,6,27
191209312,0,8,2,5,2,17
191209313,3,8,1,9,2,23
191209314,4,6,5,8,6,29
191209315,9,5,0,4,5,23
191209316,6,2,4,1,1,14
191209317,3,2,3,3,3,14
191209318,0,9,8,7,7,31
191209319,0,2,7,2,8,19
191209320,1,9,4,9,6,29
191209321,8,6,4,7,9,34
191209322,5,5,6,1,0,17
191209323,8,5,2,4,9,28
191209324,7,7,5,2,9,30
191209325,8,8,4,0,0,20
191209326,2,6,1,6,5,20
191209327,9,2,2,1,9,23
191209328,6,8,2,1,0,17
191209329,3,8,0,2,3,16
191209330,0,5,6,7,6,24
191209331,7,0,5,2,5,19
191209332,8,3,5,5,6,27
191209333,6,2,4,1,5,18
191209334,9,3,8,1,8,29
191209335,9,3,2,7,7,28
191209336,1,9,4,2,0,16
191209337,1,8,7,8,6,30
191209338,7,0,2,3,1,13
191209339,0,3,3,0,0,6
191209340,6,4,6,4,8,28
191209341,2,5,6,0,5,18
191209342,1,8,3,4,5,21
191209343,5,5,3,8,6,27
191209344,3,3,7,1,6,20
191209345,0,9,7,7,2,25
191209346,1,3,5,6,0,15
191209347,8,0,2,7,3,20
191209348,6,3,1,2,6,18
191209349,7,3,6,7,5,28
191209350,7,8,8,4,1,28
191209351,4,8,9,9,2,32
191209352,0,8,9,5,9,31
191209353,4,2,4,2,0,12
191209354,7,4,7,5,1,24
191209355,9,9,2,4,8,32
191209356,0,4,6,5,4,19
191209357,6,4,3,1,7,21
191209358,8,1,3,3,4,19
191209359,6,3,2,3,3,17
191209360,0,4,1,8,7,20
191209361,7,6,4,6,5,28
191209362,3,9,5,5,2,24
191209363,2,4,1,7,6,20
191209364,9,9,5,0,5,28
191209365,7,2,6,0,7,22
191209366,5,3,7,2,8,25
191209367,0,4,8,6,0,18
191209368,1,4,5,3,0,13
191209369,2,0,5,0,1,8
191209370,0,4,4,9,8,25
191209371,5,2,1,7,3,18
191209372,3,2,8,8,3,24
191209373,9,5,7,5,2,28
191209374,2,6,6,5,2,21
191209375,4,2,6,8,8,28
191209376,0,1,3,8,8,20
191209377,4,5,3,4,3,19
191209378,7,2,0,0,9,18
191209379,7,9,7,7,6,36
191209380,9,5,1,5,1,21
191209381,9,9,1,5,7,31
191209382,6,6,6,0,7,25
191209383,3,3,2,2,7,17
191209384,7,3,5,6,5,26
191209385,4,2,5,5,2,18
191209386,6,9,0,5,7,27
191209387,1,2,6,8,1,18
191209388,1,7,0,3,4,15
191209389,4,3,0,3,0,10
191209390,4,6,6,3,6,25
191209391,6,2,8,7,8,31
191209392,9,8,9,3,8,37
191209393,5,0,6,7,2,20
191209394,9,4,4,3,2,22
191209395,3,6,5,8,7,29
191209396,2,7,4,7,6,26
191209397,1,1,8,6,8,24
191209398,4,1,9,6,7,27
191209399,0,7,1,4,5,17
191209400,1,7,0,3,6,17
191209401,8,2,5,7,3,25
191209402,2,6,7,9,7,31
191209403,2,1,2,0,6,11
191209404,2,6,6,9,6,29
191209405,9,3,8,6,7,33
191209406,6,9,3,0,4,22
191209407,9,7,8,3,9,36
191209408,4,7,5,3,4,23
191209409,2,8,9,7,1,27
191209410,8,8,6,3,6,31
191209411,2,4,1,3,0,10
191209412,2,1,6,2,6,17
191209413,1,8,6,8,9,32
191209414,0,0,0,2,2,4
191209415,1,9,7,2,8,27
191209416,8,1,7,9,2,27
191209417,4,3,3,5,7,22
191209418,7,0,5,8,1,21
191209419,5,6,5,5,0,21
191209420,0,9,9,4,5,27
191209421,1,6,6,6,3,22
191209422,2,5,7,9,6,29
191209423,5,3,0,7,3,18
191209424,6,1,6,6,0,19
191209425,3,4,4,7,0,18
191209426,8,3,6,1,7,25
191209427,7,9,9,9,0,34
191209428,3,1,8,9,9,30
191209429,0,1,0,3,3,7
191209430,7,9,8,8,4,36
191209431,1,7,6,3,6,23
191209432,0,3,4,1,6,14
191209433,6,7,7,8,6,34
191209434,1,4,6,7,8,26
191209435,6,2,1,4,3,16
191209436,1,8,4,6,1,20
191209437,4,0,8,1,3,16
191209438,1,3,5,0,4,13
191209439,1,5,1,7,0,14
191209440,5,0,1,2,3,11
191209441,5,1,0,3,7,16
191209442,1,3,3,2,3,12
191209443,2,7,1,3,7,20
191209444,7,6,7,8,0,28
191209445,9,7,9,6,0,31
191209446,3,5,8,0,4,20
191209447,2,1,4,2,2,11
191209448,8,1,3,1,2,15
191209449,2,1,2,5,0,10
191209450,6,8,6,8,5,33
191209451,5,4,8,7,8,32
191209452,6,7,9,8,9,39
191209453,2,5,3,1,1,12
191209454,8,8,2,8,0,26
191209455,7,6,2,3,6,24
191209456,8,1,2,1,1,13
191209457,6,6,5,4,7,28
191209458,4,1,2,0,0,7
191209459,2,2,2,2,6,14
191209460,8,9,2,1,0,20
191209461,3,9,8,6,3,29
191209462,5,2,3,6,6,22
191209463,5,2,6,0,6,19
191209464,2,8,9,7,2,28
191209465,0,4,4,2,9,19
191209466,6,0,3,0,8,17
191209467,5,7,4,0,3,19
191209468,6,8,7,3,4,28
191209469,2,8,0,9,8,27
191209470,0,6,8,0,1,15
191209471,5,8,3,2,4,22
191209472,5,1,9,0,2,17
191209473,9,2,5,5,3,24
191209474,6,1,4,1,6,18
191209475,4,4,7,5,5,25
191209476,3,1,6,2,1,13
191209477,9,5,4,1,2,21
191209478,6,9,0,6,9,30
191209479,9,4,1,2,6,22
191209480,2,3,9,9,9,32
191209481,8,0,4,5,2,19
191209482,0,3,3,9,7,22
191209483,1,2,2,7,4,16
191209484,4,3,9,7,4,27
191209485,5,8,6,8,1,28
191209486,3,5,4,6,4,22
191209487,1,1,2,9,4,17
191209488,5,6,0,7,2,20
191209489,4,5,9,1,7,26
191209490,7,0,3,2,8,20
191209491,7,3,4,2,1,17
191209492,9,1,4,0,0,14
191209493,6,2,7,7,7,29
191209494,5,9,7,2,6,29
191209495,7,6,6,1,9,29
191209496,2,5,1,4,7,19
191209497,1,5,8,2,0,16
191209498,2,5,2,2,4,15
191209499,9,5,7,9,0,30
191209500,0,8,5,4,5,22
191209501,8,7,7,6,1,29
191209502,9,8,6,9,1,33
191209503,3,2,2,2,5,14
191209504,0,1,0,3,0,4
191209505,4,4,9,2,7,26
191209506,2,9,2,0,3,16
191209507,9,4,5,5,2,25
191209508,3,5,1,7,9,25
191209509,8,6,3,7,6,30
191209510,5,1,6,9,7,28
191209511,9,4,7,7,0,27
191209512,0,6,0,1,6,13
191209513,2,5,8,6,9,30
191209514,0,2,9,9,2,22
191209515,9,7,3,0,5,24
191209516,9,4,8,1,9,31
191209517,7,9,8,7,6,37
191209518,2,0,0,4,5,11
191209519,5,2,3,4,9,23
191209520,1,6,9,1,7,24
191209521,5,3,7,1,5,21
191209522,7,5,3,9,3,27
191209523,3,2,2,7,6,20
191209524,8,5,1,0,6,20
191209525,5,5,2,3,3,18
191209526,6,3,2,0,0,11
191209527,0,8,5,7,5,25
191209528,4,1,0,0,8,13
191209529,9,8,5,0,6,28
191209530,2,4,8,6,5,25
191209531,9,5,3,0,2,19
191209532,3,6,9,0,3,21
191209533,5,1,3,7,7,23
191209534,4,4,3,3,4,18
191209535,2,9,1,6,4,22
191209536,0,0,6,0,9,15
191209537,1,4,7,3,2,17
191209538,5,3,2,5,1,16
191209539,9,7,6,3,3,28
191209540,0,4,6,0,4,14
191209541,7,2,2,1,6,18
191209542,1,9,0,8,6,24
191209543,9,8,4,2,9,32
191209544,4,7,5,5,9,30
191209545,5,7,4,6,3,25
191209546,0,7,0,0,2,9
191209547,5,8,2,9,5,29
191209548,7,8,8,3,8,34
191209549,0,4,3,0,0,7
191209550,2,4,8,1,2,17
191209551,9,1,2,4,9,25
191209552,7,5,6,1,4,23
191209553,9,9,6,8,3,35
191209554,0,6,7,6,7,26
191209555,3,0,3,8,2,16
191209556,3,4,5,8,3,23
191209557,2,9,0,3,1,15
191209558,4,7,3,1,5,20
191209559,9,0,8,8,6,31
191209560,1,4,3,6,4,18
191209561,9,1,4,3,1,18
191209562,6,2,5,7,0,20
191209563,6,1,7,8,5,27
191209564,4,8,8,2,5,27
191209565,1,7,1,4,0,13
191209566,1,0,5,0,3,9
191209567,5,6,5,9,6,31
191209568,8,6,6,0,0,20
191209569,4,7,2,2,9,24
191209570,5,2,5,4,3,19
191209571,8,5,9,3,7,32
191209572,4,7,9,3,9,32
191209573,6,9,8,7,6,36
191209574,3,6,8,8,6,31
191209575,8,9,4,6,9,36
191209576,3,8,9,9,6,35
191209577,3,3,0,6,6,18
191209578,3,5,1,9,0,18
191209579,2,8,6,7,1,24
191209580,1,3,7,7,7,25
191209581,1,6,2,3,8,20
191209582,7,2,5,5,7,26
191209583,4,0,4,2,7,17
191209584,1,5,3,3,3,15
191209585,4,2,6,4,8,24
191209586,4,2,1,3,7,17
191209587,0,9,8,9,9,35
191209588,8,1,0,6,2,17
191209589,9,8,0,9,5,31
191209590,3,9,0,2,6,20
191209591,6,6,8,1,3,24
191209592,9,2,2,0,8,21
191209593,8,3,1,7,6,25
191209594,6,9,9,3,8,35
191209595,1,1,4,4,7,17
191209596,7,0,3,4,5,19
191209597,6,5,5,0,5,21
191209598,4,9,5,8,3,29
191209599,3,8,0,8,9,28
191209600,5,7,3,5,6,26
191209601,2,1,0,3,7,13
191209602,5,9,7,6,7,34
191209603,9,9,3,4,2,27
191209604,4,0,8,4,1,17
191209605,8,2,3,5,0,18
191209606,1,1,3,1,2,8
191209607,6,6,1,3,3,19
191209608,6,8,4,4,9,31
191209609,7,8,7,7,6,35
191209610,2,5,2,1,1,11
191209611,4,5,3,5,7,24
191209612,5,3,3,7,1,19
191209613,7,6,4,0,7,24
191209614,0,7,5,0,5,17
191209615,0,1,8,7,4,20
191209616,3,0,1,8,4,16
191209617,5,1,0,2,0,8
191209618,2,9,3,9,8,31
191209619,1,6,2,2,9,20
191209620,0,6,3,5,9,23
191209621,0,6,2,0,5,13
191209622,1,8,7,1,8,25
191209623,3,7,5,2,5,22
191209624,6,9,3,5,2,25
191209625,7,6,5,5,1,24
191209626,4,4,1,6,5,20
191209627,7,7,6,6,9,35
191209628,6,6,4,9,2,27
191209629,3,1,9,2,4,19
191209630,0,2,2,8,7,19
191209631,0,3,2,8,9,22
191209632,4,1,1,3,9,18
191209633,2,0,0,4,3,9
191209634,7,6,5,8,3,29
191209635,0,3,7,3,6,19
191209636,8,8,4,4,9,33
191209637,8,5,1,3,5,22
191209638,6,3,8,3,2,22
191209639,8,0,8,0,1,17
191209640,0,6,5,5,1,17
191209641,0,4,5,8,0,17
191209642,1,4,9,5,4,23
191209643,6,3,7,9,6,31
191209644,8,0,0,7,9,24
191209645,8,6,6,4,6,30
191209646,0,2,7,5,1,15
191209647,6,8,6,4,8,32
191209648,0,4,7,7,6,24
191209649,6,7,9,5,1,28
191209650,2,1,3,7,7,20
191209651,2,5,6,4,5,22
191209652,6,9,4,4,0,23
191209653,4,3,0,5,2,14
191209654,8,9,7,9,9,42
191209655,7,6,7,8,5,33
191209656,7,7,1,7,0,22
191209657,9,5,5,8,1,28
191209658,1,0,4,9,9,23
191209659,5,8,8,5,0,26
191209660,1,9,7,7,9,33
191209661,6,6,0,6,8,26
191209662,5,1,7,2,2,17
191209663,1,6,9,1,5,22
191209664,9,0,7,8,3,27
191209665,4,9,5,1,5,24
191209666,2,9,8,6,6,31
191209667,1,2,2,5,2,12
191209668,4,6,5,4,1,20
191209669,5,1,4,5,6,21
191209670,1,8,1,0,6,16
191209671,1,1,5,5,1,13
191209672,6,4,9,8,1,28
191209673,9,3,4,8,4,28
191209674,8,0,2,2,8,20
191209675,9,1,1,2,3,16
191209676,1,9,2,1,0,13
191209677,7,0,2,0,8,17
191209678,1,2,4,3,6,16
191209679,5,5,9,2,0,21
191209680,3,2,1,1,6,13
191209681,0,8,2,3,5,18
191209682,4,2,4,6,1,17
191209683,4,1,3,6,5,19
191209684,2,1,7,9,1,20
191209685,5,9,4,6,3,27
191209686,0,2,7,6,2,17
191209687,5,8,3,1,5,22
191209688,3,0,6,0,7,16
191209689,7,6,1,0,2,16
191209690,3,8,5,2,4,22
191209691,3,4,1,4,4,16
191209692,0,5,6,1,4,16
191209693,2,6,0,7,6,21
191209694,9,4,6,2,6,27
191209695,6,6,0,6,7,25
191209696,9,1,4,2,3,19
191209697,0,6,2,0,1,9
191209698,2,0,5,7,7,21
191209699,1,5,2,3,0,11
191209700,9,2,9,0,6,26
191209701,5,2,8,4,6,25
191209702,8,8,0,8,8,32
191209703,0,6,5,2,1,14
191209704,6,9,7,8,7,37
191209705,3,7,8,5,5,28
191209706,1,0,4,0,7,12
191209707,7,9,8,3,0,27
191209708,3,0,1,4,7,15
191209709,8,0,9,0,2,19
191209710,7,3,6,6,5,27
191209711,0,7,8,7,1,23
191209712,8,9,9,6,2,34
191209713,5,6,3,0,2,16
191209714,7,7,2,5,8,29
191209715,4,1,8,6,5,24
191209716,6,5,0,5,9,25
191209717,6,1,6,6,5,24
191209718,1,5,2,5,7,20
191209719,8,2,3,9,6,28
191209720,9,6,8,8,3,34
191209721,4,3,9,2,8,26
191209722,0,5,0,7,6,18
191209723,9,4,0,7,4,24
191209724,4,1,5,1,4,15
191209725,1,1,4,0,7,13
191209726,6,4,8,2,7,27
191209727,9,0,4,7,4,24
191209728,2,3,4,7,3,19
191209729,6,9,8,0,4,27
191209730,1,9,6,1,0,17
191209731,2,7,8,3,9,29
191209732,5,6,6,6,4,27
191209733,1,6,0,6,0,13
191209734,9,2,4,3,9,27
191209735,5,9,4,5,3,26
191209736,6,3,1,6,2,18
191209737,2,0,4,2,2,10
191209738,4,4,7,0,2,17
191209739,3,9,8,8,0,28
191209740,6,9,6,5,1,27
191209741,1,2,3,2,2,10
191209742,3,5,4,1,2,15
191209743,5,3,5,5,7,25
191209744,4,6,2,7,9,28
191209745,9,6,5,4,8,32
191209746,0,0,4,5,0,9
191209747,6,2,8,5,0,21
191209748,8,9,3,8,2,30
191209749,9,3,3,7,0,22
191209750,3,9,6,1,3,22
191209751,8,5,0,1,2,16
191209752,1,7,3,0,9,20
191209753,6,6,3,6,8,29
191209754,4,0,2,2,1,9
191209755,9,3,5,9,1,27
191209756,2,6,7,6,0,21
191209757,4,2,5,2,5,18
191209758,5,2,4,8,7,26
191209759,2,8,7,3,8,28
191209760,3,7,8,3,6,27
191209761,5,1,5,0,0,11
191209762,7,1,7,6,7,28
191209763,6,9,8,0,8,31
191209764,7,4,4,8,6,29
191209765,1,2,1,8,9,21
191209766,2,4,9,6,8,29
191209767,0,3,4,2,5,14
191209768,7,7,6,3,2,25
191209769,7,0,1,0,9,17
191209770,6,3,0,2,3,14
191209771,0,0,2,1,0,3
191209772,8,9,1,7,1,26
191209773,3,0,3,0,0,6
191209774,8,1,4,9,7,29
191209775,6,4,4,1,7,22
191209776,6,9,5,9,5,34
191209777,6,0,8,5,0,19
191209778,6,4,0,3,3,16
191209779,9,7,3,2,0,21
191209780,6,6,0,5,8,25
191209781,7,2,3,5,1,18
191209782,7,5,9,0,3,24
191209783,4,6,0,8,2,20
191209784,6,4,8,3,7,28
191209785,0,4,9,6,0,19
191209786,0,4,0,2,2,8
191209787,6,9,9,3,5,32
191209788,4,2,5,0,5,16
191209789,0,8,1,9,3,21
191209790,6,9,8,0,6,29
191209791,5,1,5,5,1,17
191209792,4,2,5,8,1,20
191209793,6,1,0,8,1,16
191209794,2,8,3,3,4,20
191209795,3,6,3,5,9,26
191209796,9,9,9,7,1,35
191209797,1,5,5,5,7,23
191209798,9,2,3,3,7,24
191209799,4,7,6,9,4,30
191209800,7,1,3,5,4,20
191209801,5,9,4,3,4,25
191209802,8,3,4,0,6,21
191209803,7,0,5,8,8,28
191209804,4,0,8,8,5,25
191209805,1,3,0,1,1,6
191209806,0,2,7,4,2,15
191209807,9,9,4,1,4,27
191209808,3,9,8,4,5,29
191209809,9,2,6,9,4,30
191209810,5,5,3,4,7,24
191209811,4,7,5,0,5,21
191209812,1,2,4,3,5,15
191209813,4,1,2,5,4,16
191209814,3,4,5,6,5,23
191209815,1,5,2,0,9,17
191209816,3,9,2,2,4,20
191209817,5,0,3,9,1,18
191209818,1,3,3,3,3,13
191209819,0,8,1,9,7,25
191209820,5,1,3,8,3,20
191209821,1,2,6,6,2,17
191209822,0,7,5,0,3,15
191209823,1,0,7,1,7,16
191209824,9,1,3,5,2,20
191209825,5,1,5,3,3,17
191209826,1,4,6,2,2,15
191209827,6,3,8,3,1,21
191209828,0,7,4,2,7,20
191209829,8,9,7,8,0,32
191209830,4,0,7,2,8,21
191209831,9,4,8,0,7,28
191209832,0,8,3,1,1,13
191209833,1,3,9,0,2,15
191209834,1,9,3,1,5,19
191209835,0,7,4,7,1,19
191209836,1,2,7,0,8,18
191209837,0,7,6,7,2,22
191209838,5,6,8,8,0,27
191209839,1,5,3,3,9,21
191209840,2,0,9,7,3,21
191209841,5,2,1,8,0,16
191209842,9,7,8,6,0,30
191209843,5,8,0,7,8,28
191209844,5,5,6,8,3,27
191209845,4,7,9,7,6,33
191209846,5,0,7,7,6,25
191209847,3,1,4,3,8,19
191209848,2,0,1,5,7,15
191209849,7,6,1,1,7,22
191209850,5,4,5,0,3,17
191209851,4,3,4,4,4,19
191209852,6,7,0,8,8,29
191209853,8,4,3,7,6,28
191209854,2,6,5,3,5,21
191209855,7,5,9,8,2,31
191209856,3,5,4,2,0,14
191209857,9,2,8,3,4,26
191209858,5,0,0,5,1,11
191209859,5,7,0,3,0,15
191209860,2,8,2,7,9,28
191209861,1,1,7,3,2,14
191209862,6,0,6,0,5,17
191209863,1,0,9,4,5,19
191209864,9,8,0,1,8,26
191209865,3,9,0,3,2,17
191209866,3,4,9,6,8,30
191209867,5,1,6,7,7,26
191209868,7,2,8,3,9,29
191209869,7,1,6,2,6,22
191209870,2,3,8,3,1,17
191209871,1,7,3,5,8,24
191209872,4,1,1,8,1,15
191209873,7,0,2,0,7,16
191209874,9,6,1,1,6,23
191209875,8,3,1,7,7,26
191209876,6,0,8,5,5,24
191209877,0,7,1,9,4,21
191209878,2,3,2,3,9,19
191209879,2,8,8,1,0,19
191209880,2,4,5,1,9,21
191209881,9,6,6,5,5,31
191209882,1,0,6,2,0,9
191209883,6,8,4,5,8,31
191209884,5,7,5,3,0,20
191209885,7,6,6,1,7,27
191209886,7,9,0,2,9,27
191209887,5,0,5,5,6,21
191209888,6,8,8,2,2,26
191209889,3,1,3,6,1,14
191209890,2,2,6,9,3,22
191209891,1,8,1,8,1,19
191209892,6,6,1,2,4,19
191209893,7,9,9,7,9,41
191209894,5,6,8,4,9,32
191209895,7,1,1,9,0,18
191209896,1,1,7,0,3,12
191209897,5,2,7,2,8,24
191209898,2,3,2,5,0,12
191209899,4,7,0,0,7,18
191209900,4,8,1,1,7,21
191209901,6,9,3,4,1,23
191209902,0,3,2,4,3,12
191209903,5,3,5,4,7,24
191209904,8,1,0,3,4,16
191209905,2,7,9,1,9,28
191209906,6,0,9,2,5,22
191209907,3,8,4,2,2,19
191209908,0,1,2,9,9,21
191209909,7,4,1,7,8,27
191209910,3,2,9,3,8,25
191209911,3,9,3,8,6,29
191209912,5,3,5,9,7,29
191209913,4,5,1,7,8,25
191209914,6,2,8,0,1,17
191209915,6,4,1,5,8,24
191209916,1,4,7,2,2,16
191209917,4,6,2,2,8,22
191209918,1,8,7,4,8,28
191209919,6,6,0,9,3,24
191209920,7,8,8,4,0,27
191209921,7,3,1,1,8,20
191209922,4,6,4,4,6,24
191209923,0,0,6,8,2,16
191209924,6,7,2,2,2,19
191209925,8,0,7,5,6,26
191209926,3,9,0,2,9,23
191209927,5,3,0,8,4,20
191209928,9,7,2,1,9,28
191209929,4,9,4,4,7,28
191209930,5,0,1,6,2,14
191209931,4,3,8,6,8,29
191209932,7,7,2,1,8,25
191209933,6,2,3,9,4,24
191209934,1,0,3,1,9,14
191209935,6,2,6,8,1,23
191209936,6,8,4,0,1,19
191209937,7,0,4,3,5,19
191209938,1,1,0,2,4,8
191209939,0,3,7,3,4,17
191209940,0,4,8,2,4,18
191209941,1,5,5,9,7,27
191209942,0,1,0,9,8,18
191209943,8,0,7,0,8,23
191209944,0,3,5,8,8,24
191209945,2,4,3,8,3,20
191209946,4,8,3,5,8,28
191209947,7,1,3,2,5,18
191209948,9,6,3,1,3,22
191209949,0,8,8,8,2,26
191209950,4,4,9,1,9,27
191209951,5,2,4,3,4,18
191209952,0,8,6,5,0,19
191209953,3,7,6,1,9,26
191209954,4,9,3,0,5,21
191209955,7,8,6,9,3,33
191209956,2,1,6,0,1,10
191209957,4,3,3,0,0,10
191209958,7,5,4,2,7,25
191209959,1,4,1,7,5,18
191209960,6,9,2,8,6,31
191209961,6,8,7,7,9,37
191209962,7,5,8,2,4,26
191209963,4,8,7,6,4,29
191209964,0,0,1,1,9,11
191209965,3,2,4,4,3,16
191209966,1,1,9,1,4,16
191209967,6,2,5,8,1,22
191209968,3,7,2,2,8,22
191209969,9,5,3,2,8,27
191209970,8,2,4,2,5,21
191209971,0,1,5,7,1,14
191209972,8,3,3,4,3,21
191209973,3,1,9,6,2,21
191209974,8,4,7,6,8,33
191209975,2,9,0,1,1,13
191209976,6,9,4,2,1,22
191209977,7,8,0,6,8,29
191209978,3,7,6,5,9,30
191209979,7,6,6,8,5,32
191209980,9,6,5,8,2,30
191209981,4,7,9,5,1,26
191209982,6,6,3,7,4,26
191209983,2,3,3,5,1,14
191209984,8,6,7,9,5,35
191209985,1,9,9,0,1,20
191209986,0,2,7,4,1,14
191209987,4,1,1,4,1,11
191209988,7,3,2,6,5,23
191209989,8,6,6,0,3,23
191209990,5,7,3,7,3,25
191209991,0,1,0,9,2,12
191209992,8,2,2,9,5,26
191209993,7,9,7,7,7,37
191209994,3,2,3,4,1,13
191209995,6,4,0,8,6,24
191209996,4,6,7,3,1,21
191209997,1,5,9,8,5,28
191209998,2,1,2,5,4,14
191209999,0,9,1,4,2,16
1912091000,7,3,1,0,2,13
1912091001,4,7,2,4,3,20
1912091002,0,5,8,4,0,17
1912091003,5,1,8,2,9,25
1912091004,9,6,2,4,8,29
1912091005,5,7,2,1,1,16
1912091006,9,0,7,1,3,20
1912091007,7,5,4,2,1,19
1912091008,0,4,5,1,9,19
1912091009,6,0,1,9,5,21
1912091010,1,4,3,3,1,12
1912091011,7,1,3,6,9,26
1912091012,5,0,9,4,2,20
1912091013,0,2,4,1,6,13
1912091014,1,9,0,5,4,19
1912091015,0,2,4,9,2,17
1912091016,9,8,9,3,1,30
1912091017,8,4,1,7,4,24
1912091018,1,8,3,4,2,18
1912091019,5,4,7,5,6,27
1912091020,1,6,5,4,8,24
1912091021,5,7,1,3,7,23
1912091022,9,8,0,4,2,23
1912091023,7,2,7,9,5,30
1912091024,1,8,5,9,4,27
1912091025,7,3,4,8,5,27
1912091026,8,6,0,5,5,24
1912091027,8,8,3,2,2,23
1912091028,0,2,3,9,7,21
1912091029,5,0,4,4,5,18
1912091030,9,7,3,5,1,25
1912091031,2,5,7,8,9,31
1912091032,7,1,7,4,9,28
1912091033,0,9,0,3,3,15
1912091034,2,0,7,9,8,26
1912091035,8,0,6,1,4,19
1912091036,1,6,3,6,8,24
1912091037,1,7,7,0,6,21
1912091038,3,7,2,0,2,14
1912091039,7,0,2,2,0,11
1912091040,5,5,2,8,0,20
1912091041,4,0,1,8,1,14
1912091042,6,6,2,6,8,28
1912091043,2,0,3,2,2,9
1912091044,1,0,5,4,0,10
1912091045,9,1,4,1,8,23
1912091046,9,5,6,1,0,21
1912091047,2,8,5,7,1,23
1912091048,6,0,5,7,6,24
1912091049,3,7,3,2,3,18
1912091050,3,8,6,6,4,27
1912091051,1,4,2,1,1,9
1912091052,8,6,3,1,2,20
1912091053,6,9,7,6,7,35
1912091054,8,7,5,4,0,24
1912091055,1,5,3,7,1,17
1912091056,4,3,4,1,4,16
1912091057,0,4,0,4,5,13
1912091058,7,0,8,9,9,33
1912091059,8,3,2,8,2,23
1912091060,7,6,4,1,6,24
1912091061,6,4,4,0,1,15
1912091062,8,8,4,8,4,32
1912091063,9,3,3,6,7,28
1912091064,1,9,7,2,5,24
1912091065,2,6,9,1,5,23
1912091066,8,6,1,4,2,21
1912091067,3,5,8,9,9,34
1912091068,3,7,2,3,9,24
1912091069,2,0,9,5,7,23
1912091070,8,0,9,3,6,26
1912091071,8,3,0,8,2,21
1912091072,6,4,0,1,8,19
1912091073,4,7,2,7,6,26
1912091074,0,3,1,7,8,19
1912091075,4,2,2,6,4,18
1912091076,4,7,5,1,4,21
1912091077,5,4,6,3,7,25
1912091078,7,3,0,6,4,20
1912091079,0,1,7,2,5,15
1912091080,3,0,5,1,3,12
1912091081,8,9,0,0,6,23
1912091082,8,4,3,1,8,24
1912091083,6,5,0,6,3,20
1912091084,5,8,1,9,8,31
1912091085,8,9,6,7,2,32
1912091086,0,1,0,1,2,4
1912091087,6,5,8,1,2,22
1912091088,5,0,3,0,4,12
1912091089,2,3,1,5,7,18
1912091090,1,0,3,8,9,21
1912091091,8,9,1,2,1,21
1912091092,5,5,5,1,1,17
1912091093,6,2,6,0,1,15
1912091094,6,3,4,0,7,20
1912091095,4,3,2,5,9,23
1912091096,8,0,5,0,2,15
1912091097,0,8,2,5,6,21
1912091098,9,2,3,7,4,25
1912091099,0,0,9,0,8,17
1912091100,1,5,7,9,6,28
1912091101,3,0,5,8,6,22
1912091102,7,1,4,9,3,24
1912091103,3,6,9,1,0,19
1912091104,7,0,2,9,6,24
1912091105,8,0,6,0,0,14
191210001,0,8,8,0,7,23
191210002,9,8,9,8,7,41
191210003,9,4,7,1,4,25
191210004,6,8,5,7,5,31
191210005,3,7,7,6,7,30
191210006,3,8,4,3,5,23
191210007,4,3,3,7,2,19
191210008,0,9,1,6,8,24
191210009,4,7,2,3,4,20
191210010,4,7,5,3,9,28
191210011,4,5,9,4,6,28
191210012,1,5,8,9,2,25
191210013,2,0,7,8,8,25
191210014,8,5,4,8,2,27
191210015,9,1,6,7,8,31
191210016,0,0,7,4,5,16
191210017,6,8,7,2,1,24
191210018,9,9,0,4,7,29
191210019,4,2,6,2,6,20
191210020,4,6,6,9,0,25
191210021,4,6,7,3,9,29
191210022,0,2,0,8,7,17
191210023,1,4,0,1,4,10
191210024,6,7,6,5,8,32
191210025,7,6,4,0,0,17
191210026,7,9,1,0,5,22
191210027,4,0,5,1,0,10
191210028,2,9,3,5,2,21
191210029,2,2,7,6,0,17
191210030,3,1,1,0,5,10
191210031,2,8,3,6,4,23
191210032,0,6,7,7,0,20
191210033,6,7,3,6,0,22
191210034,9,9,6,1,7,32
191210035,4,9,3,0,8,24
191210036,4,3,6,3,6,22
191210037,7,1,7,3,8,26
191210038,2,2,0,2,5,11
191210039,8,6,2,6,9,31
191210040,3,1,6,1,3,14
191210041,4,5,1,8,9,27
191210042,1,4,4,8,8,25
191210043,6,6,4,8,0,24
191210044,3,8,4,9,5,29
191210045,1,9,9,7,8,34
191210046,9,2,5,9,5,30
191210047,8,8,5,7,0,28
191210048,6,3,6,2,6,23
191210049,6,2,8,8,3,27
191210050,9,5,5,6,5,30
191210051,2,2,2,8,9,23
191210052,2,3,0,4,8,17
191210053,5,4,6,5,4,24
191210054,1,7,5,4,9,26
191210055,2,6,1,8,2,19
191210056,1,4,5,6,7,23
191210057,1,4,2,2,1,10
191210058,1,0,7,5,4,17
191210059,1,1,7,4,8,21
191210060,1,1,0,8,2,12
191210061,1,3,9,8,3,24
191210062,0,1,9,5,1,16
191210063,1,2,1,7,5,16
191210064,2,4,7,1,7,21
191210065,0,5,3,5,6,19
191210066,5,4,3,1,1,14
191210067,4,1,8,9,1,23
191210068,7,7,7,9,0,30
191210069,3,6,5,9,3,26
191210070,5,8,8,9,4,34
191210071,3,1,5,1,5,15
191210072,3,5,8,4,4,24
191210073,5,8,6,1,8,28
191210074,2,2,7,0,8,19
191210075,5,9,0,4,2,20
191210076,0,3,0,6,0,9
191210077,4,7,8,0,8,27
191210078,8,2,9,6,9,34
191210079,9,5,0,6,5,25
191210080,6,9,4,6,0,25
191210081,1,7,1,6,5,20
191210082,3,5,7,6,0,21
191210083,2,4,7,9,3,25
191210084,0,0,4,8,2,14
191210085,1,8,4,1,2,16
191210086,1,9,5,1,1,17
191210087,8,7,7,9,4,35
191210088,2,4,0,6,0,12
191210089,3,0,4,6,3,16
191210090,6,1,3,9,4,23
191210091,9,7,1,8,6,31
191210092,4,2,1,4,3,14
191210093,5,7,5,3,4,24
191210094,0,7,9,2,4,22
191210095,7,3,2,0,9,21
191210096,6,6,2,8,5,27
191210097,3,4,6,7,8,28
191210098,4,6,6,0,5,21
191210099,0,8,3,2,4,17
191210100,8,2,7,1,5,23
191210101,3,1,6,0,6,16
191210102,6,0,5,3,9,23
191210103,0,7,7,1,8,23
191210104,1,7,7,8,7,30
191210105,2,1,4,5,3,15
191210106,4,5,3,0,8,20
191210107,2,9,4,7,3,25
191210108,5,6,5,4,9,29
191210109,1,2,5,8,4,20
191210110,7,7,9,6,5,34
191210111,0,9,1,9,3,22
191210112,2,1,1,7,6,17
191210113,3,7,7,4,7,28
191210114,5,2,3,3,9,22
191210115,3,8,7,0,1,19
191210116,1,6,2,1,9,19
191210117,2,7,3,0,9,21
191210118,9,0,9,9,7,34
191210119,0,5,1,4,8,18
191210120,8,9,9,0,8,34
191210121,0,2,3,1,8,14
191210122,7,8,4,0,9,28
191210123,0,8,6,1,7,22
191210124,7,6,0,6,8,27
191210125,8,0,4,3,4,19
191210126,1,1,2,5,7,16
191210127,2,1,9,2,1,15
191210128,1,4,8,0,9,22
191210129,8,5,8,7,8,36
191210130,2,9,2,1,5,19
191210131,7,0,1,9,6,23
191210132,1,2,7,1,4,15
191210133,1,1,2,2,5,11
191210134,9,8,0,0,7,24
191210135,8,9,9,5,4,35
191210136,6,7,7,6,6,32
191210137,1,6,8,9,3,27
191210138,0,8,8,9,0,25
191210139,4,8,3,5,9,29
191210140,7,3,8,9,9,36
191210141,2,3,2,3,6,16
191210142,6,7,1,1,7,22
191210143,3,4,2,9,3,21
191210144,4,6,2,7,4,23
191210145,7,3,3,5,3,21
191210146,7,1,6,0,4,18
191210147,0,5,9,6,5,25
191210148,7,7,1,4,4,23
191210149,0,7,1,8,5,21
191210150,0,1,7,5,3,16
191210151,4,7,3,2,8,24
191210152,0,5,0,9,4,18
191210153,9,5,8,6,0,28
191210154,0,6,7,2,1,16
191210155,7,7,3,0,5,22
191210156,0,8,6,9,8,31
191210157,6,2,3,2,6,19
191210158,0,1,6,0,7,14
191210159,5,2,1,2,7,17
191210160,9,4,9,1,6,29
191210161,6,6,6,5,1,24
191210162,0,2,9,2,7,20
191210163,6,2,5,6,0,19
191210164,8,7,2,8,0,25
191210165,4,1,5,6,5,21
191210166,9,6,6,7,6,34
191210167,4,7,3,3,6,23
191210168,5,3,5,2,2,17
191210169,7,2,3,0,1,13
191210170,7,2,3,7,7,26
191210171,9,1,0,0,7,17
191210172,4,3,0,1,3,11
191210173,7,5,5,5,2,24
191210174,8,3,3,1,5,20
191210175,9,5,5,3,7,29
191210176,6,7,3,6,3,25
191210177,0,6,2,1,0,9
191210178,2,2,2,6,0,12
191210179,9,9,4,8,5,35
191210180,6,8,0,9,8,31
191210181,7,5,2,5,2,21
191210182,9,9,2,7,2,29
191210183,9,3,3,0,2,17
191210184,1,4,4,9,3,21
191210185,8,7,2,3,1,21
191210186,8,0,1,9,3,21
191210187,3,6,5,6,0,20
191210188,6,0,4,4,9,23
191210189,7,2,8,2,8,27
191210190,8,5,5,0,3,21
191210191,8,8,5,5,9,35
191210192,2,6,4,5,4,21
191210193,0,6,8,8,3,25
191210194,8,3,6,8,4,29
191210195,4,1,9,9,3,26
191210196,8,2,9,8,1,28
191210197,2,0,2,4,3,11
191210198,2,6,8,6,1,23
191210199,2,1,5,3,2,13
191210200,6,6,1,6,5,24
191210201,4,5,4,2,5,20
191210202,2,2,5,5,9,23
191210203,8,0,6,9,8,31
191210204,5,8,2,8,0,23
191210205,3,4,6,8,1,22
191210206,5,7,5,3,6,26
191210207,8,7,2,2,6,25
191210208,3,1,8,0,5,17
191210209,2,2,4,6,9,23
191210210,2,3,7,0,8,20
191210211,6,3,4,0,8,21
191210212,1,8,4,1,8,22
191210213,2,2,9,2,0,15
191210214,7,1,3,8,3,22
191210215,4,6,6,0,2,18
191210216,0,4,1,6,5,16
191210217,3,4,5,7,6,25
191210218,5,8,9,7,4,33
191210219,8,4,7,0,3,22
191210220,1,4,5,1,1,12
191210221,0,5,9,6,4,24
191210222,4,0,1,9,0,14
191210223,3,0,7,9,2,21
191210224,1,2,6,7,0,16
191210225,7,8,8,6,8,37
191210226,2,3,6,4,3,18
191210227,5,9,8,1,1,24
191210228,1,4,7,1,4,17
191210229,4,7,9,0,8,28
191210230,4,4,0,5,5,18
191210231,3,9,9,6,2,29
191210232,7,8,8,1,9,33
191210233,6,1,6,1,1,15
191210234,3,6,5,0,1,15
191210235,0,9,1,8,1,19
191210236,8,6,0,5,3,22
191210237,1,7,1,4,3,16
191210238,5,7,5,3,3,23
191210239,3,8,7,7,2,27
191210240,0,4,5,2,6,17
191210241,1,9,8,5,3,26
191210242,7,5,9,9,0,30
191210243,8,9,2,8,8,35
191210244,3,5,2,0,6,16
191210245,0,5,0,1,3,9
191210246,7,5,2,0,7,21
191210247,8,2,3,6,2,21
191210248,4,0,0,6,5,15
191210249,9,1,6,0,7,23
191210250,1,6,8,8,0,23
191210251,1,1,7,7,3,19
191210252,5,8,2,2,3,20
191210253,4,7,4,9,3,27
191210254,2,8,6,4,5,25
191210255,9,1,6,2,0,18
191210256,3,0,3,9,4,19
191210257,7,1,9,0,1,18
191210258,1,8,5,9,6,29
191210259,9,1,2,2,0,14
191210260,6,7,7,7,7,34
191210261,2,2,0,3,4,11
191210262,0,7,8,8,2,25
191210263,5,9,5,4,4,27
191210264,9,9,6,6,8,38
191210265,8,8,7,6,7,36
191210266,7,1,0,4,1,13
191210267,4,3,6,5,4,22
191210268,4,6,6,9,7,32
191210269,0,3,4,5,5,17
191210270,8,2,8,6,0,24
191210271,5,8,2,0,6,21
191210272,2,7,5,6,3,23
191210273,5,8,0,5,1,19
191210274,3,6,3,0,6,18
191210275,0,3,4,2,0,9
191210276,6,7,1,3,1,18
191210277,0,9,6,5,7,27
191210278,7,5,7,8,9,36
191210279,6,7,5,0,8,26
191210280,0,8,5,4,3,20
191210281,4,1,0,3,3,11
191210282,5,1,4,1,5,16
191210283,3,2,5,5,5,20
191210284,4,1,7,9,6,27
191210285,6,3,1,3,4,17
191210286,0,4,5,8,4,21
191210287,9,9,0,1,6,25
191210288,8,8,4,0,8,28
191210289,1,4,8,6,0,19
191210290,3,1,2,6,2,14
191210291,8,3,7,5,6,29
191210292,1,4,6,3,0,14
191210293,7,9,9,2,2,29
191210294,8,1,0,0,1,10
191210295,1,9,9,7,7,33
191210296,5,5,1,6,5,22
191210297,6,8,5,8,1,28
191210298,5,1,6,6,1,19
191210299,9,8,5,2,3,27
191210300,3,7,1,9,8,28
191210301,8,0,4,6,9,27
191210302,3,9,0,1,2,15
191210303,3,1,2,2,3,11
191210304,8,4,9,8,8,37
191210305,4,2,9,8,8,31
191210306,7,3,2,0,6,18
191210307,8,7,6,2,5,28
191210308,9,4,1,8,8,30
191210309,7,4,1,1,2,15
191210310,0,3,3,8,4,18
191210311,1,8,8,5,7,29
191210312,3,2,7,1,9,22
191210313,5,6,8,2,3,24
191210314,7,3,3,9,5,27
191210315,5,4,1,1,8,19
191210316,5,2,4,5,3,19
191210317,3,0,2,2,0,7
191210318,9,2,8,7,0,26
191210319,2,8,7,9,9,35
191210320,0,9,9,5,7,30
191210321,6,3,8,3,3,23
191210322,2,1,8,1,6,18
191210323,6,5,8,4,6,29
191210324,2,9,7,8,3,29
191210325,4,5,5,8,7,29
191210326,9,6,1,5,0,21
191210327,0,5,9,7,6,27
191210328,6,2,2,5,5,20
191210329,0,2,2,1,3,8
191210330,4,2,3,5,3,17
191210331,1,7,0,8,6,22
191210332,4,8,4,9,9,34
191210333,0,4,4,3,3,14
191210334,9,4,6,3,5,27
191210335,0,7,7,8,6,28
191210336,4,2,5,1,0,12
191210337,8,7,9,9,2,35
191210338,8,4,3,7,0,22
191210339,6,9,8,2,6,31
191210340,3,8,2,1,3,17
191210341,0,8,4,6,1,19
191210342,6,2,5,6,4,23
191210343,4,8,8,5,4,29
191210344,7,8,3,5,1,24
191210345,0,0,9,7,4,20
191210346,5,4,1,4,5,19
191210347,3,6,6,9,2,26
191210348,9,8,0,4,9,30
191210349,8,5,6,4,8,31
191210350,8,2,0,7,0,17
191210351,3,2,4,8,4,21
191210352,8,4,0,0,8,20
191210353,7,3,3,6,3,22
191210354,9,3,2,8,2,24
191210355,6,3,5,7,7,28
191210356,8,3,7,4,1,23
191210357,0,2,5,5,5,17
191210358,5,6,1,4,2,18
191210359,9,2,2,2,2,17
191210360,4,2,1,7,9,23
191210361,6,2,1,7,3,19
191210362,2,7,3,5,2,19
191210363,8,9,4,5,0,26
191210364,0,2,1,9,4,16
191210365,0,8,3,3,1,15
191210366,0,0,6,0,8,14
191210367,8,1,2,0,7,18
191210368,9,2,7,6,7,31
191210369,5,4,7,3,8,27
191210370,8,3,9,0,3,23
191210371,2,9,9,5,3,28
191210372,3,7,5,5,9,29
191210373,7,9,0,0,6,22
191210374,2,8,6,5,9,30
191210375,4,8,0,7,1,20
191210376,5,7,4,7,1,24
191210377,5,3,7,8,0,23
191210378,5,3,5,2,9,24
191210379,4,9,0,7,0,20
191210380,3,9,0,6,2,20
191210381,8,2,3,8,5,26
191210382,7,1,1,4,7,20
191210383,7,1,6,1,6,21
191210384,1,0,2,4,6,13
191210385,7,1,9,6,8,31
191210386,2,9,2,8,0,21
191210387,7,8,7,1,7,30
191210388,2,6,3,8,9,28
191210389,3,1,6,8,3,21
191210390,1,8,5,5,3,22
191210391,4,8,8,0,9,29
191210392,6,5,6,9,1,27
191210393,1,0,3,3,4,11
191210394,0,3,7,6,7,23
191210395,0,0,8,2,2,12
191210396,0,8,3,8,1,20
191210397,6,5,3,6,9,29
191210398,5,7,1,0,1,14
191210399,8,4,5,7,3,27
191210400,7,7,1,9,5,29
191210401,5,7,4,1,7,24
191210402,0,1,0,4,4,9
191210403,3,8,0,1,7,19
191210404,8,9,3,3,0,23
191210405,0,0,5,1,9,15
191210406,3,5,0,2,9,19
191210407,9,4,3,5,3,24
191210408,7,6,2,1,5,21
191210409,4,5,5,7,3,24
191210410,1,5,1,5,3,15
191210411,3,1,0,5,8,17
191210412,4,5,4,1,1,15
191210413,9,9,2,6,8,34
191210414,5,3,0,5,4,17
191210415,8,3,4,6,0,21
191210416,0,9,8,6,0,23
191210417,3,2,6,6,8,25
191210418,4,4,3,3,3,17
191210419,4,8,5,8,6,31
191210420,3,9,2,4,7,25
191210421,8,9,1,6,7,31
191210422,7,6,9,3,1,26
191210423,0,5,3,4,1,13
191210424,7,7,7,7,9,37
191210425,5,3,1,6,2,17
191210426,7,2,3,0,7,19
191210427,2,7,8,1,1,19
191210428,3,8,7,5,7,30
191210429,6,4,1,7,0,18
191210430,7,9,7,1,2,26
191210431,3,9,9,1,1,23
191210432,4,0,3,3,6,16
191210433,9,3,0,0,2,14
191210434,8,1,9,6,7,31
191210435,5,9,9,9,9,41
191210436,0,1,1,0,9,11
191210437,7,7,1,0,5,20
191210438,1,5,2,4,8,20
191210439,5,5,2,3,4,19
191210440,3,8,6,0,8,25
191210441,9,6,1,6,3,25
191210442,3,7,3,5,4,22
191210443,8,6,3,7,1,25
191210444,4,8,6,3,8,29
191210445,1,1,5,1,5,13
191210446,7,4,9,3,9,32
191210447,1,5,7,8,7,28
191210448,6,2,2,4,7,21
191210449,7,3,3,8,7,28
191210450,5,0,7,4,8,24
191210451,8,0,7,6,4,25
191210452,5,3,1,7,5,21
191210453,7,2,1,4,7,21
191210454,0,3,8,3,6,20
191210455,1,2,7,3,0,13
191210456,7,1,9,1,1,19
191210457,4,1,7,9,3,24
191210458,0,8,3,7,0,18
191210459,0,9,9,7,1,26
191210460,3,7,5,3,6,24
191210461,4,0,6,6,3,19
191210462,2,5,5,8,5,25
191210463,6,6,6,3,2,23
191210464,9,2,5,1,1,18
191210465,1,8,7,4,1,21
191210466,8,4,7,3,7,29
191210467,6,9,3,9,9,36
191210468,0,4,4,1,3,12
191210469,8,6,2,8,3,27
191210470,2,6,2,7,3,20
191210471,9,5,2,0,8,24
191210472,6,9,8,9,4,36
191210473,5,6,8,9,4,32
191210474,0,8,0,0,6,14
191210475,7,7,2,6,0,22
191210476,7,1,1,5,0,14
191210477,6,5,1,2,1,15
191210478,0,6,7,2,2,17
191210479,2,4,8,1,6,21
191210480,8,1,2,9,5,25
191210481,2,8,4,9,7,30
191210482,6,4,3,0,3,16
191210483,4,4,8,5,3,24
191210484,9,5,5,9,5,33
191210485,4,7,1,7,0,19
191210486,7,0,2,8,0,17
191210487,9,8,1,7,6,31
191210488,5,0,1,6,6,18
191210489,2,1,5,6,8,22
191210490,4,1,4,3,6,18
191210491,4,3,5,8,6,26
191210492,8,3,1,9,7,28
191210493,2,3,1,6,0,12
191210494,5,2,4,9,9,29
191210495,1,4,9,5,1,20
191210496,4,7,0,5,7,23
191210497,6,8,7,3,7,31
191210498,7,7,6,1,9,30
191210499,2,6,3,6,3,20
191210500,2,6,1,1,2,12
191210501,1,0,4,7,8,20
191210502,0,6,2,7,2,17
191210503,7,5,7,0,0,19
191210504,4,6,4,6,9,29
191210505,3,9,0,9,5,26
191210506,3,4,4,8,8,27
191210507,5,3,1,8,2,19
191210508,1,9,0,5,7,22
191210509,6,8,1,9,2,26
191210510,7,0,2,3,9,21
191210511,0,8,9,0,1,18
191210512,6,2,9,6,0,23
191210513,8,1,7,6,6,28
191210514,7,5,8,6,1,27
191210515,3,9,1,7,5,25
191210516,3,8,2,7,1,21
191210517,1,5,9,1,8,24
191210518,9,8,0,6,5,28
191210519,6,0,7,1,4,18
191210520,8,0,5,8,2,23
191210521,2,5,3,5,6,21
191210522,5,3,0,8,2,18
191210523,9,2,3,4,2,20
191210524,2,9,8,6,9,34
191210525,6,0,5,8,1,20
191210526,9,5,8,9,4,35
191210527,1,0,2,9,2,14
191210528,3,5,3,4,6,21
191210529,4,1,3,0,3,11
191210530,8,6,8,9,1,32
191210531,3,4,2,2,5,16
191210532,4,4,0,2,7,17
191210533,7,3,0,3,0,13
191210534,2,4,0,9,1,16
191210535,5,6,8,2,4,25
191210536,7,0,2,2,6,17
191210537,0,8,3,8,5,24
191210538,5,0,0,7,1,13
191210539,3,2,7,0,9,21
191210540,1,6,1,1,5,14
191210541,3,6,0,4,0,13
191210542,3,3,3,5,1,15
191210543,0,2,6,7,6,21
191210544,4,7,0,6,7,24
191210545,2,7,6,0,9,24
191210546,5,8,5,0,4,22
191210547,6,8,4,0,2,20
191210548,9,8,5,0,1,23
191210549,7,2,7,5,7,28
191210550,5,3,9,5,2,24
191210551,3,2,8,1,3,17
191210552,3,7,3,3,7,23
191210553,2,4,2,2,1,11
191210554,7,7,4,8,4,30
191210555,1,8,1,7,3,20
191210556,0,0,2,5,9,16
191210557,0,4,0,8,2,14
191210558,7,3,4,7,0,21
191210559,3,9,1,1,4,18
191210560,1,1,0,3,8,13
191210561,2,5,0,6,8,21
191210562,4,3,4,3,1,15
191210563,5,5,4,9,8,31
191210564,7,6,5,0,1,19
191210565,9,2,8,0,6,25
191210566,3,6,6,9,9,33
191210567,4,0,4,8,0,16
191210568,2,3,3,9,3,20
191210569,6,2,4,4,4,20
191210570,3,2,3,1,7,16
191210571,6,3,9,8,3,29
191210572,3,0,8,8,1,20
191210573,1,2,7,8,5,23
191210574,8,8,1,7,3,27
191210575,8,7,8,7,6,36
191210576,7,0,9,5,2,23
191210577,2,9,5,7,8,31
191210578,0,3,6,1,7,17
191210579,8,1,8,7,8,32
191210580,9,8,9,7,4,37
191210581,5,8,5,8,4,30
191210582,3,6,0,4,3,16
191210583,7,3,1,3,3,17
191210584,4,6,8,9,3,30
191210585,5,4,6,5,2,22
191210586,3,2,8,4,8,25
191210587,7,0,4,3,0,14
191210588,3,0,7,1,0,11
191210589,0,2,6,8,2,18
191210590,6,7,5,0,9,27
191210591,9,6,5,9,8,37
191210592,0,2,8,9,3,22
191210593,5,3,7,6,2,23
191210594,1,2,9,2,9,23
191210595,5,1,2,1,7,16
191210596,8,1,9,0,7,25
191210597,5,2,3,2,7,19
191210598,9,5,3,2,5,24
191210599,9,9,2,9,0,29
191210600,0,4,6,2,9,21
191210601,5,2,9,3,1,20
191210602,7,1,1,3,7,19
191210603,4,2,9,1,6,22
191210604,3,3,1,4,8,19
191210605,6,9,3,8,5,31
191210606,8,5,0,0,8,21
191210607,6,6,4,8,3,27
191210608,9,4,3,6,8,30
191210609,4,7,6,9,6,32
191210610,3,1,2,5,1,12
191210611,8,0,8,8,2,26
191210612,9,3,4,5,6,27
191210613,1,7,2,9,0,19
191210614,1,2,3,4,5,15
191210615,8,8,8,1,8,33
191210616,1,5,4,4,5,19
191210617,8,2,3,1,8,22
191210618,5,9,8,6,5,33
191210619,2,9,2,5,7,25
191210620,2,4,9,8,7,30
191210621,2,0,3,9,2,16
191210622,7,9,3,0,9,28
191210623,4,7,4,5,7,27
191210624,2,6,4,5,8,25
191210625,6,4,4,9,4,27
191210626,3,9,0,5,0,17
191210627,1,2,4,6,8,21
191210628,8,5,3,1,7,24
191210629,1,8,8,7,8,32
191210630,8,8,0,4,0,20
191210631,2,7,7,7,4,27
191210632,9,7,7,7,3,33
191210633,0,4,9,3,2,18
191210634,4,0,0,3,3,10
191210635,3,1,1,8,5,18
191210636,8,3,4,7,8,30
191210637,4,8,3,6,2,23
191210638,1,4,9,3,4,21
191210639,9,1,1,0,8,19
191210640,7,7,0,5,2,21
191210641,2,7,2,9,5,25
191210642,8,1,7,4,2,22
191210643,4,0,1,9,1,15
191210644,9,1,4,0,9,23
191210645,2,1,3,1,1,8
191210646,0,0,7,5,1,13
191210647,9,1,1,2,2,15
191210648,9,2,9,2,3,25
191210649,7,3,1,2,0,13
191210650,3,9,9,8,8,37
191210651,6,7,8,2,1,24
191210652,5,4,4,9,1,23
191210653,0,4,8,6,7,25
191210654,4,0,5,0,3,12
191210655,1,6,5,2,3,17
191210656,5,1,9,6,5,26
191210657,6,6,1,3,1,17
191210658,1,2,2,2,0,7
191210659,7,9,6,3,3,28
191210660,7,6,6,8,9,36
191210661,2,0,9,0,8,19
191210662,8,5,9,5,7,34
191210663,2,5,5,8,2,22
191210664,4,9,3,9,2,27
191210665,8,7,2,3,4,24
191210666,1,2,6,0,0,9
191210667,7,9,3,6,4,29
191210668,5,8,2,7,0,22
191210669,5,5,2,7,7,26
191210670,1,8,3,7,7,26
191210671,5,3,7,7,6,28
191210672,9,5,5,2,0,21
191210673,2,9,5,9,9,34
191210674,2,5,1,8,8,24
191210675,0,3,4,1,7,15
191210676,1,6,8,2,4,21
191210677,0,0,7,7,6,20
191210678,0,2,0,7,3,12
191210679,5,4,5,1,5,20
191210680,2,3,1,6,5,17
191210681,0,7,9,3,3,22
191210682,4,3,9,8,5,29
191210683,1,9,8,0,6,24
191210684,8,6,2,3,7,26
191210685,3,4,7,8,5,27
191210686,7,2,2,7,3,21
191210687,2,9,5,5,4,25
191210688,2,8,8,1,7,26
191210689,8,9,2,3,2,24
191210690,1,7,5,2,6,21
191210691,9,9,3,7,5,33
191210692,7,6,8,3,0,24
191210693,2,8,2,8,9,29
191210694,3,0,9,5,2,19
191210695,8,2,9,9,1,29
191210696,9,5,6,0,9,29
191210697,2,4,4,8,9,27
191210698,6,9,0,0,0,15
191210699,6,8,3,1,0,18
191210700,5,6,7,1,9,28
191210701,1,2,0,8,8,19
191210702,8,2,0,1,6,17
191210703,4,4,0,1,2,11
191210704,0,2,9,7,4,22
191210705,0,0,1,4,6,11
191210706,5,3,7,0,4,19
191210707,2,3,2,8,0,15
191210708,4,4,4,8,3,23
191210709,0,4,9,4,3,20
191210710,2,6,6,0,5,19
191210711,4,7,6,3,9,29
191210712,5,7,8,9,3,32
191210713,2,5,9,8,5,29
191210714,0,3,2,5,3,13
191210715,6,9,2,3,9,29
191210716,6,2,6,1,1,16
191210717,6,5,2,0,0,13
191210718,0,8,6,5,3,22
191210719,0,9,2,2,9,22
191210720,9,3,1,0,5,18
191210721,3,3,2,1,2,11
191210722,1,6,5,7,6,25
191210723,1,9,5,5,1,21
191210724,6,3,6,2,2,19
191210725,8,8,4,5,4,29
191210726,6,0,0,0,3,9
191210727,5,8,7,8,6,34
191210728,7,7,7,9,8,38
191210729,7,0,7,5,3,22
191210730,4,3,9,5,6,27
191210731,9,5,3,9,2,28
191210732,6,4,6,9,0,25
191210733,7,3,5,7,8,30
191210734,0,0,5,8,9,22
191210735,9,4,2,7,6,28
191210736,6,2,6,6,4,24
191210737,0,9,5,1,1,16
191210738,4,4,9,7,9,33
191210739,2,7,5,1,3,18
191210740,0,4,6,1,7,18
191210741,6,5,2,1,8,22
191210742,8,3,0,8,3,22
191210743,5,2,5,9,8,29
191210744,7,7,2,4,5,25
191210745,6,7,7,3,1,24
191210746,7,8,4,1,4,24
191210747,5,5,9,7,5,31
191210748,1,4,2,6,4,17
191210749,9,4,1,0,7,21
191210750,0,5,3,6,8,22
191210751,4,1,4,8,6,23
191210752,8,1,5,9,3,26
191210753,7,0,7,5,8,27
191210754,2,5,1,6,6,20
191210755,4,9,6,7,3,29
191210756,0,9,5,7,1,22
191210757,0,7,5,0,0,12
191210758,4,4,7,1,6,22
191210759,2,3,7,6,8,26
191210760,5,2,7,5,5,24
191210761,6,9,9,6,4,34
191210762,4,4,2,0,9,19
191210763,2,2,6,2,2,14
191210764,9,6,7,6,5,33
191210765,0,6,5,7,3,21
191210766,9,2,4,2,2,19
191210767,1,8,4,2,6,21
191210768,0,9,3,8,4,24
191210769,6,4,3,6,1,20
191210770,8,2,3,3,8,24
191210771,4,8,0,9,4,25
191210772,4,7,7,7,5,30
191210773,3,4,6,5,4,22
191210774,4,8,2,4,7,25
191210775,5,2,5,2,1,15
191210776,6,1,1,4,8,20
191210777,2,0,9,2,9,22
191210778,6,5,5,4,1,21
191210779,9,7,0,8,9,33
191210780,4,9,2,2,2,19
191210781,9,9,3,1,0,22
191210782,8,5,2,4,3,22
191210783,8,1,1,8,7,25
191210784,0,5,8,6,6,25
191210785,4,5,9,1,3,22
191210786,1,2,3,3,3,12
191210787,5,6,3,1,3,18
191210788,4,5,4,0,3,16
191210789,3,3,2,9,8,25
191210790,3,7,2,8,6,26
191210791,8,1,0,8,4,21
191210792,5,4,9,3,1,22
191210793,4,2,8,1,4,19
191210794,5,3,2,9,8,27
191210795,6,9,6,1,9,31
191210796,5,3,7,1,7,23
191210797,4,7,5,4,3,23
191210798,0,2,9,9,3,23
191210799,5,2,4,8,9,28
191210800,8,1,2,1,5,17
191210801,8,1,8,8,7,32
191210802,1,2,3,7,1,14
191210803,4,8,2,5,8,27
191210804,4,4,9,7,0,24
191210805,1,0,1,4,3,9
191210806,3,2,3,7,6,21
191210807,5,9,6,6,9,35
191210808,2,2,4,1,4,13
191210809,6,0,9,5,5,25
191210810,0,5,0,3,9,17
191210811,9,0,3,8,8,28
191210812,9,4,3,7,6,29
191210813,1,0,0,7,6,14
191210814,8,4,4,8,7,31
191210815,1,7,3,3,3,17
191210816,0,4,8,2,8,22
191210817,5,8,4,2,9,28
191210818,7,4,3,3,6,23
191210819,4,3,9,0,6,22
191210820,5,8,8,9,2,32
191210821,4,0,3,3,8,18
191210822,5,4,1,4,6,20
191210823,1,3,8,2,9,23
191210824,4,0,3,3,3,13
191210825,4,5,5,3,4,21
191210826,3,0,9,9,3,24
191210827,7,2,4,3,8,24
191210828,9,4,9,5,3,30
191210829,0,0,4,7,3,14
191210830,5,8,8,5,7,33
191210831,5,2,8,9,0,24
191210832,1,7,5,7,9,29
191210833,5,8,1,9,0,23
191210834,1,2,0,1,5,9
191210835,3,1,4,7,6,21
191210836,8,2,9,4,2,25
191210837,8,2,5,3,6,24
191210838,7,0,7,0,7,21
191210839,4,2,4,7,3,20
191210840,0,1,2,7,4,14
191210841,2,0,3,8,7,20
191210842,0,2,1,3,3,9
191210843,5,2,0,2,4,13
191210844,8,5,7,5,1,26
191210845,0,9,8,9,0,26
191210846,4,3,9,1,9,26
191210847,5,7,7,2,0,21
191210848,8,1,7,7,5,28
191210849,4,1,5,0,7,17
191210850,2,5,9,5,9,30
191210851,5,2,5,5,7,24
191210852,5,4,4,9,7,29
191210853,1,1,1,9,5,17
191210854,4,4,4,8,6,26
191210855,5,5,4,8,2,24
191210856,7,1,8,9,7,32
191210857,3,7,3,7,4,24
191210858,8,9,6,1,0,24
191210859,1,9,7,6,4,27
191210860,5,6,0,0,2,13
191210861,4,4,6,4,3,21
191210862,1,5,2,8,3,19
191210863,8,0,7,8,5,28
191210864,9,3,0,3,7,22
191210865,1,7,2,4,6,20
191210866,4,3,8,6,3,24
191210867,4,3,9,8,6,30
191210868,8,6,3,5,3,25
191210869,6,7,8,1,6,28
191210870,3,0,1,1,5,10
191210871,1,9,9,9,7,35
191210872,7,2,9,1,5,24
191210873,0,9,9,3,6,27
191210874,2,6,9,2,1,20
191210875,5,6,9,3,0,23
191210876,9,0,7,5,6,27
191210877,4,4,1,5,9,23
191210878,6,4,9,3,5,27
191210879,8,2,7,7,6,30
191210880,4,4,2,3,8,21
191210881,1,3,3,7,5,19
191210882,5,8,4,0,5,22
191210883,2,4,0,7,0,13
191210884,1,3,8,7,1,20
191210885,3,8,5,0,9,25
191210886,7,4,6,2,7,26
191210887,9,0,7,5,9,30
191210888,9,7,3,3,2,24
191210889,8,5,6,1,5,25
191210890,2,7,2,0,1,12
191210891,9,4,7,0,8,28
191210892,9,3,6,7,8,33
191210893,3,4,0,6,0,13
191210894,6,5,1,5,7,24
191210895,6,4,4,0,6,20
191210896,0,7,7,0,3,17
191210897,9,6,0,6,7,28
191210898,1,1,6,8,9,25
191210899,9,6,7,6,3,31
191210900,9,1,4,3,4,21
191210901,2,4,1,6,8,21
191210902,2,8,1,0,7,18
191210903,2,1,0,0,2,5
191210904,7,7,0,3,4,21
191210905,8,3,3,2,1,17
191210906,1,3,2,4,8,18
191210907,2,2,8,2,9,23
191210908,1,5,0,3,2,11
191210909,1,8,9,6,3,27
191210910,2,5,0,3,9,19
191210911,0,6,5,8,6,25
191210912,6,9,2,2,2,21
191210913,2,2,3,5,6,18
191210914,3,8,5,9,0,25
191210915,6,1,6,9,0,22
191210916,0,7,9,6,7,29
191210917,2,6,9,9,1,27
191210918,0,8,3,1,0,12
191210919,1,9,4,7,4,25
191210920,3,7,9,3,2,24
191210921,1,0,7,3,1,12
191210922,1,5,9,0,2,17
191210923,0,2,2,9,7,20
191210924,4,7,4,6,4,25
191210925,3,0,3,7,2,15
191210926,8,5,7,0,5,25
191210927,6,1,9,4,3,23
191210928,0,6,8,6,2,22
191210929,5,7,4,3,7,26
191210930,6,1,0,7,0,14
191210931,7,9,3,9,1,29
191210932,7,6,1,8,9,31
191210933,8,5,5,6,5,29
191210934,5,1,5,3,7,21
191210935,2,8,0,9,3,22
191210936,4,3,1,0,6,14
191210937,0,3,7,2,6,18
191210938,1,4,0,8,7,20
191210939,1,6,6,8,3,24
191210940,0,0,3,0,3,6
191210941,5,1,8,1,6,21
191210942,3,2,5,3,5,18
191210943,5,8,3,6,8,30
191210944,6,8,1,8,6,29
191210945,3,0,0,0,6,9
191210946,0,7,3,8,4,22
191210947,2,4,6,9,4,25
191210948,8,7,5,8,3,31
191210949,0,7,9,0,3,19
191210950,5,1,0,2,3,11
191210951,0,2,5,3,4,14
191210952,1,2,0,2,5,10
191210953,3,1,8,3,6,21
191210954,3,4,9,6,1,23
191210955,5,3,5,1,1,15
191210956,1,7,6,6,3,23
191210957,0,7,9,4,3,23
191210958,8,9,0,2,4,23
191210959,1,2,9,4,1,17
191210960,1,8,1,8,7,25
191210961,9,2,0,4,1,16
191210962,8,3,7,7,8,33
191210963,2,4,8,1,1,16
191210964,8,7,1,6,5,27
191210965,8,8,3,8,8,35
191210966,0,7,4,1,7,19
191210967,8,9,5,9,8,39
191210968,1,2,6,4,4,17
191210969,4,0,0,5,2,11
191210970,1,4,4,1,9,19
191210971,9,2,7,2,0,20
191210972,8,7,9,8,2,34
191210973,8,2,2,7,9,28
191210974,2,7,4,6,9,28
191210975,6,7,7,0,5,25
191210976,2,8,8,2,0,20
191210977,8,8,5,6,0,27
191210978,2,2,0,4,0,8
191210979,0,1,6,2,5,14
191210980,9,3,8,7,9,36
191210981,1,1,0,1,8,11
191210982,5,2,9,8,2,26
191210983,9,5,9,3,6,32
191210984,8,0,1,7,2,18
191210985,0,0,5,9,3,17
191210986,7,6,2,4,0,19
191210987,1,1,8,7,6,23
191210988,3,1,5,5,5,19
191210989,9,3,3,9,1,25
191210990,6,2,8,2,4,22
191210991,7,3,0,4,2,16
191210992,6,9,9,1,9,34
191210993,6,7,7,3,6,29
191210994,8,6,6,3,1,24
191210995,1,3,4,9,5,22
191210996,5,5,2,4,9,25
191210997,8,9,0,4,3,24
191210998,4,6,4,6,0,20
191210999,8,1,2,1,9,21
1912101000,9,6,4,0,7,26
1912101001,4,1,8,7,5,25
1912101002,0,3,4,3,7,17
1912101003,0,3,1,7,4,15
1912101004,2,0,8,0,5,15
1912101005,8,6,5,5,9,33
1912101006,1,2,8,3,6,20
1912101007,6,1,9,5,3,24
1912101008,8,8,6,6,5,33
1912101009,4,4,2,6,5,21
1912101010,2,2,8,6,9,27
1912101011,8,9,8,8,6,39
1912101012,6,9,2,2,1,20
1912101013,7,8,8,1,6,30
1912101014,9,1,4,7,7,28
1912101015,0,9,6,6,5,26
1912101016,3,6,4,0,8,21
1912101017,2,2,9,4,6,23
1912101018,7,7,2,5,3,24
1912101019,1,9,9,1,7,27
1912101020,5,7,6,0,1,19
1912101021,3,1,7,6,5,22
1912101022,7,9,1,7,3,27
1912101023,0,0,2,6,5,13
1912101024,7,1,5,1,7,21
1912101025,5,7,9,7,9,37
1912101026,3,7,3,2,5,20
1912101027,3,3,7,3,5,21
1912101028,6,0,5,4,7,22
1912101029,4,5,3,3,9,24
1912101030,3,2,1,8,5,19
1912101031,1,7,4,0,6,18
1912101032,4,1,0,7,0,12
1912101033,2,0,3,7,6,18
1912101034,2,0,0,0,1,3
1912101035,3,3,1,1,0,8
1912101036,4,8,8,9,0,29
1912101037,6,5,9,3,7,30
1912101038,3,7,6,3,3,22
1912101039,0,0,4,6,0,10
1912101040,6,9,3,7,3,28
1912101041,0,5,7,0,2,14
1912101042,9,5,4,8,3,29
1912101043,1,2,6,0,8,17
1912101044,8,2,2,1,0,13
1912101045,0,7,8,0,9,24
1912101046,1,0,0,3,7,11
1912101047,5,8,7,0,6,26
1912101048,0,7,7,9,5,28
1912101049,5,4,9,4,0,22
1912101050,7,0,6,2,3,18
1912101051,0,1,9,2,6,18
1912101052,4,5,5,7,4,25
1912101053,1,6,9,3,5,24
1912101054,4,1,8,1,5,19
1912101055,3,0,5,6,1,15
1912101056,3,7,0,3,9,22
1912101057,0,9,4,9,6,28
1912101058,7,0,5,9,4,25
1912101059,6,1,8,7,4,26
1912101060,5,9,1,8,3,26
1912101061,5,1,2,2,6,16
1912101062,1,8,0,5,3,17
1912101063,7,7,7,0,8,29
1912101064,4,8,1,7,9,29
1912101065,1,0,7,6,6,20
1912101066,0,4,8,1,6,19
1912101067,5,5,8,9,1,28
1912101068,2,8,3,8,4,25
1912101069,1,2,4,5,1,13
1912101070,4,6,4,0,3,17
1912101071,9,1,2,8,1,21
1912101072,8,1,8,7,1,25
1912101073,1,8,9,2,2,22
1912101074,2,6,6,4,7,25
1912101075,8,8,1,9,7,33
1912101076,7,4,7,9,7,34
1912101077,1,4,3,6,5,19
1912101078,2,9,0,7,4,22
1912101079,0,4,5,7,1,17
1912101080,8,4,1,8,2,23
1912101081,8,1,6,6,3,24
1912101082,3,2,9,8,8,30
1912101083,2,0,2,1,8,13
1912101084,8,3,1,4,0,16
1912101085,3,6,0,2,0,11
1912101086,2,1,5,4,7,19
1912101087,8,9,0,9,7,33
1912101088,8,9,6,6,3,32
1912101089,5,5,1,6,9,26
1912101090,4,3,0,9,9,25
1912101091,6,9,9,3,9,36
1912101092,4,0,5,2,8,19
1912101093,8,4,2,7,2,23
1912101094,7,7,9,5,9,37
1912101095,9,1,2,4,6,22
1912101096,3,3,8,3,9,26
1912101097,2,3,7,0,6,18
1912101098,7,6,4,2,0,19
1912101099,3,2,6,9,0,20
1912101100,8,7,2,1,6,24
1912101101,3,2,1,1,5,12
1912101102,6,5,6,8,5,30
1912101103,7,6,1,7,6,27
1912101104,0,5,4,0,8,17
1912101105,0,5,5,0,9,19
191211001,2,3,7,8,7,27
191211002,6,7,5,0,3,21
191211003,7,6,6,1,2,22
191211004,8,7,8,6,8,37
191211005,5,7,4,8,3,27
191211006,9,2,2,5,5,23
191211007,6,6,9,8,3,32
191211008,4,3,3,6,9,25
191211009,2,6,4,3,9,24
191211010,5,9,6,8,9,37
191211011,5,2,6,9,8,30
191211012,5,4,2,4,7,22
191211013,8,6,0,6,2,22
191211014,2,8,3,8,2,23
191211015,2,4,4,4,3,17
191211016,1,6,3,4,4,18
191211017,0,1,7,3,6,17
191211018,4,1,0,1,4,10
191211019,3,3,9,9,2,26
191211020,2,9,6,7,3,27
191211021,4,3,9,6,1,23
191211022,7,2,4,5,0,18
191211023,5,5,4,2,8,24
191211024,7,9,4,5,7,32
191211025,6,0,3,8,1,18
191211026,4,1,2,9,4,20
191211027,5,2,2,0,3,12
191211028,7,6,5,8,7,33
191211029,8,8,0,3,6,25
191211030,0,2,0,1,1,4
191211031,8,9,4,1,1,23
191211032,3,7,9,2,7,28
191211033,1,2,8,9,3,23
191211034,5,6,2,0,6,19
191211035,2,9,1,0,6,18
191211036,9,7,2,2,4,24
191211037,2,6,9,4,8,29
191211038,5,7,2,3,3,20
191211039,3,0,8,8,2,21
191211040,8,2,5,4,3,22
191211041,4,9,5,7,5,30
191211042,6,2,5,4,7,24
191211043,7,0,1,0,1,9
191211044,4,2,7,5,2,20
191211045,9,7,8,7,2,33
191211046,1,5,1,1,3,11
191211047,1,0,1,4,6,12
191211048,5,4,3,3,8,23
191211049,0,4,2,3,6,15
191211050,1,4,9,7,0,21
191211051,5,0,1,1,5,12
191211052,9,8,2,3,3,25
191211053,8,1,2,1,3,15
191211054,7,6,4,2,7,26
191211055,9,6,2,8,8,33
191211056,3,4,6,1,8,22
191211057,6,5,9,5,9,34
191211058,7,1,4,0,9,21
191211059,9,3,8,3,1,24
191211060,5,8,1,2,0,16
191211061,4,6,4,8,0,22
191211062,9,3,7,2,7,28
191211063,6,2,4,1,6,19
191211064,3,7,9,1,1,21
191211065,3,5,2,6,6,22
191211066,0,5,9,2,4,20
191211067,4,0,1,1,0,6
191211068,3,8,4,9,6,30
191211069,1,5,3,2,9,20
191211070,8,0,8,1,5,22
191211071,7,3,1,2,1,14
191211072,9,2,3,4,0,18
191211073,2,1,9,6,8,26
191211074,0,2,9,4,9,24
191211075,8,2,2,1,8,21
191211076,6,2,7,4,7,26
191211077,4,8,5,4,2,23
191211078,2,2,3,5,9,21
191211079,9,9,4,0,2,24
191211080,2,2,1,1,9,15
191211081,6,9,6,4,0,25
191211082,2,8,0,6,2,18
191211083,0,6,8,4,1,19
191211084,4,4,3,5,7,23
191211085,6,1,2,6,2,17
191211086,9,7,9,0,0,25
191211087,0,6,2,3,0,11
191211088,8,0,0,6,5,19
191211089,1,2,3,2,1,9
191211090,4,7,8,4,8,31
191211091,2,2,0,7,9,20
191211092,0,1,2,4,9,16
191211093,5,7,2,2,2,18
191211094,7,8,6,1,6,28
191211095,9,4,3,8,0,24
191211096,2,4,0,4,7,17
191211097,1,2,6,2,1,12
191211098,4,2,9,7,4,26
191211099,5,4,7,8,9,33
191211100,8,0,6,5,8,27
191211101,0,9,9,2,8,28
191211102,2,6,4,6,0,18
191211103,3,2,2,2,0,9
191211104,1,5,0,6,3,15
191211105,9,3,3,7,8,30
191211106,1,8,2,2,9,22
191211107,3,1,1,3,1,9
191211108,9,3,9,9,8,38
191211109,7,4,3,0,7,21
191211110,4,6,4,8,2,24
191211111,6,5,2,7,5,25
191211112,0,8,6,1,4,19
191211113,0,3,6,8,7,24
191211114,3,9,4,5,6,27
191211115,1,1,8,1,8,19
191211116,9,9,7,8,3,36
191211117,1,1,5,3,2,12
191211118,9,0,3,6,6,24
191211119,4,4,0,0,3,11
191211120,4,2,1,0,1,8
191211121,1,1,4,1,5,12
191211122,9,2,9,1,1,22
191211123,9,9,0,2,5,25
191211124,6,4,1,9,5,25
191211125,4,2,9,8,7,30
191211126,6,1,4,8,2,21
191211127,7,4,8,7,3,29
191211128,6,3,9,7,6,31
191211129,2,5,7,4,5,23
191211130,9,8,1,8,5,31
191211131,7,8,5,2,6,28
191211132,6,9,2,7,1,25
191211133,1,2,4,0,6,13
191211134,5,9,5,8,4,31
191211135,1,9,1,9,9,29
191211136,9,2,0,9,1,21
191211137,3,6,2,5,6,22
191211138,9,3,7,8,3,30
191211139,0,2,8,2,2,14
191211140,9,6,1,0,3,19
191211141,6,4,5,4,2,21
191211142,1,5,2,9,9,26
191211143,5,6,0,7,8,26
191211144,5,5,9,0,7,26
191211145,0,1,6,8,5,20
191211146,1,8,1,6,2,18
191211147,9,3,7,4,7,30
191211148,3,3,3,8,9,26
191211149,3,5,5,6,0,19
191211150,4,8,5,3,3,23
191211151,1,9,0,4,2,16
191211152,4,7,5,8,0,24
191211153,0,1,2,1,1,5
191211154,2,0,7,0,1,10
191211155,7,1,9,6,4,27
191211156,8,1,7,6,3,25
191211157,4,7,9,0,3,23
191211158,9,2,8,9,7,35
191211159,6,4,5,1,9,25
191211160,1,6,5,9,4,25
191211161,4,7,8,4,6,29
191211162,1,4,9,3,6,23
191211163,6,9,7,9,4,35
191211164,6,2,3,0,2,13
191211165,8,3,5,0,0,16
191211166,0,4,0,6,8,18
191211167,8,6,9,8,6,37
191211168,6,1,6,9,5,27
191211169,0,7,4,4,1,16
191211170,4,5,0,7,9,25
191211171,0,8,8,9,2,27
191211172,4,2,9,8,1,24
191211173,8,0,2,5,5,20
191211174,9,5,3,1,9,27
191211175,3,6,1,2,2,14
191211176,8,5,2,8,8,31
191211177,7,5,8,2,9,31
191211178,6,6,2,2,9,25
191211179,1,3,9,6,9,28
191211180,5,2,9,1,5,22
191211181,4,9,1,0,2,16
191211182,2,4,7,1,5,19
191211183,5,9,0,7,2,23
191211184,0,8,3,5,5,21
191211185,3,3,7,7,3,23
191211186,0,4,6,0,7,17
191211187,8,9,1,7,9,34
191211188,5,5,2,5,5,22
191211189,2,9,6,2,2,21
191211190,9,8,4,2,2,25
191211191,0,9,0,5,0,14
191211192,2,0,0,3,0,5
191211193,7,1,5,8,8,29
191211194,4,7,2,0,9,22
191211195,8,3,4,7,9,31
191211196,5,3,6,9,0,23
191211197,7,3,2,9,1,22
191211198,3,5,7,3,9,27
191211199,3,3,3,4,8,21
191211200,7,6,4,8,4,29
191211201,0,6,0,0,1,7
191211202,7,8,2,2,1,20
191211203,1,1,6,4,6,18
191211204,6,2,9,5,2,24
191211205,9,2,2,0,7,20
191211206,7,9,8,4,8,36
191211207,1,9,2,5,8,25
191211208,9,0,8,1,5,23
191211209,4,1,9,3,8,25
191211210,5,5,5,4,2,21
191211211,4,9,1,7,7,28
191211212,3,5,5,3,5,21
191211213,6,3,7,8,9,33
191211214,1,1,3,5,1,11
191211215,9,9,8,2,7,35
191211216,4,9,6,1,8,28
191211217,6,5,8,3,8,30
191211218,2,3,5,6,2,18
191211219,6,0,5,0,2,13
191211220,3,5,8,8,1,25
191211221,7,8,2,1,4,22
191211222,4,5,9,4,4,26
191211223,2,9,5,7,7,30
191211224,2,5,7,4,1,19
191211225,8,8,6,7,1,30
191211226,3,0,8,2,0,13
191211227,7,7,5,3,0,22
191211228,2,3,0,8,1,14
191211229,6,3,2,9,7,27
191211230,9,5,7,7,9,37
191211231,8,7,6,6,0,27
191211232,8,7,4,8,6,33
191211233,4,4,9,5,2,24
191211234,8,7,5,3,4,27
191211235,9,3,6,0,8,26
191211236,4,1,1,5,5,16
191211237,9,1,3,7,7,27
191211238,7,2,0,0,8,17
191211239,6,1,4,5,7,23
191211240,6,1,4,6,5,22
191211241,2,1,5,5,0,13
191211242,3,4,9,4,1,21
191211243,5,3,5,9,5,27
191211244,6,0,9,3,0,18
191211245,2,1,8,8,3,22
191211246,3,6,3,4,7,23
191211247,8,3,1,2,7,21
191211248,9,9,3,4,1,26
191211249,4,2,2,3,9,20
191211250,7,5,4,4,3,23
191211251,6,1,7,9,2,25
191211252,4,6,2,8,0,20
191211253,6,6,7,4,5,28
191211254,7,8,1,7,9,32
191211255,7,8,2,7,6,30
191211256,1,1,4,2,1,9
191211257,1,8,0,3,5,17
191211258,0,0,5,6,4,15
191211259,1,5,4,4,1,15
191211260,1,2,6,6,6,21
191211261,3,3,1,8,8,23
191211262,8,4,8,2,7,29
191211263,2,7,4,1,7,21
191211264,9,0,2,2,1,14
191211265,1,7,2,5,1,16
191211266,0,6,7,6,3,22
191211267,5,8,5,8,2,28
191211268,3,9,6,6,8,32
191211269,9,7,3,6,1,26
191211270,7,7,0,2,6,22
191211271,2,2,6,4,2,16
191211272,5,9,6,9,8,37
191211273,6,2,2,0,5,15
191211274,7,6,9,1,1,24
191211275,7,7,0,8,6,28
191211276,6,1,0,4,2,13
191211277,5,8,3,7,5,28
191211278,5,0,5,8,4,22
191211279,8,6,7,2,7,30
191211280,6,2,1,8,4,21
191211281,9,8,4,7,0,28
191211282,8,4,8,0,5,25
191211283,6,1,4,4,2,17
191211284,6,9,7,2,8,32
191211285,2,4,4,0,6,16
191211286,2,1,1,9,0,13
191211287,5,1,9,1,0,16
191211288,3,5,5,1,4,18
191211289,1,3,9,9,0,22
191211290,5,0,0,3,9,17
191211291,4,2,8,7,5,26
191211292,0,6,5,6,2,19
191211293,6,0,2,3,9,20
191211294,5,5,6,5,9,30
191211295,0,5,0,7,3,15
191211296,2,2,4,7,3,18
191211297,2,5,8,7,0,22
191211298,4,5,9,6,5,29
191211299,7,9,1,2,6,25
191211300,2,0,0,5,8,15
191211301,1,5,7,3,1,17
191211302,9,5,9,6,0,29
191211303,9,9,2,8,2,30
191211304,5,4,5,7,5,26
191211305,8,1,7,3,0,19
191211306,0,6,4,6,6,22
191211307,5,8,3,4,0,20
191211308,9,3,2,4,5,23
191211309,9,2,0,3,2,16
191211310,5,2,1,4,0,12
191211311,8,7,7,0,4,26
191211312,9,6,3,7,5,30
191211313,6,4,5,7,3,25
191211314,4,5,9,0,3,21
191211315,5,5,5,7,7,29
191211316,3,3,5,0,2,13
191211317,3,2,6,9,6,26
191211318,1,4,7,6,4,22
191211319,4,0,7,4,9,24
191211320,6,4,4,3,9,26
191211321,3,0,1,1,7,12
191211322,9,4,4,4,3,24
191211323,1,1,7,2,0,11
191211324,1,4,6,7,7,25
191211325,4,9,9,7,9,38
191211326,0,1,3,3,4,11
191211327,2,1,1,5,9,18
191211328,3,9,6,8,8,34
191211329,5,0,4,1,5,15
191211330,1,7,8,2,3,21
191211331,3,9,2,1,3,18
191211332,0,1,0,8,7,16
191211333,0,6,3,4,8,21
191211334,4,6,2,0,0,12
191211335,9,5,0,3,0,17
191211336,2,1,3,2,7,15
191211337,3,6,1,8,2,20
191211338,5,4,5,5,4,23
191211339,8,4,4,3,9,28
191211340,3,1,5,6,2,17
191211341,5,2,5,1,1,14
191211342,1,9,3,6,1,20
191211343,4,6,7,6,3,26
191211344,6,6,5,1,8,26
191211345,1,9,7,1,5,23
191211346,8,5,7,1,2,23
191211347,9,0,5,6,0,20
191211348,4,2,3,2,6,17
191211349,7,5,8,6,2,28
191211350,2,4,4,0,4,14
191211351,6,5,6,8,7,32
191211352,5,7,2,2,8,24
191211353,2,9,2,9,5,27
191211354,6,9,8,5,3,31
191211355,3,7,1,8,8,27
191211356,0,4,0,4,4,12
191211357,4,4,6,5,3,22
191211358,7,6,7,7,0,27
191211359,7,2,9,4,8,30
191211360,9,2,2,5,8,26
191211361,5,5,0,7,6,23
191211362,7,5,2,3,4,21
191211363,8,5,9,2,7,31
191211364,8,3,5,2,1,19
191211365,8,4,2,3,8,25
191211366,8,9,6,3,6,32
191211367,2,4,3,6,9,24
191211368,7,1,0,9,3,20
191211369,2,7,0,8,0,17
191211370,1,9,9,3,3,25
191211371,4,3,6,0,2,15
191211372,4,6,0,1,9,20
191211373,0,3,7,3,2,15
191211374,2,1,3,9,8,23
191211375,9,0,5,0,6,20
191211376,1,7,7,8,6,29
191211377,9,1,2,3,0,15
191211378,9,3,5,2,8,27
191211379,0,7,8,7,2,24
191211380,1,9,5,0,2,17
191211381,5,6,6,5,5,27
191211382,0,3,3,3,8,17
191211383,3,1,6,9,5,24
191211384,0,9,2,1,6,18
191211385,6,3,7,1,0,17
191211386,2,5,3,1,7,18
191211387,7,3,8,6,9,33
191211388,6,0,5,6,4,21
191211389,3,9,5,8,3,28
191211390,3,0,6,8,5,22
191211391,8,3,5,0,1,17
191211392,4,8,5,1,9,27
191211393,9,2,7,1,5,24
191211394,4,1,5,2,1,13
191211395,2,0,7,9,1,19
191211396,5,0,2,0,6,13
191211397,0,8,3,1,8,20
191211398,7,7,5,4,4,27
191211399,7,1,8,8,1,25
191211400,4,8,4,5,5,26
191211401,7,7,1,0,1,16
191211402,7,8,2,2,2,21
191211403,2,7,8,2,8,27
191211404,1,4,1,0,5,11
191211405,9,1,3,1,8,22
191211406,2,6,8,9,9,34
191211407,8,9,8,4,4,33
191211408,5,8,4,5,5,27
191211409,4,7,7,3,8,29
191211410,6,0,8,2,5,21
191211411,7,6,6,4,1,24
191211412,3,2,9,7,1,22
191211413,8,3,1,8,0,20
191211414,6,9,2,6,5,28
191211415,8,8,0,2,2,20
191211416,7,4,1,6,5,23
191211417,3,8,9,4,9,33
191211418,8,0,1,8,3,20
191211419,7,7,8,8,2,32
191211420,2,2,6,6,2,18
191211421,4,1,4,3,1,13
191211422,8,5,2,0,3,18
191211423,8,2,7,2,7,26
191211424,7,6,0,4,5,22
191211425,9,7,3,6,0,25
191211426,1,4,3,7,8,23
191211427,5,3,2,6,4,20
191211428,8,7,7,3,9,34
191211429,3,4,3,5,3,18
191211430,8,3,1,4,8,24
191211431,8,7,0,4,4,23
191211432,3,6,2,2,0,13
191211433,5,9,7,4,2,27
191211434,1,5,3,7,7,23
191211435,7,1,3,1,7,19
191211436,9,1,4,5,1,20
191211437,6,5,2,8,5,26
191211438,2,7,5,8,4,26
191211439,1,0,8,4,7,20
191211440,2,8,1,2,0,13
191211441,0,0,3,5,1,9
191211442,0,6,3,7,4,20
191211443,9,0,2,2,6,19
191211444,1,4,6,0,2,13
191211445,0,3,6,7,4,20
191211446,9,3,8,3,3,26
191211447,0,1,9,0,3,13
191211448,2,4,5,7,8,26
191211449,5,2,3,5,0,15
191211450,7,4,0,7,5,23
191211451,7,0,6,0,4,17
191211452,2,1,4,7,0,14
191211453,6,1,4,7,8,26
191211454,6,2,0,0,9,17
191211455,0,4,1,9,1,15
191211456,7,9,9,3,3,31
191211457,7,7,7,8,7,36
191211458,9,3,7,9,0,28
191211459,8,3,5,6,8,30
191211460,3,0,5,7,5,20
191211461,5,2,6,3,5,21
191211462,1,3,5,4,8,21
191211463,6,1,3,4,9,23
191211464,9,7,8,1,3,28
191211465,0,5,1,1,4,11
191211466,1,7,3,6,6,23
191211467,0,8,2,4,2,16
191211468,2,1,4,7,7,21
191211469,6,9,5,9,0,29
191211470,7,8,0,5,9,29
191211471,5,0,4,8,8,25
191211472,4,4,0,4,0,12
191211473,5,2,2,3,9,21
191211474,9,8,9,1,0,27
191211475,9,4,2,8,9,32
191211476,9,7,2,4,6,28
191211477,0,2,3,2,8,15
191211478,1,6,0,9,8,24
191211479,0,3,3,5,4,15
191211480,7,5,1,2,4,19
191211481,2,2,2,0,3,9
191211482,4,5,4,7,7,27
191211483,9,4,7,0,6,26
191211484,0,4,2,2,2,10
191211485,4,9,3,9,0,25
191211486,6,6,0,2,9,23
191211487,3,5,6,0,1,15
191211488,7,7,8,0,2,24
191211489,9,3,9,8,3,32
191211490,9,8,4,6,8,35
191211491,9,3,7,6,8,33
191211492,0,0,5,7,5,17
191211493,0,7,2,0,0,9
191211494,6,2,5,5,3,21
191211495,5,6,2,2,4,19
191211496,3,8,2,1,8,22
191211497,3,2,6,8,2,21
191211498,1,8,2,4,5,20
191211499,4,3,6,2,8,23
191211500,1,6,3,0,8,18
191211501,2,1,0,0,9,12
191211502,3,5,3,1,2,14
191211503,3,3,9,1,8,24
191211504,8,8,7,7,7,37
191211505,9,1,5,6,5,26
191211506,3,5,3,2,7,20
191211507,1,7,4,2,0,14
191211508,5,3,9,6,5,28
191211509,3,5,2,3,1,14
191211510,5,7,1,2,6,21
191211511,6,4,9,2,4,25
191211512,7,8,7,9,8,39
191211513,0,9,2,0,2,13
191211514,6,9,3,5,9,32
191211515,5,2,2,2,5,16
191211516,8,4,1,7,3,23
191211517,1,9,3,8,2,23
191211518,6,9,1,9,5,30
191211519,9,6,5,3,2,25
191211520,6,3,9,7,8,33
191211521,4,4,6,7,1,22
191211522,0,8,3,1,9,21
191211523,4,8,4,4,2,22
191211524,1,9,2,9,5,26
191211525,4,0,8,9,9,30
191211526,1,9,3,2,5,20
191211527,2,0,6,1,7,16
191211528,8,5,1,4,4,22
191211529,0,7,9,7,1,24
191211530,8,8,1,3,1,21
191211531,4,0,5,2,2,13
191211532,7,4,1,0,3,15
191211533,9,3,2,1,5,20
191211534,6,7,0,9,0,22
191211535,8,3,4,4,8,27
191211536,5,0,2,9,4,20
191211537,7,5,7,6,0,25
191211538,9,9,2,1,4,25
191211539,6,2,7,7,4,26
191211540,5,9,3,9,2,28
191211541,9,0,5,7,5,26
191211542,8,7,2,8,2,27
191211543,5,5,3,1,5,19
191211544,1,1,7,2,1,12
191211545,1,6,0,7,4,18
191211546,7,2,9,4,6,28
191211547,5,5,9,9,1,29
191211548,5,4,0,2,2,13
191211549,6,5,3,0,2,16
191211550,3,6,0,2,3,14
191211551,8,8,2,1,2,21
191211552,3,0,9,1,6,19
191211553,3,7,4,1,0,15
191211554,8,6,4,3,4,25
191211555,5,5,2,4,3,19
191211556,2,8,5,8,4,27
191211557,9,9,1,0,1,20
191211558,3,2,3,9,8,25
191211559,8,8,2,8,8,34
191211560,4,0,0,9,4,17
191211561,3,6,0,9,7,25
191211562,4,1,0,8,9,22
191211563,6,9,5,2,8,30
191211564,5,4,9,4,9,31
191211565,4,4,6,7,3,24
191211566,6,9,7,8,1,31
191211567,2,5,7,5,0,19
191211568,7,8,5,9,7,36
191211569,8,8,6,4,2,28
191211570,5,7,6,9,0,27
191211571,2,6,4,9,6,27
191211572,5,0,3,3,0,11
191211573,9,5,0,6,8,28
191211574,3,3,3,4,4,17
191211575,3,1,2,8,6,20
191211576,4,2,3,8,0,17
191211577,3,0,3,2,8,16
191211578,5,1,4,6,4,20
191211579,0,9,5,2,2,18
191211580,5,8,3,4,8,28
191211581,8,5,3,5,6,27
191211582,1,5,0,1,0,7
191211583,7,8,9,6,0,30
191211584,9,3,2,5,0,19
191211585,2,4,5,5,0,16
191211586,1,7,0,5,3,16
191211587,2,8,7,7,3,27
191211588,1,5,6,8,0,20
191211589,9,6,8,4,3,30
191211590,2,2,6,7,2,19
191211591,8,7,4,3,0,22
191211592,6,7,1,5,7,26
191211593,1,7,8,5,9,30
191211594,0,7,6,5,6,24
191211595,5,4,9,1,1,20
191211596,8,0,3,1,3,15
191211597,0,9,1,5,3,18
191211598,0,1,3,2,5,11
191211599,3,0,0,1,9,13
191211600,0,6,8,3,4,21
191211601,4,6,8,4,7,29
191211602,6,0,7,5,9,27
191211603,7,8,2,9,0,26
191211604,8,5,0,1,7,21
191211605,1,5,6,1,9,22
191211606,3,1,7,4,6,21
191211607,4,8,0,3,3,18
191211608,6,7,9,0,0,22
191211609,2,5,6,9,1,23
191211610,8,3,6,9,3,29
191211611,0,8,5,7,3,23
191211612,2,3,8,2,5,20
191211613,6,7,3,0,7,23
191211614,6,1,1,3,1,12
191211615,5,0,4,5,1,15
191211616,2,8,9,3,4,26
191211617,5,5,7,1,3,21
191211618,6,0,7,4,2,19
191211619,8,5,5,5,2,25
191211620,1,3,4,9,1,18
191211621,8,6,6,5,2,27
191211622,3,6,5,2,4,20
191211623,9,4,1,0,9,23
191211624,1,7,2,0,8,18
191211625,9,3,5,3,3,23
191211626,0,6,2,0,8,16
191211627,7,0,1,8,7,23
191211628,9,8,8,1,8,34
191211629,6,7,4,3,3,23
191211630,2,8,3,2,5,20
191211631,1,5,8,2,8,24
191211632,4,5,1,8,8,26
191211633,0,7,1,0,7,15
191211634,5,6,2,2,3,18
191211635,4,8,0,9,7,28
191211636,9,6,8,1,1,25
191211637,0,9,5,8,6,28
191211638,9,6,6,7,3,31
191211639,2,1,1,3,3,10
191211640,4,8,6,7,8,33
191211641,0,1,1,9,9,20
191211642,5,7,6,7,3,28
191211643,1,0,1,1,2,5
191211644,3,4,9,9,7,32
191211645,7,7,6,0,6,26
191211646,3,1,2,8,1,15
191211647,7,0,2,7,9,25
191211648,6,0,9,3,7,25
191211649,4,8,2,5,0,19
191211650,4,6,2,7,7,26
191211651,3,8,7,6,2,26
191211652,7,6,9,0,2,24
191211653,0,6,0,0,3,9
191211654,3,7,9,0,9,28
191211655,3,0,9,9,5,26
191211656,2,4,4,7,6,23
191211657,7,3,5,3,3,21
191211658,6,1,9,9,2,27
191211659,2,5,9,1,1,18
191211660,8,5,7,7,7,34
191211661,0,6,6,8,9,29
191211662,2,0,8,2,6,18
191211663,2,9,5,3,2,21
191211664,9,7,1,3,0,20
191211665,3,3,0,0,6,12
191211666,5,2,9,8,7,31
191211667,8,7,6,1,6,28
191211668,2,0,6,1,8,17
191211669,9,9,2,5,1,26
191211670,8,4,4,2,7,25
191211671,7,1,2,4,9,23
191211672,8,6,2,1,0,17
191211673,5,5,4,1,0,15
191211674,9,4,1,2,8,24
191211675,5,3,6,1,9,24
191211676,1,8,8,2,2,21
191211677,4,5,1,5,1,16
191211678,2,8,6,9,9,34
191211679,8,6,6,8,2,30
191211680,2,1,0,6,3,12
191211681,5,7,7,6,3,28
191211682,1,9,7,5,4,26
191211683,3,6,2,7,3,21
191211684,3,1,2,0,9,15
191211685,1,3,4,2,2,12
191211686,3,3,7,1,4,18
191211687,6,1,8,3,5,23
191211688,4,8,1,0,9,22
191211689,5,5,8,5,1,24
191211690,6,4,6,3,0,19
191211691,0,4,4,4,7,19
191211692,1,5,0,9,2,17
191211693,6,0,7,3,1,17
191211694,2,7,2,2,7,20
191211695,0,6,3,6,6,21
191211696,1,9,7,6,9,32
191211697,6,5,9,1,3,24
191211698,5,4,1,3,6,19
191211699,5,9,5,8,7,34
191211700,8,8,8,0,9,33
191211701,2,5,3,3,7,20
191211702,7,8,2,8,1,26
191211703,1,5,5,8,6,25
191211704,9,6,2,3,0,20
191211705,9,0,4,3,3,19
191211706,6,0,3,6,4,19
191211707,7,0,4,0,1,12
191211708,6,5,8,1,1,21
191211709,0,5,9,8,0,22
191211710,8,1,0,5,5,19
191211711,3,6,3,5,3,20
191211712,0,3,9,7,0,19
191211713,2,2,6,6,6,22
191211714,2,9,1,1,9,22
191211715,5,2,8,3,5,23
191211716,7,5,3,9,8,32
191211717,5,6,4,3,5,23
191211718,3,8,3,2,4,20
191211719,3,5,5,5,4,22
191211720,2,1,3,6,7,19
191211721,1,2,2,7,7,19
191211722,3,3,7,0,6,19
191211723,4,6,6,7,0,23
191211724,2,6,3,9,3,23
191211725,3,6,8,5,2,24
191211726,3,4,3,3,9,22
191211727,9,5,8,2,6,30
191211728,0,4,9,0,3,16
191211729,5,4,4,5,4,22
191211730,7,0,6,5,6,24
191211731,0,7,3,7,2,19
191211732,4,1,0,6,9,20
191211733,9,8,3,8,7,35
191211734,3,4,2,9,7,25
191211735,6,6,3,6,3,24
191211736,5,0,9,1,1,16
191211737,8,5,8,9,0,30
191211738,7,7,7,1,0,22
191211739,0,2,2,9,9,22
191211740,2,5,9,8,9,33
191211741,9,5,7,5,9,35
191211742,6,5,3,6,7,27
191211743,9,0,3,3,6,21
191211744,3,3,2,2,2,12
191211745,9,3,5,1,0,18
191211746,8,6,5,5,2,26
191211747,7,6,7,3,7,30
191211748,4,0,9,6,6,25
191211749,2,3,7,3,2,17
191211750,7,8,4,0,3,22
191211751,2,9,5,3,3,22
191211752,1,9,8,0,3,21
191211753,0,0,1,5,8,14
191211754,3,2,9,0,4,18
191211755,0,2,1,6,2,11
191211756,9,0,4,9,1,23
191211757,2,2,8,3,8,23
191211758,1,6,3,0,3,13
191211759,3,1,7,8,0,19
191211760,9,1,2,4,2,18
191211761,8,9,9,1,2,29
191211762,5,8,5,7,1,26
191211763,4,6,6,8,1,25
191211764,4,2,9,8,6,29
191211765,3,8,1,9,5,26
191211766,8,8,0,0,6,22
191211767,0,7,0,9,8,24
191211768,4,2,9,1,8,24
191211769,7,4,0,3,0,14
191211770,5,1,2,5,8,21
191211771,9,4,9,2,6,30
191211772,2,9,4,5,9,29
191211773,8,4,8,7,3,30
191211774,2,1,6,9,6,24
191211775,2,2,5,0,4,13
191211776,0,2,3,6,0,11
191211777,8,4,9,7,6,34
191211778,3,9,4,0,6,22
191211779,9,1,3,3,6,22
191211780,3,5,0,4,6,18
191211781,1,6,7,8,4,26
191211782,7,6,9,1,8,31
191211783,9,2,1,0,8,20
191211784,5,1,0,4,5,15
191211785,3,5,8,7,4,27
191211786,7,4,1,0,0,12
191211787,7,0,9,9,9,34
191211788,4,5,6,2,2,19
191211789,8,2,8,2,7,27
191211790,4,8,6,1,3,22
191211791,9,2,5,7,5,28
191211792,5,6,4,7,8,30
191211793,8,5,8,0,4,25
191211794,9,5,6,4,0,24
191211795,1,7,4,0,4,16
191211796,0,2,3,2,5,12
191211797,4,0,2,9,7,22
191211798,7,2,2,0,8,19
191211799,6,2,8,1,7,24
191211800,6,0,4,1,2,13
191211801,5,6,4,8,0,23
191211802,2,4,8,9,5,28
191211803,5,6,3,0,8,22
191211804,2,2,0,9,2,15
191211805,0,9,8,9,8,34
191211806,9,7,3,7,3,29
191211807,7,4,3,8,2,24
191211808,3,9,2,6,8,28
191211809,0,8,1,2,8,19
191211810,0,9,4,7,0,20
191211811,3,9,6,6,7,31
191211812,4,1,9,9,7,30
191211813,5,2,0,7,5,19
191211814,0,1,9,9,7,26
191211815,5,8,0,6,6,25
191211816,1,9,1,8,3,22
191211817,3,3,2,0,2,10
191211818,2,8,2,9,1,22
191211819,7,7,0,6,7,27
191211820,7,8,7,4,5,31
191211821,5,9,7,9,7,37
191211822,1,5,4,7,4,21
191211823,4,3,1,5,4,17
191211824,8,3,3,7,6,27
191211825,1,2,8,3,3,17
191211826,9,1,5,3,3,21
191211827,8,2,7,1,6,24
191211828,9,2,4,6,3,24
191211829,0,8,8,8,4,28
191211830,9,9,4,0,3,25
191211831,2,8,5,6,8,29
191211832,5,1,2,1,0,9
191211833,4,7,9,2,5,27
191211834,3,2,9,1,6,21
191211835,3,8,6,8,3,28
191211836,2,0,1,6,3,12
191211837,6,5,7,7,5,30
191211838,7,2,0,6,0,15
191211839,0,5,3,3,0,11
191211840,8,3,8,7,2,28
191211841,6,2,5,8,8,29
191211842,3,8,7,1,0,19
191211843,0,8,6,1,3,18
191211844,6,3,1,6,7,23
191211845,7,7,2,8,5,29
191211846,6,5,3,9,0,23
191211847,6,2,2,7,0,17
191211848,6,0,1,4,1,12
191211849,8,5,4,4,8,29
191211850,2,3,5,6,1,17
191211851,1,9,0,1,3,14
191211852,3,6,7,0,8,24
191211853,8,8,5,6,2,29
191211854,3,5,7,0,6,21
191211855,2,4,8,9,6,29
191211856,2,4,9,0,7,22
191211857,6,8,0,1,9,24
191211858,8,8,6,1,7,30
191211859,4,2,3,2,8,19
191211860,7,2,5,7,7,28
191211861,1,5,7,8,1,22
191211862,5,1,7,3,8,24
191211863,0,2,6,9,8,25
191211864,2,4,1,6,4,17
191211865,2,7,7,1,0,17
191211866,1,3,6,9,9,28
191211867,4,6,3,7,6,26
191211868,9,4,2,1,8,24
191211869,9,7,8,8,7,39
191211870,2,4,7,3,9,25
191211871,2,3,6,9,4,24
191211872,7,5,4,0,2,18
191211873,7,4,6,2,1,20
191211874,9,0,9,7,4,29
191211875,4,4,0,9,4,21
191211876,5,5,8,9,4,31
191211877,3,6,2,8,8,27
191211878,1,3,3,3,4,14
191211879,3,4,1,7,4,19
191211880,5,5,8,4,2,24
191211881,8,4,5,2,0,19
191211882,0,5,4,5,6,20
191211883,9,8,1,4,0,22
191211884,3,3,1,5,0,12
191211885,7,3,2,4,6,22
191211886,2,5,1,2,5,15
191211887,9,5,3,6,5,28
191211888,9,7,2,8,1,27
191211889,2,0,3,3,4,12
191211890,5,5,5,8,3,26
191211891,2,7,8,8,5,30
191211892,6,0,2,1,4,13
191211893,7,5,4,4,1,21
191211894,4,1,7,0,0,12
191211895,7,8,7,8,2,32
191211896,9,6,0,5,2,22
191211897,6,1,5,1,8,21
191211898,5,2,0,7,3,17
191211899,6,4,0,9,3,22
191211900,3,1,4,5,7,20
191211901,0,9,4,1,5,19
191211902,9,4,6,4,3,26
191211903,7,1,1,1,2,12
191211904,3,4,1,0,7,15
191211905,6,4,6,6,1,23
191211906,4,5,8,2,2,21
191211907,0,0,7,6,3,16
191211908,6,6,0,6,2,20
191211909,3,7,1,4,5,20
191211910,0,8,8,3,5,24
191211911,4,8,5,6,2,25
191211912,9,4,8,9,9,39
191211913,4,3,5,5,7,24
191211914,2,2,3,9,3,19
191211915,1,1,7,1,4,14
191211916,7,7,5,1,7,27
191211917,4,3,1,8,4,20
191211918,3,9,4,5,3,24
191211919,8,2,4,8,5,27
191211920,9,7,1,9,9,35
191211921,6,8,8,4,8,34
191211922,0,4,7,5,9,25
191211923,2,0,5,9,4,20
191211924,6,6,2,5,2,21
191211925,8,1,0,8,3,20
191211926,4,2,5,0,7,18
191211927,8,7,5,0,8,28
191211928,9,5,0,1,8,23
191211929,8,6,5,3,3,25
191211930,3,3,9,5,8,28
191211931,9,3,9,7,6,34
191211932,1,0,9,9,7,26
191211933,9,0,5,6,5,25
191211934,7,8,4,6,5,30
191211935,1,6,2,5,5,19
191211936,3,9,1,2,0,15
191211937,6,7,0,6,1,20
191211938,7,4,2,2,6,21
191211939,0,2,0,5,7,14
191211940,4,8,9,3,0,24
191211941,0,4,5,8,5,22
191211942,7,5,0,3,7,22
191211943,9,6,4,2,4,25
191211944,1,6,8,0,6,21
191211945,2,2,1,9,1,15
191211946,1,5,5,2,4,17
191211947,1,2,3,1,3,10
191211948,3,7,7,5,6,28
191211949,9,1,6,4,3,23
191211950,4,0,7,0,0,11
191211951,1,9,1,7,9,27
191211952,7,7,6,1,8,29
191211953,1,6,2,7,5,21
191211954,2,4,8,5,0,19
191211955,2,8,3,0,1,14
191211956,7,9,3,9,0,28
191211957,5,5,0,7,0,17
191211958,8,6,3,7,7,31
191211959,6,7,7,0,3,23
191211960,0,3,0,8,7,18
191211961,4,6,5,0,9,24
191211962,1,8,2,3,9,23
191211963,4,0,6,5,2,17
191211964,4,1,2,6,3,16
191211965,3,7,8,1,0,19
191211966,7,5,3,6,5,26
191211967,5,9,9,7,2,32
191211968,5,0,1,7,1,14
191211969,1,4,9,4,5,23
191211970,9,3,7,8,1,28
191211971,9,2,3,7,2,23
191211972,2,8,5,3,9,27
191211973,9,0,1,6,1,17
191211974,5,1,3,3,8,20
191211975,0,6,2,0,7,15
191211976,8,8,1,4,9,30
191211977,9,9,7,1,4,30
191211978,4,7,5,4,9,29
191211979,1,3,5,7,4,20
191211980,8,5,8,3,5,29
191211981,5,6,3,9,0,23
191211982,0,8,0,3,9,20
191211983,7,3,9,1,4,24
191211984,3,9,8,1,1,22
191211985,3,1,5,3,8,20
191211986,7,1,0,4,7,19
191211987,1,2,4,9,8,24
191211988,1,0,9,4,5,19
191211989,6,4,4,6,9,29
191211990,1,7,2,8,0,18
191211991,3,6,4,2,5,20
191211992,2,1,6,2,7,18
191211993,7,6,7,3,1,24
191211994,8,4,2,8,3,25
191211995,7,9,5,1,5,27
191211996,5,9,3,9,1,27
191211997,8,9,3,7,4,31
191211998,8,2,3,5,1,19
191211999,4,7,1,2,1,15
1912111000,1,6,4,9,8,28
1912111001,2,4,1,7,6,20
1912111002,5,5,2,8,8,28
1912111003,2,8,8,8,9,35
1912111004,9,0,0,3,8,20
1912111005,6,0,0,4,2,12
1912111006,0,7,5,8,4,24
1912111007,1,0,4,0,5,10
1912111008,3,3,0,9,1,16
1912111009,0,4,1,1,2,8
1912111010,2,1,4,4,9,20
1912111011,0,8,7,0,8,23
1912111012,5,2,4,9,7,27
1912111013,0,7,1,8,2,18
1912111014,0,6,6,7,0,19
1912111015,2,6,5,4,9,26
1912111016,0,0,1,1,3,5
1912111017,9,3,7,5,3,27
1912111018,5,3,9,3,4,24
1912111019,3,5,3,9,9,29
1912111020,0,0,0,7,0,7
1912111021,7,0,1,1,5,14
1912111022,0,6,1,7,0,14
1912111023,2,9,9,5,4,29
1912111024,5,3,3,4,7,22
1912111025,3,8,3,4,9,27
1912111026,7,7,3,0,2,19
1912111027,1,6,3,8,3,21
1912111028,0,1,9,3,1,14
1912111029,7,7,5,1,0,20
1912111030,1,4,7,4,6,22
1912111031,8,1,6,0,5,20
1912111032,9,5,8,0,5,27
1912111033,3,2,3,4,6,18
1912111034,6,7,9,4,9,35
1912111035,1,7,2,3,1,14
1912111036,4,9,8,7,8,36
1912111037,7,2,0,4,2,15
1912111038,0,3,9,6,4,22
1912111039,1,3,6,4,4,18
1912111040,7,8,0,1,9,25
1912111041,0,9,7,3,8,27
1912111042,2,6,9,4,1,22
1912111043,4,8,2,1,2,17
1912111044,5,8,2,8,7,30
1912111045,4,3,0,7,4,18
1912111046,1,3,6,7,1,18
1912111047,3,8,5,5,2,23
1912111048,0,5,9,5,5,24
1912111049,1,0,5,4,3,13
1912111050,7,8,5,6,8,34
1912111051,7,5,7,4,2,25
1912111052,5,4,5,3,8,25
1912111053,7,8,7,9,1,32
1912111054,2,1,1,5,8,17
1912111055,8,8,5,7,3,31
1912111056,8,7,1,6,3,25
1912111057,2,8,7,2,6,25
1912111058,7,5,9,3,8,32
1912111059,6,9,2,2,7,26
1912111060,9,5,6,8,7,35
1912111061,8,5,1,2,7,23
1912111062,0,3,9,5,6,23
1912111063,8,6,9,2,2,27
1912111064,9,0,7,0,3,19
1912111065,5,6,6,6,4,27
1912111066,5,0,2,2,1,10
1912111067,4,2,2,2,5,15
1912111068,3,9,5,5,1,23
1912111069,0,1,5,2,6,14
1912111070,8,1,2,8,2,21
1912111071,5,3,4,6,3,21
1912111072,6,6,8,4,1,25
1912111073,8,4,2,6,8,28
1912111074,1,0,5,4,2,12
1912111075,2,6,0,6,3,17
1912111076,7,3,0,7,8,25
1912111077,9,3,5,8,7,32
1912111078,4,7,5,5,6,27
1912111079,0,1,9,5,9,24
1912111080,0,6,7,4,2,19
1912111081,3,9,0,8,4,24
1912111082,6,9,8,2,7,32
1912111083,2,7,3,2,4,18
1912111084,8,3,6,3,5,25
1912111085,5,2,7,8,3,25
1912111086,6,1,2,5,6,20
1912111087,7,4,4,2,7,24
1912111088,9,8,7,8,7,39
1912111089,7,2,1,1,6,17
1912111090,8,1,1,4,2,16
1912111091,7,9,5,6,5,32
1912111092,1,5,5,8,0,19
1912111093,5,8,0,8,8,29
1912111094,0,4,4,3,9,20
1912111095,3,2,2,4,3,14
1912111096,5,4,9,0,8,26
1912111097,8,5,0,5,7,25
1912111098,7,1,7,8,6,29
1912111099,7,2,1,3,2,15
1912111100,7,0,0,3,2,12
1912111101,2,4,7,0,8,21
1912111102,4,7,0,5,2,18
1912111103,9,0,6,9,0,24
1912111104,8,7,7,4,5,31
1912111105,4,2,4,8,9,27
191212001,6,5,8,1,8,28
191212002,9,2,0,0,0,11
191212003,4,4,8,6,0,22
191212004,6,0,3,3,8,20
191212005,1,4,2,6,3,16
191212006,2,7,0,5,2,16
191212007,1,5,8,6,4,24
191212008,4,6,0,1,5,16
191212009,3,6,1,5,6,21
191212010,9,1,9,4,4,27
191212011,9,2,5,4,3,23
191212012,2,1,0,2,5,10
191212013,4,3,4,1,7,19
191212014,8,6,5,4,3,26
191212015,1,7,6,5,1,20
191212016,0,9,1,5,0,15
191212017,9,6,1,5,3,24
191212018,3,9,4,3,7,26
191212019,0,7,5,4,8,24
191212020,2,1,8,1,3,15
191212021,4,4,5,9,6,28
191212022,6,4,8,0,0,18
191212023,4,5,9,2,2,22
191212024,9,3,6,1,6,25
191212025,8,8,6,0,9,31
191212026,6,1,8,2,2,19
191212027,4,5,9,9,7,34
191212028,9,6,6,2,8,31
191212029,7,6,0,4,8,25
191212030,6,5,5,4,6,26
191212031,1,0,3,2,0,6
191212032,5,8,3,1,1,18
191212033,7,6,1,3,0,17
191212034,9,1,9,2,3,24
191212035,1,8,5,5,2,21
191212036,4,5,4,9,1,23
191212037,2,9,9,7,7,34
191212038,8,5,4,6,7,30
191212039,6,7,3,2,3,21
191212040,4,9,7,4,2,26
191212041,7,2,5,2,4,20
191212042,2,7,1,2,0,12
191212043,1,9,7,2,7,26
191212044,8,8,8,4,0,28
191212045,7,2,4,6,1,20
191212046,2,3,3,8,6,22
191212047,4,9,6,4,3,26
191212048,3,6,5,3,5,22
191212049,3,2,2,5,2,14
191212050,7,2,0,4,4,17
191212051,8,5,4,6,4,27
191212052,8,4,7,5,2,26
191212053,7,8,5,3,7,30
191212054,3,9,5,9,9,35
191212055,5,7,4,4,7,27
191212056,9,5,0,5,5,24
191212057,7,3,8,8,8,34
191212058,2,5,9,0,8,24
191212059,5,7,9,3,8,32
191212060,9,9,5,9,0,32
191212061,3,8,3,0,2,16
191212062,4,6,1,1,4,16
191212063,6,2,5,5,8,26
191212064,3,1,3,3,4,14
191212065,4,5,4,7,3,23
191212066,9,3,1,2,3,18
191212067,5,5,0,3,9,22
191212068,4,2,7,1,9,23
191212069,5,4,4,7,0,20
191212070,3,3,3,4,7,20
191212071,3,6,5,7,7,28
191212072,9,7,2,1,7,26
191212073,4,0,4,2,3,13
191212074,6,2,9,0,3,20
191212075,4,7,9,8,3,31
191212076,2,8,1,9,2,22
191212077,1,9,3,0,8,21
191212078,8,4,6,2,6,26
191212079,2,4,3,3,4,16
191212080,8,3,7,3,3,24
191212081,3,5,3,0,8,19
191212082,7,2,8,1,6,24
191212083,7,0,1,9,7,24
191212084,5,6,9,9,2,31
191212085,5,7,2,1,1,16
191212086,3,6,6,8,7,30
191212087,8,1,4,3,8,24
191212088,2,4,6,9,5,26
191212089,1,6,6,5,8,26
191212090,7,7,2,0,1,17
191212091,5,3,3,2,3,16
191212092,3,4,6,9,5,27
191212093,3,8,5,2,5,23
191212094,1,7,3,9,4,24
191212095,1,0,0,1,8,10
191212096,6,7,7,8,8,36
191212097,3,4,4,0,1,12
191212098,4,1,3,8,9,25
191212099,8,9,4,4,6,31
191212100,9,0,4,5,9,27
191212101,3,3,7,0,1,14
191212102,8,8,8,4,7,35
191212103,6,3,6,4,0,19
191212104,2,0,0,1,5,8
191212105,7,7,3,1,6,24
191212106,0,3,8,5,0,16
191212107,2,9,1,5,6,23
191212108,8,4,1,0,6,19
191212109,6,6,4,9,8,33
191212110,6,5,2,3,2,18
191212111,4,1,0,9,2,16
191212112,1,3,4,7,5,20
191212113,3,4,1,3,5,16
191212114,3,8,5,1,5,22
191212115,2,9,0,2,4,17
191212116,1,2,5,7,3,18
191212117,7,1,5,2,8,23
191212118,1,4,0,5,2,12
191212119,4,4,7,4,4,23
191212120,8,7,1,7,7,30
191212121,4,6,8,8,0,26
191212122,8,0,2,8,1,19
191212123,5,4,6,3,0,18
191212124,8,8,0,0,5,21
191212125,9,5,7,8,3,32
191212126,6,4,1,6,5,22
191212127,7,5,8,8,0,28
191212128,0,4,8,8,5,25
191212129,6,7,0,4,9,26
191212130,0,5,9,4,0,18
191212131,5,5,5,7,5,27
191212132,8,3,6,0,1,18
191212133,1,7,2,3,9,22
191212134,0,8,4,9,8,29
191212135,0,0,6,9,4,19
191212136,1,8,0,2,8,19
191212137,6,7,7,1,6,27
191212138,6,4,6,8,9,33
191212139,7,9,4,9,6,35
191212140,4,7,8,5,7,31
191212141,3,1,5,9,0,18
191212142,8,8,0,7,1,24
191212143,7,2,8,2,9,28
191212144,3,8,3,0,5,19
191212145,9,9,9,7,6,40
191212146,4,8,3,0,8,23
191212147,8,1,7,5,9,30
191212148,6,1,6,9,2,24
191212149,8,0,3,5,3,19
191212150,9,0,3,1,3,16
191212151,3,0,7,9,9,28
191212152,9,5,0,1,4,19
191212153,5,0,6,5,3,19
191212154,4,0,7,9,4,24
191212155,2,5,0,8,5,20
191212156,5,0,8,2,0,15
191212157,4,7,8,3,9,31
191212158,7,7,2,1,0,17
191212159,9,9,1,6,1,26
191212160,4,5,6,7,4,26
191212161,3,0,5,2,2,12
191212162,2,5,3,1,9,20
191212163,2,7,2,4,5,20
191212164,9,3,8,7,8,35
191212165,1,0,5,2,3,11
191212166,6,9,9,6,7,37
191212167,9,2,1,8,5,25
191212168,2,1,4,3,9,19
191212169,8,0,9,8,2,27
191212170,8,7,9,0,1,25
191212171,2,5,9,5,4,25
191212172,8,0,6,3,0,17
191212173,7,1,9,3,0,20
191212174,6,5,2,4,8,25
191212175,3,0,2,2,8,15
191212176,7,0,0,9,2,18
191212177,8,0,1,5,3,17
191212178,5,1,0,8,0,14
191212179,1,3,4,2,7,17
191212180,4,5,3,4,2,18
191212181,3,1,8,7,5,24
191212182,3,0,8,0,3,14
191212183,6,2,8,8,5,29
191212184,5,6,5,5,4,25
191212185,0,7,2,4,4,17
191212186,6,8,9,4,3,30
191212187,6,4,6,7,6,29
191212188,4,2,5,3,5,19
191212189,2,8,7,4,2,23
191212190,1,9,5,5,9,29
191212191,9,3,3,9,3,27
191212192,9,8,2,0,8,27
191212193,3,7,2,7,4,23
191212194,9,1,8,6,4,28
191212195,5,3,2,2,5,17
191212196,6,1,2,9,1,19
191212197,5,7,6,1,3,22
191212198,6,7,5,9,6,33
191212199,9,9,0,5,9,32
191212200,0,3,3,2,8,16
191212201,8,0,2,6,8,24
191212202,1,1,5,4,4,15
191212203,9,9,1,6,4,29
191212204,9,9,2,4,8,32
191212205,4,5,2,7,9,27
191212206,3,6,8,1,1,19
191212207,7,9,8,1,2,27
191212208,8,2,7,5,6,28
191212209,6,0,6,3,6,21
191212210,6,9,2,3,2,22
191212211,5,2,2,9,0,18
191212212,6,4,8,7,9,34
191212213,2,8,4,4,3,21
191212214,4,7,2,3,4,20
191212215,1,7,4,1,8,21
191212216,2,1,9,5,3,20
191212217,1,0,5,9,0,15
191212218,4,9,2,5,2,22
191212219,0,1,7,8,7,23
191212220,3,7,9,0,7,26
191212221,9,6,5,9,6,35
191212222,2,5,4,7,4,22
191212223,5,0,6,0,2,13
191212224,3,7,4,1,7,22
191212225,9,8,1,0,9,27
191212226,3,5,4,2,1,15
191212227,2,6,6,1,7,22
191212228,1,9,2,9,3,24
191212229,3,0,7,2,8,20
191212230,8,3,6,1,8,26
191212231,7,7,5,4,3,26
191212232,2,7,4,3,4,20
191212233,7,2,1,4,9,23
191212234,9,6,8,0,1,24
191212235,2,9,2,2,0,15
191212236,7,5,9,3,2,26
191212237,1,8,5,6,0,20
191212238,8,3,3,9,0,23
191212239,7,5,7,3,8,30
191212240,7,6,4,7,7,31
191212241,8,4,9,5,9,35
191212242,7,2,7,0,5,21
191212243,5,1,9,2,9,26
191212244,6,0,8,0,0,14
191212245,6,8,2,7,1,24
191212246,0,9,2,0,7,18
191212247,0,4,6,3,1,14
191212248,0,3,2,6,2,13
191212249,1,0,8,5,0,14
191212250,2,1,7,6,7,23
191212251,2,4,6,4,5,21
191212252,6,0,2,9,4,21
191212253,0,6,1,4,0,11
191212254,5,4,2,2,4,17
191212255,9,8,9,0,0,26
191212256,2,2,0,3,8,15
191212257,2,3,8,4,9,26
191212258,2,1,0,1,8,12
191212259,5,0,1,7,7,20
191212260,4,2,3,4,6,19
191212261,8,1,4,0,7,20
191212262,7,7,7,4,3,28
191212263,4,4,3,2,0,13
191212264,6,4,7,7,3,27
191212265,8,2,5,0,5,20
191212266,0,1,7,0,7,15
191212267,1,9,3,1,9,23
191212268,6,2,8,2,1,19
191212269,6,5,9,6,4,30
191212270,9,1,0,2,9,21
191212271,8,0,3,3,2,16
191212272,6,3,8,7,7,31
191212273,4,1,2,4,7,18
191212274,5,5,7,1,8,26
191212275,3,3,5,9,4,24
191212276,0,5,7,1,0,13
191212277,0,6,7,3,9,25
191212278,6,8,5,6,2,27
191212279,8,5,3,7,1,24
191212280,3,4,4,2,3,16
191212281,4,6,7,2,4,23
191212282,8,6,7,7,1,29
191212283,7,5,4,9,5,30
191212284,3,2,7,7,0,19
191212285,1,1,6,5,7,20
191212286,8,5,9,9,2,33
191212287,9,1,6,0,1,17
191212288,3,9,4,6,3,25
191212289,9,0,7,0,6,22
191212290,6,3,6,0,4,19
191212291,0,6,8,2,1,17
191212292,5,2,1,9,5,22
191212293,0,2,1,7,0,10
191212294,3,3,1,3,3,13
191212295,9,0,5,5,3,22
191212296,9,0,4,4,6,23
191212297,1,4,8,4,1,18
191212298,1,0,3,0,8,12
191212299,6,9,7,1,3,26
191212300,4,9,0,5,4,22
191212301,3,4,1,8,3,19
191212302,9,6,7,0,0,22
191212303,4,1,9,3,0,17
191212304,1,5,4,1,2,13
191212305,8,1,1,7,6,23
191212306,3,1,5,7,6,22
191212307,5,2,6,3,9,25
191212308,7,3,7,3,8,28
191212309,5,7,5,3,2,22
191212310,3,2,1,9,6,21
191212311,2,7,2,1,6,18
191212312,0,4,7,5,5,21
191212313,5,7,8,9,2,31
191212314,7,6,9,1,5,28
191212315,5,8,7,5,2,27
191212316,6,5,2,0,1,14
191212317,4,3,5,9,4,25
191212318,1,0,2,2,0,5
191212319,7,7,8,8,0,30
191212320,7,1,0,9,0,17
191212321,3,0,0,2,2,7
191212322,1,6,9,1,3,20
191212323,0,3,9,1,2,15
191212324,3,2,9,4,2,20
191212325,6,4,8,3,5,26
191212326,0,9,2,2,1,14
191212327,9,4,6,9,5,33
191212328,2,3,9,7,7,28
191212329,3,0,3,2,4,12
191212330,6,1,2,0,5,14
191212331,5,1,5,4,5,20
191212332,2,2,6,3,2,15
191212333,2,4,5,9,9,29
191212334,8,8,0,5,7,28
191212335,3,4,8,7,1,23
191212336,8,9,4,8,3,32
191212337,2,6,4,3,1,16
191212338,1,2,2,2,2,9
191212339,7,2,8,3,1,21
191212340,9,1,5,4,3,22
191212341,2,8,0,9,0,19
191212342,7,0,7,2,8,24
191212343,4,2,5,9,2,22
191212344,9,9,6,8,9,41
191212345,8,9,5,1,9,32
191212346,1,4,2,9,6,22
191212347,1,1,8,4,4,18
191212348,8,8,9,3,1,29
191212349,7,9,3,5,7,31
191212350,0,8,1,5,5,19
191212351,3,4,7,7,8,29
191212352,0,0,1,2,1,4
191212353,2,6,7,8,7,30
191212354,2,5,0,8,8,23
191212355,3,1,2,2,2,10
191212356,0,8,0,2,0,10
191212357,2,0,6,4,0,12
191212358,9,4,3,5,9,30
191212359,8,8,2,4,2,24
191212360,0,7,2,9,3,21
191212361,5,9,4,8,5,31
191212362,6,1,7,5,0,19
191212363,1,4,8,8,9,30
191212364,8,3,4,1,7,23
191212365,2,2,8,5,3,20
191212366,3,7,8,9,7,34
191212367,8,0,5,6,4,23
191212368,6,0,9,0,6,21
191212369,7,4,3,8,5,27
191212370,7,1,8,3,5,24
191212371,1,0,6,3,6,16
191212372,6,1,0,3,5,15
191212373,5,8,9,3,3,28
191212374,4,0,0,1,3,8
191212375,0,1,1,5,3,10
191212376,7,9,5,6,9,36
191212377,4,4,8,7,7,30
191212378,4,0,1,5,5,15
191212379,9,2,9,1,5,26
191212380,3,5,8,3,2,21
191212381,1,6,0,9,0,16
191212382,0,1,6,5,5,17
191212383,5,7,0,7,3,22
191212384,0,2,4,3,6,15
191212385,8,8,3,9,8,36
191212386,0,1,1,0,0,2
191212387,9,6,3,8,1,27
191212388,1,9,1,4,6,21
191212389,4,3,3,7,6,23
191212390,2,0,5,9,9,25
191212391,2,6,6,6,4,24
191212392,4,0,8,7,4,23
191212393,8,9,6,5,2,30
191212394,0,6,0,2,0,8
191212395,5,7,7,2,8,29
191212396,0,1,9,3,3,16
191212397,0,8,6,6,0,20
191212398,4,1,8,0,6,19
191212399,1,1,4,4,6,16
191212400,7,3,0,5,0,15
191212401,3,6,4,0,3,16
191212402,0,1,0,2,1,4
191212403,1,9,3,6,4,23
191212404,6,5,0,6,0,17
191212405,7,8,1,8,1,25
191212406,8,2,9,3,2,24
191212407,0,9,0,2,6,17
191212408,1,0,0,7,4,12
191212409,6,9,4,8,1,28
191212410,9,2,7,5,1,24
191212411,4,1,7,2,1,15
191212412,2,7,7,7,9,32
191212413,5,8,7,2,8,30
191212414,0,0,2,6,0,8
191212415,1,4,7,1,8,21
191212416,2,2,4,9,7,24
191212417,9,9,1,7,2,28
191212418,6,7,4,0,5,22
191212419,8,6,2,6,1,23
191212420,6,4,0,6,2,18
191212421,9,6,0,4,0,19
191212422,0,9,4,9,0,22
191212423,4,0,0,2,8,14
191212424,7,4,7,4,1,23
191212425,5,9,5,6,4,29
191212426,0,5,7,5,5,22
191212427,3,8,7,8,8,34
191212428,2,5,2,6,3,18
191212429,5,6,5,2,0,18
191212430,1,6,4,2,2,15
191212431,3,2,5,2,6,18
191212432,9,5,2,8,5,29
191212433,0,2,2,6,9,19
191212434,5,2,2,8,2,19
191212435,4,6,3,3,5,21
191212436,8,7,1,5,1,22
191212437,3,6,6,9,1,25
191212438,9,9,7,7,3,35
191212439,9,4,0,4,9,26
191212440,6,3,5,1,4,19
191212441,8,3,1,4,9,25
191212442,3,9,6,0,0,18
191212443,9,6,4,3,6,28
191212444,5,0,4,5,4,18
191212445,6,3,2,3,9,23
191212446,2,3,6,7,5,23
191212447,3,8,8,9,4,32
191212448,5,9,1,1,0,16
191212449,3,2,7,6,0,18
191212450,8,0,3,2,1,14
191212451,9,6,1,8,1,25
191212452,2,0,3,6,8,19
191212453,2,1,8,0,5,16
191212454,4,8,5,3,7,27
191212455,4,7,5,6,2,24
191212456,0,2,6,8,9,25
191212457,5,6,6,7,0,24
191212458,7,9,2,4,7,29
191212459,6,7,6,3,9,31
191212460,1,5,8,2,6,22
191212461,6,7,0,4,6,23
191212462,2,3,7,0,0,12
191212463,6,8,1,9,1,25
191212464,2,4,9,3,6,24
191212465,4,2,3,1,8,18
191212466,4,6,1,2,0,13
191212467,5,6,5,8,8,32
191212468,5,8,0,7,1,21
191212469,0,7,7,1,1,16
191212470,9,1,7,7,8,32
191212471,8,5,9,3,8,33
191212472,6,4,4,4,7,25
191212473,8,4,2,2,7,23
191212474,8,1,9,1,7,26
191212475,8,5,7,7,1,28
191212476,2,3,0,0,5,10
191212477,6,7,3,1,2,19
191212478,9,9,2,9,6,35
191212479,5,5,3,5,5,23
191212480,7,2,8,0,0,17
191212481,5,7,8,7,3,30
191212482,4,9,5,2,4,24
191212483,8,8,5,4,0,25
191212484,8,5,0,5,3,21
191212485,6,4,3,0,9,22
191212486,8,1,8,1,1,19
191212487,8,7,9,6,6,36
191212488,1,3,1,9,3,17
191212489,2,6,8,0,3,19
191212490,8,8,2,1,9,28
191212491,2,2,1,7,7,19
191212492,9,5,0,9,5,28
191212493,3,2,1,2,0,8
191212494,6,6,7,8,9,36
191212495,8,0,4,6,2,20
191212496,9,0,5,4,5,23
191212497,6,8,0,3,2,19
191212498,6,3,8,5,5,27
191212499,7,0,0,1,5,13
191212500,9,9,5,8,6,37
191212501,6,1,8,7,1,23
191212502,5,5,6,5,6,27
191212503,3,8,8,3,5,27
191212504,9,1,9,2,2,23
191212505,6,0,0,2,2,10
191212506,4,9,8,3,2,26
191212507,1,6,5,2,6,20
191212508,6,2,1,2,8,19
191212509,2,4,5,9,0,20
191212510,6,8,4,8,1,27
191212511,7,1,1,3,3,15
191212512,4,1,6,0,6,17
191212513,9,0,6,3,7,25
191212514,8,0,4,1,9,22
191212515,0,6,6,7,2,21
191212516,3,7,4,3,8,25
191212517,7,7,4,4,1,23
191212518,8,5,8,2,0,23
191212519,1,9,2,0,9,21
191212520,3,6,9,4,1,23
191212521,5,0,3,7,5,20
191212522,4,1,1,6,1,13
191212523,6,2,7,6,4,25
191212524,4,7,7,4,6,28
191212525,1,1,3,7,3,15
191212526,5,0,3,9,6,23
191212527,2,5,0,3,2,12
191212528,1,0,4,9,2,16
191212529,1,5,5,0,3,14
191212530,0,5,4,3,9,21
191212531,6,7,0,7,4,24
191212532,7,9,1,5,5,27
191212533,6,4,8,6,6,30
191212534,5,6,3,8,1,23
191212535,4,9,3,5,2,23
191212536,7,5,6,7,8,33
191212537,8,1,3,9,3,24
191212538,9,0,6,0,6,21
191212539,8,1,7,8,6,30
191212540,3,4,4,5,1,17
191212541,5,8,2,4,4,23
191212542,9,5,4,6,5,29
191212543,7,3,5,4,4,23
191212544,8,7,2,6,9,32
191212545,2,3,6,3,2,16
191212546,1,5,4,6,4,20
191212547,9,2,7,0,6,24
191212548,2,6,6,2,3,19
191212549,0,8,3,5,8,24
191212550,7,4,4,5,3,23
191212551,1,3,4,0,2,10
191212552,6,3,0,6,9,24
191212553,7,4,1,3,8,23
191212554,2,5,9,2,2,20
191212555,9,5,4,0,6,24
191212556,6,7,8,5,7,33
191212557,1,7,5,8,6,27
191212558,9,5,6,3,0,23
191212559,9,0,9,6,8,32
191212560,5,9,6,4,7,31
191212561,4,8,7,4,0,23
191212562,4,3,6,0,9,22
191212563,1,9,4,3,4,21
191212564,5,3,9,2,6,25
191212565,9,2,5,7,3,26
191212566,0,6,1,4,4,15
191212567,9,4,0,1,6,20
191212568,9,5,0,4,3,21
191212569,6,5,8,0,3,22
191212570,3,8,8,0,1,20
191212571,6,6,3,0,2,17
191212572,2,7,0,1,7,17
191212573,6,4,7,3,1,21
191212574,2,9,0,5,7,23
191212575,1,7,5,8,3,24
191212576,8,7,9,6,5,35
191212577,5,5,4,9,6,29
191212578,8,6,3,6,4,27
191212579,1,3,8,5,0,17
191212580,6,4,9,2,1,22
191212581,6,4,9,1,9,29
191212582,9,1,7,6,5,28
191212583,6,9,5,1,7,28
191212584,5,0,5,6,9,25
191212585,4,5,3,7,5,24
191212586,5,7,9,8,8,37
191212587,0,2,2,5,8,17
191212588,1,8,7,3,1,20
191212589,3,6,7,9,5,30
191212590,1,4,4,4,3,16
191212591,1,9,5,7,6,28
191212592,5,1,1,4,7,18
191212593,6,2,9,4,5,26
191212594,2,0,9,7,4,22
191212595,6,6,0,0,0,12
191212596,0,1,4,3,2,10
191212597,3,3,4,3,5,18
191212598,0,5,2,3,9,19
191212599,6,6,4,1,6,23
191212600,8,8,3,0,5,24
191212601,2,1,9,3,8,23
191212602,3,0,1,6,5,15
191212603,2,6,8,1,9,26
191212604,6,6,8,6,6,32
191212605,6,7,2,7,4,26
191212606,1,5,1,1,6,14
191212607,6,7,2,4,0,19
191212608,0,8,3,5,4,20
191212609,7,7,4,7,4,29
191212610,0,1,3,1,8,13
191212611,7,6,4,9,3,29
191212612,9,4,8,9,7,37
191212613,6,9,7,2,6,30
191212614,2,7,9,8,6,32
191212615,4,0,5,4,2,15
191212616,3,3,1,8,5,20
191212617,5,7,2,4,2,20
191212618,0,8,9,0,5,22
191212619,1,6,3,2,9,21
191212620,1,8,2,4,0,15
191212621,7,7,6,2,4,26
191212622,6,9,7,0,1,23
191212623,8,7,9,6,8,38
191212624,6,0,8,2,1,17
191212625,7,0,8,0,4,19
191212626,8,0,3,7,4,22
191212627,0,5,5,1,2,13
191212628,5,6,4,5,7,27
191212629,6,9,5,6,9,35
191212630,4,2,4,5,9,24
191212631,3,4,7,6,0,20
191212632,1,0,2,7,7,17
191212633,4,1,5,9,4,23
191212634,4,9,2,1,7,23
191212635,2,7,0,3,8,20
191212636,2,6,4,0,8,20
191212637,6,0,8,8,3,25
191212638,4,3,6,6,1,20
191212639,1,5,1,8,9,24
191212640,6,8,2,3,0,19
191212641,8,8,3,2,5,26
191212642,1,0,8,7,1,17
191212643,1,2,8,1,8,20
191212644,2,2,9,2,3,18
191212645,1,2,1,4,7,15
191212646,5,0,7,7,1,20
191212647,0,6,2,2,9,19
191212648,0,2,0,4,7,13
191212649,6,0,8,9,3,26
191212650,3,9,4,9,1,26
191212651,0,5,6,6,5,22
191212652,2,1,8,5,2,18
191212653,8,2,3,0,1,14
191212654,5,9,6,3,9,32
191212655,3,9,4,2,7,25
191212656,9,0,1,6,2,18
191212657,5,7,7,2,6,27
191212658,5,4,0,5,2,16
191212659,8,7,3,6,6,30
191212660,2,2,0,5,6,15
191212661,4,0,9,6,4,23
191212662,0,3,2,0,9,14
191212663,1,7,5,3,1,17
191212664,0,7,0,1,5,13
191212665,4,0,8,9,0,21
191212666,5,3,4,5,4,21
191212667,4,0,6,1,1,12
191212668,2,4,5,2,9,22
191212669,1,2,3,4,3,13
191212670,0,5,3,9,1,18
191212671,5,8,6,7,5,31
191212672,8,9,0,5,8,30
191212673,8,3,3,9,4,27
191212674,5,9,3,4,6,27
191212675,9,1,8,3,5,26
191212676,4,3,6,8,4,25
191212677,3,6,2,6,1,18
191212678,7,4,4,1,1,17
191212679,9,4,2,7,9,31
191212680,8,6,5,5,7,31
191212681,2,1,2,3,2,10
191212682,8,7,9,3,1,28
191212683,0,8,4,1,6,19
191212684,5,6,5,1,8,25
191212685,1,6,6,6,6,25
191212686,4,2,9,7,3,25
191212687,4,9,9,7,4,33
191212688,4,8,3,8,1,24
191212689,3,3,6,9,0,21
191212690,3,2,2,4,4,15
191212691,5,0,6,1,2,14
191212692,5,6,1,8,7,27
191212693,2,3,3,6,5,19
191212694,6,2,9,8,3,28
191212695,9,1,2,4,1,17
191212696,2,5,6,2,5,20
191212697,9,0,7,9,6,31
191212698,7,6,2,1,8,24
191212699,8,4,6,0,1,19
191212700,9,6,8,7,7,37
191212701,9,0,0,2,8,19
191212702,9,3,2,9,3,26
191212703,4,0,1,5,0,10
191212704,4,1,9,4,2,20
191212705,4,7,9,8,0,28
191212706,1,5,1,6,3,16
191212707,6,7,2,5,3,23
191212708,0,4,5,4,6,19
191212709,5,6,0,6,3,20
191212710,2,8,8,8,3,29
191212711,7,1,5,9,4,26
191212712,0,9,9,3,3,24
191212713,6,5,9,4,6,30
191212714,5,4,9,6,0,24
191212715,6,2,9,6,0,23
191212716,2,7,5,9,3,26
191212717,6,6,1,2,7,22
191212718,3,3,8,4,6,24
191212719,4,7,4,5,1,21
191212720,0,9,1,1,6,17
191212721,3,9,9,3,6,30
191212722,7,9,7,2,8,33
191212723,7,7,2,5,0,21
191212724,5,5,7,9,7,33
191212725,0,0,4,2,3,9
191212726,8,7,0,0,0,15
191212727,8,2,2,2,5,19
191212728,5,4,0,0,3,12
191212729,7,4,8,5,7,31
191212730,5,3,4,1,2,15
191212731,3,3,6,7,7,26
191212732,0,1,5,6,1,13
191212733,1,8,0,2,2,13
191212734,4,9,2,1,0,16
191212735,8,3,2,0,1,14
191212736,8,2,6,1,0,17
191212737,3,8,1,3,9,24
191212738,5,7,4,4,2,22
191212739,9,3,8,7,3,30
191212740,6,7,5,7,8,33
191212741,1,7,5,9,4,26
191212742,6,3,3,4,6,22
191212743,6,7,7,7,5,32
191212744,8,8,0,0,1,17
191212745,3,6,2,0,6,17
191212746,9,4,1,0,1,15
191212747,8,5,5,7,6,31
191212748,8,0,2,9,5,24
191212749,4,2,9,0,2,17
191212750,8,1,7,7,6,29
191212751,5,2,0,4,2,13
191212752,5,5,0,2,3,15
191212753,7,3,6,3,2,21
191212754,7,3,8,2,1,21
191212755,9,5,2,6,6,28
191212756,5,4,0,9,8,26
191212757,4,7,5,0,7,23
191212758,9,0,8,1,1,19
191212759,8,4,6,0,0,18
191212760,8,8,1,1,3,21
191212761,9,6,1,1,2,19
191212762,3,5,5,7,1,21
191212763,3,0,2,3,6,14
191212764,3,5,5,4,0,17
191212765,4,5,4,7,0,20
191212766,3,9,6,6,2,26
191212767,8,7,3,0,8,26
191212768,2,2,4,5,6,19
191212769,5,7,1,7,5,25
191212770,7,2,3,7,6,25
191212771,0,5,1,7,6,19
191212772,8,3,6,1,9,27
191212773,9,1,5,3,8,26
191212774,5,0,2,2,7,16
191212775,8,6,1,5,3,23
191212776,1,8,3,2,5,19
191212777,9,3,2,8,9,31
191212778,2,8,0,9,1,20
191212779,0,6,2,5,9,22
191212780,9,0,6,1,5,21
191212781,6,3,5,0,7,21
191212782,6,6,7,8,8,35
191212783,2,7,9,3,1,22
191212784,2,8,5,3,4,22
191212785,2,6,4,7,6,25
191212786,7,8,7,1,0,23
191212787,3,2,1,1,6,13
191212788,8,1,2,1,0,12
191212789,0,0,8,9,4,21
191212790,1,3,5,3,1,13
191212791,7,7,9,4,1,28
191212792,0,1,1,4,6,12
191212793,0,7,0,4,9,20
191212794,7,6,2,2,4,21
191212795,7,3,4,4,6,24
191212796,1,8,0,6,4,19
191212797,3,3,8,1,8,23
191212798,8,4,0,2,1,15
191212799,8,8,0,9,8,33
191212800,9,4,9,8,2,32
191212801,8,9,6,1,2,26
191212802,0,1,0,6,7,14
191212803,0,9,5,2,0,16
191212804,9,1,4,3,1,18
191212805,5,3,8,5,9,30
191212806,9,5,6,9,1,30
191212807,6,1,9,5,4,25
191212808,5,3,5,9,1,23
191212809,6,5,9,0,5,25
191212810,8,5,6,2,6,27
191212811,1,7,4,1,4,17
191212812,1,1,2,0,5,9
191212813,9,3,0,1,3,16
191212814,9,8,7,4,0,28
191212815,9,0,7,1,1,18
191212816,0,4,9,3,9,25
191212817,8,6,3,6,3,26
191212818,3,6,4,5,5,23
191212819,9,4,4,9,1,27
191212820,0,8,8,2,5,23
191212821,0,1,0,9,2,12
191212822,5,2,0,9,3,19
191212823,0,3,9,5,8,25
191212824,5,8,0,3,8,24
191212825,5,4,3,7,2,21
191212826,6,9,1,2,1,19
191212827,3,0,5,3,6,17
191212828,6,7,5,0,0,18
191212829,4,9,0,1,5,19
191212830,5,4,0,4,0,13
191212831,9,5,9,2,6,31
191212832,0,4,3,6,4,17
191212833,1,1,6,9,0,17
191212834,7,9,4,7,1,28
191212835,6,2,9,7,7,31
191212836,2,3,1,7,0,13
191212837,4,3,0,2,1,10
191212838,6,2,2,4,7,21
191212839,0,4,4,5,2,15
191212840,6,1,3,6,0,16
191212841,8,7,5,9,1,30
191212842,2,8,1,8,9,28
191212843,2,3,0,5,7,17
191212844,4,2,9,4,5,24
191212845,5,0,6,6,9,26
191212846,2,3,0,3,8,16
191212847,3,7,5,4,9,28
191212848,0,9,0,6,1,16
191212849,6,9,7,8,9,39
191212850,9,6,5,6,3,29
191212851,6,8,4,4,7,29
191212852,7,5,2,4,9,27
191212853,8,7,0,8,7,30
191212854,4,8,9,8,5,34
191212855,3,6,0,3,7,19
191212856,2,5,1,2,2,12
191212857,2,9,3,8,9,31
191212858,0,3,2,0,5,10
191212859,4,5,5,4,0,18
191212860,2,1,4,4,5,16
191212861,4,5,0,3,6,18
191212862,1,1,2,3,1,8
191212863,9,9,9,9,5,41
191212864,9,8,4,2,6,29
191212865,5,9,3,3,2,22
191212866,5,3,1,1,7,17
191212867,6,4,6,3,9,28
191212868,3,9,3,9,1,25
191212869,2,6,9,0,6,23
191212870,5,8,9,6,1,29
191212871,7,1,3,0,3,14
191212872,9,2,5,4,7,27
191212873,3,0,8,4,8,23
191212874,0,3,6,6,9,24
191212875,5,0,1,5,6,17
191212876,7,4,6,3,7,27
191212877,5,7,8,0,4,24
191212878,9,6,4,4,5,28
191212879,5,9,3,9,8,34
191212880,1,5,7,8,0,21
191212881,8,8,0,9,0,25
191212882,3,9,0,1,3,16
191212883,6,6,7,6,4,29
191212884,3,2,0,1,5,11
191212885,4,3,2,4,9,22
191212886,4,1,7,0,7,19
191212887,7,4,7,8,5,31
191212888,5,8,8,8,5,34
191212889,0,2,3,0,1,6
191212890,0,6,4,3,3,16
191212891,2,5,9,9,3,28
191212892,3,9,0,0,5,17
191212893,7,7,4,3,5,26
191212894,0,8,6,2,6,22
191212895,4,9,8,1,9,31
191212896,6,2,8,9,3,28
191212897,1,4,6,3,6,20
191212898,9,8,4,6,3,30
191212899,5,8,5,1,0,19
191212900,3,9,9,7,1,29
191212901,8,2,0,8,2,20
191212902,4,1,6,0,0,11
191212903,5,5,2,3,0,15
191212904,5,4,2,6,7,24
191212905,3,3,8,9,9,32
191212906,3,0,8,3,8,22
191212907,7,0,6,8,0,21
191212908,2,8,5,9,4,28
191212909,4,1,8,6,6,25
191212910,4,7,4,4,3,22
191212911,0,3,8,9,6,26
191212912,3,6,5,3,8,25
191212913,8,9,6,9,8,40
191212914,3,8,1,8,9,29
191212915,7,8,8,4,8,35
191212916,7,1,1,6,8,23
191212917,4,4,5,5,1,19
191212918,8,6,1,8,0,23
191212919,4,4,5,5,4,22
191212920,9,8,9,7,5,38
191212921,3,5,6,2,6,22
191212922,6,6,8,3,8,31
191212923,5,7,0,4,3,19
191212924,6,8,3,4,1,22
191212925,9,8,1,5,8,31
191212926,9,1,7,2,4,23
191212927,3,7,7,0,3,20
191212928,9,1,6,1,6,23
191212929,8,2,6,0,7,23
191212930,4,8,8,9,3,32
191212931,7,8,1,6,4,26
191212932,2,7,1,5,0,15
191212933,0,0,9,2,1,12
191212934,0,3,7,9,1,20
191212935,4,0,4,8,8,24
191212936,3,8,8,3,8,30
191212937,3,2,0,9,8,22
191212938,0,7,0,0,8,15
191212939,4,7,4,2,3,20
191212940,3,4,4,5,1,17
191212941,8,3,3,4,2,20
191212942,1,7,3,3,2,16
191212943,9,5,9,0,5,28
191212944,2,0,4,3,9,18
191212945,7,1,0,6,9,23
191212946,6,1,1,1,9,18
191212947,5,7,4,4,6,26
191212948,1,3,5,6,9,24
191212949,8,6,0,9,2,25
191212950,2,6,5,3,2,18
191212951,4,5,2,4,6,21
191212952,8,1,2,4,7,22
191212953,3,4,2,6,6,21
191212954,0,5,6,9,0,20
191212955,0,5,8,4,5,22
191212956,6,3,1,2,9,21
191212957,0,1,9,5,8,23
191212958,2,8,0,5,2,17
191212959,5,1,7,3,5,21
191212960,8,7,3,1,2,21
191212961,4,1,5,9,8,27
191212962,0,3,2,3,3,11
191212963,7,7,6,8,8,36
191212964,6,4,8,6,0,24
191212965,0,5,4,5,4,18
191212966,4,2,4,5,7,22
191212967,9,5,8,3,7,32
191212968,0,7,9,7,9,32
191212969,6,1,6,6,0,19
191212970,1,5,1,6,8,21
191212971,3,0,8,6,0,17
191212972,4,7,8,4,3,26
191212973,6,4,4,0,7,21
191212974,6,2,6,1,9,24
191212975,5,6,9,0,0,20
191212976,4,0,4,0,6,14
191212977,5,9,1,4,2,21
191212978,2,5,8,8,7,30
191212979,5,3,2,3,2,15
191212980,9,9,4,6,6,34
191212981,2,0,4,3,7,16
191212982,2,2,7,1,7,19
191212983,5,8,6,5,7,31
191212984,6,1,2,7,4,20
191212985,1,1,1,8,5,16
191212986,4,9,4,7,2,26
191212987,5,0,0,7,2,14
191212988,6,0,1,0,4,11
191212989,1,6,9,2,3,21
191212990,9,1,2,9,8,29
191212991,2,2,9,3,1,17
191212992,3,6,8,2,0,19
191212993,7,0,8,6,0,21
191212994,5,5,2,1,7,20
191212995,3,9,9,5,3,29
191212996,9,5,3,7,3,27
191212997,7,3,2,9,2,23
191212998,5,7,5,2,2,21
191212999,3,4,8,6,2,23
1912121000,1,2,8,9,2,22
1912121001,4,0,3,4,4,15
1912121002,4,9,2,5,9,29
1912121003,1,1,8,7,2,19
1912121004,0,7,5,0,4,16
1912121005,1,8,4,3,1,17
1912121006,7,2,4,6,8,27
1912121007,4,3,5,2,1,15
1912121008,8,2,2,3,2,17
1912121009,1,5,6,5,5,22
1912121010,5,6,8,6,1,26
1912121011,6,4,5,3,8,26
1912121012,5,3,1,4,0,13
1912121013,3,0,7,6,7,23
1912121014,0,6,8,0,2,16
1912121015,7,8,6,2,7,30
1912121016,0,2,2,0,2,6
1912121017,9,3,7,1,1,21
1912121018,5,7,2,9,8,31
1912121019,0,6,9,3,7,25
1912121020,5,0,7,5,7,24
1912121021,2,4,5,5,4,20
1912121022,0,9,2,1,2,14
1912121023,4,1,2,3,2,12
1912121024,1,7,7,3,2,20
1912121025,5,9,4,5,7,30
1912121026,1,8,0,2,0,11
1912121027,6,3,6,6,7,28
1912121028,8,9,6,7,9,39
1912121029,4,9,0,0,1,14
1912121030,3,8,0,3,1,15
1912121031,9,1,4,3,3,20
1912121032,2,3,9,8,6,28
1912121033,1,8,4,2,6,21
1912121034,7,8,5,8,7,35
1912121035,7,3,4,2,5,21
1912121036,9,5,7,9,8,38
1912121037,7,4,1,3,7,22
1912121038,1,1,4,2,9,17
1912121039,6,9,6,5,5,31
1912121040,2,5,5,1,0,13
1912121041,7,9,0,7,7,30
1912121042,7,1,0,8,6,22
1912121043,3,3,9,7,1,23
1912121044,2,5,5,4,3,19
1912121045,1,1,2,4,8,16
1912121046,5,0,0,4,5,14
1912121047,9,8,0,7,6,30
1912121048,1,2,5,6,0,14
1912121049,5,3,1,9,8,26
1912121050,0,7,8,7,5,27
1912121051,4,7,9,9,1,30
1912121052,6,6,3,5,7,27
1912121053,4,9,2,9,0,24
1912121054,8,4,7,1,1,21
1912121055,0,7,8,3,4,22
1912121056,7,8,7,6,0,28
1912121057,7,2,0,0,4,13
1912121058,5,0,5,0,6,16
1912121059,4,6,6,2,9,27
1912121060,7,5,5,0,4,21
1912121061,7,6,0,3,8,24
1912121062,3,2,5,5,8,23
1912121063,0,0,8,2,3,13
1912121064,9,4,3,7,7,30
1912121065,9,0,6,9,9,33
1912121066,9,9,1,8,9,36
1912121067,3,9,0,5,0,17
1912121068,4,3,2,0,1,10
1912121069,9,3,5,8,3,28
1912121070,5,2,6,7,2,22
1912121071,6,0,5,9,7,27
1912121072,2,7,1,3,9,22
1912121073,1,1,5,2,6,15
1912121074,3,8,5,2,4,22
1912121075,5,8,7,7,8,35
1912121076,0,7,4,2,0,13
1912121077,4,0,4,2,4,14
1912121078,5,4,9,5,1,24
1912121079,5,8,8,0,1,22
1912121080,6,8,8,7,3,32
1912121081,3,4,9,3,5,24
1912121082,3,5,9,2,1,20
1912121083,0,1,8,7,3,19
1912121084,7,7,0,7,4,25
1912121085,9,4,2,5,2,22
1912121086,3,6,1,6,5,21
1912121087,7,8,7,8,7,37
1912121088,1,1,5,8,8,23
1912121089,5,1,3,1,7,17
1912121090,2,9,2,9,9,31
1912121091,0,7,1,2,1,11
1912121092,7,8,1,0,5,21
1912121093,7,7,7,6,9,36
1912121094,4,3,3,4,2,16
1912121095,1,2,8,4,3,18
1912121096,4,9,7,1,0,21
1912121097,3,3,0,9,8,23
1912121098,8,3,2,4,9,26
1912121099,1,2,9,4,8,24
1912121100,5,6,0,1,1,13
1912121101,9,9,1,4,4,27
1912121102,1,9,3,5,1,19
1912121103,9,7,6,0,4,26
1912121104,0,2,3,2,2,9
1912121105,6,3,2,3,2,16
191213001,2,4,0,2,1,9
191213002,1,6,4,7,0,18
191213003,7,2,6,1,7,23
191213004,2,0,8,1,7,18
191213005,8,1,8,9,0,26
191213006,8,0,7,0,9,24
191213007,3,8,2,6,2,21
191213008,9,6,5,9,2,31
191213009,2,1,4,4,0,11
191213010,6,8,5,6,5,30
191213011,6,5,9,7,9,36
191213012,1,2,5,0,3,11
191213013,4,3,7,4,6,24
191213014,7,9,6,6,7,35
191213015,6,8,8,2,1,25
191213016,4,5,3,1,9,22
191213017,2,9,8,5,4,28
191213018,0,8,6,7,4,25
191213019,8,0,2,4,3,17
191213020,4,0,6,4,5,19
191213021,0,4,4,4,1,13
191213022,7,1,6,6,7,27
191213023,4,1,3,6,1,15
191213024,6,0,9,8,3,26
191213025,1,5,4,9,9,28
191213026,7,2,2,6,8,25
191213027,3,0,5,0,4,12
191213028,7,2,5,2,1,17
191213029,7,4,6,5,9,31
191213030,4,2,1,4,1,12
191213031,6,5,6,6,1,24
191213032,6,4,2,2,4,18
191213033,4,2,8,9,9,32
191213034,1,2,4,8,5,20
191213035,4,7,3,2,8,24
191213036,7,1,7,6,8,29
191213037,7,4,4,7,8,30
191213038,3,9,3,2,7,24
191213039,2,6,2,7,0,17
191213040,5,4,3,9,4,25
191213041,0,6,9,8,4,27
191213042,8,3,2,2,1,16
191213043,8,5,4,3,2,22
191213044,8,0,4,7,0,19
191213045,0,5,0,8,3,16
191213046,2,5,0,9,3,19
191213047,9,2,2,2,3,18
191213048,5,8,6,1,6,26
191213049,4,8,5,1,3,21
191213050,1,9,9,6,7,32
191213051,7,9,2,7,6,31
191213052,8,9,9,5,4,35
191213053,6,7,9,6,2,30
191213054,3,6,6,7,5,27
191213055,5,9,4,8,1,27
191213056,7,0,5,6,8,26
191213057,5,4,0,7,5,21
191213058,8,1,1,5,6,21
191213059,2,6,8,7,4,27
191213060,5,8,9,7,4,33
191213061,1,6,4,2,5,18
191213062,7,9,3,0,0,19
191213063,0,2,5,6,5,18
191213064,2,5,9,3,5,24
191213065,6,4,0,3,4,17
191213066,1,2,2,3,3,11
191213067,0,8,6,4,8,26
191213068,0,1,5,2,0,8
191213069,3,9,6,7,2,27
191213070,8,0,6,8,2,24
191213071,6,7,9,4,5,31
191213072,0,9,4,1,1,15
191213073,4,7,3,4,5,23
191213074,4,3,4,7,2,20
191213075,0,6,8,1,7,22
191213076,1,1,5,7,2,16
191213077,7,7,4,0,2,20
191213078,7,4,4,2,0,17
191213079,1,4,5,4,1,15
191213080,2,3,7,5,7,24
191213081,8,7,2,0,4,21
191213082,8,4,9,0,0,21
191213083,2,9,5,6,7,29
191213084,3,8,1,5,2,19
191213085,2,6,6,5,6,25
191213086,6,1,9,8,2,26
191213087,5,8,6,5,0,24
191213088,4,4,9,7,9,33
191213089,7,6,1,5,4,23
191213090,2,8,0,9,5,24
191213091,2,1,9,9,6,27
191213092,2,1,1,1,8,13
191213093,9,8,9,5,9,40
191213094,9,8,4,7,1,29
191213095,1,4,1,0,1,7
191213096,7,7,0,9,4,27
191213097,5,7,9,3,3,27
191213098,3,2,5,0,7,17
191213099,7,2,7,9,4,29
191213100,0,6,0,5,2,13
191213101,0,5,4,2,2,13
191213102,7,2,2,4,5,20
191213103,5,3,0,6,9,23
191213104,9,3,6,1,7,26
191213105,2,3,6,2,9,22
191213106,5,2,8,4,1,20
191213107,8,4,5,8,8,33
191213108,9,0,0,8,7,24
191213109,7,7,4,1,0,19
191213110,5,8,8,3,8,32
191213111,1,3,8,4,7,23
191213112,6,9,3,3,6,27
191213113,0,6,1,1,9,17
191213114,9,2,0,5,2,18
191213115,8,2,5,2,8,25
191213116,0,6,1,7,5,19
191213117,6,1,3,9,5,24
191213118,2,8,3,3,3,19
191213119,2,0,6,5,5,18
191213120,3,7,2,0,7,19
191213121,0,2,3,3,8,16
191213122,2,2,9,0,6,19
191213123,0,6,3,8,7,24
191213124,8,1,9,7,1,26
191213125,8,7,6,4,1,26
191213126,5,1,5,2,5,18
191213127,4,6,0,9,5,24
191213128,4,9,0,3,1,17
191213129,5,0,1,5,2,13
191213130,0,0,9,8,8,25
191213131,5,0,5,4,5,19
191213132,0,9,1,9,8,27
191213133,0,3,8,4,9,24
191213134,5,1,8,9,4,27
191213135,2,2,6,8,9,27
191213136,3,9,9,0,3,24
191213137,1,8,1,1,0,11
191213138,9,0,4,3,7,23
191213139,8,9,5,5,0,27
191213140,6,2,9,2,4,23
191213141,4,0,9,7,3,23
191213142,1,6,4,6,7,24
191213143,0,9,8,5,9,31
191213144,5,1,1,2,6,15
191213145,5,4,4,5,0,18
191213146,2,9,6,3,9,29
191213147,8,6,0,7,5,26
191213148,7,7,4,5,4,27
191213149,2,6,5,0,0,13
191213150,8,4,5,6,3,26
191213151,6,1,9,1,6,23
191213152,5,2,6,7,4,24
191213153,4,8,9,9,3,33
191213154,3,4,8,3,1,19
191213155,7,4,6,2,4,23
191213156,2,8,8,8,0,26
191213157,5,0,0,4,1,10
191213158,9,9,7,8,2,35
191213159,7,5,6,9,4,31
191213160,4,1,2,3,3,13
191213161,6,7,0,8,8,29
191213162,4,5,2,3,2,16
191213163,9,9,4,0,8,30
191213164,9,6,7,3,2,27
191213165,0,4,1,8,7,20
191213166,0,8,6,8,4,26
191213167,3,0,9,0,4,16
191213168,4,1,1,0,8,14
191213169,5,9,8,4,4,30
191213170,7,1,5,5,9,27
191213171,4,9,6,3,7,29
191213172,0,6,0,3,7,16
191213173,8,9,7,8,7,39
191213174,5,3,3,8,4,23
191213175,8,0,5,9,4,26
191213176,4,4,3,4,9,24
191213177,3,5,4,8,9,29
191213178,8,3,4,0,3,18
191213179,5,5,4,2,5,21
191213180,7,7,5,8,3,30
191213181,3,2,1,7,5,18
191213182,4,1,4,1,7,17
191213183,3,1,5,2,8,19
191213184,8,6,2,5,7,28
191213185,3,6,7,4,6,26
191213186,4,0,0,1,0,5
191213187,5,3,7,5,6,26
191213188,2,3,5,4,7,21
191213189,4,0,6,1,9,20
191213190,9,3,4,7,0,23
191213191,9,6,6,7,1,29
191213192,3,1,4,8,9,25
191213193,9,3,9,8,5,34
191213194,8,8,8,1,2,27
191213195,1,1,6,6,8,22
191213196,6,9,8,4,4,31
191213197,2,8,3,7,1,21
191213198,3,1,8,6,0,18
191213199,9,6,0,9,1,25
191213200,4,6,8,0,4,22
191213201,5,2,1,2,9,19
191213202,8,3,9,2,7,29
191213203,9,2,1,3,6,21
191213204,9,5,0,5,4,23
191213205,1,8,0,7,8,24
191213206,2,7,8,8,7,32
191213207,8,0,3,9,6,26
191213208,2,6,8,2,5,23
191213209,9,8,7,4,5,33
191213210,5,7,6,8,6,32
191213211,4,1,0,1,7,13
191213212,8,5,3,5,7,28
191213213,0,8,3,6,4,21
191213214,5,4,9,7,8,33
191213215,5,1,6,0,5,17
191213216,9,6,9,0,3,27
191213217,2,2,2,8,3,17
191213218,3,4,0,8,7,22
191213219,4,2,0,9,1,16
191213220,3,7,5,8,0,23
191213221,3,5,9,2,4,23
191213222,1,1,4,9,3,18
191213223,2,1,8,5,9,25
191213224,8,2,4,7,5,26
191213225,6,6,9,1,5,27
191213226,3,1,9,8,4,25
191213227,5,6,0,9,8,28
191213228,9,2,9,3,5,28
191213229,7,3,1,2,9,22
191213230,6,7,9,4,4,30
191213231,8,6,9,5,4,32
191213232,5,3,4,3,1,16
191213233,3,6,4,2,1,16
191213234,1,9,7,7,4,28
191213235,1,1,7,3,3,15
191213236,0,8,3,2,4,17
191213237,1,1,0,9,9,20
191213238,2,2,3,4,9,20
191213239,1,3,4,2,5,15
191213240,8,0,1,5,5,19
191213241,4,5,2,8,0,19
191213242,6,6,0,2,1,15
191213243,9,6,4,5,8,32
191213244,7,5,8,5,8,33
191213245,3,7,8,4,5,27
191213246,5,2,5,9,1,22
191213247,4,3,2,9,1,19
191213248,6,5,5,0,7,23
191213249,1,0,8,1,2,12
191213250,0,5,2,5,7,19
191213251,9,7,6,0,9,31
191213252,5,2,8,1,6,22
191213253,8,0,5,8,9,30
191213254,7,4,0,2,7,20
191213255,3,8,9,2,0,22
191213256,2,5,6,6,0,19
191213257,5,7,9,4,7,32
191213258,9,4,5,3,6,27
191213259,0,9,1,7,5,22
191213260,3,9,2,6,7,27
191213261,8,0,0,8,6,22
191213262,8,0,2,6,1,17
191213263,8,1,0,1,7,17
191213264,8,6,7,5,0,26
191213265,9,0,0,2,2,13
191213266,1,7,5,8,9,30
191213267,2,0,2,6,3,13
191213268,0,7,0,4,2,13
191213269,7,1,7,6,3,24
191213270,8,5,5,3,1,22
191213271,0,8,7,7,4,26
191213272,7,6,8,2,5,28
191213273,1,5,9,9,4,28
191213274,5,2,9,6,6,28
191213275,5,5,1,0,7,18
191213276,1,9,6,1,4,21
191213277,6,9,5,9,7,36
191213278,7,9,8,7,9,40
191213279,1,9,2,2,9,23
191213280,7,4,9,8,1,29
191213281,2,0,0,4,1,7
191213282,2,8,9,8,3,30
191213283,2,2,4,9,8,25
191213284,5,3,5,3,8,24
191213285,4,4,0,5,6,19
191213286,2,4,7,1,8,22
191213287,7,4,3,7,3,24
191213288,6,8,6,2,7,29
191213289,4,8,7,6,4,29
191213290,5,5,9,6,4,29
191213291,5,1,9,8,4,27
191213292,6,7,5,8,3,29
191213293,3,0,3,6,6,18
191213294,3,6,6,2,1,18
191213295,2,7,7,7,2,25
191213296,9,4,5,6,8,32
191213297,8,8,0,1,3,20
191213298,0,0,8,9,9,26
191213299,2,9,4,3,9,27
191213300,1,5,3,5,4,18
191213301,5,3,9,9,8,34
191213302,5,0,3,5,6,19
191213303,1,6,1,2,8,18
191213304,4,0,3,1,0,8
191213305,0,1,0,3,9,13
191213306,8,4,7,3,4,26
191213307,1,2,4,2,2,11
191213308,8,4,5,7,0,24
191213309,6,5,4,3,6,24
191213310,8,2,7,0,1,18
191213311,5,1,1,2,5,14
191213312,8,9,2,5,7,31
191213313,3,5,8,7,9,32
191213314,3,8,3,1,5,20
191213315,3,2,1,2,5,13
191213316,6,0,6,1,6,19
191213317,9,2,9,6,9,35
191213318,2,2,3,7,2,16
191213319,0,1,1,7,9,18
191213320,9,4,8,8,2,31
191213321,2,2,7,0,7,18
191213322,5,6,1,7,7,26
191213323,3,4,3,2,8,20
191213324,5,1,2,0,3,11
191213325,0,6,7,6,2,21
191213326,5,9,9,4,3,30
191213327,8,8,1,3,4,24
191213328,2,1,7,5,2,17
191213329,0,8,0,1,4,13
191213330,0,6,4,3,9,22
191213331,0,6,2,6,4,18
191213332,3,3,5,7,4,22
191213333,3,1,3,2,4,13
191213334,0,3,1,5,6,15
191213335,1,5,4,2,3,15
191213336,9,3,9,2,9,32
191213337,3,5,9,5,6,28
191213338,7,4,4,9,3,27
191213339,7,3,5,9,1,25
191213340,3,5,2,5,6,21
191213341,1,4,9,2,5,21
191213342,4,6,5,4,0,19
191213343,0,5,4,8,2,19
191213344,1,2,4,1,0,8
191213345,1,6,9,2,5,23
191213346,1,2,6,0,0,9
191213347,5,6,1,1,9,22
191213348,6,3,3,8,7,27
191213349,9,0,9,2,4,24
191213350,5,1,1,7,0,14
191213351,6,5,6,5,7,29
191213352,1,1,9,1,0,12
191213353,8,9,0,8,2,27
191213354,8,0,0,2,2,12
191213355,3,9,3,5,0,20
191213356,4,4,5,2,7,22
191213357,8,7,9,4,6,34
191213358,2,8,9,0,6,25
191213359,4,9,4,2,5,24
191213360,6,5,1,0,2,14
191213361,4,1,5,1,9,20
191213362,9,0,7,0,7,23
191213363,6,7,6,9,4,32
191213364,6,7,2,4,4,23
191213365,0,4,1,5,9,19
191213366,8,8,8,4,2,30
191213367,0,0,6,3,3,12
191213368,0,8,5,0,7,20
191213369,4,6,1,6,2,19
191213370,8,3,3,7,5,26
191213371,6,9,2,0,5,22
191213372,4,3,6,3,2,18
191213373,9,1,3,8,6,27
191213374,6,8,4,3,5,26
191213375,2,9,6,2,0,19
191213376,4,8,8,5,8,33
191213377,6,4,0,2,1,13
191213378,6,8,2,5,8,29
191213379,0,2,1,3,5,11
191213380,1,0,4,5,1,11
191213381,1,7,0,1,2,11
191213382,7,3,0,3,0,13
191213383,4,4,3,8,0,19
191213384,7,2,1,2,4,16
191213385,1,4,9,8,4,26
191213386,6,8,6,3,1,24
191213387,2,7,2,3,2,16
191213388,8,9,4,0,4,25
191213389,7,2,4,6,2,21
191213390,1,1,7,8,0,17
191213391,9,8,6,7,6,36
191213392,3,3,6,8,4,24
191213393,5,5,7,7,0,24
191213394,1,8,8,7,8,32
191213395,9,8,0,6,4,27
191213396,6,0,3,5,3,17
191213397,0,6,3,2,2,13
191213398,1,0,2,6,9,18
191213399,2,3,3,9,1,18
191213400,7,7,4,3,3,24
191213401,4,7,4,7,7,29
191213402,5,2,7,6,8,28
191213403,9,6,3,3,0,21
191213404,1,9,0,3,6,19
191213405,5,2,6,6,8,27
191213406,1,4,5,9,4,23
191213407,9,6,9,7,7,38
191213408,6,6,9,7,6,34
191213409,0,5,6,1,6,18
191213410,0,6,7,7,4,24
191213411,3,5,3,8,3,22
191213412,1,4,5,3,4,17
191213413,9,7,3,1,9,29
191213414,2,4,2,8,4,20
191213415,3,1,6,0,7,17
191213416,0,9,4,6,3,22
191213417,6,2,4,0,0,12
191213418,1,2,9,3,8,23
191213419,4,5,1,8,6,24
191213420,7,6,0,1,0,14
191213421,5,0,8,1,5,19
191213422,8,3,1,3,4,19
191213423,7,0,8,6,7,28
191213424,6,6,1,4,8,25
191213425,2,3,9,5,9,28
191213426,8,9,0,6,3,26
191213427,3,4,2,4,9,22
191213428,6,2,2,0,3,13
191213429,9,7,7,0,3,26
191213430,2,1,6,0,3,12
191213431,2,3,2,3,2,12
191213432,4,8,6,3,4,25
191213433,3,8,9,4,1,25
191213434,4,2,1,1,9,17
191213435,0,7,3,9,4,23
191213436,6,1,4,5,3,19
191213437,7,5,7,1,7,27
191213438,7,4,2,7,5,25
191213439,7,4,4,6,4,25
191213440,7,0,3,2,6,18
191213441,0,0,9,6,4,19
191213442,1,2,5,3,5,16
191213443,3,3,6,9,3,24
191213444,6,3,2,0,7,18
191213445,8,3,0,9,2,22
191213446,2,1,2,7,1,13
191213447,7,5,3,9,1,25
191213448,6,0,1,8,0,15
191213449,4,8,6,2,5,25
191213450,8,5,8,8,1,30
191213451,4,6,4,8,3,25
191213452,3,1,0,1,6,11
191213453,4,5,7,4,7,27
191213454,3,3,6,1,1,14
191213455,1,4,2,1,7,15
191213456,0,3,8,6,5,22
191213457,0,1,0,5,8,14
191213458,6,5,5,7,7,30
191213459,8,1,3,7,2,21
191213460,0,8,1,0,0,9
191213461,8,7,2,3,1,21
191213462,2,1,6,8,2,19
191213463,0,5,2,6,5,18
191213464,1,2,1,8,3,15
191213465,2,6,7,7,6,28
191213466,3,9,4,0,9,25
191213467,2,1,4,7,5,19
191213468,0,2,4,0,5,11
191213469,2,4,4,7,4,21
191213470,1,9,4,1,6,21
191213471,5,2,2,5,0,14
191213472,7,1,8,2,8,26
191213473,6,4,1,7,7,25
191213474,3,3,9,0,8,23
191213475,1,6,8,7,5,27
191213476,6,7,3,2,3,21
191213477,3,1,0,1,8,13
191213478,3,0,1,9,9,22
191213479,9,2,2,7,6,26
191213480,0,9,8,2,1,20
191213481,5,3,8,1,7,24
191213482,6,3,4,1,0,14
191213483,8,8,4,0,6,26
191213484,3,0,5,7,1,16
191213485,4,9,4,4,5,26
191213486,1,9,1,8,9,28
191213487,7,9,5,8,6,35
191213488,2,9,0,3,5,19
191213489,3,9,1,4,4,21
191213490,2,0,0,5,4,11
191213491,7,3,8,6,0,24
191213492,7,6,4,5,6,28
191213493,9,8,7,5,3,32
191213494,8,7,7,9,6,37
191213495,9,8,8,3,4,32
191213496,7,8,5,9,5,34
191213497,7,0,9,8,1,25
191213498,8,2,7,4,7,28
191213499,5,4,8,8,0,25
191213500,2,5,2,2,0,11
191213501,4,4,8,5,9,30
191213502,5,2,3,6,5,21
191213503,0,5,5,2,3,15
191213504,8,0,1,5,2,16
191213505,2,7,9,1,6,25
191213506,9,2,8,1,1,21
191213507,5,4,1,8,8,26
191213508,8,8,4,9,6,35
191213509,5,9,3,8,7,32
191213510,1,7,7,6,0,21
191213511,0,4,6,9,4,23
191213512,9,3,4,2,1,19
191213513,9,1,9,9,8,36
191213514,5,2,9,3,0,19
191213515,0,4,1,3,8,16
191213516,6,9,3,0,4,22
191213517,6,2,9,4,9,30
191213518,7,4,9,9,5,34
191213519,4,0,1,8,8,21
191213520,7,7,9,6,2,31
191213521,4,4,2,6,6,22
191213522,6,8,5,8,6,33
191213523,1,7,7,5,4,24
191213524,3,2,4,9,6,24
191213525,0,5,0,6,3,14
191213526,8,4,7,7,4,30
191213527,7,6,6,4,2,25
191213528,9,1,0,6,9,25
191213529,8,7,2,0,5,22
191213530,2,2,0,6,3,13
191213531,7,3,6,2,6,24
191213532,5,9,5,8,3,30
191213533,0,2,3,2,1,8
191213534,2,0,7,5,3,17
191213535,9,2,2,0,4,17
191213536,2,5,7,1,8,23
191213537,7,6,4,2,2,21
191213538,9,5,1,2,4,21
191213539,5,4,9,7,3,28
191213540,3,2,4,9,3,21
191213541,6,3,9,0,0,18
191213542,7,3,8,1,3,22
191213543,6,6,8,7,1,28
191213544,1,1,2,6,4,14
191213545,1,6,1,8,6,22
191213546,5,9,9,0,6,29
191213547,5,2,8,1,7,23
191213548,9,5,2,5,2,23
191213549,6,6,2,9,2,25
191213550,4,6,7,3,0,20
191213551,0,9,1,3,0,13
191213552,5,6,2,0,9,22
191213553,5,4,0,4,9,22
191213554,4,5,0,1,9,19
191213555,8,2,9,0,4,23
191213556,6,4,3,1,3,17
191213557,4,6,9,4,3,26
191213558,5,5,6,3,1,20
191213559,6,9,4,7,8,34
191213560,3,4,5,4,1,17
191213561,5,5,4,7,2,23
191213562,1,3,4,0,5,13
191213563,4,2,5,7,2,20
191213564,5,1,6,7,4,23
191213565,3,8,5,5,4,25
191213566,9,8,3,1,9,30
191213567,2,8,4,1,7,22
191213568,8,8,6,3,4,29
191213569,0,8,5,6,6,25
191213570,9,7,3,4,0,23
191213571,0,7,6,0,6,19
191213572,2,3,3,5,7,20
191213573,1,6,0,8,6,21
191213574,7,0,2,0,7,16
191213575,3,7,6,5,3,24
191213576,2,6,4,2,4,18
191213577,4,5,5,2,3,19
191213578,6,7,3,4,0,20
191213579,5,9,6,5,6,31
191213580,3,9,9,3,1,25
191213581,4,1,2,0,5,12
191213582,2,9,8,0,0,19
191213583,4,4,2,8,1,19
191213584,7,6,8,3,3,27
191213585,1,5,7,4,8,25
191213586,9,1,9,2,3,24
191213587,4,9,2,7,2,24
191213588,0,7,6,6,4,23
191213589,3,4,0,8,1,16
191213590,0,4,9,4,5,22
191213591,0,0,2,0,2,4
191213592,8,0,2,9,8,27
191213593,6,5,3,7,4,25
191213594,6,9,8,7,0,30
191213595,6,8,7,2,2,25
191213596,7,5,6,4,4,26
191213597,5,4,0,2,7,18
191213598,1,0,6,5,2,14
191213599,1,0,1,3,1,6
191213600,0,4,8,5,6,23
191213601,7,2,5,9,3,26
191213602,0,9,7,7,2,25
191213603,1,5,6,6,4,22
191213604,3,7,6,8,3,27
191213605,8,7,3,0,1,19
191213606,2,0,8,7,2,19
191213607,9,8,6,7,2,32
191213608,6,7,7,8,1,29
191213609,2,4,7,8,2,23
191213610,5,9,8,1,9,32
191213611,1,0,6,0,6,13
191213612,7,9,9,4,9,38
191213613,6,3,3,4,0,16
191213614,5,9,3,5,4,26
191213615,7,6,4,4,5,26
191213616,9,6,9,7,5,36
191213617,9,1,6,7,5,28
191213618,9,9,2,1,0,21
191213619,7,1,1,2,9,20
191213620,4,9,7,1,5,26
191213621,2,4,2,3,1,12
191213622,7,2,7,3,0,19
191213623,2,2,4,6,9,23
191213624,2,0,4,5,7,18
191213625,0,1,2,6,6,15
191213626,8,9,7,5,6,35
191213627,1,5,4,4,6,20
191213628,9,5,7,7,1,29
191213629,1,0,2,6,8,17
191213630,8,8,0,8,5,29
191213631,8,5,0,7,8,28
191213632,5,1,1,2,8,17
191213633,1,0,2,4,3,10
191213634,9,5,2,5,4,25
191213635,7,9,0,7,3,26
191213636,3,1,8,8,0,20
191213637,4,9,5,7,1,26
191213638,6,3,2,4,0,15
191213639,6,5,9,1,5,26
191213640,8,5,1,0,2,16
191213641,6,5,1,5,4,21
191213642,6,1,6,0,5,18
191213643,1,7,8,6,7,29
191213644,5,0,2,2,6,15
191213645,5,1,4,5,2,17
191213646,2,0,7,1,7,17
191213647,6,8,0,3,7,24
191213648,5,8,3,2,7,25
191213649,7,4,9,9,2,31
191213650,0,3,2,9,4,18
191213651,1,5,4,1,4,15
191213652,1,7,5,3,0,16
191213653,1,2,1,3,8,15
191213654,4,1,9,9,4,27
191213655,5,4,6,5,2,22
191213656,9,3,4,0,6,22
191213657,6,9,3,8,1,27
191213658,0,7,3,9,3,22
191213659,1,6,0,8,8,23
191213660,2,4,4,9,4,23
191213661,4,2,1,9,0,16
191213662,4,0,6,7,7,24
191213663,4,0,2,2,0,8
191213664,9,1,7,0,9,26
191213665,1,2,8,2,3,16
191213666,6,0,8,4,0,18
191213667,3,7,5,7,2,24
191213668,1,7,1,7,3,19
191213669,9,1,9,9,7,35
191213670,2,2,1,3,8,16
191213671,0,5,0,2,9,16
191213672,1,0,4,6,1,12
191213673,6,1,8,6,6,27
191213674,2,9,6,8,0,25
191213675,3,9,0,2,5,19
191213676,9,0,3,8,5,25
191213677,1,1,0,7,0,9
191213678,2,3,2,2,7,16
191213679,3,2,5,7,3,20
191213680,0,0,7,1,3,11
191213681,6,7,0,8,9,30
191213682,0,3,6,5,6,20
191213683,7,7,4,0,3,21
191213684,1,8,0,6,6,21
191213685,9,7,1,5,5,27
191213686,1,4,5,3,1,14
191213687,7,9,5,2,3,26
191213688,6,5,9,3,5,28
191213689,4,2,5,8,9,28
191213690,3,6,5,2,3,19
191213691,2,6,9,5,1,23
191213692,2,0,3,0,8,13
191213693,3,3,3,6,8,23
191213694,3,4,1,8,0,16
191213695,3,5,4,6,7,25
191213696,4,9,9,8,5,35
191213697,8,4,5,7,6,30
191213698,7,2,5,8,6,28
191213699,0,5,8,4,4,21
191213700,7,1,1,2,1,12
191213701,8,0,1,1,8,18
191213702,7,7,2,2,1,19
191213703,1,4,2,4,2,13
191213704,9,7,8,5,4,33
191213705,5,3,3,4,3,18
191213706,7,2,8,9,1,27
191213707,9,7,8,2,4,30
191213708,7,3,4,8,2,24
191213709,1,8,7,7,6,29
191213710,5,1,3,9,9,27
191213711,9,1,3,1,4,18
191213712,4,1,1,2,4,12
191213713,1,2,1,0,5,9
191213714,7,3,8,8,2,28
191213715,6,8,2,2,1,19
191213716,7,5,0,7,5,24
191213717,6,7,5,4,5,27
191213718,7,5,0,7,2,21
191213719,6,7,3,7,0,23
191213720,1,1,6,0,8,16
191213721,1,5,5,7,8,26
191213722,1,0,2,0,2,5
191213723,4,2,0,2,8,16
191213724,2,9,7,4,7,29
191213725,0,8,0,2,4,14
191213726,4,2,0,5,9,20
191213727,4,3,1,5,9,22
191213728,8,1,8,8,9,34
191213729,2,0,8,3,1,14
191213730,9,9,1,6,6,31
191213731,4,0,4,5,8,21
191213732,3,2,4,4,9,22
191213733,7,4,1,6,4,22
191213734,9,2,0,5,4,20
191213735,8,8,1,4,6,27
191213736,6,6,2,0,8,22
191213737,2,2,0,7,8,19
191213738,1,9,9,1,9,29
191213739,7,8,7,7,1,30
191213740,6,7,7,7,3,30
191213741,4,0,9,0,2,15
191213742,1,3,8,2,1,15
191213743,8,7,4,4,7,30
191213744,1,2,7,1,1,12
191213745,9,5,7,6,2,29
191213746,5,0,5,2,9,21
191213747,7,9,7,7,8,38
191213748,4,1,1,3,6,15
191213749,8,0,1,5,7,21
191213750,3,3,2,8,5,21
191213751,3,2,2,5,0,12
191213752,9,1,6,7,2,25
191213753,7,3,7,3,2,22
191213754,8,7,1,5,0,21
191213755,9,4,6,6,4,29
191213756,0,6,0,8,0,14
191213757,0,5,0,2,2,9
191213758,9,7,2,1,5,24
191213759,5,5,1,7,1,19
191213760,5,1,8,2,4,20
191213761,1,4,7,4,5,21
191213762,5,6,9,2,4,26
191213763,2,3,4,1,5,15
191213764,2,9,6,4,3,24
191213765,8,6,7,1,8,30
191213766,0,0,5,9,9,23
191213767,9,8,6,0,5,28
191213768,3,3,8,2,5,21
191213769,6,0,0,7,5,18
191213770,4,4,8,1,9,26
191213771,5,5,7,7,1,25
191213772,7,3,3,4,8,25
191213773,8,6,1,9,2,26
191213774,8,5,9,6,1,29
191213775,7,7,2,6,0,22
191213776,2,7,6,5,5,25
191213777,4,1,8,0,3,16
191213778,1,4,1,2,4,12
191213779,1,9,4,2,7,23
191213780,7,5,1,2,5,20
191213781,0,2,9,5,6,22
191213782,7,6,9,8,2,32
191213783,0,7,3,8,6,24
191213784,2,8,2,2,7,21
191213785,9,9,9,6,7,40
191213786,2,8,9,2,8,29
191213787,8,3,1,6,0,18
191213788,2,5,4,8,0,19
191213789,8,3,0,8,9,28
191213790,6,2,6,3,5,22
191213791,2,4,9,9,2,26
191213792,1,8,4,7,8,28
191213793,2,9,5,1,1,18
191213794,6,9,1,7,2,25
191213795,7,0,8,5,0,20
191213796,2,0,5,7,8,22
191213797,7,3,4,6,0,20
191213798,3,7,7,2,4,23
191213799,6,2,5,0,7,20
191213800,5,4,0,4,6,19
191213801,5,1,3,7,2,18
191213802,6,7,1,8,8,30
191213803,0,8,3,3,4,18
191213804,6,3,1,2,4,16
191213805,3,2,6,1,8,20
191213806,0,7,6,7,3,23
191213807,1,3,9,9,5,27
191213808,9,1,4,9,9,32
191213809,3,4,9,3,6,25
191213810,3,1,1,0,6,11
191213811,6,3,8,7,1,25
191213812,4,9,6,0,9,28
191213813,5,3,9,8,5,30
191213814,8,9,1,9,1,28
191213815,8,0,0,5,7,20
191213816,6,3,1,9,7,26
191213817,2,1,5,3,9,20
191213818,3,7,3,1,3,17
191213819,2,9,1,7,0,19
191213820,6,0,2,0,5,13
191213821,6,3,1,3,6,19
191213822,5,9,5,6,5,30
191213823,6,8,8,4,2,28
191213824,2,8,2,4,3,19
191213825,1,5,0,9,0,15
191213826,9,2,1,7,8,27
191213827,4,4,9,3,6,26
191213828,1,3,7,9,1,21
191213829,3,1,0,6,2,12
191213830,2,7,4,9,6,28
191213831,5,6,5,2,3,21
191213832,7,4,5,9,3,28
191213833,6,1,6,4,1,18
191213834,2,5,2,3,5,17
191213835,8,4,1,0,1,14
191213836,1,9,9,3,0,22
191213837,5,4,0,4,7,20
191213838,2,3,1,2,9,17
191213839,2,4,6,9,5,26
191213840,9,1,9,3,0,22
191213841,7,2,6,7,3,25
191213842,7,7,6,4,8,32
191213843,5,5,4,4,2,20
191213844,0,2,7,7,8,24
191213845,2,3,4,7,7,23
191213846,7,7,0,1,7,22
191213847,9,8,0,9,9,35
191213848,0,8,6,6,2,22
191213849,3,0,6,9,9,27
191213850,7,7,4,8,6,32
191213851,8,1,9,1,6,25
191213852,5,3,4,6,2,20
191213853,2,9,2,8,7,28
191213854,8,4,7,7,2,28
191213855,6,1,5,1,2,15
191213856,8,7,0,1,5,21
191213857,9,1,1,4,0,15
191213858,3,3,4,6,7,23
191213859,6,1,6,7,3,23
191213860,0,2,7,2,9,20
191213861,6,7,4,9,6,32
191213862,2,4,5,7,2,20
191213863,3,5,6,7,1,22
191213864,4,6,7,1,2,20
191213865,3,4,7,4,9,27
191213866,8,4,7,9,5,33
191213867,9,1,8,7,7,32
191213868,8,7,7,1,7,30
191213869,6,8,8,7,4,33
191213870,1,8,3,6,7,25
191213871,7,6,8,1,5,27
191213872,8,3,3,4,1,19
191213873,8,0,7,9,9,33
191213874,4,5,9,9,1,28
191213875,1,3,8,5,0,17
191213876,2,1,6,4,4,17
191213877,8,1,1,9,6,25
191213878,4,1,5,1,4,15
191213879,3,8,8,2,5,26
191213880,1,4,3,9,6,23
191213881,8,4,9,2,4,27
191213882,5,0,4,5,1,15
191213883,5,6,9,6,8,34
191213884,1,6,0,7,5,19
191213885,0,2,7,7,7,23
191213886,8,2,2,7,6,25
191213887,4,5,0,8,4,21
191213888,8,8,8,2,7,33
191213889,9,0,9,5,2,25
191213890,5,4,3,0,4,16
191213891,5,6,5,9,4,29
191213892,0,3,2,2,5,12
191213893,4,1,9,1,4,19
191213894,6,5,3,2,9,25
191213895,1,1,3,0,4,9
191213896,2,5,7,5,7,26
191213897,2,3,6,2,0,13
191213898,7,0,9,7,0,23
191213899,8,7,6,0,6,27
191213900,8,6,0,0,6,20
191213901,6,3,9,8,0,26
191213902,7,1,0,1,8,17
191213903,6,8,8,8,7,37
191213904,2,0,8,7,1,18
191213905,9,3,7,9,1,29
191213906,5,3,9,1,1,19
191213907,4,2,9,3,0,18
191213908,6,5,0,1,6,18
191213909,8,2,6,7,1,24
191213910,6,1,3,4,1,15
191213911,3,4,9,6,9,31
191213912,9,6,7,4,2,28
191213913,4,2,7,1,7,21
191213914,3,4,1,8,8,24
191213915,2,2,4,0,9,17
191213916,3,2,4,6,7,22
191213917,5,2,4,8,4,23
191213918,1,1,5,5,1,13
191213919,5,7,6,4,2,24
191213920,5,6,1,2,2,16
191213921,2,1,9,9,5,26
191213922,2,5,7,5,9,28
191213923,8,4,0,0,3,15
191213924,2,7,9,4,7,29
191213925,7,5,7,8,8,35
191213926,6,3,2,7,1,19
191213927,9,7,9,6,8,39
191213928,4,6,9,3,1,23
191213929,9,6,9,9,4,37
191213930,6,0,9,5,7,27
191213931,9,0,4,9,1,23
191213932,2,5,1,0,5,13
191213933,2,5,7,0,9,23
191213934,3,1,9,9,5,27
191213935,3,8,3,7,7,28
191213936,6,1,6,7,9,29
191213937,3,5,6,4,7,25
191213938,6,7,2,5,8,28
191213939,3,7,3,7,3,23
191213940,0,1,8,7,4,20
191213941,7,2,0,1,6,16
191213942,9,2,9,3,2,25
191213943,6,4,9,1,3,23
191213944,1,2,9,7,6,25
191213945,5,7,8,2,4,26
191213946,6,6,4,5,4,25
191213947,4,8,4,6,0,22
191213948,2,4,7,4,4,21
191213949,0,8,5,3,5,21
191213950,6,7,8,8,6,35
191213951,0,6,6,2,4,18
191213952,3,9,4,1,0,17
191213953,7,3,5,8,3,26
191213954,2,6,2,7,9,26
191213955,2,1,2,1,0,6
191213956,8,3,8,8,2,29
191213957,5,3,3,0,9,20
191213958,6,1,5,2,1,15
191213959,2,4,0,8,6,20
191213960,8,5,4,8,9,34
191213961,0,6,3,1,9,19
191213962,7,0,1,1,7,16
191213963,6,9,6,8,5,34
191213964,7,6,1,4,2,20
191213965,1,9,0,3,0,13
191213966,5,1,2,4,8,20
191213967,2,4,3,2,4,15
191213968,2,7,4,0,0,13
191213969,4,8,7,7,3,29
191213970,1,4,0,3,6,14
191213971,9,2,0,4,5,20
191213972,2,8,9,1,2,22
191213973,6,2,1,3,2,14
191213974,5,3,7,7,9,31
191213975,5,8,4,7,3,27
191213976,3,2,5,3,1,14
191213977,8,5,2,7,4,26
191213978,9,9,7,5,8,38
191213979,8,8,5,7,4,32
191213980,9,6,6,1,9,31
191213981,2,0,4,5,6,17
191213982,4,5,7,6,0,22
191213983,7,2,0,6,4,19
191213984,1,6,7,6,7,27
191213985,4,5,4,9,2,24
191213986,8,3,3,5,8,27
191213987,2,5,0,4,6,17
191213988,9,7,8,5,9,38
191213989,8,9,3,3,7,30
191213990,1,2,8,9,6,26
191213991,4,9,8,2,9,32
191213992,8,4,7,0,4,23
191213993,5,9,2,5,9,30
191213994,4,9,1,1,8,23
191213995,5,0,5,0,1,11
191213996,3,3,7,3,7,23
191213997,1,1,8,6,9,25
191213998,1,2,8,0,7,18
191213999,6,0,5,5,9,25
1912131000,9,1,5,8,7,30
1912131001,0,8,7,4,5,24
1912131002,2,7,8,4,5,26
1912131003,8,6,3,3,2,22
1912131004,5,3,8,6,9,31
1912131005,1,7,3,5,4,20
1912131006,0,3,9,3,8,23
1912131007,6,5,2,8,0,21
1912131008,1,0,7,6,5,19
1912131009,2,6,0,8,2,18
1912131010,1,7,4,2,8,22
1912131011,4,2,9,0,7,22
1912131012,4,5,4,7,5,25
1912131013,0,7,6,8,2,23
1912131014,7,9,2,7,3,28
1912131015,1,2,4,5,6,18
1912131016,0,1,4,0,9,14
1912131017,0,8,3,3,3,17
1912131018,9,6,4,0,5,24
1912131019,7,0,2,2,9,20
1912131020,6,2,0,0,9,17
1912131021,3,6,1,0,3,13
1912131022,9,9,3,0,2,23
1912131023,3,5,7,9,1,25
1912131024,0,0,6,9,9,24
1912131025,2,2,2,8,4,18
1912131026,0,0,6,6,8,20
1912131027,9,2,7,0,7,25
1912131028,6,6,9,5,7,33
1912131029,3,7,9,6,9,34
1912131030,9,9,8,8,2,36
1912131031,9,5,8,5,7,34
1912131032,2,1,6,1,3,13
1912131033,8,5,7,0,8,28
1912131034,9,6,0,4,9,28
1912131035,3,5,6,8,9,31
1912131036,2,0,9,3,8,22
1912131037,3,8,7,7,4,29
1912131038,3,9,7,6,8,33
1912131039,5,1,9,5,8,28
1912131040,0,7,1,8,4,20
1912131041,2,8,7,0,6,23
1912131042,2,9,0,0,4,15
1912131043,9,4,8,8,7,36
1912131044,4,2,4,0,9,19
1912131045,9,3,1,3,9,25
1912131046,3,7,7,8,3,28
1912131047,3,6,7,9,8,33
1912131048,2,6,4,2,7,21
1912131049,4,4,2,9,9,28
1912131050,4,3,4,6,7,24
1912131051,8,7,0,1,7,23
1912131052,1,1,7,2,9,20
1912131053,6,2,3,3,1,15
1912131054,5,1,6,5,3,20
1912131055,6,6,8,4,2,26
1912131056,9,4,9,3,0,25
1912131057,9,0,0,8,4,21
1912131058,2,0,6,5,9,22
1912131059,5,5,0,0,7,17
1912131060,2,9,3,4,7,25
1912131061,5,8,3,5,3,24
1912131062,6,4,5,3,3,21
1912131063,2,3,5,3,7,20
1912131064,2,7,1,8,1,19
1912131065,7,1,9,7,0,24
1912131066,6,8,8,5,0,27
1912131067,3,8,5,0,7,23
1912131068,5,7,3,7,0,22
1912131069,2,0,0,8,0,10
1912131070,2,5,6,1,4,18
1912131071,1,4,3,8,5,21
1912131072,4,4,6,1,3,18
1912131073,5,2,2,8,4,21
1912131074,2,7,0,9,1,19
1912131075,3,6,6,3,7,25
1912131076,5,2,3,8,7,25
1912131077,5,5,1,8,8,27
1912131078,1,7,5,2,3,18
1912131079,3,5,1,9,5,23
1912131080,0,8,5,1,1,15
1912131081,6,2,5,0,6,19
1912131082,9,3,1,9,7,29
1912131083,4,4,4,8,9,29
1912131084,4,4,1,2,1,12
1912131085,6,0,7,8,6,27
1912131086,6,6,0,6,7,25
1912131087,3,8,6,1,4,22
1912131088,0,2,3,8,4,17
1912131089,1,7,4,9,5,26
1912131090,4,2,2,6,9,23
1912131091,9,5,1,0,0,15
1912131092,9,3,1,1,6,20
1912131093,1,3,0,6,6,16
1912131094,0,0,7,9,7,23
1912131095,6,5,5,5,9,30
1912131096,2,3,4,6,8,23
1912131097,6,6,5,3,7,27
1912131098,7,0,5,6,1,19
1912131099,9,0,4,1,9,23
1912131100,6,2,9,5,0,22
1912131101,4,1,5,0,6,16
1912131102,3,8,6,9,9,35
1912131103,1,1,1,6,8,17
1912131104,4,0,1,2,3,10
1912131105,3,6,9,8,7,33
191214001,6,4,0,9,9,28
191214002,0,7,7,3,7,24
191214003,3,6,0,6,8,23
191214004,0,3,2,2,3,10
191214005,0,9,2,3,3,17
191214006,8,2,3,1,5,19
191214007,4,7,1,2,8,22
191214008,3,0,3,4,1,11
191214009,4,5,1,9,4,23
191214010,7,6,9,1,4,27
191214011,6,9,6,1,2,24
191214012,2,1,5,0,1,9
191214013,4,6,0,0,3,13
191214014,1,5,4,8,2,20
191214015,5,3,6,8,3,25
191214016,8,8,1,1,7,25
191214017,9,4,0,9,9,31
191214018,8,6,1,1,4,20
191214019,0,3,6,8,9,26
191214020,3,3,8,5,1,20
191214021,0,9,8,1,3,21
191214022,0,1,5,4,6,16
191214023,1,2,4,8,7,22
191214024,4,2,1,9,6,22
191214025,3,1,0,1,9,14
191214026,4,7,6,4,6,27
191214027,4,9,8,0,6,27
191214028,4,1,7,8,5,25
191214029,5,3,5,4,0,17
191214030,6,5,3,3,9,26
191214031,9,7,5,5,0,26
191214032,2,9,7,5,8,31
191214033,4,7,9,5,9,34
191214034,0,0,7,6,1,14
191214035,3,3,2,5,0,13
191214036,4,7,4,3,6,24
191214037,6,4,3,8,1,22
191214038,0,4,8,7,0,19
191214039,2,1,3,1,2,9
191214040,6,7,2,5,6,26
191214041,2,5,0,6,3,16
191214042,1,9,1,7,5,23
191214043,0,5,6,3,0,14
191214044,7,1,0,7,0,15
191214045,8,5,3,8,5,29
191214046,6,9,4,5,8,32
191214047,5,5,5,9,7,31
191214048,3,4,0,0,0,7
191214049,0,0,1,7,9,17
191214050,5,4,1,6,4,20
191214051,5,8,2,7,2,24
191214052,3,7,8,6,2,26
191214053,3,6,2,1,1,13
191214054,4,3,8,8,9,32
191214055,1,3,9,8,6,27
191214056,3,5,6,7,4,25
191214057,9,7,3,7,1,27
191214058,7,8,6,2,3,26
191214059,0,7,1,7,7,22
191214060,1,3,2,7,5,18
191214061,4,4,3,0,5,16
191214062,2,2,0,9,3,16
191214063,1,9,3,2,0,15
191214064,6,9,6,9,9,39
191214065,2,6,2,9,5,24
191214066,5,1,1,6,2,15
191214067,9,6,8,8,0,31
191214068,1,3,2,7,4,17
191214069,0,0,4,8,5,17
191214070,0,3,5,6,6,20
191214071,7,2,5,3,6,23
191214072,0,3,7,3,9,22
191214073,3,0,1,5,4,13
191214074,7,4,5,8,0,24
191214075,4,5,2,2,8,21
191214076,0,2,4,1,5,12
191214077,1,9,3,3,6,22
191214078,3,2,1,4,4,14
191214079,8,0,9,2,7,26
191214080,4,1,0,2,3,10
191214081,8,6,2,2,2,20
191214082,8,7,2,3,2,22
191214083,4,5,8,3,3,23
191214084,1,5,5,3,6,20
191214085,4,7,4,5,6,26
191214086,6,8,5,3,7,29
191214087,1,6,1,7,7,22
191214088,8,5,9,9,2,33
191214089,0,1,9,1,0,11
191214090,5,8,5,3,7,28
191214091,6,6,7,9,2,30
191214092,2,5,3,4,6,20
191214093,5,9,2,7,0,23
191214094,2,1,1,2,8,14
191214095,5,7,2,7,7,28
191214096,5,5,8,4,9,31
191214097,9,3,3,0,4,19
191214098,4,3,2,7,2,18
191214099,6,9,0,8,1,24
191214100,6,5,6,3,6,26
191214101,1,5,1,5,1,13
191214102,4,0,2,8,0,14
191214103,2,4,6,2,2,16
191214104,9,2,0,2,0,13
191214105,0,8,9,5,3,25
191214106,6,7,6,5,6,30
191214107,1,9,4,5,7,26
191214108,4,1,9,2,7,23
191214109,1,4,0,4,3,12
191214110,4,2,2,9,7,24
191214111,1,7,0,0,6,14
191214112,0,0,4,0,4,8
191214113,3,5,6,0,2,16
191214114,9,9,8,0,0,26
191214115,8,9,9,5,6,37
191214116,3,7,4,3,6,23
191214117,4,4,5,6,0,19
191214118,3,5,4,9,5,26
191214119,9,0,8,5,2,24
191214120,3,2,0,4,6,15
191214121,1,6,3,1,4,15
191214122,1,7,8,0,5,21
191214123,9,9,6,2,6,32
191214124,2,3,0,1,1,7
191214125,6,6,5,3,3,23
191214126,5,5,0,0,9,19
191214127,3,0,2,2,2,9
191214128,6,5,8,8,5,32
191214129,9,2,3,4,1,19
191214130,8,7,1,4,4,24
191214131,4,1,9,7,2,23
191214132,1,0,4,4,0,9
191214133,4,6,2,0,0,12
191214134,5,6,3,8,8,30
191214135,9,6,1,8,8,32
191214136,6,2,4,9,7,28
191214137,8,8,4,1,1,22
191214138,5,9,7,2,5,28
191214139,9,4,0,7,8,28
191214140,2,0,6,2,2,12
191214141,4,3,3,4,1,15
191214142,0,5,5,5,1,16
191214143,5,6,3,2,3,19
191214144,3,1,5,6,1,16
191214145,5,7,4,9,5,30
191214146,5,7,1,8,1,22
191214147,9,3,5,5,5,27
191214148,4,5,3,6,2,20
191214149,4,3,5,0,7,19
191214150,7,2,9,3,6,27
191214151,7,1,7,4,7,26
191214152,0,1,3,3,8,15
191214153,3,4,7,8,7,29
191214154,6,3,4,2,7,22
191214155,9,0,9,9,8,35
191214156,8,7,5,6,4,30
191214157,0,3,6,2,1,12
191214158,5,3,0,8,6,22
191214159,7,7,7,3,9,33
191214160,3,6,3,4,4,20
191214161,1,9,6,8,1,25
191214162,9,4,0,9,6,28
191214163,1,6,0,1,6,14
191214164,1,7,3,1,3,15
191214165,1,3,6,6,0,16
191214166,7,2,7,5,8,29
191214167,0,6,5,6,2,19
191214168,2,7,7,1,6,23
191214169,0,8,4,6,2,20
191214170,9,5,3,5,4,26
191214171,5,6,2,2,6,21
191214172,9,1,2,9,9,30
191214173,5,4,4,0,3,16
191214174,1,8,5,3,4,21
191214175,6,8,2,3,9,28
191214176,1,8,9,2,3,23
191214177,6,9,5,8,5,33
191214178,0,3,5,5,9,22
191214179,5,8,0,2,8,23
191214180,5,7,0,0,6,18
191214181,0,3,2,9,8,22
191214182,9,7,4,0,0,20
191214183,0,7,7,8,0,22
191214184,0,9,4,9,4,26
191214185,6,6,8,9,6,35
191214186,6,1,7,5,4,23
191214187,6,7,8,5,5,31
191214188,5,9,7,1,1,23
191214189,3,6,5,3,3,20
191214190,9,9,1,0,4,23
191214191,0,7,6,4,8,25
191214192,2,4,9,7,1,23
191214193,6,4,0,4,6,20
191214194,2,2,9,8,7,28
191214195,2,9,6,8,9,34
191214196,3,8,4,0,9,24
191214197,3,0,9,2,3,17
191214198,6,9,2,0,8,25
191214199,7,5,9,2,4,27
191214200,6,8,6,3,3,26
191214201,4,9,7,8,1,29
191214202,6,1,9,1,4,21
191214203,9,4,3,6,8,30
191214204,4,6,9,8,0,27
191214205,6,1,1,0,1,9
191214206,7,9,2,6,6,30
191214207,0,8,6,5,9,28
191214208,5,6,3,6,0,20
191214209,6,0,6,9,5,26
191214210,8,9,6,7,2,32
191214211,5,4,2,7,4,22
191214212,1,6,3,7,9,26
191214213,6,7,1,1,9,24
191214214,8,3,5,1,7,24
191214215,4,1,4,4,2,15
191214216,7,8,6,4,7,32
191214217,1,8,5,8,9,31
191214218,1,7,7,5,5,25
191214219,9,8,8,6,3,34
191214220,5,5,1,2,6,19
191214221,5,4,1,6,8,24
191214222,7,1,2,4,8,22
191214223,2,6,3,4,1,16
191214224,7,4,2,2,5,20
191214225,8,1,7,6,3,25
191214226,3,2,0,9,5,19
191214227,9,5,4,6,6,30
191214228,5,0,0,2,2,9
191214229,7,1,5,8,1,22
191214230,3,8,0,8,1,20
191214231,6,1,9,3,6,25
191214232,9,8,7,3,4,31
191214233,1,0,5,1,8,15
191214234,9,3,2,8,4,26
191214235,5,8,3,5,4,25
191214236,1,1,2,3,6,13
191214237,2,2,7,8,6,25
191214238,7,3,8,7,9,34
191214239,6,9,0,9,3,27
191214240,6,1,4,8,7,26
191214241,8,4,2,7,5,26
191214242,2,6,0,6,4,18
191214243,8,4,9,7,4,32
191214244,0,8,2,4,7,21
191214245,4,9,4,3,8,28
191214246,5,7,0,1,7,20
191214247,0,4,3,2,6,15
191214248,8,5,4,4,0,21
191214249,0,8,5,2,1,16
191214250,1,8,8,7,4,28
191214251,5,5,7,6,9,32
191214252,2,5,1,1,6,15
191214253,5,3,0,4,5,17
191214254,2,4,1,4,5,16
191214255,3,3,3,3,1,13
191214256,8,5,0,9,7,29
191214257,2,1,6,0,0,9
191214258,3,2,4,2,6,17
191214259,0,7,9,2,9,27
191214260,8,1,9,6,4,28
191214261,5,0,9,7,8,29
191214262,2,1,7,2,4,16
191214263,5,9,6,4,7,31
191214264,9,9,4,0,7,29
191214265,7,2,0,8,1,18
191214266,8,6,2,7,5,28
191214267,0,7,7,3,4,21
191214268,6,3,4,9,0,22
191214269,3,4,4,2,2,15
191214270,7,6,9,1,7,30
191214271,4,0,8,2,6,20
191214272,4,5,5,9,5,28
191214273,3,5,8,6,7,29
191214274,3,8,2,2,3,18
191214275,2,5,1,1,8,17
191214276,7,0,3,1,4,15
191214277,1,7,4,9,9,30
191214278,9,2,1,5,2,19
191214279,7,9,4,8,4,32
191214280,2,6,9,9,2,28
191214281,1,8,2,3,9,23
191214282,0,8,9,4,4,25
191214283,9,1,9,5,6,30
191214284,5,9,9,2,5,30
191214285,4,2,4,4,9,23
191214286,6,1,9,3,1,20
191214287,8,2,6,4,6,26
191214288,8,3,2,8,4,25
191214289,5,8,7,2,3,25
191214290,3,6,3,2,9,23
191214291,5,9,9,7,8,38
191214292,2,7,3,6,9,27
191214293,9,2,7,3,5,26
191214294,2,9,0,6,6,23
191214295,8,7,0,5,1,21
191214296,8,8,3,4,0,23
191214297,2,4,7,1,9,23
191214298,1,4,5,3,0,13
191214299,7,5,5,1,8,26
191214300,4,6,8,5,5,28
191214301,6,9,7,0,2,24
191214302,4,2,6,5,2,19
191214303,6,1,8,1,3,19
191214304,2,7,2,0,2,13
191214305,1,5,6,7,1,20
191214306,8,1,3,4,2,18
191214307,1,7,9,9,8,34
191214308,4,8,5,6,8,31
191214309,4,3,4,4,7,22
191214310,0,7,3,3,1,14
191214311,3,6,4,7,9,29
191214312,6,7,4,3,9,29
191214313,1,7,1,1,0,10
191214314,6,9,9,5,1,30
191214315,7,1,0,7,2,17
191214316,6,7,7,3,5,28
191214317,5,6,4,6,0,21
191214318,7,3,0,8,4,22
191214319,3,8,1,3,4,19
191214320,7,6,2,8,5,28
191214321,8,7,7,2,9,33
191214322,1,1,9,7,5,23
191214323,2,8,7,3,3,23
191214324,9,3,1,4,9,26
191214325,1,0,5,6,9,21
191214326,5,3,4,7,0,19
191214327,9,2,9,1,5,26
191214328,0,2,0,9,5,16
191214329,1,7,6,3,4,21
191214330,3,6,1,9,9,28
191214331,1,4,2,1,4,12
191214332,4,5,2,3,5,19
191214333,3,2,7,4,8,24
191214334,0,0,9,4,6,19
191214335,0,4,3,6,6,19
191214336,4,9,8,9,1,31
191214337,3,9,3,6,2,23
191214338,7,6,7,2,0,22
191214339,6,8,5,7,8,34
191214340,3,3,5,7,0,18
191214341,1,5,6,7,3,22
191214342,6,0,1,5,3,15
191214343,5,1,4,2,8,20
191214344,4,4,0,8,0,16
191214345,7,8,4,7,4,30
191214346,6,4,0,5,3,18
191214347,1,7,7,4,2,21
191214348,2,5,3,5,0,15
191214349,8,1,2,0,2,13
191214350,5,4,0,9,9,27
191214351,9,0,6,9,1,25
191214352,5,2,8,5,1,21
191214353,4,8,0,7,8,27
191214354,4,1,8,1,0,14
191214355,5,7,6,0,5,23
191214356,7,7,7,7,9,37
191214357,4,2,0,5,7,18
191214358,0,5,0,5,6,16
191214359,3,0,7,0,8,18
191214360,9,6,4,5,0,24
191214361,7,8,6,5,0,26
191214362,1,7,5,4,8,25
191214363,2,6,4,8,2,22
191214364,7,6,4,3,2,22
191214365,4,4,3,8,4,23
191214366,2,7,6,3,6,24
191214367,1,9,4,9,0,23
191214368,7,4,2,9,3,25
191214369,0,7,4,5,5,21
191214370,9,5,2,4,4,24
191214371,6,2,3,0,9,20
191214372,6,7,8,6,9,36
191214373,2,7,0,4,8,21
191214374,9,4,1,9,6,29
191214375,0,9,5,1,3,18
191214376,8,2,4,5,6,25
191214377,4,1,8,2,4,19
191214378,8,2,4,1,8,23
191214379,6,4,7,3,6,26
191214380,7,5,2,5,0,19
191214381,1,6,4,8,0,19
191214382,9,2,9,9,7,36
191214383,9,1,5,9,1,25
191214384,4,7,7,5,2,25
191214385,1,8,9,8,9,35
191214386,2,9,1,7,6,25
191214387,4,0,4,9,6,23
191214388,3,1,7,1,5,17
191214389,3,9,8,9,6,35
191214390,6,3,9,3,0,21
191214391,2,4,4,2,8,20
191214392,7,2,3,9,6,27
191214393,4,1,1,8,8,22
191214394,5,5,6,0,1,17
191214395,3,0,2,1,6,12
191214396,0,3,1,9,2,15
191214397,7,5,7,8,2,29
191214398,7,4,6,9,5,31
191214399,9,8,5,3,0,25
191214400,7,1,1,6,3,18
191214401,8,0,6,8,6,28
191214402,2,5,1,4,9,21
191214403,2,0,4,9,3,18
191214404,7,1,2,4,9,23
191214405,3,9,8,0,0,20
191214406,6,0,3,1,2,12
191214407,1,1,3,9,5,19
191214408,7,4,1,9,9,30
191214409,3,2,2,7,4,18
191214410,9,6,7,0,3,25
191214411,7,2,1,6,4,20
191214412,5,9,5,8,4,31
191214413,9,1,3,6,6,25
191214414,1,8,4,4,8,25
191214415,1,8,2,4,9,24
191214416,3,5,8,3,5,24
191214417,6,8,2,6,9,31
191214418,0,3,2,3,1,9
191214419,2,3,1,3,9,18
191214420,9,7,3,5,2,26
191214421,2,6,2,3,3,16
191214422,7,3,2,7,4,23
191214423,1,0,4,7,8,20
191214424,4,2,0,4,8,18
191214425,6,0,5,1,9,21
191214426,3,8,3,7,9,30
191214427,0,4,5,3,7,19
191214428,8,4,7,7,8,34
191214429,6,2,4,2,3,17
191214430,2,8,3,1,6,20
191214431,6,6,1,2,2,17
191214432,4,1,8,4,0,17
191214433,0,0,1,6,7,14
191214434,7,4,5,2,4,22
191214435,8,8,8,8,9,41
191214436,5,4,6,8,7,30
191214437,5,1,8,7,2,23
191214438,0,7,4,3,3,17
191214439,3,2,8,0,9,22
191214440,8,9,3,1,5,26
191214441,4,7,6,1,8,26
191214442,1,8,5,5,8,27
191214443,4,8,8,9,8,37
191214444,2,7,0,4,3,16
191214445,9,6,2,6,9,32
191214446,8,0,7,0,3,18
191214447,5,8,7,7,7,34
191214448,5,8,3,2,8,26
191214449,1,9,5,5,6,26
191214450,1,6,6,0,5,18
191214451,7,3,6,4,5,25
191214452,6,8,3,5,7,29
191214453,1,3,5,2,6,17
191214454,6,1,1,2,9,19
191214455,2,4,1,0,4,11
191214456,2,0,0,7,0,9
191214457,4,9,6,4,4,27
191214458,9,5,4,2,5,25
191214459,9,7,3,7,3,29
191214460,4,7,8,2,5,26
191214461,9,5,7,8,8,37
191214462,2,3,2,9,8,24
191214463,4,5,7,0,6,22
191214464,1,9,4,6,3,23
191214465,0,0,9,9,0,18
191214466,2,6,6,3,3,20
191214467,4,1,4,2,3,14
191214468,0,5,6,5,3,19
191214469,6,2,0,8,0,16
191214470,8,8,2,8,4,30
191214471,7,9,6,1,2,25
191214472,2,9,7,7,6,31
191214473,9,5,9,6,0,29
191214474,1,5,2,2,4,14
191214475,4,7,3,6,1,21
191214476,8,2,5,6,4,25
191214477,2,9,7,1,1,20
191214478,7,6,3,6,4,26
191214479,1,8,8,5,9,31
191214480,5,5,2,0,1,13
191214481,3,2,3,8,5,21
191214482,7,5,6,1,8,27
191214483,4,1,8,7,8,28
191214484,8,3,4,4,7,26
191214485,2,4,4,8,3,21
191214486,8,8,4,2,0,22
191214487,9,6,0,2,9,26
191214488,5,5,4,5,1,20
191214489,0,8,5,3,2,18
191214490,7,6,5,0,7,25
191214491,8,1,0,1,5,15
191214492,6,5,5,1,9,26
191214493,0,4,0,1,9,14
191214494,5,4,8,3,1,21
191214495,3,2,4,7,2,18
191214496,2,6,2,6,7,23
191214497,5,7,3,6,3,24
191214498,1,3,7,7,3,21
191214499,5,9,7,6,3,30
191214500,7,3,6,4,7,27
191214501,3,8,9,8,5,33
191214502,6,9,1,1,1,18
191214503,2,4,8,7,5,26
191214504,1,7,2,7,7,24
191214505,1,9,0,6,9,25
191214506,7,3,6,3,3,22
191214507,7,6,1,7,5,26
191214508,0,0,9,6,5,20
191214509,6,1,9,8,3,27
191214510,8,5,2,8,7,30
191214511,1,2,1,5,8,17
191214512,0,6,3,6,8,23
191214513,7,6,2,0,2,17
191214514,1,4,9,6,9,29
191214515,8,7,9,9,1,34
191214516,0,3,7,7,4,21
191214517,7,6,3,5,5,26
191214518,2,2,8,2,2,16
191214519,8,4,7,2,7,28
191214520,3,3,5,4,5,20
191214521,6,6,1,7,7,27
191214522,8,8,3,6,2,27
191214523,6,0,3,2,4,15
191214524,6,5,9,5,9,34
191214525,7,5,6,5,2,25
191214526,3,9,4,6,9,31
191214527,4,5,6,6,3,24
191214528,2,2,2,8,9,23
191214529,0,3,6,3,1,13
191214530,3,6,4,2,6,21
191214531,8,3,9,5,1,26
191214532,0,2,4,9,0,15
191214533,6,1,5,5,0,17
191214534,4,0,2,4,2,12
191214535,9,8,3,6,4,30
191214536,2,4,8,9,7,30
191214537,8,9,3,8,0,28
191214538,3,1,1,2,1,8
191214539,3,7,8,2,5,25
191214540,6,1,8,8,8,31
191214541,5,8,2,7,0,22
191214542,4,3,6,8,2,23
191214543,7,1,3,8,4,23
191214544,5,2,6,2,8,23
191214545,9,4,8,7,4,32
191214546,1,5,5,2,9,22
191214547,8,0,2,2,5,17
191214548,8,6,3,7,7,31
191214549,6,3,4,3,1,17
191214550,9,5,0,0,0,14
191214551,9,1,3,0,2,15
191214552,1,1,3,1,4,10
191214553,2,4,5,0,4,15
191214554,8,9,5,2,4,28
191214555,2,1,8,3,4,18
191214556,0,3,7,5,1,16
191214557,8,1,1,1,2,13
191214558,1,8,9,8,8,34
191214559,5,4,5,6,5,25
191214560,2,7,9,8,0,26
191214561,3,9,4,7,1,24
191214562,5,6,5,4,2,22
191214563,7,3,3,5,3,21
191214564,6,5,1,5,7,24
191214565,9,5,9,3,3,29
191214566,4,4,7,6,0,21
191214567,5,9,9,6,7,36
191214568,4,6,1,9,2,22
191214569,5,1,1,3,7,17
191214570,8,0,0,6,6,20
191214571,6,2,0,5,5,18
191214572,5,1,4,4,1,15
191214573,1,7,2,4,1,15
191214574,6,8,5,3,6,28
191214575,6,8,7,8,9,38
191214576,4,6,7,3,8,28
191214577,3,8,7,4,3,25
191214578,3,2,0,9,0,14
191214579,1,1,3,8,3,16
191214580,8,6,0,8,8,30
191214581,4,6,6,3,8,27
191214582,8,2,7,6,1,24
191214583,4,7,5,0,9,25
191214584,2,6,1,6,0,15
191214585,9,6,4,4,2,25
191214586,3,1,6,1,1,12
191214587,1,0,9,2,0,12
191214588,4,7,8,8,5,32
191214589,0,2,1,8,1,12
191214590,6,3,7,7,4,27
191214591,9,4,9,8,6,36
191214592,9,9,8,1,1,28
191214593,8,9,8,5,2,32
191214594,4,0,5,8,6,23
191214595,0,6,5,1,6,18
191214596,1,0,3,7,8,19
191214597,5,1,2,3,2,13
191214598,1,1,1,0,3,6
191214599,0,8,4,9,2,23
191214600,8,2,7,1,5,23
191214601,3,6,0,1,9,19
191214602,7,6,3,3,7,26
191214603,7,2,7,0,5,21
191214604,5,4,3,3,9,24
191214605,4,8,4,6,2,24
191214606,9,7,8,3,3,30
191214607,8,1,5,5,2,21
191214608,4,0,6,3,0,13
191214609,3,3,6,7,1,20
191214610,9,9,1,3,3,25
191214611,7,7,2,7,8,31
191214612,0,1,1,4,5,11
191214613,7,2,6,2,8,25
191214614,6,7,4,3,4,24
191214615,9,3,6,7,0,25
191214616,3,1,7,1,2,14
191214617,2,1,0,6,9,18
191214618,1,3,9,7,6,26
191214619,4,7,7,4,3,25
191214620,1,5,9,5,4,24
191214621,6,4,7,2,0,19
191214622,9,6,2,9,8,34
191214623,7,7,1,8,3,26
191214624,7,6,4,1,0,18
191214625,7,5,7,6,9,34
191214626,1,1,7,8,9,26
191214627,9,2,1,4,3,19
191214628,0,7,7,4,7,25
191214629,7,8,6,8,3,32
191214630,2,2,8,5,7,24
191214631,0,5,5,6,3,19
191214632,9,9,5,8,9,40
191214633,9,7,9,6,6,37
191214634,2,4,3,8,2,19
191214635,0,1,7,2,8,18
191214636,3,8,2,7,2,22
191214637,3,5,6,6,5,25
191214638,5,6,7,2,6,26
191214639,4,1,8,8,0,21
191214640,6,7,3,2,2,20
191214641,0,1,9,5,6,21
191214642,7,0,8,2,5,22
191214643,9,3,8,0,4,24
191214644,1,0,6,0,8,15
191214645,3,1,1,0,0,5
191214646,3,1,1,3,6,14
191214647,1,0,9,0,8,18
191214648,7,2,3,8,0,20
191214649,6,1,8,3,9,27
191214650,3,4,4,6,2,19
191214651,4,2,2,3,1,12
191214652,0,8,7,1,7,23
191214653,1,3,4,1,5,14
191214654,4,6,8,2,1,21
191214655,4,0,9,2,6,21
191214656,0,0,3,1,7,11
191214657,0,9,7,0,9,25
191214658,3,1,8,7,1,20
191214659,9,6,0,4,4,23
191214660,2,1,7,7,3,20
191214661,6,8,5,0,2,21
191214662,1,9,7,4,8,29
191214663,0,5,2,3,7,17
191214664,6,3,7,6,3,25
191214665,0,4,2,9,6,21
191214666,6,4,8,2,3,23
191214667,6,0,3,7,3,19
191214668,4,6,5,7,9,31
191214669,5,1,7,1,5,19
191214670,0,6,9,4,8,27
191214671,4,9,2,0,6,21
191214672,9,0,6,0,6,21
191214673,8,4,4,1,4,21
191214674,0,7,2,4,8,21
191214675,2,3,3,0,4,12
191214676,1,4,5,0,2,12
191214677,1,0,9,6,2,18
191214678,1,0,7,6,6,20
191214679,8,3,3,2,3,19
191214680,9,0,3,5,3,20
191214681,4,1,9,1,2,17
191214682,9,5,7,6,1,28
191214683,0,0,7,0,9,16
191214684,0,0,6,1,8,15
191214685,1,6,3,7,8,25
191214686,7,6,2,5,8,28
191214687,3,0,7,1,3,14
191214688,4,4,8,5,6,27
191214689,2,6,6,6,7,27
191214690,6,4,1,9,4,24
191214691,2,1,3,4,6,16
191214692,2,0,2,2,6,12
191214693,4,0,7,0,0,11
191214694,9,3,7,2,2,23
191214695,7,0,5,4,6,22
191214696,3,3,8,0,0,14
191214697,5,0,9,7,6,27
191214698,1,5,1,8,5,20
191214699,5,8,7,3,1,24
191214700,5,6,5,9,0,25
191214701,6,4,5,3,2,20
191214702,3,2,8,3,6,22
191214703,6,8,1,8,0,23
191214704,1,7,5,6,8,27
191214705,8,2,5,0,2,17
191214706,8,0,9,3,6,26
191214707,3,1,2,3,1,10
191214708,5,4,0,0,6,15
191214709,2,5,8,5,7,27
191214710,6,9,2,9,2,28
191214711,0,3,9,4,3,19
191214712,2,3,6,1,5,17
191214713,5,6,9,6,0,26
191214714,9,8,3,6,1,27
191214715,0,4,9,6,3,22
191214716,8,7,9,3,6,33
191214717,0,9,1,6,6,22
191214718,5,8,6,5,2,26
191214719,6,6,8,9,3,32
191214720,4,6,6,2,3,21
191214721,1,6,2,2,8,19
191214722,0,5,6,2,2,15
191214723,5,6,7,2,2,22
191214724,6,6,5,2,2,21
191214725,5,5,4,5,0,19
191214726,1,1,1,0,4,7
191214727,7,6,6,4,5,28
191214728,3,7,5,5,7,27
191214729,4,7,1,6,2,20
191214730,6,6,2,6,2,22
191214731,8,9,8,9,6,40
191214732,5,6,0,6,9,26
191214733,2,8,8,9,7,34
191214734,5,4,2,2,8,21
191214735,8,9,3,8,5,33
191214736,6,4,0,8,8,26
191214737,9,6,2,9,7,33
191214738,2,9,3,5,1,20
191214739,6,7,3,5,1,22
191214740,6,0,9,8,5,28
191214741,3,9,5,1,2,20
191214742,7,7,2,6,3,25
191214743,9,9,3,9,8,38
191214744,4,0,6,9,0,19
191214745,4,7,0,4,6,21
191214746,8,3,4,8,9,32
191214747,9,4,8,7,5,33
191214748,4,2,3,2,9,20
191214749,2,5,1,4,7,19
191214750,5,8,9,1,4,27
191214751,2,7,4,3,4,20
191214752,4,6,2,6,5,23
191214753,9,5,0,1,7,22
191214754,4,8,4,4,0,20
191214755,0,5,5,7,5,22
191214756,6,1,6,3,8,24
191214757,4,4,6,8,4,26
191214758,2,1,0,1,7,11
191214759,0,9,0,6,0,15
191214760,3,3,1,5,7,19
191214761,1,6,4,2,8,21
191214762,9,5,0,4,0,18
191214763,2,7,6,4,1,20
191214764,2,8,3,4,4,21
191214765,8,3,9,3,8,31
191214766,8,6,3,9,5,31
191214767,3,9,1,7,2,22
191214768,1,5,0,6,0,12
191214769,0,8,9,9,5,31
191214770,1,4,2,3,9,19
191214771,8,9,7,3,9,36
191214772,4,5,9,7,5,30
191214773,4,0,2,0,5,11
191214774,9,3,3,2,5,22
191214775,0,9,6,7,9,31
191214776,3,3,1,0,6,13
191214777,9,5,4,9,9,36
191214778,5,7,9,0,1,22
191214779,1,8,8,1,9,27
191214780,8,2,8,9,1,28
191214781,9,1,7,9,4,30
191214782,6,4,6,2,0,18
191214783,0,6,4,5,2,17
191214784,3,7,7,3,9,29
191214785,8,1,3,9,6,27
191214786,1,2,6,3,5,17
191214787,2,8,5,0,6,21
191214788,3,9,8,1,7,28
191214789,0,4,1,4,2,11
191214790,6,0,0,5,0,11
191214791,1,4,1,5,7,18
191214792,1,1,8,4,3,17
191214793,6,3,0,1,6,16
191214794,9,0,7,2,3,21
191214795,2,9,4,0,2,17
191214796,6,6,3,9,7,31
191214797,0,6,4,5,7,22
191214798,3,3,4,0,5,15
191214799,1,3,1,7,9,21
191214800,5,6,4,7,2,24
191214801,5,7,4,3,0,19
191214802,6,1,8,3,0,18
191214803,1,6,2,8,7,24
191214804,6,3,1,2,3,15
191214805,4,5,3,9,9,30
191214806,4,5,9,4,2,24
191214807,4,4,6,1,5,20
191214808,3,7,4,4,8,26
191214809,7,0,8,9,6,30
191214810,6,5,8,6,2,27
191214811,5,6,4,3,5,23
191214812,4,5,9,3,3,24
191214813,4,3,4,9,5,25
191214814,0,7,3,6,2,18
191214815,0,8,9,6,6,29
191214816,7,6,2,8,1,24
191214817,4,3,6,9,8,30
191214818,4,1,9,4,5,23
191214819,0,9,6,0,9,24
191214820,3,3,0,6,9,21
191214821,9,8,8,8,5,38
191214822,3,7,0,6,6,22
191214823,3,0,1,9,5,18
191214824,3,4,1,4,3,15
191214825,2,1,3,4,9,19
191214826,5,3,9,7,6,30
191214827,5,2,7,7,7,28
191214828,2,2,2,5,2,13
191214829,6,1,7,9,1,24
191214830,6,4,0,9,5,24
191214831,5,5,0,0,6,16
191214832,5,7,3,0,5,20
191214833,4,5,4,6,1,20
191214834,0,1,6,9,4,20
191214835,0,8,6,4,5,23
191214836,7,7,4,7,2,27
191214837,7,7,8,1,7,30
191214838,0,4,6,9,6,25
191214839,7,2,6,5,0,20
191214840,1,5,3,8,6,23
191214841,0,4,6,8,8,26
191214842,8,7,7,0,2,24
191214843,3,5,2,0,9,19
191214844,8,5,8,3,2,26
191214845,6,2,0,5,1,14
191214846,4,6,0,5,4,19
191214847,8,5,7,2,0,22
191214848,3,4,5,2,0,14
191214849,0,9,3,5,1,18
191214850,6,1,4,4,4,19
191214851,4,9,9,3,1,26
191214852,3,9,2,4,3,21
191214853,2,6,9,1,2,20
191214854,5,0,9,2,3,19
191214855,5,3,6,0,9,23
191214856,1,3,1,7,1,13
191214857,2,3,2,2,3,12
191214858,5,4,3,0,2,14
191214859,1,1,7,7,0,16
191214860,2,9,7,9,5,32
191214861,5,3,0,0,5,13
191214862,5,9,3,0,0,17
191214863,4,4,7,3,6,24
191214864,9,7,3,1,4,24
191214865,9,4,1,0,7,21
191214866,7,6,7,7,8,35
191214867,4,9,3,5,0,21
191214868,6,5,2,1,7,21
191214869,7,4,8,7,7,33
191214870,0,1,7,1,9,18
191214871,7,6,2,1,0,16
191214872,8,8,9,5,7,37
191214873,1,3,6,4,9,23
191214874,7,7,9,4,7,34
191214875,6,1,7,8,8,30
191214876,6,5,2,2,9,24
191214877,2,9,0,9,8,28
191214878,1,4,4,1,5,15
191214879,5,9,3,6,3,26
191214880,0,7,0,2,2,11
191214881,0,5,8,7,1,21
191214882,6,5,7,3,9,30
191214883,9,9,3,2,8,31
191214884,0,5,3,0,7,15
191214885,3,7,7,4,1,22
191214886,0,1,6,7,1,15
191214887,1,3,0,9,7,20
191214888,9,9,4,7,3,32
191214889,2,8,6,1,6,23
191214890,4,9,7,4,4,28
191214891,2,8,1,8,2,21
191214892,2,6,1,0,9,18
191214893,9,4,0,3,7,23
191214894,1,8,0,0,2,11
191214895,4,8,5,9,1,27
191214896,6,3,9,7,0,25
191214897,8,4,9,8,0,29
191214898,5,5,2,8,0,20
191214899,0,2,2,4,0,8
191214900,0,8,6,6,0,20
191214901,7,8,6,6,1,28
191214902,6,5,5,7,1,24
191214903,8,4,4,1,1,18
191214904,6,8,2,7,3,26
191214905,1,1,6,9,2,19
191214906,4,0,3,5,8,20
191214907,9,9,8,9,0,35
191214908,2,9,7,9,6,33
191214909,6,2,8,7,3,26
191214910,7,4,6,3,4,24
191214911,8,0,8,4,5,25
191214912,9,0,2,1,0,12
191214913,1,8,1,8,3,21
191214914,4,2,6,3,4,19
191214915,4,7,0,5,6,22
191214916,9,5,5,2,6,27
191214917,6,1,5,3,7,22
191214918,5,6,8,3,5,27
191214919,8,2,9,4,6,29
191214920,7,7,5,6,7,32
191214921,2,2,0,5,7,16
191214922,7,9,6,7,3,32
191214923,7,0,4,8,9,28
191214924,6,0,2,0,6,14
191214925,9,9,8,3,1,30
191214926,1,6,6,9,3,25
191214927,5,8,7,1,2,23
191214928,5,8,9,3,8,33
191214929,5,6,0,8,7,26
191214930,5,3,8,0,8,24
191214931,6,8,6,0,7,27
191214932,0,8,0,5,2,15
191214933,8,2,0,8,6,24
191214934,4,6,1,6,3,20
191214935,2,7,2,5,5,21
191214936,3,2,6,1,1,13
191214937,6,0,5,9,2,22
191214938,8,3,9,5,5,30
191214939,7,9,0,3,6,25
191214940,7,3,9,2,2,23
191214941,0,6,7,8,7,28
191214942,5,7,6,8,4,30
191214943,3,9,0,8,8,28
191214944,4,0,6,8,4,22
191214945,7,9,3,1,7,27
191214946,4,2,0,8,0,14
191214947,9,6,3,4,3,25
191214948,5,6,1,8,7,27
191214949,6,7,8,3,9,33
191214950,9,3,6,8,2,28
191214951,1,5,9,3,0,18
191214952,9,2,9,4,8,32
191214953,1,3,3,7,2,16
191214954,5,4,5,7,8,29
191214955,1,7,9,4,7,28
191214956,4,4,0,5,3,16
191214957,9,5,9,9,3,35
191214958,3,2,3,4,3,15
191214959,4,1,1,4,3,13
191214960,4,1,5,7,5,22
191214961,2,4,9,3,5,23
191214962,7,3,4,1,2,17
191214963,0,3,8,8,6,25
191214964,7,2,4,5,7,25
191214965,0,2,6,9,7,24
191214966,0,1,3,5,8,17
191214967,2,3,7,2,6,20
191214968,4,1,2,8,4,19
191214969,3,6,9,6,1,25
191214970,8,6,3,2,3,22
191214971,4,0,7,4,9,24
191214972,7,1,1,0,8,17
191214973,6,9,4,0,1,20
191214974,0,3,0,0,8,11
191214975,5,3,1,1,4,14
191214976,6,6,0,1,2,15
191214977,3,3,6,7,5,24
191214978,3,9,9,5,4,30
191214979,6,5,6,1,8,26
191214980,3,5,2,9,3,22
191214981,6,3,3,5,7,24
191214982,5,9,7,9,1,31
191214983,8,3,3,9,7,30
191214984,1,0,3,9,4,17
191214985,1,8,4,9,0,22
191214986,1,5,1,1,6,14
191214987,2,0,0,8,2,12
191214988,9,5,5,8,0,27
191214989,0,9,0,2,7,18
191214990,4,7,4,0,5,20
191214991,5,8,6,6,1,26
191214992,4,3,9,4,9,29
191214993,3,0,8,0,7,18
191214994,2,4,8,8,7,29
191214995,2,3,8,1,9,23
191214996,7,2,4,5,8,26
191214997,4,4,9,2,0,19
191214998,0,0,6,9,4,19
191214999,7,2,2,7,4,22
1912141000,1,3,9,0,1,14
1912141001,1,2,4,9,2,18
1912141002,8,8,5,3,4,28
1912141003,3,1,7,4,9,24
1912141004,7,2,8,0,1,18
1912141005,8,9,8,8,8,41
1912141006,3,9,6,1,2,21
1912141007,6,9,3,6,1,25
1912141008,8,1,0,0,9,18
1912141009,4,4,0,1,8,17
1912141010,2,5,6,4,2,19
1912141011,6,1,4,9,5,25
1912141012,3,1,8,4,4,20
1912141013,4,4,1,1,4,14
1912141014,8,5,5,1,3,22
1912141015,3,2,8,1,7,21
1912141016,8,1,4,9,4,26
1912141017,9,9,6,7,6,37
1912141018,8,2,0,5,1,16
1912141019,5,8,8,8,5,34
1912141020,4,3,8,3,6,24
1912141021,1,9,5,5,1,21
1912141022,3,6,4,8,0,21
1912141023,8,9,3,4,0,24
1912141024,5,2,3,8,4,22
1912141025,9,7,3,5,5,29
1912141026,1,8,7,6,1,23
1912141027,3,3,2,3,7,18
1912141028,4,9,4,7,9,33
1912141029,6,1,0,8,0,15
1912141030,9,3,9,5,7,33
1912141031,3,7,1,2,5,18
1912141032,4,0,0,0,7,11
1912141033,9,5,2,4,5,25
1912141034,0,9,7,6,2,24
1912141035,6,6,4,4,9,29
1912141036,9,4,5,2,7,27
1912141037,5,6,6,1,2,20
1912141038,4,9,2,1,2,18
1912141039,1,7,1,0,3,12
1912141040,2,1,7,1,7,18
1912141041,1,5,0,4,9,19
1912141042,1,3,4,4,2,14
1912141043,7,0,1,7,3,18
1912141044,7,1,6,7,4,25
1912141045,4,5,5,0,7,21
1912141046,9,0,7,2,1,19
1912141047,4,3,0,4,0,11
1912141048,5,4,3,9,9,30
1912141049,4,3,1,5,6,19
1912141050,9,1,9,2,6,27
1912141051,7,2,3,3,0,15
1912141052,0,3,9,6,8,26
1912141053,7,4,8,5,6,30
1912141054,3,2,3,2,3,13
1912141055,2,0,6,6,5,19
1912141056,7,5,3,7,8,30
1912141057,6,3,8,5,8,30
1912141058,6,4,8,7,8,33
1912141059,5,8,3,1,7,24
1912141060,6,2,1,0,1,10
1912141061,7,5,5,7,2,26
1912141062,0,2,9,0,3,14
1912141063,3,8,9,6,5,31
1912141064,8,3,3,1,2,17
1912141065,6,5,9,8,9,37
1912141066,8,2,9,3,5,27
1912141067,7,1,2,6,4,20
1912141068,4,5,2,7,1,19
1912141069,3,2,2,7,0,14
1912141070,3,9,0,9,1,22
1912141071,0,2,4,5,3,14
1912141072,0,2,3,9,5,19
1912141073,7,4,2,5,0,18
1912141074,8,7,7,1,1,24
1912141075,0,1,7,0,7,15
1912141076,6,1,6,1,8,22
1912141077,9,4,7,7,1,28
1912141078,0,8,6,3,9,26
1912141079,1,7,3,8,0,19
1912141080,7,9,3,2,5,26
1912141081,0,9,4,1,7,21
1912141082,6,7,2,6,6,27
1912141083,1,7,1,0,0,9
1912141084,3,8,7,9,9,36
1912141085,1,6,9,3,5,24
1912141086,2,6,8,0,1,17
1912141087,6,2,5,4,3,20
1912141088,5,7,3,8,4,27
1912141089,0,4,3,1,5,13
1912141090,6,5,0,0,1,12
1912141091,4,3,9,0,4,20
1912141092,0,5,9,5,6,25
1912141093,6,2,2,3,0,13
1912141094,6,2,4,3,9,24
1912141095,9,6,1,4,6,26
1912141096,6,4,5,2,8,25
1912141097,3,3,9,9,8,32
1912141098,0,9,7,6,4,26
1912141099,5,9,1,6,4,25
1912141100,0,6,1,2,5,14
1912141101,8,7,8,8,3,34
1912141102,7,6,6,7,3,29
1912141103,5,4,8,3,9,29
1912141104,2,0,5,2,1,10
1912141105,2,9,2,8,0,21
191215001,8,5,4,0,3,20
191215002,7,7,1,2,4,21
191215003,2,2,6,9,9,28
191215004,0,6,3,1,1,11
191215005,8,3,3,3,6,23
191215006,9,1,8,6,4,28
191215007,7,7,8,9,4,35
191215008,1,0,7,2,2,12
191215009,8,6,0,6,0,20
191215010,1,2,5,4,0,12
191215011,4,9,6,4,6,29
191215012,6,5,6,1,9,27
191215013,7,2,9,2,6,26
191215014,2,7,7,7,8,31
191215015,0,9,8,5,1,23
191215016,8,1,6,2,2,19
191215017,7,8,1,2,9,27
191215018,0,2,4,4,7,17
191215019,8,8,7,7,4,34
191215020,5,3,7,4,2,21
191215021,9,9,1,2,5,26
191215022,3,7,2,3,3,18
191215023,9,0,1,4,5,19
191215024,2,5,8,6,3,24
191215025,9,0,1,7,2,19
191215026,0,0,4,4,1,9
191215027,2,1,1,2,4,10
191215028,2,5,2,6,0,15
191215029,8,6,7,7,4,32
191215030,6,5,8,6,0,25
191215031,2,0,4,3,9,18
191215032,1,8,1,7,5,22
191215033,1,8,0,5,7,21
191215034,6,0,9,9,7,31
191215035,1,5,4,9,8,27
191215036,9,4,5,8,2,28
191215037,4,0,9,8,6,27
191215038,8,8,3,1,7,27
191215039,9,5,4,5,8,31
191215040,2,5,9,1,9,26
191215041,1,9,6,6,3,25
191215042,3,7,1,0,9,20
191215043,8,8,5,9,7,37
191215044,2,8,5,6,1,22
191215045,8,4,9,3,4,28
191215046,0,2,5,0,7,14
191215047,2,4,2,5,4,17
191215048,0,9,4,1,0,14
191215049,1,4,7,1,9,22
191215050,1,4,5,3,9,22
191215051,8,2,0,4,4,18
191215052,1,5,9,9,9,33
191215053,5,1,9,8,5,28
191215054,3,3,4,2,0,12
191215055,0,9,0,2,8,19
191215056,9,6,2,0,8,25
191215057,5,1,6,4,9,25
191215058,3,4,5,2,2,16
191215059,2,1,3,9,0,15
191215060,5,8,0,7,5,25
191215061,1,6,8,4,9,28
191215062,7,5,0,6,5,23
191215063,4,0,2,2,1,9
191215064,8,2,1,9,0,20
191215065,2,0,6,0,3,11
191215066,7,4,1,7,4,23
191215067,6,3,5,2,6,22
191215068,5,9,0,5,8,27
191215069,7,6,8,7,4,32
191215070,4,6,2,8,3,23
191215071,9,0,8,2,3,22
191215072,3,0,9,2,6,20
191215073,3,2,1,9,4,19
191215074,5,6,1,8,0,20
191215075,8,9,9,3,0,29
191215076,6,7,2,4,0,19
191215077,5,7,0,0,1,13
191215078,4,7,6,3,4,24
191215079,8,8,6,4,9,35
191215080,2,3,2,3,5,15
191215081,5,2,6,0,5,18
191215082,7,8,7,3,2,27
191215083,7,2,2,6,1,18
191215084,2,3,3,1,2,11
191215085,6,5,1,9,6,27
191215086,4,2,3,7,7,23
191215087,8,9,9,6,0,32
191215088,2,0,2,8,9,21
191215089,7,8,3,7,7,32
191215090,4,5,7,1,2,19
191215091,8,2,0,3,7,20
191215092,1,0,9,0,6,16
191215093,7,5,2,8,4,26
191215094,3,4,5,2,8,22
191215095,6,2,4,1,5,18
191215096,8,1,9,1,5,24
191215097,9,4,7,6,4,30
191215098,1,4,5,6,6,22
191215099,4,7,7,0,1,19
191215100,9,5,5,4,8,31
191215101,2,5,6,5,7,25
191215102,0,8,6,4,1,19
191215103,6,7,2,3,0,18
191215104,7,4,7,3,8,29
191215105,3,0,9,9,8,29
191215106,4,4,9,5,8,30
191215107,6,8,9,9,8,40
191215108,1,7,7,1,7,23
191215109,8,6,9,3,8,34
191215110,0,1,7,1,3,12
191215111,1,1,8,6,7,23
191215112,0,9,0,2,0,11
191215113,6,4,0,3,9,22
191215114,9,1,8,5,9,32
191215115,4,3,9,2,0,18
191215116,5,3,0,9,6,23
191215117,5,6,6,8,1,26
191215118,0,8,3,6,5,22
191215119,1,7,2,4,4,18
191215120,1,1,8,5,8,23
191215121,9,1,9,9,5,33
191215122,7,1,9,9,4,30
191215123,0,8,7,6,8,29
191215124,4,3,6,1,6,20
191215125,1,8,6,3,0,18
191215126,2,3,1,0,3,9
191215127,7,5,5,3,8,28
191215128,2,2,4,1,0,9
191215129,5,0,6,8,5,24
191215130,8,6,2,0,8,24
191215131,2,9,3,3,4,21
191215132,6,7,1,4,6,24
191215133,7,1,6,3,8,25
191215134,5,8,3,8,3,27
191215135,5,7,8,8,5,33
191215136,7,2,3,9,1,22
191215137,6,3,6,2,6,23
191215138,1,4,4,4,9,22
191215139,5,9,5,1,0,20
191215140,4,9,3,0,5,21
191215141,5,9,2,4,6,26
191215142,2,0,8,6,1,17
191215143,4,1,2,0,8,15
191215144,1,8,3,2,9,23
191215145,3,3,5,0,2,13
191215146,4,0,8,5,8,25
191215147,3,6,3,3,2,17
191215148,6,4,1,3,6,20
191215149,3,8,9,9,1,30
191215150,0,5,8,0,2,15
191215151,1,6,3,3,2,15
191215152,0,7,6,0,3,16
191215153,3,3,9,5,3,23
191215154,2,9,6,8,5,30
191215155,0,7,4,0,0,11
191215156,7,4,1,8,7,27
191215157,2,8,2,6,6,24
191215158,2,9,3,0,2,16
191215159,1,2,6,7,6,22
191215160,8,8,1,4,1,22
191215161,5,0,1,7,5,18
191215162,8,7,8,0,7,30
191215163,1,2,4,9,7,23
191215164,6,0,5,3,3,17
191215165,7,9,0,7,5,28
191215166,4,6,0,0,5,15
191215167,3,9,8,0,3,23
191215168,7,0,6,2,2,17
191215169,5,4,1,7,9,26
191215170,6,0,6,8,7,27
191215171,6,6,4,6,2,24
191215172,1,7,9,1,3,21
191215173,1,5,3,8,2,19
191215174,1,6,3,8,9,27
191215175,3,5,6,2,6,22
191215176,6,1,9,7,3,26
191215177,5,3,9,0,8,25
191215178,1,2,9,2,0,14
191215179,1,9,4,9,5,28
191215180,8,7,4,9,5,33
191215181,1,4,6,9,0,20
191215182,9,4,3,3,0,19
191215183,8,5,0,3,5,21
191215184,6,6,6,6,9,33
191215185,5,2,5,1,9,22
191215186,8,3,9,7,6,33
191215187,3,4,6,7,4,24
191215188,6,9,1,4,7,27
191215189,5,8,9,2,1,25
191215190,6,9,1,7,6,29
191215191,9,6,3,4,1,23
191215192,2,0,8,1,6,17
191215193,1,1,4,9,6,21
191215194,3,4,6,6,0,19
191215195,5,6,7,8,2,28
191215196,2,0,2,7,2,13
191215197,1,0,6,6,9,22
191215198,6,9,5,4,9,33
191215199,3,9,1,4,3,20
191215200,3,3,6,7,2,21
191215201,9,0,8,5,7,29
191215202,8,5,9,5,3,30
191215203,6,0,6,3,8,23
191215204,9,7,9,6,1,32
191215205,8,5,8,8,9,38
191215206,1,8,6,1,5,21
191215207,3,5,0,4,7,19
191215208,8,6,0,7,6,27
191215209,2,1,7,3,2,15
191215210,8,5,8,1,9,31
191215211,6,4,4,3,5,22
191215212,5,9,2,2,1,19
191215213,5,2,6,9,0,22
191215214,8,7,1,7,5,28
191215215,7,5,5,4,8,29
191215216,9,2,3,1,0,15
191215217,0,8,9,0,3,20
191215218,4,3,1,3,2,13
191215219,5,1,8,1,9,24
191215220,0,9,7,7,0,23
191215221,4,3,0,9,7,23
191215222,5,7,2,3,3,20
191215223,8,7,8,6,2,31
191215224,9,3,0,2,2,16
191215225,6,1,8,2,4,21
191215226,8,5,1,0,4,18
191215227,6,3,5,0,1,15
191215228,1,4,3,0,7,15
191215229,6,9,9,5,9,38
191215230,6,6,7,8,9,36
191215231,7,6,5,2,4,24
191215232,1,6,0,5,3,15
191215233,7,7,8,6,3,31
191215234,9,3,9,8,0,29
191215235,6,2,5,4,4,21
191215236,9,2,1,9,8,29
191215237,4,9,4,4,4,25
191215238,9,1,4,0,8,22
191215239,7,5,2,8,8,30
191215240,3,1,8,8,1,21
191215241,9,6,8,2,8,33
191215242,8,3,9,1,0,21
191215243,5,4,0,4,4,17
191215244,6,8,8,0,3,25
191215245,3,3,6,8,1,21
191215246,2,3,0,9,5,19
191215247,1,6,3,8,8,26
191215248,6,0,8,4,5,23
191215249,4,9,2,4,5,24
191215250,6,6,6,3,3,24
191215251,3,2,1,4,2,12
191215252,8,8,1,5,5,27
191215253,9,2,5,4,0,20
191215254,9,4,6,3,3,25
191215255,9,9,4,3,3,28
191215256,8,5,3,4,0,20
191215257,6,1,0,8,1,16
191215258,0,7,2,2,4,15
191215259,5,8,2,6,3,24
191215260,8,0,7,2,9,26
191215261,2,7,5,0,5,19
191215262,6,6,9,8,2,31
191215263,3,5,9,2,6,25
191215264,2,8,2,6,8,26
191215265,6,5,0,6,4,21
191215266,2,0,5,1,2,10
191215267,9,2,1,3,9,24
191215268,9,2,5,7,6,29
191215269,8,9,1,4,6,28
191215270,5,3,0,8,3,19
191215271,6,0,2,6,5,19
191215272,3,7,8,1,0,19
191215273,7,7,6,0,3,23
191215274,9,3,8,3,7,30
191215275,7,1,8,5,9,30
191215276,3,8,9,1,3,24
191215277,3,3,4,0,2,12
191215278,9,9,0,4,4,26
191215279,9,2,5,3,4,23
191215280,4,4,1,1,9,19
191215281,3,2,1,8,4,18
191215282,8,9,8,3,5,33
191215283,3,4,6,3,5,21
191215284,5,6,8,2,3,24
191215285,5,5,2,0,3,15
191215286,7,0,2,8,8,25
191215287,5,8,1,4,6,24
191215288,6,0,8,4,9,27
191215289,4,3,2,6,9,24
191215290,8,0,2,8,2,20
191215291,9,4,4,5,0,22
191215292,8,8,5,1,0,22
191215293,1,1,6,1,1,10
191215294,3,1,6,5,4,19
191215295,9,3,2,9,5,28
191215296,4,1,5,7,2,19
191215297,9,2,8,7,8,34
191215298,0,8,9,0,6,23
191215299,0,5,3,3,7,18
191215300,8,5,1,6,2,22
191215301,3,9,9,6,6,33
191215302,8,0,3,7,5,23
191215303,4,4,8,4,6,26
191215304,0,0,3,2,2,7
191215305,3,3,5,3,4,18
191215306,1,9,1,9,8,28
191215307,3,2,8,4,3,20
191215308,9,7,2,5,3,26
191215309,0,8,6,7,8,29
191215310,5,6,7,8,0,26
191215311,1,0,4,8,9,22
191215312,1,8,3,5,8,25
191215313,8,5,8,7,2,30
191215314,2,4,3,0,4,13
191215315,1,0,1,4,7,13
191215316,3,0,3,5,8,19
191215317,9,1,7,8,9,34
191215318,7,2,4,4,9,26
191215319,5,3,5,9,7,29
191215320,1,9,2,1,2,15
191215321,5,3,6,6,5,25
191215322,6,0,4,5,9,24
191215323,2,9,1,3,2,17
191215324,7,9,8,8,7,39
191215325,6,9,2,2,1,20
191215326,6,0,3,1,0,10
191215327,2,5,0,4,9,20
191215328,8,6,9,5,6,34
191215329,1,0,5,5,4,15
191215330,6,6,6,5,2,25
191215331,0,4,2,9,2,17
191215332,3,4,3,2,1,13
191215333,3,5,7,1,4,20
191215334,6,1,2,4,9,22
191215335,2,9,9,0,1,21
191215336,5,8,9,7,5,34
191215337,9,0,5,3,1,18
191215338,6,4,5,1,1,17
191215339,4,4,1,6,4,19
191215340,0,0,8,3,8,19
191215341,0,3,2,7,8,20
191215342,4,8,1,2,7,22
191215343,0,2,8,4,7,21
191215344,7,4,1,2,1,15
191215345,0,1,7,6,4,18
191215346,0,5,4,4,1,14
191215347,9,1,0,6,6,22
191215348,5,2,7,0,8,22
191215349,7,0,3,8,5,23
191215350,1,0,2,2,1,6
191215351,9,8,0,5,5,27
191215352,1,4,3,7,0,15
191215353,2,3,0,3,3,11
191215354,9,2,4,1,9,25
191215355,1,2,2,2,0,7
191215356,9,3,7,6,9,34
191215357,4,5,7,2,0,18
191215358,3,6,9,5,9,32
191215359,7,9,9,0,4,29
191215360,2,9,5,9,0,25
191215361,2,4,3,4,0,13
191215362,1,8,8,7,9,33
191215363,3,2,1,0,7,13
191215364,6,3,3,0,6,18
191215365,8,5,4,7,8,32
191215366,6,1,0,0,3,10
191215367,3,2,7,6,7,25
191215368,1,3,4,0,0,8
191215369,8,4,2,5,6,25
191215370,6,7,7,9,7,36
191215371,7,1,2,1,8,19
191215372,1,9,0,6,2,18
191215373,6,3,2,9,4,24
191215374,8,4,1,0,6,19
191215375,2,9,0,4,9,24
191215376,5,7,5,3,6,26
191215377,5,0,0,1,7,13
191215378,2,3,9,6,8,28
191215379,1,5,1,2,1,10
191215380,1,1,0,0,6,8
191215381,6,1,7,1,9,24
191215382,3,3,2,5,5,18
191215383,9,5,0,6,7,27
191215384,6,6,2,8,7,29
191215385,5,3,2,6,3,19
191215386,8,6,3,0,8,25
191215387,5,5,8,0,4,22
191215388,1,1,7,3,4,16
191215389,0,8,8,8,5,29
191215390,6,5,0,2,3,16
191215391,2,8,8,9,8,35
191215392,9,0,8,7,8,32
191215393,1,5,5,0,4,15
191215394,4,9,0,5,3,21
191215395,0,5,9,6,6,26
191215396,1,6,9,4,6,26
191215397,9,4,9,9,2,33
191215398,9,3,3,3,9,27
191215399,1,9,3,8,6,27
191215400,5,7,8,3,7,30
191215401,0,8,5,4,8,25
191215402,8,1,4,7,4,24
191215403,7,3,8,8,1,27
191215404,8,3,2,3,9,25
191215405,1,5,9,1,0,16
191215406,4,8,2,4,3,21
191215407,9,2,4,4,5,24
191215408,5,3,4,6,6,24
191215409,7,5,1,8,7,28
191215410,5,1,3,6,4,19
191215411,2,5,3,5,3,18
191215412,5,1,7,2,1,16
191215413,0,9,0,8,1,18
191215414,7,9,6,3,3,28
191215415,8,2,6,0,1,17
191215416,5,6,7,0,4,22
191215417,7,3,1,1,1,13
191215418,7,4,5,4,0,20
191215419,9,9,1,1,8,28
191215420,1,1,7,7,2,18
191215421,2,8,5,3,9,27
191215422,5,4,3,4,9,25
191215423,2,8,3,9,3,25
191215424,1,3,8,8,4,24
191215425,2,9,4,0,4,19
191215426,1,0,9,0,5,15
191215427,0,4,4,9,3,20
191215428,1,2,1,5,6,15
191215429,5,6,2,8,0,21
191215430,3,1,2,1,8,15
191215431,2,4,3,9,0,18
191215432,2,7,1,8,3,21
191215433,5,0,1,8,1,15
191215434,8,4,4,0,2,18
191215435,6,1,1,5,9,22
191215436,7,0,6,6,7,26
191215437,4,7,3,2,3,19
191215438,4,4,4,5,0,17
191215439,6,3,4,4,7,24
191215440,2,4,4,9,6,25
191215441,8,3,7,7,5,30
191215442,2,4,4,0,8,18
191215443,4,5,1,2,4,16
191215444,1,0,9,4,7,21
191215445,5,2,1,1,8,17
191215446,3,9,4,1,9,26
191215447,3,6,3,8,6,26
191215448,3,0,4,5,6,18
191215449,0,0,7,2,9,18
191215450,9,5,1,6,5,26
191215451,1,4,1,6,4,16
191215452,4,3,9,3,0,19
191215453,6,7,6,9,4,32
191215454,7,2,6,7,0,22
191215455,7,8,4,9,4,32
191215456,5,0,1,4,0,10
191215457,4,3,9,5,6,27
191215458,6,4,0,0,7,17
191215459,9,1,7,4,2,23
191215460,3,1,3,9,1,17
191215461,2,4,0,9,9,24
191215462,6,9,2,2,7,26
191215463,5,3,8,8,1,25
191215464,6,8,7,4,7,32
191215465,7,5,7,5,2,26
191215466,2,1,1,4,0,8
191215467,0,7,3,2,5,17
191215468,6,3,0,1,0,10
191215469,4,6,7,4,3,24
191215470,3,7,4,2,5,21
191215471,5,8,5,5,9,32
191215472,9,1,3,8,6,27
191215473,3,3,7,5,0,18
191215474,0,7,3,1,1,12
191215475,9,2,5,5,3,24
191215476,4,5,0,6,2,17
191215477,2,7,9,0,0,18
191215478,5,8,4,1,8,26
191215479,7,3,4,2,3,19
191215480,0,7,9,6,6,28
191215481,7,4,3,9,8,31
191215482,0,3,1,7,0,11
191215483,4,5,9,9,9,36
191215484,9,5,2,2,4,22
191215485,4,6,4,8,2,24
191215486,7,7,0,4,5,23
191215487,9,3,8,7,0,27
191215488,1,4,8,5,6,24
191215489,9,0,7,4,9,29
191215490,5,5,7,8,0,25
191215491,5,7,8,6,9,35
191215492,7,9,1,2,6,25
191215493,6,8,0,0,3,17
191215494,8,2,9,5,8,32
191215495,5,2,8,9,2,26
191215496,4,3,9,8,0,24
191215497,3,8,7,3,6,27
191215498,3,1,9,6,0,19
191215499,6,3,5,2,2,18
191215500,9,1,9,2,1,22
191215501,5,9,3,5,3,25
191215502,8,9,2,3,2,24
191215503,1,4,4,6,0,15
191215504,6,6,6,7,9,34
191215505,6,4,2,2,2,16
191215506,7,3,9,1,3,23
191215507,7,8,1,3,2,21
191215508,3,6,4,2,7,22
191215509,6,4,5,9,8,32
191215510,5,9,3,6,4,27
191215511,8,8,7,0,1,24
191215512,4,3,9,2,3,21
191215513,3,9,8,2,1,23
191215514,5,8,5,0,6,24
191215515,6,6,0,5,1,18
191215516,2,9,0,7,0,18
191215517,6,3,8,5,3,25
191215518,6,9,7,1,9,32
191215519,3,7,7,9,8,34
191215520,2,8,9,5,1,25
191215521,9,2,7,5,2,25
191215522,6,5,9,2,2,24
191215523,0,8,6,6,6,26
191215524,5,9,3,5,8,30
191215525,6,9,5,7,1,28
191215526,7,7,9,0,5,28
191215527,3,4,2,9,7,25
191215528,4,4,4,3,5,20
191215529,6,8,1,4,9,28
191215530,6,0,6,4,0,16
191215531,5,0,7,0,9,21
191215532,5,6,6,1,0,18
191215533,0,3,6,4,6,19
191215534,4,1,6,7,6,24
191215535,4,2,0,0,2,8
191215536,6,7,3,4,6,26
191215537,3,6,9,8,2,28
191215538,6,3,8,0,9,26
191215539,2,4,0,4,7,17
191215540,9,7,2,2,0,20
191215541,0,2,6,5,2,15
191215542,8,6,8,4,5,31
191215543,5,1,0,6,9,21
191215544,1,1,7,9,4,22
191215545,0,7,7,6,5,25
191215546,0,4,2,2,2,10
191215547,1,3,4,4,1,13
191215548,7,1,9,3,5,25
191215549,2,5,1,8,8,24
191215550,8,0,1,9,4,22
191215551,3,9,6,5,1,24
191215552,0,5,2,0,9,16
191215553,4,4,5,3,1,17
191215554,2,0,9,2,8,21
191215555,4,4,7,6,3,24
191215556,3,0,2,0,3,8
191215557,2,1,1,5,6,15
191215558,2,5,5,4,8,24
191215559,5,5,3,7,0,20
191215560,5,3,3,6,0,17
191215561,6,1,7,5,2,21
191215562,5,5,5,8,8,31
191215563,3,1,1,3,5,13
191215564,8,3,8,0,3,22
191215565,9,3,1,7,2,22
191215566,6,2,1,5,7,21
191215567,4,4,6,2,4,20
191215568,4,2,0,2,3,11
191215569,1,8,7,6,9,31
191215570,3,0,1,0,2,6
191215571,6,8,5,4,6,29
191215572,0,9,2,3,8,22
191215573,0,5,7,3,8,23
191215574,5,9,2,7,4,27
191215575,8,4,3,6,5,26
191215576,1,1,8,8,7,25
191215577,9,0,6,9,3,27
191215578,6,7,1,2,6,22
191215579,6,3,2,2,7,20
191215580,0,4,1,8,8,21
191215581,5,2,4,6,8,25
191215582,0,5,2,5,5,17
191215583,7,0,7,3,2,19
191215584,5,4,4,6,7,26
191215585,0,7,7,0,9,23
191215586,5,0,2,1,1,9
191215587,1,8,4,9,8,30
191215588,1,4,2,6,2,15
191215589,0,2,9,8,6,25
191215590,7,7,3,5,6,28
191215591,6,6,7,9,5,33
191215592,6,6,0,0,6,18
191215593,2,9,7,4,0,22
191215594,5,7,7,8,4,31
191215595,9,8,6,0,3,26
191215596,0,3,7,0,7,17
191215597,3,1,2,6,4,16
191215598,0,4,1,8,5,18
191215599,3,6,6,2,9,26
191215600,8,5,0,0,2,15
191215601,7,9,2,3,4,25
191215602,4,0,3,7,9,23
191215603,8,5,3,0,9,25
191215604,9,6,1,6,4,26
191215605,2,7,3,6,6,24
191215606,3,4,2,5,0,14
191215607,8,5,7,4,6,30
191215608,4,9,0,7,5,25
191215609,6,1,8,3,3,21
191215610,1,0,3,8,6,18
191215611,8,5,3,6,5,27
191215612,4,6,2,8,8,28
191215613,5,8,5,2,1,21
191215614,8,2,2,7,8,27
191215615,2,8,1,2,0,13
191215616,3,2,5,3,4,17
191215617,8,2,1,0,4,15
191215618,0,1,5,4,7,17
191215619,8,0,1,0,0,9
191215620,9,9,3,4,8,33
191215621,9,4,6,1,0,20
191215622,2,0,8,4,2,16
191215623,8,1,8,3,2,22
191215624,5,9,0,9,4,27
191215625,2,9,3,8,8,30
191215626,3,3,0,9,4,19
191215627,3,2,8,5,4,22
191215628,9,1,3,7,0,20
191215629,1,9,9,1,3,23
191215630,9,2,7,9,9,36
191215631,4,4,4,0,8,20
191215632,0,9,4,2,1,16
191215633,8,5,3,3,7,26
191215634,2,1,6,5,6,20
191215635,7,0,4,9,2,22
191215636,7,8,2,1,9,27
191215637,6,3,0,0,7,16
191215638,5,4,3,1,8,21
191215639,0,8,8,0,2,18
191215640,2,8,0,5,2,17
191215641,5,4,8,2,8,27
191215642,1,8,2,9,3,23
191215643,7,7,8,3,2,27
191215644,2,5,4,2,0,13
191215645,7,5,9,1,9,31
191215646,9,8,1,1,9,28
191215647,6,3,3,6,6,24
191215648,5,6,4,0,4,19
191215649,7,6,3,2,0,18
191215650,2,4,9,0,1,16
191215651,3,3,8,8,5,27
191215652,4,6,0,4,1,15
191215653,1,9,4,0,3,17
191215654,4,9,6,3,9,31
191215655,2,2,1,1,9,15
191215656,2,8,7,1,4,22
191215657,1,8,5,6,3,23
191215658,1,3,0,3,4,11
191215659,6,3,3,8,7,27
191215660,2,3,7,8,3,23
191215661,0,1,8,4,1,14
191215662,4,3,8,0,0,15
191215663,3,4,2,0,2,11
191215664,6,4,9,9,1,29
191215665,6,7,1,5,0,19
191215666,5,4,7,4,9,29
191215667,6,1,2,5,5,19
191215668,4,8,6,7,1,26
191215669,1,1,4,5,3,14
191215670,7,6,0,6,6,25
191215671,0,3,5,6,5,19
191215672,9,3,3,2,9,26
191215673,8,6,6,6,3,29
191215674,2,8,2,5,9,26
191215675,5,7,0,9,7,28
191215676,1,3,9,6,0,19
191215677,5,2,7,7,9,30
191215678,9,6,6,6,3,30
191215679,8,3,8,9,4,32
191215680,7,3,2,5,0,17
191215681,5,6,6,2,9,28
191215682,4,9,8,0,2,23
191215683,0,6,1,2,8,17
191215684,8,9,3,0,9,29
191215685,3,5,0,4,4,16
191215686,2,6,3,7,2,20
191215687,2,5,1,2,2,12
191215688,9,6,2,6,7,30
191215689,2,0,8,1,0,11
191215690,1,6,1,0,3,11
191215691,4,0,6,9,7,26
191215692,1,8,8,1,6,24
191215693,6,2,3,1,1,13
191215694,3,5,3,8,9,28
191215695,1,1,5,6,4,17
191215696,9,0,3,5,2,19
191215697,2,6,7,2,8,25
191215698,6,1,5,7,6,25
191215699,8,1,6,3,5,23
191215700,5,4,9,7,5,30
191215701,2,7,1,3,7,20
191215702,5,1,8,8,1,23
191215703,8,9,1,3,0,21
191215704,4,9,5,8,6,32
191215705,2,3,1,8,5,19
191215706,2,5,2,8,2,19
191215707,6,3,4,1,3,17
191215708,2,6,2,8,5,23
191215709,9,5,3,9,6,32
191215710,0,7,7,6,6,26
191215711,7,8,6,6,6,33
191215712,7,0,6,9,8,30
191215713,5,4,6,0,2,17
191215714,0,6,7,6,2,21
191215715,5,4,1,0,5,15
191215716,7,6,1,2,0,16
191215717,5,7,8,2,1,23
191215718,7,5,6,3,5,26
191215719,3,8,7,5,7,30
191215720,7,0,8,4,4,23
191215721,4,0,9,2,3,18
191215722,8,2,8,2,8,28
191215723,2,5,3,8,3,21
191215724,2,3,2,2,1,10
191215725,5,2,8,3,9,27
191215726,5,2,6,5,5,23
191215727,1,1,6,4,5,17
191215728,3,5,4,3,9,24
191215729,7,0,3,0,6,16
191215730,1,6,1,8,4,20
191215731,2,2,6,5,4,19
191215732,5,9,5,2,3,24
191215733,6,7,4,0,5,22
191215734,3,0,2,8,4,17
191215735,7,5,5,1,3,21
191215736,2,1,7,4,8,22
191215737,2,8,5,4,4,23
191215738,2,8,5,1,6,22
191215739,1,2,8,4,3,18
191215740,9,3,1,2,2,17
191215741,6,9,3,1,3,22
191215742,8,7,1,8,5,29
191215743,3,5,3,1,2,14
191215744,1,4,7,3,5,20
191215745,5,0,2,7,4,18
191215746,2,7,7,4,1,21
191215747,1,0,9,3,9,22
191215748,7,7,6,9,1,30
191215749,1,0,4,4,1,10
191215750,1,2,2,9,4,18
191215751,8,5,1,6,7,27
191215752,7,6,6,4,3,26
191215753,7,8,6,3,9,33
191215754,3,7,4,2,2,18
191215755,7,4,6,0,9,26
191215756,3,6,6,5,1,21
191215757,8,6,8,7,8,37
191215758,1,4,2,1,2,10
191215759,9,5,1,5,7,27
191215760,1,2,8,7,3,21
191215761,6,0,9,0,3,18
191215762,5,3,3,6,5,22
191215763,8,2,6,6,2,24
191215764,0,3,0,9,8,20
191215765,5,3,7,2,3,20
191215766,6,1,0,1,5,13
191215767,1,1,5,6,7,20
191215768,9,3,3,5,8,28
191215769,3,3,8,7,6,27
191215770,9,6,5,8,5,33
191215771,2,1,2,6,3,14
191215772,9,2,6,0,7,24
191215773,2,9,5,7,2,25
191215774,7,2,3,9,9,30
191215775,3,0,1,7,5,16
191215776,1,7,4,6,1,19
191215777,4,2,9,7,8,30
191215778,7,2,0,0,3,12
191215779,8,2,5,6,1,22
191215780,6,2,7,2,2,19
191215781,3,6,2,2,4,17
191215782,3,7,7,0,2,19
191215783,7,3,9,2,6,27
191215784,3,6,9,5,4,27
191215785,5,5,6,0,6,22
191215786,8,4,7,7,7,33
191215787,3,0,7,0,9,19
191215788,5,6,4,1,1,17
191215789,3,1,9,1,0,14
191215790,8,4,7,3,0,22
191215791,1,7,4,5,5,22
191215792,8,6,1,7,1,23
191215793,8,8,7,4,5,32
191215794,5,4,4,1,4,18
191215795,4,3,8,8,7,30
191215796,4,8,7,3,5,27
191215797,8,3,9,3,6,29
191215798,8,6,2,6,3,25
191215799,2,9,4,4,9,28
191215800,9,5,0,5,3,22
191215801,7,2,2,7,8,26
191215802,7,1,3,1,1,13
191215803,6,0,9,3,0,18
191215804,6,2,1,4,3,16
191215805,4,9,9,9,3,34
191215806,5,5,9,7,8,34
191215807,2,4,4,0,5,15
191215808,4,9,5,7,0,25
191215809,6,1,2,6,9,24
191215810,2,7,9,6,7,31
191215811,0,1,0,6,7,14
191215812,7,4,0,6,1,18
191215813,9,7,1,1,2,20
191215814,8,9,8,1,1,27
191215815,1,6,7,2,3,19
191215816,4,9,6,0,2,21
191215817,4,7,8,7,8,34
191215818,7,3,2,5,1,18
191215819,6,4,8,1,3,22
191215820,8,1,4,9,1,23
191215821,7,3,9,5,5,29
191215822,0,0,3,9,6,18
191215823,2,6,7,9,3,27
191215824,4,6,2,4,0,16
191215825,6,4,0,9,6,25
191215826,3,7,2,1,5,18
191215827,9,1,1,0,8,19
191215828,9,1,1,5,3,19
191215829,6,4,7,4,3,24
191215830,6,0,8,6,5,25
191215831,3,4,7,1,9,24
191215832,0,9,0,4,3,16
191215833,3,8,3,2,9,25
191215834,5,9,4,5,3,26
191215835,2,3,1,4,8,18
191215836,5,6,2,4,2,19
191215837,8,3,3,0,9,23
191215838,2,8,5,9,3,27
191215839,1,3,8,5,3,20
191215840,0,7,8,5,4,24
191215841,3,2,4,5,0,14
191215842,4,6,1,5,2,18
191215843,7,2,8,1,5,23
191215844,4,8,9,7,1,29
191215845,0,7,9,7,8,31
191215846,1,6,4,9,3,23
191215847,8,0,4,9,5,26
191215848,4,5,1,7,1,18
191215849,8,6,4,7,0,25
191215850,7,8,0,3,8,26
191215851,9,6,5,8,7,35
191215852,7,4,1,2,7,21
191215853,7,8,6,5,8,34
191215854,4,1,5,3,5,18
191215855,7,6,1,9,9,32
191215856,6,3,4,4,5,22
191215857,1,2,2,7,1,13
191215858,3,3,7,0,3,16
191215859,2,6,3,9,3,23
191215860,2,6,6,4,2,20
191215861,6,5,9,8,1,29
191215862,2,8,1,2,5,18
191215863,6,2,2,3,4,17
191215864,4,1,6,5,5,21
191215865,9,3,7,2,6,27
191215866,7,1,8,8,5,29
191215867,9,6,3,0,4,22
191215868,7,4,9,7,6,33
191215869,5,9,6,3,6,29
191215870,8,1,4,9,7,29
191215871,7,4,3,7,2,23
191215872,3,4,4,7,6,24
191215873,5,8,4,5,9,31
191215874,7,2,7,8,1,25
191215875,9,8,9,7,9,42
191215876,8,6,7,9,9,39
191215877,0,7,8,9,3,27
191215878,4,2,9,4,4,23
191215879,4,7,8,1,3,23
191215880,3,8,2,7,0,20
191215881,4,9,7,1,8,29
191215882,1,7,5,5,6,24
191215883,0,3,0,3,1,7
191215884,1,7,4,2,3,17
191215885,4,6,2,7,9,28
191215886,4,9,9,8,7,37
191215887,5,9,4,4,0,22
191215888,2,8,0,8,9,27
191215889,4,6,0,4,0,14
191215890,6,4,0,5,7,22
191215891,9,5,9,7,6,36
191215892,2,3,5,9,7,26
191215893,6,6,5,5,6,28
191215894,0,9,7,2,7,25
191215895,6,8,1,0,2,17
191215896,2,4,8,5,5,24
191215897,5,8,7,8,5,33
191215898,0,5,4,9,1,19
191215899,7,0,9,6,3,25
191215900,9,0,2,0,3,14
191215901,7,8,0,0,3,18
191215902,9,3,5,2,5,24
191215903,6,2,7,3,3,21
191215904,9,1,4,5,4,23
191215905,2,8,4,8,4,26
191215906,5,5,2,0,0,12
191215907,5,4,2,2,4,17
191215908,2,4,8,0,0,14
191215909,4,5,2,1,9,21
191215910,3,9,3,1,4,20
191215911,9,5,7,6,6,33
191215912,1,4,9,5,2,21
191215913,8,0,2,5,3,18
191215914,3,6,9,7,4,29
191215915,1,5,0,1,1,8
191215916,2,1,3,2,1,9
191215917,3,7,0,6,2,18
191215918,2,3,7,5,3,20
191215919,7,8,4,9,7,35
191215920,9,2,5,6,5,27
191215921,7,4,1,7,7,26
191215922,5,7,0,7,5,24
191215923,6,4,0,9,8,27
191215924,3,7,9,3,6,28
191215925,3,7,9,7,7,33
191215926,1,9,5,2,7,24
191215927,8,8,8,3,8,35
191215928,4,4,1,3,7,19
191215929,5,1,2,1,0,9
191215930,3,3,9,8,6,29
191215931,0,8,3,5,7,23
191215932,7,5,0,7,3,22
191215933,3,5,6,9,5,28
191215934,8,9,3,8,6,34
191215935,5,2,4,8,7,26
191215936,1,0,8,6,7,22
191215937,1,4,6,3,8,22
191215938,6,4,0,7,5,22
191215939,1,7,6,5,4,23
191215940,0,4,2,1,8,15
191215941,6,7,4,9,9,35
191215942,4,2,6,7,6,25
191215943,5,7,6,9,1,28
191215944,6,2,9,3,1,21
191215945,8,1,1,0,6,16
191215946,4,0,6,1,1,12
191215947,3,5,8,9,8,33
191215948,8,7,6,7,9,37
191215949,2,1,8,9,0,20
191215950,1,2,9,5,1,18
191215951,7,7,1,1,1,17
191215952,5,7,5,3,4,24
191215953,2,5,4,5,5,21
191215954,7,5,3,2,0,17
191215955,9,3,7,6,4,29
191215956,4,9,5,2,2,22
191215957,1,0,7,7,4,19
191215958,9,9,0,7,8,33
191215959,6,3,9,6,1,25
191215960,3,7,1,2,1,14
191215961,6,7,2,7,1,23
191215962,1,4,0,9,9,23
191215963,9,8,2,1,6,26
191215964,2,5,1,6,2,16
191215965,9,6,5,3,2,25
191215966,8,7,8,0,2,25
191215967,4,6,7,6,0,23
191215968,2,9,8,7,9,35
191215969,6,1,3,5,9,24
191215970,4,0,1,4,4,13
191215971,1,7,2,0,1,11
191215972,6,4,0,3,5,18
191215973,2,7,1,1,7,18
191215974,8,4,6,5,6,29
191215975,7,0,9,8,8,32
191215976,5,6,8,3,7,29
191215977,4,3,5,0,8,20
191215978,1,9,6,9,5,30
191215979,7,4,5,6,9,31
191215980,2,4,8,3,4,21
191215981,9,4,8,2,5,28
191215982,7,0,6,0,7,20
191215983,9,7,7,9,9,41
191215984,1,0,8,5,4,18
191215985,5,1,2,8,8,24
191215986,9,2,8,9,9,37
191215987,1,0,8,2,0,11
191215988,8,3,3,0,1,15
191215989,6,8,1,8,5,28
191215990,8,1,5,3,3,20
191215991,9,0,4,3,1,17
191215992,4,0,3,2,5,14
191215993,5,6,7,0,3,21
191215994,4,0,8,7,0,19
191215995,2,2,5,9,7,25
191215996,7,8,8,1,6,30
191215997,4,8,6,3,9,30
191215998,4,0,3,5,9,21
191215999,4,7,4,2,9,26
1912151000,6,7,8,3,1,25
1912151001,9,5,7,9,6,36
1912151002,3,8,8,8,3,30
1912151003,2,1,2,8,3,16
1912151004,8,7,5,7,6,33
1912151005,2,9,1,3,9,24
1912151006,8,0,1,4,4,17
1912151007,2,6,5,2,6,21
1912151008,3,5,8,1,1,18
1912151009,0,2,2,1,4,9
1912151010,5,7,3,6,4,25
1912151011,8,4,6,1,2,21
1912151012,0,7,1,0,0,8
1912151013,5,8,8,3,0,24
1912151014,8,0,1,7,4,20
1912151015,5,6,5,2,6,24
1912151016,9,4,4,6,0,23
1912151017,5,4,4,7,8,28
1912151018,1,0,2,9,1,13
1912151019,0,5,2,1,6,14
1912151020,8,8,1,8,2,27
1912151021,2,1,1,6,9,19
1912151022,8,8,7,2,6,31
1912151023,4,4,0,1,5,14
1912151024,7,6,9,0,2,24
1912151025,7,5,7,3,2,24
1912151026,9,3,8,0,0,20
1912151027,5,3,1,2,1,12
1912151028,4,6,7,8,8,33
1912151029,5,2,2,5,0,14
1912151030,1,0,3,2,4,10
1912151031,1,7,3,7,7,25
1912151032,1,1,9,0,3,14
1912151033,3,5,7,8,3,26
1912151034,3,3,0,3,8,17
1912151035,8,3,7,7,9,34
1912151036,0,7,8,0,6,21
1912151037,4,2,8,1,8,23
1912151038,1,9,5,7,2,24
1912151039,4,2,9,3,3,21
1912151040,0,9,2,8,6,25
1912151041,9,0,5,8,0,22
1912151042,0,8,1,3,3,15
1912151043,0,0,3,1,2,6
1912151044,2,9,4,2,4,21
1912151045,5,3,6,4,4,22
1912151046,5,4,7,5,1,22
1912151047,8,6,0,0,7,21
1912151048,9,7,5,7,4,32
1912151049,7,5,6,5,9,32
1912151050,9,8,9,1,3,30
1912151051,6,1,9,9,5,30
1912151052,2,2,1,6,8,19
1912151053,0,7,0,3,4,14
1912151054,9,2,0,6,9,26
1912151055,1,6,7,2,2,18
1912151056,9,8,1,2,5,25
1912151057,0,6,6,3,6,21
1912151058,9,4,7,1,2,23
1912151059,6,1,6,6,2,21
1912151060,3,2,3,3,5,16
1912151061,7,2,4,0,7,20
1912151062,9,3,3,7,8,30
1912151063,2,0,3,0,3,8
1912151064,9,7,1,8,8,33
1912151065,3,7,4,0,2,16
1912151066,4,9,3,7,9,32
1912151067,3,4,4,9,8,28
1912151068,5,6,2,0,2,15
1912151069,6,1,1,0,9,17
1912151070,5,0,6,9,5,25
1912151071,4,6,9,5,2,26
1912151072,3,6,9,8,8,34
1912151073,6,1,6,7,3,23
1912151074,3,2,9,9,3,26
1912151075,5,3,2,1,6,17
1912151076,1,2,1,9,9,22
1912151077,7,9,2,5,5,28
1912151078,1,2,6,1,6,16
1912151079,5,8,4,0,6,23
1912151080,0,9,1,2,9,21
1912151081,6,9,2,7,3,27
1912151082,2,4,7,5,5,23
1912151083,4,9,0,6,4,23
1912151084,4,5,1,8,8,26
1912151085,6,6,0,2,6,20
1912151086,6,9,7,3,7,32
1912151087,4,7,7,5,0,23
1912151088,6,1,9,0,5,21
1912151089,1,5,1,9,5,21
1912151090,5,7,2,1,0,15
1912151091,7,0,9,2,2,20
1912151092,6,2,4,5,5,22
1912151093,1,7,7,9,3,27
1912151094,8,5,1,7,3,24
1912151095,9,7,1,4,0,21
1912151096,8,9,2,3,9,31
1912151097,8,8,9,4,8,37
1912151098,4,0,5,3,4,16
1912151099,0,3,9,1,9,22
1912151100,8,8,6,0,2,24
1912151101,5,7,7,8,0,27
1912151102,3,5,2,5,4,19
1912151103,9,6,6,1,8,30
1912151104,7,0,8,6,1,22
1912151105,3,6,8,5,5,27
191216001,4,6,9,2,5,26
191216002,1,4,5,1,6,17
191216003,7,0,1,7,8,23
191216004,2,4,2,8,6,22
191216005,8,6,1,0,7,22
191216006,5,6,3,0,4,18
191216007,8,4,0,0,9,21
191216008,9,7,8,5,2,31
191216009,0,5,3,1,8,17
191216010,3,8,7,7,8,33
191216011,1,5,9,0,3,18
191216012,5,9,5,7,8,34
191216013,8,1,5,5,4,23
191216014,5,3,0,9,2,19
191216015,4,8,0,1,7,20
191216016,2,1,8,7,7,25
191216017,2,1,4,8,7,22
191216018,7,3,2,5,6,23
191216019,0,9,3,7,5,24
191216020,5,4,9,0,2,20
191216021,4,9,7,8,5,33
191216022,3,7,2,4,5,21
191216023,2,5,7,4,6,24
191216024,1,5,1,2,9,18
191216025,8,5,2,9,7,31
191216026,3,2,0,8,6,19
191216027,2,8,7,7,5,29
191216028,3,4,1,6,0,14
191216029,5,1,1,8,2,17
191216030,9,6,0,3,0,18
191216031,5,2,3,4,2,16
191216032,1,8,4,8,9,30
191216033,6,4,3,7,6,26
191216034,9,4,6,3,0,22
191216035,9,0,0,1,0,10
191216036,5,3,3,1,4,16
191216037,0,5,4,6,3,18
191216038,4,5,8,8,2,27
191216039,1,8,0,5,2,16
191216040,4,4,1,7,9,25
191216041,6,4,4,5,3,22
191216042,4,3,3,0,9,19
191216043,1,8,0,3,7,19
191216044,7,7,8,7,3,32
191216045,2,7,5,8,0,22
191216046,7,1,9,0,3,20
191216047,8,1,4,8,7,28
191216048,1,3,3,8,4,19
191216049,6,1,3,9,6,25
191216050,3,2,3,3,3,14
191216051,9,3,2,8,9,31
191216052,7,1,5,2,7,22
191216053,9,5,3,7,6,30
191216054,5,0,0,1,2,8
191216055,2,0,0,6,5,13
191216056,2,8,1,7,5,23
191216057,9,1,3,6,8,27
191216058,4,3,2,2,2,13
191216059,1,5,2,7,7,22
191216060,0,1,1,7,1,10
191216061,9,5,2,6,1,23
191216062,1,9,6,6,4,26
191216063,9,2,8,0,0,19
191216064,8,8,7,4,2,29
191216065,7,3,5,4,9,28
191216066,0,2,2,5,7,16
191216067,3,8,4,8,4,27
191216068,1,5,8,3,1,18
191216069,1,0,2,5,5,13
191216070,4,3,1,7,9,24
191216071,3,0,7,5,3,18
191216072,8,0,7,4,5,24
191216073,3,6,4,8,4,25
191216074,7,6,1,2,8,24
191216075,4,9,1,4,5,23
191216076,0,0,9,6,3,18
191216077,2,1,0,1,8,12
191216078,5,6,7,3,6,27
191216079,3,4,6,0,2,15
191216080,0,7,5,9,6,27
191216081,0,3,7,3,5,18
191216082,7,0,5,6,7,25
191216083,5,4,5,1,7,22
191216084,4,9,2,6,4,25
191216085,4,5,4,5,3,21
191216086,1,5,4,0,3,13
191216087,1,2,1,3,8,15
191216088,8,7,1,1,0,17
191216089,8,4,3,8,6,29
191216090,6,6,7,5,0,24
191216091,3,0,1,3,3,10
191216092,3,9,9,7,2,30
191216093,3,8,3,4,9,27
191216094,4,6,9,7,3,29
191216095,3,0,1,5,1,10
191216096,1,8,7,3,0,19
191216097,4,6,7,4,7,28
191216098,4,0,7,8,7,26
191216099,7,8,3,1,2,21
191216100,8,4,6,2,6,26
191216101,3,7,2,1,1,14
191216102,9,7,6,5,9,36
191216103,2,0,1,9,7,19
191216104,5,0,3,2,6,16
191216105,4,9,6,1,4,24
191216106,4,0,3,9,9,25
191216107,4,8,1,0,1,14
191216108,6,4,4,5,9,28
191216109,2,4,5,8,2,21
191216110,4,8,9,6,3,30
191216111,5,6,9,5,6,31
191216112,3,0,1,7,9,20
191216113,5,0,7,6,1,19
191216114,9,1,1,3,9,23
191216115,4,2,0,3,9,18
191216116,8,5,9,9,5,36
191216117,3,2,9,7,3,24
191216118,9,8,9,2,7,35
191216119,1,8,2,9,4,24
191216120,0,6,3,9,3,21
191216121,0,9,9,5,3,26
191216122,8,7,5,3,7,30
191216123,5,4,2,6,8,25
191216124,9,1,8,1,4,23
191216125,3,0,6,4,9,22
191216126,2,8,0,5,6,21
191216127,3,8,3,5,2,21
191216128,6,6,8,6,9,35
191216129,6,9,7,2,9,33
191216130,2,9,8,8,8,35
191216131,7,2,7,7,0,23
191216132,1,2,7,6,7,23
191216133,3,0,2,4,3,12
191216134,4,6,9,5,9,33
191216135,9,0,1,4,3,17
191216136,6,9,0,8,2,25
191216137,6,1,7,4,9,27
191216138,0,2,5,3,9,19
191216139,9,6,7,1,7,30
191216140,3,1,0,1,0,5
191216141,2,2,1,9,8,22
191216142,7,8,5,2,7,29
191216143,5,0,7,1,9,22
191216144,9,4,0,7,2,22
191216145,9,6,7,2,9,33
191216146,6,2,1,3,3,15
191216147,5,6,7,8,6,32
191216148,0,2,6,8,1,17
191216149,0,6,3,0,9,18
191216150,5,1,9,7,1,23
191216151,4,7,8,6,1,26
191216152,8,6,5,6,8,33
191216153,5,1,2,6,2,16
191216154,3,9,2,6,6,26
191216155,4,3,5,1,0,13
191216156,2,2,0,1,4,9
191216157,5,6,5,3,5,24
191216158,4,2,8,5,2,21
191216159,6,8,8,7,7,36
191216160,6,3,7,2,6,24
191216161,4,2,2,6,6,20
191216162,0,5,7,8,4,24
191216163,2,4,8,3,6,23
191216164,5,4,6,7,4,26
191216165,3,2,3,5,4,17
191216166,6,2,7,2,8,25
191216167,4,9,8,9,8,38
191216168,5,5,2,0,6,18
191216169,0,5,5,5,7,22
191216170,7,6,8,4,0,25
191216171,9,6,8,3,4,30
191216172,5,2,7,1,1,16
191216173,5,8,0,6,0,19
191216174,0,0,4,3,0,7
191216175,7,1,0,0,4,12
191216176,7,4,8,0,0,19
191216177,6,6,5,6,8,31
191216178,8,4,1,0,2,15
191216179,5,7,6,8,6,32
191216180,7,4,3,3,4,21
191216181,7,6,3,2,5,23
191216182,0,6,9,8,6,29
191216183,2,5,2,0,5,14
191216184,9,6,1,7,7,30
191216185,1,4,7,7,5,24
191216186,1,2,7,8,8,26
191216187,3,6,1,0,0,10
191216188,5,4,3,0,4,16
191216189,5,1,3,2,9,20
191216190,5,8,2,6,0,21
191216191,3,8,4,7,1,23
191216192,8,6,5,4,9,32
191216193,7,4,2,6,2,21
191216194,4,7,9,3,4,27
191216195,1,8,3,3,6,21
191216196,0,5,3,2,6,16
191216197,1,7,2,9,7,26
191216198,2,7,5,3,8,25
191216199,6,4,6,5,3,24
191216200,4,5,9,7,2,27
191216201,4,0,6,0,8,18
191216202,1,5,5,6,5,22
191216203,0,8,0,6,9,23
191216204,1,4,3,6,9,23
191216205,5,5,9,8,4,31
191216206,1,9,1,7,7,25
191216207,7,4,0,6,8,25
191216208,4,2,9,2,3,20
191216209,5,6,1,5,2,19
191216210,3,5,9,3,4,24
191216211,3,1,2,6,8,20
191216212,9,2,5,9,2,27
191216213,5,8,7,7,0,27
191216214,2,9,6,9,9,35
191216215,8,3,6,0,2,19
191216216,0,2,5,4,8,19
191216217,0,3,8,0,8,19
191216218,6,1,3,3,3,16
191216219,1,5,5,3,3,17
191216220,9,9,8,9,7,42
191216221,1,9,7,1,7,25
191216222,2,3,0,1,2,8
191216223,0,7,1,1,7,16
191216224,4,5,5,0,3,17
191216225,6,5,4,9,8,32
191216226,1,5,9,4,6,25
191216227,0,5,1,6,4,16
191216228,5,9,5,3,2,24
191216229,8,8,9,9,4,38
191216230,9,6,7,1,4,27
191216231,4,4,3,0,1,12
191216232,1,3,5,5,2,16
191216233,3,1,1,0,2,7
191216234,4,9,8,4,2,27
191216235,7,9,6,5,9,36
191216236,4,3,1,4,1,13
191216237,6,7,1,6,4,24
191216238,7,0,4,6,8,25
191216239,6,7,7,4,3,27
191216240,8,1,5,9,6,29
191216241,2,1,2,1,6,12
191216242,9,3,2,6,5,25
191216243,2,7,7,9,9,34
191216244,3,1,1,1,1,7
191216245,5,2,8,2,5,22
191216246,5,2,8,9,0,24
191216247,0,3,9,0,9,21
191216248,2,5,8,8,8,31
191216249,5,6,5,5,7,28
191216250,6,5,4,9,3,27
191216251,8,7,1,5,2,23
191216252,4,9,2,1,9,25
191216253,0,8,2,4,3,17
191216254,3,1,1,0,5,10
191216255,0,8,0,1,7,16
191216256,7,2,8,5,2,24
191216257,7,2,3,1,0,13
191216258,5,1,7,4,6,23
191216259,0,6,2,9,6,23
191216260,8,9,8,5,0,30
191216261,9,8,4,5,5,31
191216262,7,2,0,1,3,13
191216263,3,7,7,2,5,24
191216264,9,8,5,6,8,36
191216265,2,7,6,6,8,29
191216266,3,5,6,3,5,22
191216267,2,4,0,6,9,21
191216268,5,1,2,4,8,20
191216269,6,8,5,5,6,30
191216270,1,4,6,8,9,28
191216271,6,0,5,6,9,26
191216272,2,9,9,3,9,32
191216273,7,6,5,7,1,26
191216274,7,3,1,0,5,16
191216275,0,7,2,0,7,16
191216276,8,3,7,2,7,27
191216277,5,1,9,5,1,21
191216278,7,3,2,6,4,22
191216279,5,8,4,4,9,30
191216280,3,8,2,8,1,22
191216281,9,7,9,7,8,40
191216282,2,2,7,5,0,16
191216283,1,0,3,7,6,17
191216284,2,8,5,7,1,23
191216285,6,9,2,8,8,33
191216286,1,7,3,6,5,22
191216287,4,0,5,2,3,14
191216288,2,6,1,4,5,18
191216289,8,3,1,1,2,15
191216290,7,6,4,0,1,18
191216291,0,9,1,4,6,20
191216292,5,0,8,8,1,22
191216293,8,4,1,7,6,26
191216294,1,8,4,2,3,18
191216295,4,3,6,8,5,26
191216296,6,8,8,7,5,34
191216297,9,7,1,6,0,23
191216298,6,7,7,6,0,26
191216299,3,1,4,5,0,13
191216300,7,4,7,7,5,30
191216301,7,5,8,7,6,33
191216302,7,3,1,8,4,23
191216303,8,4,3,1,1,17
191216304,6,2,1,3,4,16
191216305,9,0,8,7,4,28
191216306,0,2,1,9,4,16
191216307,6,8,7,5,5,31
191216308,4,2,9,0,2,17
191216309,6,9,6,1,3,25
191216310,8,7,7,7,0,29
191216311,2,9,7,6,8,32
191216312,4,9,0,1,0,14
191216313,1,0,5,0,9,15
191216314,4,6,2,5,5,22
191216315,7,4,2,2,8,23
191216316,7,4,7,2,1,21
191216317,5,4,7,8,4,28
191216318,1,7,4,8,2,22
191216319,2,2,7,2,8,21
191216320,3,5,2,9,5,24
191216321,8,0,6,2,5,21
191216322,6,2,2,7,3,20
191216323,9,4,5,3,6,27
191216324,0,4,4,2,9,19
191216325,7,4,8,3,5,27
191216326,3,5,3,3,5,19
191216327,0,8,1,1,5,15
191216328,1,3,7,1,4,16
191216329,7,8,4,6,9,34
191216330,1,7,8,5,3,24
191216331,8,3,4,8,2,25
191216332,7,6,9,6,6,34
191216333,8,8,8,3,0,27
191216334,8,4,7,8,1,28
191216335,4,8,3,9,4,28
191216336,5,1,9,4,8,27
191216337,4,4,5,7,6,26
191216338,8,5,2,8,8,31
191216339,5,5,9,8,7,34
191216340,2,1,9,2,7,21
191216341,0,9,6,9,7,31
191216342,4,3,2,2,1,12
191216343,7,6,2,0,7,22
191216344,3,3,8,0,5,19
191216345,7,3,9,3,2,24
191216346,5,0,2,6,4,17
191216347,4,6,8,8,3,29
191216348,7,2,4,4,5,22
191216349,9,7,7,9,7,39
191216350,9,1,8,5,5,28
191216351,6,7,5,4,3,25
191216352,9,5,6,4,0,24
191216353,5,9,9,7,3,33
191216354,7,2,8,4,3,24
191216355,9,9,7,7,4,36
191216356,2,2,2,4,6,16
191216357,3,5,1,8,8,25
191216358,2,2,4,2,4,14
191216359,3,7,8,9,5,32
191216360,2,9,0,0,9,20
191216361,8,8,2,1,3,22
191216362,8,0,8,0,3,19
191216363,8,4,0,1,0,13
191216364,0,9,5,1,4,19
191216365,8,2,4,1,9,24
191216366,1,5,0,2,8,16
191216367,0,6,9,9,2,26
191216368,0,3,5,9,7,24
191216369,7,1,1,4,3,16
191216370,5,1,9,6,5,26
191216371,1,3,6,2,5,17
191216372,9,4,0,5,8,26
191216373,3,7,7,8,5,30
191216374,1,5,3,8,1,18
191216375,8,0,6,3,8,25
191216376,3,7,1,4,3,18
191216377,8,5,6,9,2,30
191216378,8,6,7,0,1,22
191216379,4,7,1,4,0,16
191216380,7,0,7,3,1,18
191216381,2,3,7,6,3,21
191216382,9,1,5,7,9,31
191216383,2,3,1,1,0,7
191216384,0,5,3,2,1,11
191216385,0,5,7,4,4,20
191216386,7,1,7,2,9,26
191216387,7,3,1,6,3,20
191216388,6,5,9,9,9,38
191216389,5,4,2,4,3,18
191216390,0,6,6,0,6,18
191216391,7,3,8,2,7,27
191216392,0,1,4,8,5,18
191216393,3,9,1,4,6,23
191216394,2,8,2,8,4,24
191216395,5,0,2,3,9,19
191216396,2,6,9,9,4,30
191216397,2,9,8,1,5,25
191216398,9,7,5,3,7,31
191216399,7,1,9,9,3,29
191216400,6,2,6,3,8,25
191216401,7,0,5,2,9,23
191216402,0,8,5,0,7,20
191216403,7,9,1,5,3,25
191216404,8,8,9,1,2,28
191216405,5,4,5,9,7,30
191216406,6,5,0,2,8,21
191216407,7,0,3,7,4,21
191216408,8,2,4,8,0,22
191216409,3,8,5,4,4,24
191216410,9,6,3,3,8,29
191216411,8,9,1,4,8,30
191216412,3,5,4,6,9,27
191216413,5,7,4,9,7,32
191216414,3,0,1,0,6,10
191216415,9,7,5,5,4,30
191216416,8,5,8,3,0,24
191216417,3,4,2,5,9,23
191216418,0,0,8,6,6,20
191216419,1,3,6,4,2,16
191216420,1,4,5,2,8,20
191216421,1,7,2,4,7,21
191216422,8,9,3,2,6,28
191216423,8,3,7,6,1,25
191216424,7,7,3,2,3,22
191216425,3,4,9,2,7,25
191216426,9,8,4,4,0,25
191216427,3,2,5,6,7,23
191216428,0,6,1,7,4,18
191216429,3,5,3,6,1,18
191216430,2,0,3,4,9,18
191216431,5,7,7,4,7,30
191216432,0,3,1,5,5,14
191216433,9,8,9,0,0,26
191216434,9,3,6,3,3,24
191216435,8,4,6,7,2,27
191216436,6,0,6,8,0,20
191216437,2,2,5,9,6,24
191216438,3,1,1,0,6,11
191216439,0,6,0,6,6,18
191216440,6,4,7,5,3,25
191216441,1,4,6,5,2,18
191216442,8,7,7,1,4,27
191216443,2,9,5,4,1,21
191216444,5,7,5,5,6,28
191216445,7,9,1,3,3,23
191216446,0,5,7,7,2,21
191216447,5,2,7,6,5,25
191216448,6,8,7,4,8,33
191216449,4,5,6,3,5,23
191216450,9,2,4,6,0,21
191216451,6,9,9,0,7,31
191216452,0,6,8,6,7,27
191216453,9,8,2,8,3,30
191216454,6,0,4,7,4,21
191216455,3,0,1,7,0,11
191216456,6,8,5,0,4,23
191216457,8,6,9,8,0,31
191216458,5,7,1,3,3,19
191216459,8,0,6,9,7,30
191216460,5,2,3,7,8,25
191216461,4,0,0,1,4,9
191216462,3,6,4,0,2,15
191216463,8,3,1,2,7,21
191216464,2,0,9,7,6,24
191216465,8,9,9,8,0,34
191216466,2,8,1,9,1,21
191216467,0,0,1,4,3,8
191216468,2,6,2,0,3,13
191216469,9,2,3,3,8,25
191216470,6,3,3,0,1,13
191216471,3,4,1,5,9,22
191216472,3,4,8,6,5,26
191216473,4,3,0,7,6,20
191216474,7,0,9,2,5,23
191216475,5,0,7,1,4,17
191216476,4,1,7,9,9,30
191216477,8,8,0,7,4,27
191216478,2,5,8,8,1,24
191216479,2,4,9,0,2,17
191216480,6,0,7,3,7,23
191216481,6,1,4,8,3,22
191216482,3,2,4,6,7,22
191216483,1,1,2,8,2,14
191216484,4,8,0,6,4,22
191216485,5,1,1,4,2,13
191216486,7,8,6,8,4,33
191216487,1,1,4,7,2,15
191216488,0,1,4,6,5,16
191216489,4,2,6,6,6,24
191216490,3,3,1,1,7,15
191216491,6,8,2,9,1,26
191216492,3,1,9,0,7,20
191216493,4,8,0,9,3,24
191216494,0,1,8,7,4,20
191216495,2,6,4,9,3,24
191216496,3,7,8,6,7,31
191216497,6,4,5,8,9,32
191216498,8,1,7,4,1,21
191216499,0,2,2,4,3,11
191216500,4,5,6,4,9,28
191216501,7,7,3,4,7,28
191216502,0,8,6,0,6,20
191216503,5,4,0,8,5,22
191216504,7,4,8,2,0,21
191216505,3,9,2,0,0,14
191216506,5,3,1,5,3,17
191216507,8,6,2,8,0,24
191216508,1,4,0,2,4,11
191216509,4,3,2,0,1,10
191216510,5,2,8,0,0,15
191216511,9,4,4,7,4,28
191216512,9,4,9,1,5,28
191216513,7,2,8,2,3,22
191216514,7,8,5,7,2,29
191216515,6,2,3,5,2,18
191216516,9,7,7,0,0,23
191216517,5,9,1,7,0,22
191216518,1,0,5,5,0,11
191216519,5,8,7,2,4,26
191216520,0,2,3,6,4,15
191216521,2,6,4,1,8,21
191216522,3,1,2,8,0,14
191216523,0,3,5,4,3,15
191216524,5,0,8,9,7,29
191216525,9,8,9,2,3,31
191216526,6,7,8,4,4,29
191216527,5,8,4,0,0,17
191216528,1,5,5,0,9,20
191216529,3,4,4,8,3,22
191216530,7,6,1,6,8,28
191216531,0,9,2,7,7,25
191216532,6,2,7,1,8,24
191216533,7,3,1,6,2,19
191216534,3,7,5,1,1,17
191216535,4,0,9,2,1,16
191216536,5,7,4,1,7,24
191216537,2,0,5,6,9,22
191216538,9,8,0,0,0,17
191216539,3,6,1,7,4,21
191216540,2,7,6,4,2,21
191216541,7,4,1,6,7,25
191216542,5,1,4,2,8,20
191216543,1,6,8,1,0,16
191216544,2,2,0,1,8,13
191216545,0,3,7,1,0,11
191216546,6,1,5,3,9,24
191216547,8,6,5,4,6,29
191216548,3,4,8,4,4,23
191216549,1,6,1,7,3,18
191216550,2,9,6,5,8,30
191216551,5,3,8,5,0,21
191216552,4,6,6,5,9,30
191216553,1,0,2,9,9,21
191216554,0,3,9,9,6,27
191216555,2,6,9,5,6,28
191216556,8,2,2,5,0,17
191216557,6,9,5,9,5,34
191216558,3,6,1,5,8,23
191216559,5,4,4,0,2,15
191216560,6,7,1,7,8,29
191216561,5,9,0,6,8,28
191216562,0,6,3,8,6,23
191216563,0,7,4,6,9,26
191216564,5,7,0,2,9,23
191216565,7,0,4,2,3,16
191216566,5,0,0,1,8,14
191216567,9,6,6,8,4,33
191216568,3,2,7,8,2,22
191216569,4,8,1,4,0,17
191216570,6,7,6,0,2,21
191216571,1,0,6,1,0,8
191216572,1,2,4,2,4,13
191216573,8,9,6,9,1,33
191216574,5,5,2,2,1,15
191216575,3,8,6,2,6,25
191216576,6,3,5,6,4,24
191216577,2,9,0,2,1,14
191216578,4,1,3,0,8,16
191216579,6,7,6,0,7,26
191216580,5,5,2,0,1,13
191216581,7,5,8,2,5,27
191216582,7,7,0,2,0,16
191216583,9,3,3,4,7,26
191216584,1,2,4,9,4,20
191216585,8,4,5,0,9,26
191216586,8,9,1,8,6,32
191216587,5,6,0,7,4,22
191216588,2,4,0,7,3,16
191216589,3,8,3,8,5,27
191216590,7,5,8,3,1,24
191216591,0,2,6,0,8,16
191216592,9,9,5,3,3,29
191216593,9,0,0,4,4,17
191216594,8,8,4,0,1,21
191216595,4,6,8,7,4,29
191216596,2,4,5,4,0,15
191216597,5,7,9,3,2,26
191216598,5,7,1,8,1,22
191216599,2,9,3,2,1,17
191216600,1,6,3,6,6,22
191216601,3,4,9,0,9,25
191216602,2,7,3,9,4,25
191216603,0,2,7,1,3,13
191216604,2,4,1,1,3,11
191216605,7,5,7,8,0,27
191216606,2,0,4,5,7,18
191216607,7,5,6,1,1,20
191216608,1,2,0,4,6,13
191216609,1,0,5,9,9,24
191216610,9,4,7,7,3,30
191216611,0,0,1,2,7,10
191216612,7,5,5,3,7,27
191216613,6,4,1,2,2,15
191216614,6,3,7,7,8,31
191216615,5,2,1,7,7,22
191216616,8,0,1,3,7,19
191216617,5,1,3,0,0,9
191216618,3,1,0,5,0,9
191216619,6,9,1,4,6,26
191216620,7,7,2,1,6,23
191216621,7,0,9,6,0,22
191216622,3,7,9,6,5,30
191216623,5,3,5,4,5,22
191216624,3,4,8,7,4,26
191216625,4,5,1,3,0,13
191216626,1,8,7,4,9,29
191216627,5,4,5,5,1,20
191216628,2,0,1,2,3,8
191216629,9,2,3,7,6,27
191216630,1,6,9,7,9,32
191216631,3,0,5,5,6,19
191216632,4,3,8,2,7,24
191216633,9,9,9,9,8,44
191216634,5,3,4,9,2,23
191216635,9,3,5,6,2,25
191216636,8,1,4,7,1,21
191216637,5,6,1,6,3,21
191216638,2,5,4,5,7,23
191216639,7,4,6,5,0,22
191216640,0,1,2,8,3,14
191216641,3,4,8,8,1,24
191216642,1,3,6,4,7,21
191216643,0,3,9,8,7,27
191216644,0,8,9,6,9,32
191216645,4,4,1,8,5,22
191216646,9,7,2,9,2,29
191216647,0,9,5,3,4,21
191216648,6,3,7,5,5,26
191216649,8,4,3,0,1,16
191216650,4,2,5,0,4,15
191216651,2,8,8,3,3,24
191216652,8,6,3,1,4,22
191216653,1,2,9,4,5,21
191216654,9,0,7,7,2,25
191216655,4,4,2,0,1,11
191216656,3,9,6,9,7,34
191216657,1,0,6,9,2,18
191216658,6,4,7,3,9,29
191216659,4,7,4,1,2,18
191216660,3,1,2,4,1,11
191216661,1,9,9,8,7,34
191216662,4,6,2,8,5,25
191216663,7,3,5,6,0,21
191216664,6,5,4,7,9,31
191216665,3,3,3,6,0,15
191216666,1,2,8,5,3,19
191216667,2,1,6,7,9,25
191216668,9,0,2,3,9,23
191216669,8,0,3,4,1,16
191216670,9,8,3,4,4,28
191216671,6,4,5,3,3,21
191216672,6,8,0,9,8,31
191216673,3,8,3,2,8,24
191216674,2,2,3,5,2,14
191216675,2,6,8,2,3,21
191216676,7,6,2,0,2,17
191216677,3,8,7,0,5,23
191216678,6,9,9,4,3,31
191216679,8,9,0,7,1,25
191216680,9,5,3,6,8,31
191216681,2,1,3,7,3,16
191216682,3,1,6,9,0,19
191216683,7,8,5,6,6,32
191216684,9,4,5,7,7,32
191216685,4,3,1,1,6,15
191216686,4,8,8,2,6,28
191216687,5,2,4,7,3,21
191216688,7,4,0,6,3,20
191216689,6,7,3,8,8,32
191216690,2,3,3,3,7,18
191216691,6,0,1,7,8,22
191216692,7,7,3,0,0,17
191216693,7,3,4,0,9,23
191216694,0,3,9,0,7,19
191216695,6,9,5,0,2,22
191216696,7,0,1,8,5,21
191216697,6,5,5,0,5,21
191216698,6,4,8,5,5,28
191216699,8,2,8,3,1,22
191216700,2,6,3,4,7,22
191216701,6,0,4,3,4,17
191216702,9,2,6,1,9,27
191216703,4,3,4,9,6,26
191216704,9,2,0,3,5,19
191216705,8,4,7,5,1,25
191216706,8,3,2,0,3,16
191216707,7,6,4,9,2,28
191216708,1,0,0,9,3,13
191216709,8,4,5,3,0,20
191216710,2,1,6,0,7,16
191216711,4,1,2,6,5,18
191216712,8,0,5,0,3,16
191216713,6,7,5,9,7,34
191216714,6,8,9,4,2,29
191216715,3,7,6,9,6,31
191216716,0,1,9,6,6,22
191216717,9,6,9,7,1,32
191216718,9,6,0,2,0,17
191216719,5,7,2,7,2,23
191216720,5,9,7,7,6,34
191216721,4,1,1,0,9,15
191216722,2,2,6,6,5,21
191216723,6,6,9,1,2,24
191216724,6,0,4,2,6,18
191216725,9,1,6,9,6,31
191216726,7,3,4,3,3,20
191216727,0,7,7,8,7,29
191216728,4,9,3,4,2,22
191216729,5,6,4,2,1,18
191216730,9,8,0,6,9,32
191216731,0,0,0,2,5,7
191216732,9,8,5,9,2,33
191216733,0,3,1,6,3,13
191216734,3,1,0,3,5,12
191216735,2,0,4,0,4,10
191216736,9,5,1,4,5,24
191216737,3,6,9,2,4,24
191216738,5,7,2,1,5,20
191216739,4,8,5,1,1,19
191216740,1,7,9,7,2,26
191216741,1,5,0,3,8,17
191216742,5,8,5,1,1,20
191216743,2,5,4,4,6,21
191216744,6,2,0,4,0,12
191216745,7,6,5,2,5,25
191216746,4,2,9,1,4,20
191216747,3,2,6,2,4,17
191216748,7,1,2,7,4,21
191216749,1,3,0,5,0,9
191216750,2,2,7,3,7,21
191216751,2,1,1,8,2,14
191216752,5,0,4,0,0,9
191216753,8,1,2,8,4,23
191216754,0,5,9,5,8,27
191216755,9,8,4,7,4,32
191216756,0,1,1,4,6,12
191216757,9,2,0,8,0,19
191216758,1,2,3,9,4,19
191216759,5,3,0,2,4,14
191216760,8,0,6,3,5,22
191216761,4,7,7,2,0,20
191216762,2,6,1,2,8,19
191216763,2,1,2,2,5,12
191216764,2,9,9,8,2,30
191216765,0,1,0,6,6,13
191216766,9,5,3,3,5,25
191216767,7,4,6,9,3,29
191216768,0,9,0,4,6,19
191216769,1,9,5,8,4,27
191216770,0,7,0,0,3,10
191216771,1,3,1,4,4,13
191216772,2,2,5,8,9,26
191216773,5,6,7,7,5,30
191216774,6,5,1,3,3,18
191216775,7,1,5,4,9,26
191216776,6,1,6,2,8,23
191216777,9,6,7,1,1,24
191216778,2,6,7,6,7,28
191216779,2,9,1,5,5,22
191216780,1,0,0,3,1,5
191216781,8,6,7,9,7,37
191216782,6,1,1,9,2,19
191216783,2,4,7,4,2,19
191216784,4,6,3,6,6,25
191216785,7,6,3,2,8,26
191216786,0,5,2,1,2,10
191216787,6,0,3,5,1,15
191216788,1,1,7,4,3,16
191216789,5,6,9,0,4,24
191216790,8,6,1,6,7,28
191216791,8,4,7,9,4,32
191216792,8,1,1,0,2,12
191216793,0,7,1,4,0,12
191216794,3,3,7,2,5,20
191216795,8,3,8,5,3,27
191216796,7,0,1,1,1,10
191216797,8,9,7,5,3,32
191216798,3,6,1,8,0,18
191216799,8,5,5,2,7,27
191216800,7,7,0,4,1,19
191216801,5,6,9,6,9,35
191216802,1,7,6,9,4,27
191216803,4,1,0,1,2,8
191216804,7,9,3,9,1,29
191216805,9,5,5,1,4,24
191216806,6,7,3,9,9,34
191216807,3,2,7,2,5,19
191216808,3,4,4,4,7,22
191216809,2,3,5,4,6,20
191216810,8,6,3,7,8,32
191216811,5,1,7,7,3,23
191216812,1,4,5,9,6,25
191216813,0,7,5,1,9,22
191216814,9,9,0,9,9,36
191216815,9,6,6,2,1,24
191216816,6,2,7,1,3,19
191216817,0,8,1,8,0,17
191216818,2,4,6,8,1,21
191216819,1,8,2,2,5,18
191216820,0,5,1,2,1,9
191216821,3,9,6,6,2,26
191216822,0,3,2,6,1,12
191216823,7,2,1,1,7,18
191216824,7,7,9,6,3,32
191216825,0,3,1,7,1,12
191216826,3,0,1,6,6,16
191216827,4,0,9,3,1,17
191216828,1,4,7,6,4,22
191216829,4,1,7,8,5,25
191216830,4,6,9,8,3,30
191216831,3,1,7,3,9,23
191216832,8,3,9,0,1,21
191216833,6,7,8,6,8,35
191216834,6,6,1,4,5,22
191216835,3,0,3,0,6,12
191216836,7,0,0,0,4,11
191216837,9,5,1,1,2,18
191216838,5,8,4,6,3,26
191216839,2,4,4,1,5,16
191216840,2,7,6,7,2,24
191216841,2,8,3,0,0,13
191216842,5,4,5,4,0,18
191216843,4,4,4,7,3,22
191216844,4,1,4,2,1,12
191216845,0,2,2,7,3,14
191216846,9,6,0,6,0,21
191216847,3,9,9,3,1,25
191216848,7,4,9,8,2,30
191216849,4,5,1,5,5,20
191216850,8,8,2,0,4,22
191216851,3,3,0,9,5,20
191216852,6,8,1,5,0,20
191216853,5,6,9,8,5,33
191216854,7,4,1,6,9,27
191216855,2,2,8,2,2,16
191216856,0,2,1,3,9,15
191216857,7,9,4,2,1,23
191216858,2,2,8,5,8,25
191216859,5,0,1,5,1,12
191216860,2,9,6,6,7,30
191216861,7,3,1,7,5,23
191216862,4,9,1,6,5,25
191216863,9,3,7,3,6,28
191216864,8,3,1,3,6,21
191216865,6,6,1,9,5,27
191216866,9,3,9,7,5,33
191216867,1,3,2,1,8,15
191216868,2,3,3,1,9,18
191216869,4,9,1,8,8,30
191216870,8,6,8,2,6,30
191216871,9,4,6,1,7,27
191216872,3,8,8,3,7,29
191216873,0,7,9,0,0,16
191216874,1,2,5,2,4,14
191216875,7,1,6,1,6,21
191216876,3,7,5,8,2,25
191216877,7,5,2,5,3,22
191216878,6,6,0,3,3,18
191216879,0,2,0,0,2,4
191216880,9,5,7,9,8,38
191216881,9,6,9,0,9,33
191216882,2,5,2,1,9,19
191216883,9,9,2,9,7,36
191216884,0,2,4,6,9,21
191216885,6,8,3,6,7,30
191216886,1,1,5,0,0,7
191216887,3,7,6,5,4,25
191216888,9,6,2,2,2,21
191216889,5,1,2,8,0,16
191216890,9,6,2,1,6,24
191216891,3,7,4,8,7,29
191216892,2,6,1,5,9,23
191216893,1,2,4,7,1,15
191216894,9,4,2,7,5,27
191216895,8,1,6,2,0,17
191216896,1,1,8,4,7,21
191216897,4,3,6,0,5,18
191216898,3,4,0,3,8,18
191216899,4,2,2,2,8,18
191216900,1,3,2,8,0,14
191216901,3,3,1,6,9,22
191216902,6,7,3,8,2,26
191216903,0,8,4,9,4,25
191216904,4,1,4,0,0,9
191216905,2,0,8,4,4,18
191216906,9,5,9,7,7,37
191216907,4,5,5,1,6,21
191216908,0,1,7,7,6,21
191216909,6,5,2,7,6,26
191216910,6,6,4,4,5,25
191216911,2,1,6,5,5,19
191216912,1,6,4,9,0,20
191216913,1,6,9,3,0,19
191216914,5,9,5,1,6,26
191216915,8,7,7,8,0,30
191216916,3,6,7,9,0,25
191216917,0,0,6,6,7,19
191216918,3,0,2,8,7,20
191216919,3,4,0,7,6,20
191216920,0,7,5,9,5,26
191216921,8,9,5,3,3,28
191216922,2,5,2,6,7,22
191216923,4,4,2,0,8,18
191216924,6,4,0,8,3,21
191216925,7,2,7,4,8,28
191216926,8,1,3,8,9,29
191216927,6,6,5,8,1,26
191216928,3,9,2,0,7,21
191216929,0,7,3,5,9,24
191216930,9,9,5,7,2,32
191216931,8,5,4,0,9,26
191216932,3,7,9,9,0,28
191216933,2,7,7,8,4,28
191216934,2,6,3,3,5,19
191216935,2,2,6,3,4,17
191216936,8,0,4,0,5,17
191216937,7,2,3,8,0,20
191216938,2,0,1,5,1,9
191216939,8,9,1,9,7,34
191216940,8,4,4,6,8,30
191216941,0,6,1,8,0,15
191216942,7,2,2,2,4,17
191216943,4,9,0,5,5,23
191216944,0,5,2,5,1,13
191216945,6,7,0,2,1,16
191216946,6,5,2,2,0,15
191216947,8,2,7,6,9,32
191216948,1,7,5,4,9,26
191216949,4,2,9,8,8,31
191216950,8,7,5,3,6,29
191216951,4,0,4,3,8,19
191216952,0,7,5,5,8,25
191216953,0,9,1,7,8,25
191216954,8,7,2,5,6,28
191216955,9,5,9,5,2,30
191216956,9,2,5,1,1,18
191216957,8,2,2,0,8,20
191216958,3,4,2,9,9,27
191216959,4,7,9,4,8,32
191216960,9,4,8,7,0,28
191216961,5,3,0,1,4,13
191216962,9,8,3,2,8,30
191216963,9,5,9,5,6,34
191216964,1,7,4,2,2,16
191216965,1,4,8,0,4,17
191216966,3,6,0,8,2,19
191216967,4,0,1,4,2,11
191216968,9,8,2,7,2,28
191216969,8,6,8,8,9,39
191216970,0,3,5,6,2,16
191216971,3,9,3,2,9,26
191216972,2,6,7,6,6,27
191216973,7,4,8,9,1,29
191216974,9,7,7,8,6,37
191216975,6,2,7,8,5,28
191216976,5,0,2,6,1,14
191216977,4,9,3,5,4,25
191216978,4,0,3,7,3,17
191216979,8,6,0,9,5,28
191216980,3,5,2,8,5,23
191216981,2,7,2,4,4,19
191216982,2,7,5,2,6,22
191216983,0,3,6,6,3,18
191216984,4,8,2,0,7,21
191216985,0,2,0,1,0,3
191216986,2,1,5,3,8,19
191216987,3,9,4,9,8,33
191216988,0,6,8,0,9,23
191216989,0,3,8,9,8,28
191216990,5,8,3,2,4,22
191216991,0,6,4,2,1,13
191216992,0,5,3,8,0,16
191216993,6,7,6,0,4,23
191216994,6,0,9,4,8,27
191216995,9,3,1,2,9,24
191216996,2,9,5,3,5,24
191216997,5,2,6,8,2,23
191216998,9,6,4,7,4,30
191216999,6,4,7,3,2,22
1912161000,0,6,7,7,5,25
1912161001,7,1,3,8,7,26
1912161002,2,6,6,8,8,30
1912161003,1,5,0,3,5,14
1912161004,0,5,0,3,5,13
1912161005,1,8,0,4,9,22
1912161006,3,4,9,4,2,22
1912161007,1,9,0,3,7,20
1912161008,2,9,3,7,8,29
1912161009,3,2,6,0,7,18
1912161010,3,4,7,4,3,21
1912161011,3,0,7,9,4,23
1912161012,7,5,5,9,3,29
1912161013,1,7,1,9,4,22
1912161014,7,7,8,4,6,32
1912161015,2,5,7,9,0,23
1912161016,2,5,1,9,9,26
1912161017,3,8,7,0,8,26
1912161018,8,0,8,8,2,26
1912161019,8,9,6,6,5,34
1912161020,1,4,4,6,9,24
1912161021,1,9,3,8,8,29
1912161022,7,6,9,5,3,30
1912161023,5,9,9,6,4,33
1912161024,3,5,7,4,1,20
1912161025,3,2,7,7,7,26
1912161026,4,1,3,3,5,16
1912161027,5,9,8,9,3,34
1912161028,5,9,5,9,4,32
1912161029,3,0,9,5,9,26
1912161030,8,5,2,5,5,25
1912161031,1,2,5,0,1,9
1912161032,6,0,2,4,7,19
1912161033,4,3,1,2,2,12
1912161034,5,0,9,2,0,16
1912161035,9,5,6,4,9,33
1912161036,5,0,3,3,1,12
1912161037,2,3,7,5,4,21
1912161038,8,7,8,6,8,37
1912161039,9,2,2,4,0,17
1912161040,1,6,7,0,4,18
1912161041,9,9,3,2,0,23
1912161042,8,1,2,2,4,17
1912161043,5,2,8,6,6,27
1912161044,5,5,6,6,6,28
1912161045,9,0,6,0,0,15
1912161046,7,6,0,2,2,17
1912161047,8,6,9,2,8,33
1912161048,1,6,4,8,9,28
1912161049,4,1,4,3,5,17
1912161050,9,9,7,9,5,39
1912161051,6,7,0,4,3,20
1912161052,2,8,5,1,3,19
1912161053,6,1,8,5,5,25
1912161054,6,6,3,5,0,20
1912161055,0,3,5,3,2,13
1912161056,8,5,3,9,0,25
1912161057,8,5,0,8,1,22
1912161058,2,6,0,9,6,23
1912161059,3,2,2,2,6,15
1912161060,4,3,4,6,0,17
1912161061,7,6,4,0,8,25
1912161062,2,4,8,5,6,25
1912161063,1,4,6,1,0,12
1912161064,7,2,5,4,1,19
1912161065,1,1,0,8,2,12
1912161066,3,6,1,4,7,21
1912161067,5,7,7,9,8,36
1912161068,4,4,8,6,9,31
1912161069,2,5,2,5,9,23
1912161070,0,4,8,5,7,24
1912161071,3,1,4,5,5,18
1912161072,2,6,8,0,0,16
1912161073,7,4,9,1,9,30
1912161074,9,4,3,8,8,32
1912161075,6,2,9,7,8,32
1912161076,5,2,7,6,4,24
1912161077,2,8,4,8,6,28
1912161078,1,7,1,8,4,21
1912161079,9,6,9,2,7,33
1912161080,9,8,9,4,9,39
1912161081,6,7,5,1,9,28
1912161082,6,3,5,5,8,27
1912161083,6,0,6,7,1,20
1912161084,4,1,2,4,5,16
1912161085,1,5,0,8,8,22
1912161086,1,3,0,2,1,7
1912161087,1,9,1,2,2,15
1912161088,2,8,9,4,6,29
1912161089,6,8,3,4,4,25
1912161090,4,1,0,0,5,10
1912161091,0,0,4,5,0,9
1912161092,2,9,3,4,0,18
1912161093,3,1,3,1,5,13
1912161094,2,6,2,1,4,15
1912161095,4,9,7,9,3,32
1912161096,7,9,1,2,3,22
1912161097,7,2,7,7,9,32
1912161098,6,1,0,3,6,16
1912161099,8,2,3,6,4,23
1912161100,9,2,1,4,8,24
1912161101,4,4,4,0,9,21
1912161102,1,8,0,8,1,18
1912161103,0,8,8,6,5,27
1912161104,0,4,5,4,7,20
1912161105,6,0,8,4,4,22
191217001,2,8,5,8,9,32
191217002,8,7,1,9,4,29
191217003,7,3,0,2,3,15
191217004,6,4,5,9,3,27
191217005,9,4,8,3,9,33
191217006,4,7,2,4,3,20
191217007,7,2,5,8,1,23
191217008,6,4,4,9,3,26
191217009,7,3,7,8,7,32
191217010,5,7,5,0,8,25
191217011,5,2,0,8,8,23
191217012,3,7,0,8,8,26
191217013,8,3,2,4,0,17
191217014,0,6,6,7,6,25
191217015,2,9,6,4,6,27
191217016,3,1,5,1,0,10
191217017,8,3,3,9,6,29
191217018,9,9,4,4,4,30
191217019,2,1,8,0,7,18
191217020,8,1,2,1,3,15
191217021,7,1,6,7,1,22
191217022,7,8,2,3,8,28
191217023,6,2,5,8,9,30
191217024,8,4,3,1,6,22
191217025,3,2,2,6,3,16
191217026,0,3,5,7,9,24
191217027,9,8,5,1,3,26
191217028,8,5,5,9,5,32
191217029,0,1,6,1,0,8
191217030,2,2,2,7,9,22
191217031,6,7,2,2,8,25
191217032,8,0,9,9,0,26
191217033,6,5,5,9,3,28
191217034,1,7,7,7,7,29
191217035,5,0,0,7,6,18
191217036,2,5,8,1,1,17
191217037,2,0,6,6,5,19
191217038,3,8,3,8,6,28
191217039,9,6,3,4,8,30
191217040,2,7,1,0,2,12
191217041,1,9,8,8,2,28
191217042,1,0,8,0,3,12
191217043,5,9,1,7,6,28
191217044,1,8,8,6,0,23
191217045,9,1,7,9,6,32
191217046,7,6,2,7,4,26
191217047,3,2,6,0,3,14
191217048,7,8,1,1,0,17
191217049,6,8,9,7,9,39
191217050,7,9,2,3,5,26
191217051,9,1,3,1,2,16
191217052,3,2,4,0,8,17
191217053,6,0,0,2,4,12
191217054,1,8,1,4,1,15
191217055,1,0,7,6,5,19
191217056,5,5,0,1,0,11
191217057,8,4,1,5,3,21
191217058,5,3,4,1,2,15
191217059,3,7,6,3,1,20
191217060,9,0,1,9,1,20
191217061,8,1,7,4,2,22
191217062,4,5,4,2,7,22
191217063,5,8,7,4,1,25
191217064,3,1,8,2,2,16
191217065,0,4,7,8,3,22
191217066,3,0,0,6,3,12
191217067,0,2,3,0,9,14
191217068,2,7,1,7,4,21
191217069,2,5,3,0,4,14
191217070,4,5,0,2,8,19
191217071,8,5,3,1,9,26
191217072,6,1,9,1,6,23
191217073,0,2,1,2,9,14
191217074,6,3,5,8,8,30
191217075,7,5,2,1,7,22
191217076,1,0,5,8,5,19
191217077,9,1,6,8,5,29
191217078,6,6,3,0,9,24
191217079,1,5,2,8,0,16
191217080,2,0,9,0,8,19
191217081,0,1,0,6,5,12
191217082,8,5,5,5,2,25
191217083,5,4,5,4,2,20
191217084,4,5,8,4,9,30
191217085,1,7,1,5,5,19
191217086,4,4,7,2,6,23
191217087,2,2,0,6,3,13
191217088,3,5,1,8,5,22
191217089,7,9,5,1,3,25
191217090,6,7,0,1,1,15
191217091,6,1,0,9,0,16
191217092,7,9,0,8,3,27
191217093,1,6,9,8,7,31
191217094,5,0,9,1,4,19
191217095,4,1,8,6,9,28
191217096,9,2,0,0,7,18
191217097,1,4,2,7,8,22
191217098,4,4,6,2,3,19
191217099,0,2,3,7,7,19
191217100,0,2,4,9,5,20
191217101,3,0,3,3,2,11
191217102,5,7,2,0,0,14
191217103,4,4,2,3,1,14
191217104,6,8,1,4,4,23
191217105,3,4,7,4,8,26
191217106,1,7,0,0,5,13
191217107,0,2,1,6,5,14
191217108,9,7,1,3,0,20
191217109,1,1,3,4,9,18
191217110,5,8,0,5,6,24
191217111,2,6,3,7,5,23
191217112,6,3,3,3,5,20
191217113,2,3,3,9,8,25
191217114,8,9,5,9,5,36
191217115,4,2,7,0,4,17
191217116,1,7,6,0,8,22
191217117,0,9,0,6,1,16
191217118,8,6,9,4,3,30
191217119,6,6,9,3,1,25
191217120,7,5,4,8,2,26
191217121,4,8,9,7,9,37
191217122,2,8,4,9,9,32
191217123,3,9,0,6,4,22
191217124,5,8,3,8,0,24
191217125,4,2,4,9,5,24
191217126,7,6,8,1,8,30
191217127,4,7,3,8,2,24
191217128,1,2,8,7,9,27
191217129,4,2,0,0,9,15
191217130,3,1,0,0,8,12
191217131,4,2,0,6,3,15
191217132,6,8,6,9,4,33
191217133,1,8,1,8,9,27
191217134,1,8,0,6,7,22
191217135,3,4,7,0,4,18
191217136,3,9,4,6,7,29
191217137,1,9,5,0,9,24
191217138,3,5,0,3,9,20
191217139,6,1,9,2,1,19
191217140,5,3,2,9,2,21
191217141,9,5,5,9,4,32
191217142,9,3,6,8,4,30
191217143,9,5,8,5,8,35
191217144,7,6,2,3,7,25
191217145,8,8,5,9,8,38
191217146,0,6,4,1,1,12
191217147,6,2,1,8,9,26
191217148,0,6,3,4,0,13
191217149,1,8,4,9,4,26
191217150,9,5,7,2,6,29
191217151,7,5,3,2,9,26
191217152,9,8,2,4,7,30
191217153,0,8,3,8,1,20
191217154,3,3,0,5,7,18
191217155,0,5,1,1,1,8
191217156,6,5,4,4,9,28
191217157,1,5,4,5,6,21
191217158,9,1,1,0,9,20
191217159,3,9,7,5,9,33
191217160,0,2,7,6,0,15
191217161,3,1,6,0,4,14
191217162,6,8,0,7,5,26
191217163,9,2,0,7,9,27
191217164,2,6,3,5,9,25
191217165,0,8,4,1,8,21
191217166,1,6,5,9,7,28
191217167,9,8,7,2,8,34
191217168,9,5,5,3,3,25
191217169,0,2,4,9,9,24
191217170,4,2,8,6,8,28
191217171,7,4,8,7,6,32
191217172,3,2,3,5,5,18
191217173,2,8,3,5,6,24
191217174,9,9,5,4,7,34
191217175,8,7,3,3,7,28
191217176,9,4,0,3,4,20
191217177,2,8,3,6,5,24
191217178,7,0,1,1,2,11
191217179,4,9,9,2,4,28
191217180,8,6,9,3,8,34
191217181,0,4,7,7,3,21
191217182,9,7,2,4,5,27
191217183,6,8,5,9,3,31
191217184,7,5,3,6,1,22
191217185,0,7,6,1,0,14
191217186,9,6,9,9,4,37
191217187,9,2,3,0,0,14
191217188,2,7,2,4,5,20
191217189,4,9,5,5,7,30
191217190,0,5,2,0,5,12
191217191,5,2,3,9,7,26
191217192,3,5,7,2,6,23
191217193,6,6,4,5,7,28
191217194,8,4,8,9,6,35
191217195,1,4,9,7,9,30
191217196,6,4,2,0,4,16
191217197,6,3,3,8,6,26
191217198,1,1,0,0,2,4
191217199,3,9,1,6,3,22
191217200,7,2,4,4,6,23
191217201,6,5,0,7,2,20
191217202,0,6,8,6,6,26
191217203,1,1,1,5,0,8
191217204,1,6,9,9,7,32
191217205,3,7,3,3,7,23
191217206,7,9,0,3,3,22
191217207,0,6,1,6,8,21
191217208,2,1,0,3,0,6
191217209,4,5,9,3,4,25
191217210,6,2,3,6,1,18
191217211,2,4,4,5,9,24
191217212,6,6,6,4,5,27
191217213,9,9,3,6,1,28
191217214,6,6,9,1,9,31
191217215,9,8,4,4,9,34
191217216,9,1,0,7,2,19
191217217,9,0,4,7,2,22
191217218,0,2,2,2,3,9
191217219,7,1,6,7,2,23
191217220,6,0,4,9,4,23
191217221,8,7,8,9,2,34
191217222,9,8,1,6,9,33
191217223,3,5,0,0,5,13
191217224,2,1,2,8,7,20
191217225,5,7,1,3,0,16
191217226,2,1,5,9,3,20
191217227,3,9,3,4,9,28
191217228,1,9,6,0,8,24
191217229,6,9,3,4,5,27
191217230,0,7,5,8,7,27
191217231,6,6,4,8,5,29
191217232,7,3,5,6,7,28
191217233,6,1,8,4,9,28
191217234,3,9,9,4,0,25
191217235,6,7,7,1,9,30
191217236,0,5,6,2,7,20
191217237,5,3,4,5,8,25
191217238,4,3,0,1,0,8
191217239,5,4,8,4,4,25
191217240,3,6,0,9,5,23
191217241,7,6,1,6,4,24
191217242,7,4,5,6,4,26
191217243,6,3,2,5,2,18
191217244,5,8,1,6,3,23
191217245,0,4,3,5,3,15
191217246,7,9,4,6,9,35
191217247,4,3,7,9,2,25
191217248,9,2,5,7,9,32
191217249,2,4,8,8,2,24
191217250,2,9,7,3,5,26
191217251,0,9,6,5,2,22
191217252,8,4,4,7,5,28
191217253,2,6,9,1,2,20
191217254,0,5,4,5,7,21
191217255,3,0,2,3,8,16
191217256,9,1,8,0,0,18
191217257,3,0,4,8,1,16
191217258,7,0,9,1,0,17
191217259,4,7,0,0,7,18
191217260,5,1,9,2,0,17
191217261,7,0,3,9,5,24
191217262,6,2,1,3,7,19
191217263,1,7,5,8,6,27
191217264,4,6,2,0,5,17
191217265,4,5,1,5,4,19
191217266,6,0,1,3,8,18
191217267,1,3,5,3,7,19
191217268,5,2,6,5,1,19
191217269,1,1,2,3,4,11
191217270,2,4,7,2,0,15
191217271,5,6,4,8,2,25
191217272,3,6,7,9,5,30
191217273,2,2,9,4,5,22
191217274,6,3,6,2,6,23
191217275,2,7,7,3,5,24
191217276,1,9,1,0,1,12
191217277,5,5,0,3,9,22
191217278,8,2,0,2,1,13
191217279,2,2,1,0,1,6
191217280,0,1,3,5,7,16
191217281,9,9,1,3,4,26
191217282,8,5,8,0,2,23
191217283,4,8,7,0,7,26
191217284,7,6,3,7,8,31
191217285,8,9,6,8,7,38
191217286,4,6,9,4,6,29
191217287,1,7,7,0,4,19
191217288,7,9,5,0,8,29
191217289,7,9,5,9,8,38
191217290,9,4,6,4,0,23
191217291,0,4,8,7,7,26
191217292,0,6,4,6,9,25
191217293,1,7,4,6,6,24
191217294,6,3,0,3,0,12
191217295,0,0,5,5,3,13
191217296,4,0,1,5,6,16
191217297,4,1,1,1,0,7
191217298,0,8,3,6,3,20
191217299,3,1,6,5,0,15
191217300,6,7,9,7,8,37
191217301,9,9,5,2,3,28
191217302,7,5,4,4,5,25
191217303,5,0,1,3,4,13
191217304,4,0,9,8,8,29
191217305,8,8,6,1,9,32
191217306,0,4,0,8,3,15
191217307,1,0,8,7,6,22
191217308,4,4,3,5,7,23
191217309,4,1,1,7,7,20
191217310,2,9,4,8,7,30
191217311,7,5,5,7,6,30
191217312,1,2,9,1,0,13
191217313,9,5,9,0,3,26
191217314,7,2,4,5,6,24
191217315,3,4,1,7,9,24
191217316,5,7,1,6,8,27
191217317,8,4,8,5,7,32
191217318,8,7,0,9,3,27
191217319,9,2,2,5,3,21
191217320,5,5,1,9,8,28
191217321,6,2,1,8,3,20
191217322,1,4,1,9,4,19
191217323,4,2,2,0,1,9
191217324,5,8,3,7,4,27
191217325,0,8,9,9,6,32
191217326,7,9,6,0,7,29
191217327,4,5,1,9,2,21
191217328,0,1,5,9,8,23
191217329,6,5,3,2,8,24
191217330,1,1,0,6,6,14
191217331,8,7,5,6,1,27
191217332,1,0,3,6,4,14
191217333,8,0,5,7,9,29
191217334,7,4,6,3,8,28
191217335,2,8,2,6,1,19
191217336,7,6,7,7,7,34
191217337,1,9,5,4,8,27
191217338,7,0,3,0,5,15
191217339,5,0,4,8,6,23
191217340,4,7,6,2,3,22
191217341,4,9,1,3,4,21
191217342,8,7,9,8,2,34
191217343,9,7,2,8,1,27
191217344,7,1,7,5,1,21
191217345,4,5,9,5,1,24
191217346,6,6,6,8,3,29
191217347,3,4,6,8,8,29
191217348,2,6,3,1,0,12
191217349,8,1,4,1,5,19
191217350,2,0,5,3,3,13
191217351,7,1,3,6,0,17
191217352,2,7,9,7,6,31
191217353,6,0,8,9,5,28
191217354,1,3,8,8,9,29
191217355,4,4,5,3,3,19
191217356,7,6,3,3,8,27
191217357,3,7,0,4,4,18
191217358,4,6,2,5,7,24
191217359,9,1,5,3,4,22
191217360,0,5,5,6,4,20
191217361,4,7,0,1,1,13
191217362,2,8,1,6,7,24
191217363,6,1,6,7,8,28
191217364,4,2,7,8,9,30
191217365,6,6,9,5,9,35
191217366,5,1,6,0,2,14
191217367,3,7,5,8,1,24
191217368,3,6,1,4,2,16
191217369,1,2,9,4,9,25
191217370,6,2,8,6,7,29
191217371,5,1,0,8,9,23
191217372,9,7,3,6,7,32
191217373,0,5,4,0,0,9
191217374,3,1,3,3,8,18
191217375,3,5,1,4,3,16
191217376,0,4,8,9,3,24
191217377,8,7,9,0,2,26
191217378,2,0,6,3,2,13
191217379,6,7,5,7,0,25
191217380,8,8,1,6,5,28
191217381,1,8,2,8,6,25
191217382,0,8,5,8,6,27
191217383,8,4,6,6,4,28
191217384,4,5,1,8,2,20
191217385,1,2,0,3,1,7
191217386,9,3,6,4,0,22
191217387,7,0,7,5,5,24
191217388,8,4,9,9,0,30
191217389,2,4,4,0,4,14
191217390,3,9,3,7,2,24
191217391,5,5,7,5,8,30
191217392,5,3,3,5,0,16
191217393,8,5,2,7,9,31
191217394,5,8,3,7,7,30
191217395,3,9,5,2,5,24
191217396,1,8,8,7,5,29
191217397,7,1,0,8,9,25
191217398,6,5,4,6,1,22
191217399,2,8,9,4,5,28
191217400,0,9,7,8,7,31
191217401,4,5,0,4,7,20
191217402,8,4,9,2,2,25
191217403,8,7,4,7,2,28
191217404,7,2,2,0,9,20
191217405,6,6,5,9,4,30
191217406,1,7,4,6,3,21
191217407,7,3,2,4,3,19
191217408,8,9,6,0,7,30
191217409,9,8,8,9,6,40
191217410,0,4,5,1,9,19
191217411,9,2,1,5,2,19
191217412,1,3,9,0,1,14
191217413,3,2,2,0,1,8
191217414,6,9,2,9,7,33
191217415,4,1,1,6,3,15
191217416,0,2,6,1,9,18
191217417,8,4,8,9,2,31
191217418,2,4,8,2,6,22
191217419,8,8,7,5,6,34
191217420,3,7,0,3,4,17
191217421,1,2,7,4,3,17
191217422,2,5,6,5,3,21
191217423,6,4,6,2,5,23
191217424,6,5,9,9,3,32
191217425,0,3,8,7,4,22
191217426,7,3,8,0,9,27
191217427,8,6,5,8,2,29
191217428,3,3,5,3,8,22
191217429,1,1,9,8,2,21
191217430,5,3,1,6,3,18
191217431,9,9,6,4,5,33
191217432,1,5,1,7,6,20
191217433,2,8,9,0,4,23
191217434,7,5,9,8,8,37
191217435,1,9,0,9,8,27
191217436,5,0,5,5,0,15
191217437,5,2,6,0,5,18
191217438,9,9,9,8,5,40
191217439,7,3,0,2,0,12
191217440,4,5,6,1,9,25
191217441,3,6,4,6,4,23
191217442,7,0,8,8,1,24
191217443,2,9,3,5,0,19
191217444,4,3,8,6,2,23
191217445,6,4,3,7,4,24
191217446,5,5,9,1,5,25
191217447,4,3,1,2,3,13
191217448,6,1,7,9,1,24
191217449,6,4,1,6,3,20
191217450,7,2,2,7,3,21
191217451,5,9,2,3,2,21
191217452,3,9,9,4,2,27
191217453,5,0,3,1,5,14
191217454,5,7,5,6,3,26
191217455,0,9,8,0,9,26
191217456,4,4,8,1,6,23
191217457,2,8,2,7,4,23
191217458,9,8,4,9,7,37
191217459,2,7,9,5,5,28
191217460,6,6,0,7,0,19
191217461,9,8,8,5,7,37
191217462,0,1,2,0,5,8
191217463,2,5,9,0,1,17
191217464,7,8,4,2,3,24
191217465,3,9,5,2,3,22
191217466,2,4,7,1,1,15
191217467,1,4,0,2,2,9
191217468,3,8,3,7,8,29
191217469,1,2,7,7,6,23
191217470,2,7,8,1,7,25
191217471,4,9,2,3,0,18
191217472,7,9,1,6,6,29
191217473,0,7,5,9,0,21
191217474,5,5,8,6,0,24
191217475,7,8,6,1,9,31
191217476,4,8,2,5,5,24
191217477,0,9,5,6,3,23
191217478,5,2,8,7,2,24
191217479,5,7,4,7,8,31
191217480,4,4,2,5,7,22
191217481,7,0,3,3,2,15
191217482,0,4,9,5,7,25
191217483,8,9,2,5,6,30
191217484,4,9,6,9,9,37
191217485,6,4,8,4,5,27
191217486,6,5,8,5,5,29
191217487,1,6,1,2,4,14
191217488,9,9,8,2,3,31
191217489,1,9,0,6,7,23
191217490,4,5,0,6,2,17
191217491,5,6,7,2,7,27
191217492,4,2,2,4,5,17
191217493,9,0,7,8,3,27
191217494,2,8,4,0,4,18
191217495,3,8,6,7,8,32
191217496,3,1,8,6,8,26
191217497,4,1,3,2,3,13
191217498,6,8,4,7,8,33
191217499,8,1,0,3,9,21
191217500,9,7,6,3,2,27
191217501,7,5,3,7,0,22
191217502,7,3,3,2,8,23
191217503,3,3,1,2,5,14
191217504,6,3,0,7,4,20
191217505,4,4,2,1,8,19
191217506,1,3,7,7,0,18
191217507,1,8,1,4,8,22
191217508,6,8,1,2,7,24
191217509,1,5,7,2,5,20
191217510,3,8,2,5,5,23
191217511,7,1,1,5,9,23
191217512,0,3,3,7,6,19
191217513,4,8,7,9,7,35
191217514,6,8,1,6,3,24
191217515,3,6,9,4,5,27
191217516,5,9,8,8,7,37
191217517,8,4,4,6,3,25
191217518,0,2,0,5,5,12
191217519,3,7,9,9,6,34
191217520,8,4,3,9,2,26
191217521,7,0,6,2,8,23
191217522,6,5,3,2,0,16
191217523,5,9,5,0,7,26
191217524,9,3,2,9,9,32
191217525,8,6,1,6,0,21
191217526,6,7,4,7,4,28
191217527,2,5,6,8,5,26
191217528,2,5,7,1,6,21
191217529,3,4,5,2,6,20
191217530,6,4,1,3,0,14
191217531,5,5,1,8,8,27
191217532,5,5,3,8,0,21
191217533,4,8,6,0,7,25
191217534,8,4,2,5,3,22
191217535,9,4,9,8,5,35
191217536,1,1,2,3,7,14
191217537,2,4,2,6,6,20
191217538,9,9,6,9,0,33
191217539,4,1,1,4,5,15
191217540,4,6,1,4,1,16
191217541,0,1,0,5,7,13
191217542,8,9,0,7,5,29
191217543,2,8,9,1,6,26
191217544,5,4,6,5,1,21
191217545,1,4,7,6,3,21
191217546,3,3,9,8,7,30
191217547,4,4,1,3,8,20
191217548,9,9,6,8,7,39
191217549,4,1,5,7,8,25
191217550,5,5,7,4,3,24
191217551,9,8,7,4,8,36
191217552,2,2,0,5,3,12
191217553,5,1,8,5,0,19
191217554,5,0,4,9,8,26
191217555,5,1,0,4,4,14
191217556,7,5,5,5,4,26
191217557,5,3,0,3,9,20
191217558,0,7,2,1,9,19
191217559,7,3,9,3,9,31
191217560,4,8,6,8,9,35
191217561,3,3,5,1,2,14
191217562,8,5,9,1,6,29
191217563,3,7,4,8,9,31
191217564,8,6,2,8,8,32
191217565,5,2,3,4,8,22
191217566,5,3,2,5,7,22
191217567,9,9,3,2,8,31
191217568,4,1,5,2,8,20
191217569,0,2,1,1,7,11
191217570,0,5,4,0,5,14
191217571,5,1,1,5,5,17
191217572,5,8,2,9,7,31
191217573,3,3,2,0,8,16
191217574,2,0,4,1,1,8
191217575,5,6,2,0,5,18
191217576,8,7,5,7,7,34
191217577,0,3,3,7,8,21
191217578,3,5,6,3,3,20
191217579,0,3,2,7,1,13
191217580,9,9,4,3,5,30
191217581,4,5,4,6,5,24
191217582,5,5,6,4,4,24
191217583,3,6,3,4,6,22
191217584,0,9,2,5,5,21
191217585,9,4,8,3,4,28
191217586,1,4,9,0,2,16
191217587,9,2,5,7,0,23
191217588,3,7,1,4,1,16
191217589,4,1,5,0,1,11
191217590,9,9,7,2,1,28
191217591,3,2,8,7,0,20
191217592,0,3,6,5,9,23
191217593,2,0,5,2,6,15
191217594,5,1,3,7,1,17
191217595,6,2,2,1,7,18
191217596,2,6,0,1,9,18
191217597,6,6,3,2,4,21
191217598,7,1,8,3,7,26
191217599,4,3,5,2,6,20
191217600,1,1,7,3,5,17
191217601,9,1,9,7,0,26
191217602,5,0,1,5,2,13
191217603,9,7,7,1,5,29
191217604,5,4,6,0,6,21
191217605,7,6,2,8,1,24
191217606,1,8,7,8,7,31
191217607,3,5,4,1,3,16
191217608,5,6,5,5,9,30
191217609,7,6,2,6,9,30
191217610,0,4,5,8,4,21
191217611,2,5,7,6,1,21
191217612,4,8,0,4,4,20
191217613,4,7,5,5,1,22
191217614,9,2,9,0,4,24
191217615,1,4,6,5,8,24
191217616,8,8,2,8,3,29
191217617,7,3,6,9,1,26
191217618,5,8,4,4,7,28
191217619,5,7,0,0,6,18
191217620,9,3,7,0,9,28
191217621,5,8,4,4,5,26
191217622,4,9,8,0,0,21
191217623,7,3,8,5,2,25
191217624,7,1,2,4,2,16
191217625,5,3,0,8,1,17
191217626,5,6,2,0,7,20
191217627,7,5,3,9,0,24
191217628,1,2,8,0,1,12
191217629,5,9,4,4,7,29
191217630,2,2,0,3,1,8
191217631,1,4,3,2,9,19
191217632,9,5,3,2,5,24
191217633,0,3,3,8,2,16
191217634,6,2,5,7,8,28
191217635,1,5,5,9,7,27
191217636,2,9,8,7,0,26
191217637,1,1,9,5,2,18
191217638,5,0,3,1,8,17
191217639,8,3,9,1,2,23
191217640,8,2,8,3,4,25
191217641,1,8,2,5,4,20
191217642,5,5,8,1,3,22
191217643,5,1,6,8,6,26
191217644,2,8,6,8,9,33
191217645,2,3,0,6,4,15
191217646,1,7,6,3,1,18
191217647,2,4,2,2,9,19
191217648,8,2,4,8,8,30
191217649,8,1,3,3,4,19
191217650,1,8,7,4,8,28
191217651,9,5,1,8,7,30
191217652,3,3,0,0,8,14
191217653,6,8,7,6,5,32
191217654,2,5,2,7,4,20
191217655,8,0,1,5,6,20
191217656,6,0,1,0,1,8
191217657,9,0,9,6,8,32
191217658,3,5,8,0,1,17
191217659,9,3,5,6,0,23
191217660,1,4,4,1,2,12
191217661,6,3,3,0,8,20
191217662,2,7,9,8,0,26
191217663,8,6,2,2,8,26
191217664,5,8,5,4,4,26
191217665,9,6,3,5,8,31
191217666,8,6,6,8,2,30
191217667,7,4,5,2,0,18
191217668,6,8,0,7,6,27
191217669,6,1,9,6,6,28
191217670,2,5,9,2,0,18
191217671,2,3,1,1,7,14
191217672,4,1,1,4,6,16
191217673,2,5,3,0,8,18
191217674,3,6,7,3,7,26
191217675,0,7,5,8,4,24
191217676,2,2,6,8,6,24
191217677,3,0,6,7,2,18
191217678,9,4,5,3,5,26
191217679,2,3,0,4,6,15
191217680,4,1,3,2,4,14
191217681,9,7,5,5,8,34
191217682,1,6,7,9,7,30
191217683,2,6,5,9,9,31
191217684,6,6,6,6,5,29
191217685,0,1,8,0,4,13
191217686,9,6,5,1,8,29
191217687,8,5,1,2,2,18
191217688,6,7,6,5,7,31
191217689,5,8,0,9,0,22
191217690,0,0,2,7,9,18
191217691,2,6,7,6,4,25
191217692,8,1,3,9,2,23
191217693,2,8,6,0,7,23
191217694,1,0,6,9,3,19
191217695,3,7,3,8,0,21
191217696,1,7,7,5,0,20
191217697,5,5,3,2,3,18
191217698,8,9,9,0,4,30
191217699,8,4,6,3,9,30
191217700,8,7,1,2,4,22
191217701,5,5,6,6,9,31
191217702,6,6,6,2,3,23
191217703,4,0,5,6,5,20
191217704,5,4,1,1,7,18
191217705,0,4,3,5,4,16
191217706,9,6,8,1,6,30
191217707,8,8,1,1,9,27
191217708,0,4,9,9,1,23
191217709,5,4,1,5,1,16
191217710,3,7,9,8,7,34
191217711,7,5,8,1,6,27
191217712,6,2,2,8,3,21
191217713,1,6,0,5,3,15
191217714,7,9,8,2,2,28
191217715,6,5,8,4,4,27
191217716,9,7,8,3,9,36
191217717,3,0,2,0,5,10
191217718,5,6,5,0,8,24
191217719,4,3,6,4,2,19
191217720,4,5,9,9,6,33
191217721,1,7,3,1,5,17
191217722,2,1,4,7,9,23
191217723,1,8,1,3,0,13
191217724,6,7,1,5,0,19
191217725,3,0,0,4,0,7
191217726,6,1,0,5,2,14
191217727,6,0,3,4,5,18
191217728,6,4,0,9,5,24
191217729,6,1,1,2,4,14
191217730,3,2,1,9,5,20
191217731,1,6,0,2,4,13
191217732,2,9,2,6,3,22
191217733,5,2,3,2,7,19
191217734,4,0,1,5,1,11
191217735,6,3,4,4,6,23
191217736,5,2,2,2,9,20
191217737,2,0,3,2,1,8
191217738,4,0,0,3,0,7
191217739,2,1,3,1,7,14
191217740,1,9,2,7,8,27
191217741,5,2,0,7,4,18
191217742,0,2,3,4,6,15
191217743,0,8,4,4,9,25
191217744,2,0,5,3,7,17
191217745,7,5,7,6,8,33
191217746,5,6,1,4,4,20
191217747,6,6,2,4,2,20
191217748,3,5,0,3,2,13
191217749,4,6,6,2,6,24
191217750,0,4,8,0,7,19
191217751,3,2,3,3,1,12
191217752,9,8,0,9,7,33
191217753,4,9,6,1,7,27
191217754,4,2,2,1,8,17
191217755,0,0,9,2,4,15
191217756,6,7,8,2,0,23
191217757,1,5,9,8,5,28
191217758,0,0,9,7,9,25
191217759,1,3,9,2,6,21
191217760,7,3,6,8,6,30
191217761,2,0,7,0,9,18
191217762,9,2,0,6,4,21
191217763,8,4,0,4,3,19
191217764,8,7,4,5,3,27
191217765,5,7,9,9,6,36
191217766,2,0,1,9,0,12
191217767,9,4,9,0,0,22
191217768,6,9,4,6,2,27
191217769,1,7,5,2,6,21
191217770,8,4,6,7,1,26
191217771,8,3,2,9,9,31
191217772,4,4,1,0,6,15
191217773,0,2,0,5,3,10
191217774,9,4,7,2,2,24
191217775,1,2,9,5,6,23
191217776,2,7,5,5,8,27
191217777,2,1,6,9,1,19
191217778,1,3,6,4,1,15
191217779,1,7,9,6,7,30
191217780,9,9,8,7,6,39
191217781,2,5,5,8,3,23
191217782,4,0,1,7,9,21
191217783,2,9,9,2,9,31
191217784,7,7,7,5,2,28
191217785,0,3,1,6,7,17
191217786,1,2,6,1,3,13
191217787,0,3,0,5,1,9
191217788,5,0,8,6,3,22
191217789,5,1,9,3,9,27
191217790,7,8,0,9,9,33
191217791,8,7,6,7,3,31
191217792,6,6,7,3,0,22
191217793,3,8,9,7,7,34
191217794,3,0,0,2,3,8
191217795,6,5,6,3,6,26
191217796,0,5,6,7,3,21
191217797,6,7,4,6,2,25
191217798,1,5,7,7,2,22
191217799,1,5,2,2,2,12
191217800,2,2,5,8,8,25
191217801,6,1,5,4,8,24
191217802,5,9,8,0,5,27
191217803,5,1,7,1,7,21
191217804,5,2,5,2,2,16
191217805,6,6,1,9,6,28
191217806,5,4,1,3,5,18
191217807,4,1,9,7,7,28
191217808,5,9,4,7,6,31
191217809,0,3,1,9,0,13
191217810,7,4,9,6,3,29
191217811,7,3,0,1,7,18
191217812,4,4,7,1,8,24
191217813,0,0,8,8,0,16
191217814,6,7,8,3,6,30
191217815,1,2,0,8,6,17
191217816,9,1,8,5,3,26
191217817,0,6,9,6,8,29
191217818,0,4,7,2,0,13
191217819,5,4,6,3,4,22
191217820,6,9,4,5,8,32
191217821,5,6,5,4,7,27
191217822,0,9,8,6,0,23
191217823,7,5,4,0,0,16
191217824,4,8,6,7,4,29
191217825,1,7,7,8,0,23
191217826,2,2,9,0,5,18
191217827,6,6,3,7,0,22
191217828,7,2,9,4,4,26
191217829,8,1,5,4,1,19
191217830,5,8,1,5,6,25
191217831,0,0,6,1,3,10
191217832,8,4,8,4,4,28
191217833,5,7,2,6,0,20
191217834,9,6,1,0,9,25
191217835,4,5,0,0,8,17
191217836,5,2,9,7,4,27
191217837,0,0,5,9,8,22
191217838,7,5,7,5,9,33
191217839,7,7,7,4,1,26
191217840,3,2,6,1,9,21
191217841,9,3,7,9,8,36
191217842,8,8,4,4,7,31
191217843,5,2,7,8,9,31
191217844,0,2,8,8,3,21
191217845,7,2,9,6,4,28
191217846,0,6,6,1,1,14
191217847,8,7,6,2,2,25
191217848,6,8,5,9,0,28
191217849,9,9,3,9,5,35
191217850,1,2,8,2,8,21
191217851,8,4,7,6,9,34
191217852,4,8,8,7,7,34
191217853,4,4,0,4,0,12
191217854,7,4,4,5,2,22
191217855,8,0,1,4,2,15
191217856,1,8,8,2,9,28
191217857,5,8,2,5,9,29
191217858,9,2,0,8,2,21
191217859,9,8,7,4,0,28
191217860,0,2,3,0,7,12
191217861,4,1,8,4,3,20
191217862,2,3,4,4,8,21
191217863,7,9,3,8,2,29
191217864,0,2,0,9,4,15
191217865,8,4,3,1,3,19
191217866,9,6,4,6,0,25
191217867,2,1,8,6,4,21
191217868,3,7,3,6,1,20
191217869,6,1,0,4,3,14
191217870,1,4,6,7,4,22
191217871,4,6,7,6,9,32
191217872,3,0,3,2,9,17
191217873,3,4,7,8,8,30
191217874,5,7,1,0,7,20
191217875,7,3,6,9,4,29
191217876,0,1,5,5,1,12
191217877,9,7,6,5,1,28
191217878,8,2,4,8,3,25
191217879,6,7,3,7,1,24
191217880,3,5,2,8,8,26
191217881,1,5,1,7,0,14
191217882,0,5,7,0,0,12
191217883,4,9,3,4,3,23
191217884,0,8,0,0,8,16
191217885,3,1,4,7,8,23
191217886,6,3,4,7,5,25
191217887,5,0,9,7,9,30
191217888,4,5,7,7,9,32
191217889,2,8,0,6,8,24
191217890,7,7,3,7,0,24
191217891,3,3,9,5,3,23
191217892,7,9,2,7,3,28
191217893,2,6,8,6,2,24
191217894,8,7,7,6,9,37
191217895,7,3,3,9,4,26
191217896,3,9,5,6,9,32
191217897,2,9,1,1,2,15
191217898,4,5,5,4,1,19
191217899,3,6,8,6,1,24
191217900,2,0,6,5,8,21
191217901,3,1,2,6,6,18
191217902,7,8,0,5,8,28
191217903,1,2,7,3,6,19
191217904,0,5,0,9,8,22
191217905,1,5,6,5,7,24
191217906,9,8,3,0,2,22
191217907,2,0,5,7,4,18
191217908,5,0,3,9,5,22
191217909,1,5,5,4,6,21
191217910,1,9,0,8,3,21
191217911,8,4,9,2,1,24
191217912,7,7,2,9,1,26
191217913,3,3,6,4,5,21
191217914,9,2,5,3,4,23
191217915,1,0,4,3,6,14
191217916,6,6,5,8,2,27
191217917,4,6,2,7,6,25
191217918,7,8,6,7,2,30
191217919,8,7,5,7,9,36
191217920,1,4,4,9,4,22
191217921,9,0,1,8,2,20
191217922,4,5,7,7,1,24
191217923,8,7,7,6,1,29
191217924,9,1,5,2,4,21
191217925,8,5,7,8,5,33
191217926,4,8,9,3,3,27
191217927,3,9,9,8,9,38
191217928,1,0,6,2,4,13
191217929,8,8,9,0,2,27
191217930,0,1,2,4,8,15
191217931,7,5,2,5,2,21
191217932,5,0,5,5,5,20
191217933,3,2,3,6,6,20
191217934,1,8,5,3,7,24
191217935,0,9,7,2,5,23
191217936,6,6,8,7,5,32
191217937,5,7,4,4,1,21
191217938,3,2,8,0,0,13
191217939,8,5,5,5,1,24
191217940,4,8,9,9,8,38
191217941,0,5,6,7,6,24
191217942,4,8,3,6,0,21
191217943,0,1,9,7,6,23
191217944,3,8,4,4,1,20
191217945,3,0,4,5,0,12
191217946,4,6,2,6,3,21
191217947,2,6,5,9,5,27
191217948,0,5,1,9,7,22
191217949,5,2,5,1,4,17
191217950,3,7,0,9,6,25
191217951,8,8,4,1,5,26
191217952,8,0,7,4,9,28
191217953,6,5,6,0,8,25
191217954,3,0,4,2,3,12
191217955,7,5,0,2,1,15
191217956,3,5,5,8,7,28
191217957,5,9,6,4,8,32
191217958,4,4,9,6,8,31
191217959,9,4,8,1,4,26
191217960,0,3,2,5,1,11
191217961,9,6,7,9,8,39
191217962,5,8,4,5,3,25
191217963,0,8,1,7,5,21
191217964,5,1,0,0,7,13
191217965,9,3,8,7,2,29
191217966,8,7,9,2,6,32
191217967,1,5,6,8,1,21
191217968,3,5,6,1,8,23
191217969,9,7,3,0,8,27
191217970,8,3,5,9,0,25
191217971,2,1,6,4,7,20
191217972,1,5,6,3,2,17
191217973,2,2,0,6,5,15
191217974,1,6,4,1,4,16
191217975,6,4,2,2,3,17
191217976,6,7,7,0,6,26
191217977,0,0,2,7,7,16
191217978,4,4,4,2,2,16
191217979,6,4,3,2,7,22
191217980,7,7,9,9,2,34
191217981,8,7,1,8,9,33
191217982,1,3,2,0,1,7
191217983,8,4,9,8,0,29
191217984,6,3,6,2,8,25
191217985,7,1,0,6,0,14
191217986,0,9,5,2,2,18
191217987,0,0,1,0,9,10
191217988,7,8,8,8,0,31
191217989,9,5,8,8,1,31
191217990,8,6,6,3,0,23
191217991,2,6,3,7,0,18
191217992,8,8,4,8,4,32
191217993,7,4,2,4,6,23
191217994,7,8,1,2,6,24
191217995,6,0,2,3,0,11
191217996,5,6,0,9,0,20
191217997,5,7,3,5,8,28
191217998,3,8,2,2,1,16
191217999,6,0,5,2,3,16
1912171000,6,6,7,8,1,28
1912171001,5,1,7,0,4,17
1912171002,5,0,1,1,9,16
1912171003,9,4,3,4,1,21
1912171004,2,6,6,9,2,25
1912171005,1,8,2,7,9,27
1912171006,7,2,9,0,7,25
1912171007,8,3,7,2,6,26
1912171008,9,1,0,7,7,24
1912171009,4,4,4,2,0,14
1912171010,8,6,8,4,9,35
1912171011,2,2,3,0,4,11
1912171012,7,7,6,9,1,30
1912171013,5,0,0,3,4,12
1912171014,6,1,4,1,2,14
1912171015,4,3,9,5,6,27
1912171016,4,0,6,1,9,20
1912171017,7,9,4,4,4,28
1912171018,0,7,5,7,6,25
1912171019,9,3,6,2,5,25
1912171020,0,8,4,9,5,26
1912171021,9,0,5,0,5,19
1912171022,2,6,7,7,2,24
1912171023,1,1,3,8,5,18
1912171024,2,1,1,6,4,14
1912171025,1,8,4,8,3,24
1912171026,4,7,1,4,8,24
1912171027,7,0,3,7,6,23
1912171028,4,1,5,1,3,14
1912171029,2,7,6,7,5,27
1912171030,2,9,2,5,0,18
1912171031,4,1,7,2,3,17
1912171032,9,7,0,7,7,30
1912171033,0,8,4,0,9,21
1912171034,7,2,9,8,4,30
1912171035,7,1,3,6,4,21
1912171036,3,9,5,5,0,22
1912171037,1,1,7,9,6,24
1912171038,6,9,2,8,4,29
1912171039,2,5,7,7,6,27
1912171040,5,4,8,0,8,25
1912171041,1,0,1,8,6,16
1912171042,5,2,6,6,2,21
1912171043,7,1,1,8,5,22
1912171044,4,8,8,3,0,23
1912171045,3,6,5,0,3,17
1912171046,9,1,4,9,1,24
1912171047,9,6,2,0,6,23
1912171048,6,7,0,7,0,20
1912171049,6,8,5,3,1,23
1912171050,7,9,2,8,8,34
1912171051,4,2,2,9,0,17
1912171052,5,7,5,3,3,23
1912171053,9,5,7,3,0,24
1912171054,8,7,2,7,3,27
1912171055,1,5,6,4,7,23
1912171056,9,7,6,9,4,35
1912171057,0,1,4,5,5,15
1912171058,2,8,7,3,8,28
1912171059,7,5,1,7,7,27
1912171060,2,9,0,9,7,27
1912171061,1,5,9,0,1,16
1912171062,0,0,1,1,3,5
1912171063,7,7,3,1,9,27
1912171064,5,7,7,7,4,30
1912171065,5,8,8,3,4,28
1912171066,3,3,3,0,0,9
1912171067,6,3,8,5,4,26
1912171068,7,2,5,3,6,23
1912171069,2,8,6,1,7,24
1912171070,0,3,3,5,7,18
1912171071,2,6,4,8,5,25
1912171072,5,2,8,7,3,25
1912171073,8,9,0,8,7,32
1912171074,8,3,6,5,5,27
1912171075,2,7,7,9,1,26
1912171076,0,5,8,4,4,21
1912171077,6,2,8,1,4,21
1912171078,8,6,1,6,5,26
1912171079,4,3,0,7,2,16
1912171080,2,8,0,9,0,19
1912171081,8,3,7,1,0,19
1912171082,0,4,6,8,3,21
1912171083,0,6,6,6,6,24
1912171084,4,2,8,4,4,22
1912171085,0,9,3,2,4,18
1912171086,4,6,5,4,5,24
1912171087,8,4,9,7,9,37
1912171088,5,4,8,5,5,27
1912171089,9,7,4,7,2,29
1912171090,4,9,7,5,5,30
1912171091,5,5,5,5,9,29
1912171092,2,0,2,6,1,11
1912171093,5,1,1,1,1,9
1912171094,7,0,1,6,2,16
1912171095,8,9,9,4,1,31
1912171096,4,2,5,9,3,23
1912171097,2,2,4,2,3,13
1912171098,9,0,8,7,2,26
1912171099,9,5,7,3,9,33
1912171100,0,7,5,7,4,23
1912171101,0,8,6,0,0,14
1912171102,8,6,0,0,4,18
1912171103,8,4,4,4,1,21
1912171104,9,2,3,3,3,20
1912171105,9,0,6,1,6,22
191218001,5,6,7,0,4,22
191218002,3,8,3,7,4,25
191218003,5,8,6,0,9,28
191218004,5,6,1,8,7,27
191218005,0,5,5,5,6,21
191218006,0,8,5,2,2,17
191218007,0,0,7,1,6,14
191218008,6,3,6,2,4,21
191218009,6,1,9,8,2,26
191218010,1,5,3,7,1,17
191218011,0,2,1,4,1,8
191218012,4,7,7,7,8,33
191218013,6,7,9,9,6,37
191218014,2,6,9,0,8,25
191218015,2,9,5,1,9,26
191218016,8,9,7,9,0,33
191218017,9,3,2,8,6,28
191218018,4,6,7,7,9,33
191218019,4,1,4,7,1,17
191218020,3,6,7,0,0,16
191218021,3,6,4,0,1,14
191218022,5,8,2,0,6,21
191218023,4,7,0,5,4,20
191218024,9,4,2,4,1,20
191218025,3,1,5,4,6,19
191218026,0,3,8,6,7,24
191218027,0,4,1,4,0,9
191218028,2,8,0,0,1,11
191218029,5,9,0,2,8,24
191218030,3,8,1,7,2,21
191218031,5,9,4,6,1,25
191218032,3,2,9,9,6,29
191218033,0,9,3,1,7,20
191218034,7,3,3,3,7,23
191218035,5,9,7,4,4,29
191218036,3,7,2,0,5,17
191218037,8,8,2,5,2,25
191218038,4,8,7,2,5,26
191218039,0,6,2,0,8,16
191218040,0,0,9,2,1,12
191218041,9,5,8,9,3,34
191218042,2,4,6,5,5,22
191218043,1,9,3,0,3,16
191218044,5,8,1,7,6,27
191218045,2,8,2,5,7,24
191218046,2,5,9,3,1,20
191218047,1,0,6,7,4,18
191218048,4,5,2,2,5,18
191218049,9,8,7,4,4,32
191218050,9,2,5,0,3,19
191218051,5,9,4,5,0,23
191218052,8,8,4,0,8,28
191218053,7,6,3,2,1,19
191218054,2,3,3,6,0,14
191218055,8,5,4,5,2,24
191218056,0,7,9,8,8,32
191218057,1,7,6,8,9,31
191218058,3,2,8,5,3,21
191218059,1,2,8,5,8,24
191218060,5,3,0,7,7,22
191218061,3,2,9,8,4,26
191218062,1,7,5,1,8,22
191218063,8,8,1,0,6,23
191218064,9,2,4,6,9,30
191218065,6,7,4,1,3,21
191218066,8,5,6,4,6,29
191218067,2,2,8,0,9,21
191218068,7,7,1,7,1,23
191218069,6,3,9,1,8,27
191218070,4,0,4,5,9,22
191218071,4,1,3,3,1,12
191218072,0,2,1,3,5,11
191218073,6,3,5,9,2,25
191218074,1,8,0,8,5,22
191218075,8,6,8,5,2,29
191218076,2,3,2,2,7,16
191218077,3,5,5,5,1,19
191218078,3,7,0,5,1,16
191218079,0,1,3,6,5,15
191218080,7,6,3,3,7,26
191218081,2,2,6,1,4,15
191218082,6,5,8,6,2,27
191218083,4,9,6,0,4,23
191218084,9,1,1,7,0,18
191218085,6,1,8,7,9,31
191218086,4,4,0,1,0,9
191218087,1,5,2,9,9,26
191218088,5,7,9,0,4,25
191218089,9,5,2,3,1,20
191218090,5,9,9,0,1,24
191218091,9,8,1,7,1,26
191218092,9,7,3,7,5,31
191218093,9,2,5,5,8,29
191218094,8,1,9,3,6,27
191218095,8,4,4,3,3,22
191218096,6,7,9,4,7,33
191218097,3,2,2,9,6,22
191218098,0,5,2,1,6,14
191218099,1,1,0,9,0,11
191218100,3,4,4,5,7,23
191218101,1,3,6,2,3,15
191218102,9,6,5,2,9,31
191218103,4,1,2,8,6,21
191218104,5,2,9,3,9,28
191218105,7,5,6,7,4,29
191218106,7,6,0,8,8,29
191218107,2,7,5,7,8,29
191218108,4,8,1,3,0,16
191218109,3,7,2,2,6,20
191218110,2,0,2,7,9,20
191218111,3,9,8,0,0,20
191218112,9,5,4,5,8,31
191218113,2,1,1,2,1,7
191218114,0,5,9,0,1,15
191218115,9,0,2,4,0,15
191218116,8,2,7,9,0,26
191218117,8,5,3,9,1,26
191218118,6,8,1,8,1,24
191218119,1,9,6,4,5,25
191218120,8,7,4,0,3,22
191218121,7,6,3,3,4,23
191218122,3,8,7,7,5,30
191218123,8,2,8,4,7,29
191218124,3,1,2,8,3,17
191218125,3,9,2,4,5,23
191218126,7,1,3,3,6,20
191218127,2,8,1,2,3,16
191218128,4,0,4,8,2,18
191218129,6,0,0,7,9,22
191218130,1,9,6,8,0,24
191218131,6,8,8,2,7,31
191218132,6,0,2,8,1,17
191218133,9,2,6,8,2,27
191218134,3,7,4,1,0,15
191218135,6,7,1,3,2,19
191218136,8,1,4,2,7,22
191218137,8,5,1,6,4,24
191218138,6,6,9,6,8,35
191218139,4,2,8,3,8,25
191218140,0,4,6,5,4,19
191218141,7,5,2,7,2,23
191218142,7,6,9,5,7,34
191218143,8,7,4,2,0,21
191218144,2,9,2,0,5,18
191218145,1,3,7,4,3,18
191218146,8,2,5,1,0,16
191218147,2,4,8,7,1,22
191218148,9,4,6,7,9,35
191218149,5,5,8,0,5,23
191218150,5,3,7,0,9,24
191218151,6,1,1,4,5,17
191218152,1,9,4,2,8,24
191218153,3,3,4,9,4,23
191218154,7,2,6,3,9,27
191218155,9,6,0,2,3,20
191218156,5,9,1,1,2,18
191218157,1,8,6,5,2,22
191218158,8,9,4,6,4,31
191218159,0,6,1,3,0,10
191218160,8,0,4,7,4,23
191218161,2,8,2,8,9,29
191218162,1,3,8,4,5,21
191218163,2,1,2,9,4,18
191218164,3,1,5,4,4,17
191218165,8,5,3,3,2,21
191218166,9,1,2,1,1,14
191218167,7,1,5,3,6,22
191218168,4,5,2,5,6,22
191218169,4,9,9,8,6,36
191218170,7,3,5,1,0,16
191218171,6,6,9,8,4,33
191218172,4,3,2,7,3,19
191218173,9,6,7,3,1,26
191218174,6,2,0,3,4,15
191218175,6,0,2,9,0,17
191218176,8,0,5,8,4,25
191218177,8,4,0,6,8,26
191218178,9,6,5,5,3,28
191218179,8,5,8,2,9,32
191218180,3,5,3,9,2,22
191218181,0,0,7,5,6,18
191218182,4,9,5,7,9,34
191218183,5,4,2,4,8,23
191218184,8,0,6,9,1,24
191218185,0,7,1,3,8,19
191218186,2,2,3,1,6,14
191218187,9,9,1,8,6,33
191218188,3,0,3,9,9,24
191218189,2,7,8,2,6,25
191218190,7,0,9,8,9,33
191218191,8,3,3,7,0,21
191218192,3,0,0,8,3,14
191218193,1,6,4,5,8,24
191218194,2,6,1,4,3,16
191218195,5,4,6,1,3,19
191218196,4,4,9,9,4,30
191218197,4,0,0,5,2,11
191218198,4,4,4,9,9,30
191218199,7,1,5,1,4,18
191218200,8,5,4,5,3,25
191218201,2,6,8,3,6,25
191218202,7,0,7,3,3,20
191218203,8,0,9,8,5,30
191218204,2,7,2,3,7,21
191218205,7,0,3,8,7,25
191218206,7,6,6,9,5,33
191218207,9,6,0,1,2,18
191218208,0,2,0,5,6,13
191218209,8,5,5,7,2,27
191218210,1,8,7,5,0,21
191218211,1,3,3,9,5,21
191218212,8,3,0,1,7,19
191218213,7,5,5,9,7,33
191218214,6,7,3,1,4,21
191218215,8,6,1,7,6,28
191218216,2,4,8,9,5,28
191218217,7,4,4,2,5,22
191218218,4,3,1,9,1,18
191218219,3,0,0,3,5,11
191218220,0,7,5,7,7,26
191218221,2,1,6,1,2,12
191218222,3,2,4,4,5,18
191218223,1,0,1,9,4,15
191218224,2,3,1,1,8,15
191218225,2,2,8,0,8,20
191218226,9,5,3,6,4,27
191218227,0,7,0,6,9,22
191218228,3,9,8,2,6,28
191218229,1,1,6,0,0,8
191218230,6,7,3,6,5,27
191218231,9,6,1,0,4,20
191218232,6,3,4,4,0,17
191218233,1,4,2,1,6,14
191218234,6,9,7,1,1,24
191218235,0,9,7,8,0,24
191218236,9,6,7,0,4,26
191218237,9,8,2,8,9,36
191218238,0,6,6,6,1,19
191218239,9,5,8,2,0,24
191218240,9,0,3,6,3,21
191218241,5,4,5,5,4,23
191218242,2,7,2,8,2,21
191218243,2,0,5,7,2,16
191218244,5,6,4,5,4,24
191218245,7,6,3,0,2,18
191218246,9,3,9,6,7,34
191218247,7,1,5,7,3,23
191218248,5,4,7,8,2,26
191218249,7,6,7,6,8,34
191218250,7,0,3,8,3,21
191218251,3,1,9,7,8,28
191218252,7,6,4,5,8,30
191218253,2,0,6,0,6,14
191218254,3,9,4,7,4,27
191218255,9,8,3,8,1,29
191218256,5,8,7,8,9,37
191218257,9,0,4,9,0,22
191218258,9,3,8,8,7,35
191218259,3,0,0,0,6,9
191218260,7,5,1,3,2,18
191218261,2,2,4,0,1,9
191218262,4,9,1,0,9,23
191218263,4,9,2,8,1,24
191218264,8,3,2,5,1,19
191218265,0,8,6,2,4,20
191218266,5,5,5,2,5,22
191218267,5,3,1,6,2,17
191218268,2,5,1,6,4,18
191218269,1,9,4,3,9,26
191218270,8,2,1,4,6,21
191218271,2,5,7,4,1,19
191218272,4,3,4,1,4,16
191218273,1,5,3,0,7,16
191218274,5,4,7,7,3,26
191218275,4,2,1,9,1,17
191218276,9,9,0,2,8,28
191218277,3,1,7,9,9,29
191218278,4,7,2,7,2,22
191218279,1,3,4,6,9,23
191218280,7,2,6,5,5,25
191218281,2,6,1,2,7,18
191218282,2,8,7,7,2,26
191218283,8,2,5,5,0,20
191218284,0,3,0,2,0,5
191218285,2,3,1,2,8,16
191218286,1,6,5,8,8,28
191218287,3,6,3,8,4,24
191218288,0,7,8,3,5,23
191218289,4,0,5,0,8,17
191218290,8,8,0,4,6,26
191218291,3,1,6,1,5,16
191218292,9,3,5,5,4,26
191218293,4,6,3,8,9,30
191218294,3,5,2,2,4,16
191218295,0,6,0,5,8,19
191218296,1,9,5,1,8,24
191218297,5,9,1,5,2,22
191218298,8,7,1,1,1,18
191218299,9,6,6,3,9,33
191218300,6,9,3,7,0,25
191218301,5,8,7,0,0,20
191218302,9,0,1,6,5,21
191218303,2,0,6,5,7,20
191218304,0,8,4,2,6,20
191218305,9,2,4,0,5,20
191218306,2,2,9,2,6,21
191218307,9,8,8,7,6,38
191218308,1,9,0,7,5,22
191218309,3,2,5,3,7,20
191218310,7,4,8,3,2,24
191218311,2,5,7,0,1,15
191218312,8,7,8,2,2,27
191218313,6,8,7,9,0,30
191218314,6,7,2,3,7,25
191218315,1,8,7,6,7,29
191218316,0,5,7,0,2,14
191218317,7,9,0,0,9,25
191218318,1,6,4,8,5,24
191218319,9,0,2,3,8,22
191218320,2,9,1,3,7,22
191218321,5,1,1,0,4,11
191218322,6,8,9,1,9,33
191218323,3,8,8,3,1,23
191218324,6,2,9,9,5,31
191218325,4,4,6,9,5,28
191218326,9,6,5,8,2,30
191218327,2,7,0,9,6,24
191218328,9,3,3,5,8,28
191218329,9,0,1,0,8,18
191218330,5,2,7,2,6,22
191218331,2,7,4,8,9,30
191218332,9,9,9,4,3,34
191218333,0,4,5,6,1,16
191218334,6,8,3,1,6,24
191218335,1,5,7,5,2,20
191218336,5,4,5,5,8,27
191218337,7,0,6,7,4,24
191218338,9,1,0,4,7,21
191218339,7,2,7,8,7,31
191218340,2,9,3,7,1,22
191218341,6,1,6,4,6,23
191218342,2,0,1,0,6,9
191218343,6,8,9,5,4,32
191218344,0,7,0,6,3,16
191218345,7,6,9,7,1,30
191218346,8,8,7,8,3,34
191218347,2,8,6,9,6,31
191218348,4,8,7,1,2,22
191218349,4,9,6,7,0,26
191218350,2,9,8,2,1,22
191218351,0,0,3,1,8,12
191218352,2,1,5,8,4,20
191218353,2,8,5,6,9,30
191218354,4,9,3,6,8,30
191218355,7,0,6,0,9,22
191218356,0,5,0,7,0,12
191218357,1,8,9,2,2,22
191218358,6,8,5,7,1,27
191218359,8,9,6,3,2,28
191218360,9,7,2,7,7,32
191218361,1,2,2,0,1,6
191218362,5,4,6,1,7,23
191218363,8,9,0,8,4,29
191218364,3,0,3,3,9,18
191218365,6,9,1,9,2,27
191218366,5,2,3,6,1,17
191218367,2,3,3,5,2,15
191218368,5,6,5,8,4,28
191218369,1,4,1,4,3,13
191218370,2,6,3,6,2,19
191218371,2,7,0,5,7,21
191218372,3,8,2,5,9,27
191218373,1,7,7,5,2,22
191218374,8,5,8,7,7,35
191218375,1,1,4,0,3,9
191218376,0,2,5,5,0,12
191218377,6,2,9,5,7,29
191218378,2,9,2,1,7,21
191218379,5,5,2,4,7,23
191218380,1,2,4,1,9,17
191218381,9,9,9,5,4,36
191218382,0,2,5,0,9,16
191218383,9,7,6,6,1,29
191218384,8,3,3,1,5,20
191218385,0,0,3,1,1,5
191218386,0,2,3,8,6,19
191218387,8,0,0,1,5,14
191218388,5,1,9,2,4,21
191218389,0,5,4,8,7,24
191218390,4,3,9,9,8,33
191218391,0,0,3,8,4,15
191218392,9,6,2,9,5,31
191218393,2,6,3,7,6,24
191218394,0,9,5,0,6,20
191218395,8,8,0,2,7,25
191218396,3,3,7,7,5,25
191218397,8,5,2,8,4,27
191218398,2,9,9,9,4,33
191218399,9,9,1,6,9,34
191218400,3,7,9,3,2,24
191218401,0,4,1,1,3,9
191218402,9,2,6,8,1,26
191218403,4,1,1,7,5,18
191218404,8,8,3,4,8,31
191218405,4,9,0,6,8,27
191218406,6,1,6,3,8,24
191218407,3,8,6,3,1,21
191218408,4,0,2,3,0,9
191218409,1,1,5,1,2,10
191218410,3,7,0,1,5,16
191218411,4,7,8,8,1,28
191218412,4,2,3,9,8,26
191218413,3,1,2,5,6,17
191218414,7,2,0,1,2,12
191218415,5,8,0,6,2,21
191218416,1,6,0,8,5,20
191218417,0,1,1,6,6,14
191218418,8,6,0,3,4,21
191218419,3,0,4,8,8,23
191218420,8,6,4,5,9,32
191218421,0,1,2,5,5,13
191218422,6,7,6,4,3,26
191218423,2,1,8,5,3,19
191218424,0,3,5,2,7,17
191218425,3,0,4,5,8,20
191218426,7,8,9,5,6,35
191218427,2,8,3,2,9,24
191218428,4,1,8,1,6,20
191218429,7,7,6,9,2,31
191218430,7,5,8,9,0,29
191218431,0,7,9,2,2,20
191218432,0,4,5,7,2,18
191218433,6,8,8,6,7,35
191218434,1,8,5,6,0,20
191218435,9,2,5,9,5,30
191218436,0,8,9,7,0,24
191218437,7,2,3,4,7,23
191218438,2,8,0,3,9,22
191218439,5,2,8,5,1,21
191218440,2,1,8,7,6,24
191218441,6,1,5,7,7,26
191218442,5,1,4,8,9,27
191218443,6,6,1,8,7,28
191218444,5,7,6,7,4,29
191218445,0,7,8,3,3,21
191218446,7,3,4,2,3,19
191218447,5,0,9,9,2,25
191218448,3,2,2,1,3,11
191218449,5,1,1,0,8,15
191218450,6,1,7,7,6,27
191218451,1,2,7,2,4,16
191218452,3,3,3,5,1,15
191218453,2,1,5,5,9,22
191218454,6,9,7,3,4,29
191218455,2,1,1,2,7,13
191218456,7,5,6,4,2,24
191218457,9,3,9,9,0,30
191218458,4,8,7,3,0,22
191218459,2,1,6,7,6,22
191218460,4,7,8,3,9,31
191218461,8,4,9,2,0,23
191218462,3,8,8,0,4,23
191218463,8,0,2,3,8,21
191218464,5,3,8,9,6,31
191218465,3,6,3,8,0,20
191218466,1,2,0,8,7,18
191218467,6,1,6,0,9,22
191218468,1,6,2,4,4,17
191218469,7,4,4,2,1,18
191218470,7,6,4,3,2,22
191218471,8,0,0,1,1,10
191218472,0,3,3,6,5,17
191218473,9,1,9,8,7,34
191218474,3,4,4,2,8,21
191218475,3,8,8,9,0,28
191218476,3,0,3,6,0,12
191218477,0,1,1,3,3,8
191218478,0,2,4,1,4,11
191218479,6,9,8,3,0,26
191218480,2,0,3,4,8,17
191218481,3,2,6,3,3,17
191218482,5,9,9,2,0,25
191218483,9,4,8,7,1,29
191218484,0,1,5,3,1,10
191218485,3,3,9,3,0,18
191218486,2,0,1,2,0,5
191218487,0,6,2,0,7,15
191218488,7,2,5,5,7,26
191218489,9,3,5,6,3,26
191218490,9,4,0,5,8,26
191218491,6,1,9,6,2,24
191218492,0,8,7,2,4,21
191218493,3,5,8,9,1,26
191218494,2,6,3,5,7,23
191218495,6,5,0,4,2,17
191218496,1,9,5,9,0,24
191218497,3,1,0,4,2,10
191218498,6,4,6,6,4,26
191218499,4,0,3,8,2,17
191218500,5,3,6,1,4,19
191218501,8,4,8,3,7,30
191218502,4,0,2,5,1,12
191218503,1,6,1,4,7,19
191218504,7,3,3,4,7,24
191218505,0,7,7,6,4,24
191218506,6,6,7,6,0,25
191218507,0,0,2,2,0,4
191218508,4,5,0,5,5,19
191218509,8,4,2,3,5,22
191218510,5,6,2,4,8,25
191218511,9,3,4,3,3,22
191218512,1,3,7,2,3,16
191218513,5,2,1,7,3,18
191218514,2,7,7,3,9,28
191218515,7,9,1,7,6,30
191218516,3,5,0,8,3,19
191218517,2,1,7,5,4,19
191218518,5,2,2,4,3,16
191218519,8,5,2,1,5,21
191218520,5,0,0,2,6,13
191218521,4,3,0,0,1,8
191218522,7,0,0,2,5,14
191218523,3,4,6,8,4,25
191218524,6,1,3,7,4,21
191218525,9,9,8,6,5,37
191218526,3,1,5,1,3,13
191218527,9,1,4,3,5,22
191218528,4,4,0,0,4,12
191218529,2,5,7,8,3,25
191218530,1,3,8,0,2,14
191218531,8,8,5,3,3,27
191218532,1,4,9,0,7,21
191218533,9,0,8,9,7,33
191218534,2,0,5,1,9,17
191218535,4,7,6,9,5,31
191218536,6,4,8,9,7,34
191218537,3,9,6,8,2,28
191218538,9,0,8,9,5,31
191218539,1,3,5,4,8,21
191218540,0,3,2,8,2,15
191218541,1,2,6,8,0,17
191218542,7,3,4,0,5,19
191218543,8,8,7,2,2,27
191218544,8,2,4,8,9,31
191218545,8,7,3,7,8,33
191218546,7,9,8,0,6,30
191218547,8,1,4,6,1,20
191218548,7,9,8,4,2,30
191218549,9,5,2,3,9,28
191218550,2,1,4,2,6,15
191218551,4,2,5,6,0,17
191218552,4,4,5,5,4,22
191218553,6,8,9,0,0,23
191218554,6,1,8,9,9,33
191218555,6,5,0,6,3,20
191218556,4,1,5,2,2,14
191218557,6,4,9,3,2,24
191218558,8,9,3,3,4,27
191218559,9,7,3,0,4,23
191218560,9,0,3,6,2,20
191218561,0,6,1,5,2,14
191218562,3,1,8,1,8,21
191218563,7,7,8,5,9,36
191218564,2,3,0,0,0,5
191218565,1,3,9,7,6,26
191218566,9,0,0,7,3,19
191218567,5,8,7,1,1,22
191218568,0,4,4,0,7,15
191218569,9,8,9,3,0,29
191218570,8,3,7,3,0,21
191218571,3,7,4,7,0,21
191218572,2,1,8,3,4,18
191218573,4,6,5,0,5,20
191218574,0,4,6,9,4,23
191218575,5,4,7,0,1,17
191218576,7,3,6,1,5,22
191218577,3,3,2,8,4,20
191218578,0,9,8,2,2,21
191218579,7,7,1,3,6,24
191218580,3,2,8,4,0,17
191218581,8,4,7,7,1,27
191218582,4,1,6,9,1,21
191218583,4,1,1,2,4,12
191218584,1,7,5,3,0,16
191218585,6,8,0,3,5,22
191218586,4,2,1,4,9,20
191218587,5,2,6,7,0,20
191218588,4,0,4,4,9,21
191218589,7,2,0,9,8,26
191218590,9,2,2,1,7,21
191218591,6,2,5,1,5,19
191218592,8,9,9,5,9,40
191218593,6,6,1,4,2,19
191218594,0,8,3,6,9,26
191218595,9,3,9,4,5,30
191218596,0,6,5,6,7,24
191218597,4,3,9,5,4,25
191218598,6,8,9,4,9,36
191218599,2,6,6,2,1,17
191218600,1,3,5,2,8,19
191218601,0,8,0,7,9,24
191218602,4,1,1,1,3,10
191218603,0,1,4,3,3,11
191218604,3,5,8,6,0,22
191218605,9,7,4,6,7,33
191218606,2,0,8,9,0,19
191218607,8,2,0,4,3,17
191218608,4,0,4,6,1,15
191218609,2,0,8,2,0,12
191218610,2,5,3,5,8,23
191218611,5,9,7,1,1,23
191218612,1,5,8,4,2,20
191218613,2,5,0,1,6,14
191218614,4,7,8,0,9,28
191218615,9,1,8,7,1,26
191218616,0,5,8,5,9,27
191218617,2,0,0,7,6,15
191218618,2,2,0,6,9,19
191218619,8,5,3,7,1,24
191218620,8,5,5,5,5,28
191218621,7,9,3,7,4,30
191218622,5,3,4,7,9,28
191218623,6,3,9,2,5,25
191218624,3,3,5,1,1,13
191218625,2,6,8,3,4,23
191218626,3,5,3,6,3,20
191218627,8,8,9,6,9,40
191218628,3,7,9,2,6,27
191218629,6,1,1,5,4,17
191218630,5,2,9,8,4,28
191218631,2,0,4,9,4,19
191218632,8,5,9,7,0,29
191218633,0,1,5,8,4,18
191218634,8,4,6,1,9,28
191218635,6,0,5,1,5,17
191218636,6,5,6,7,0,24
191218637,5,3,5,5,7,25
191218638,8,9,1,8,2,28
191218639,7,6,0,4,7,24
191218640,9,0,4,3,9,25
191218641,4,3,0,3,3,13
191218642,3,5,3,7,7,25
191218643,7,6,7,9,3,32
191218644,8,9,7,8,7,39
191218645,2,1,7,7,6,23
191218646,6,5,0,5,5,21
191218647,6,5,4,7,4,26
191218648,4,7,8,4,7,30
191218649,6,8,2,9,8,33
191218650,6,3,9,7,1,26
191218651,8,0,3,8,4,23
191218652,4,0,0,4,0,8
191218653,5,8,8,4,4,29
191218654,2,7,5,2,5,21
191218655,3,9,4,7,6,29
191218656,2,3,0,5,3,13
191218657,9,6,5,3,6,29
191218658,1,8,3,9,4,25
191218659,0,0,1,3,6,10
191218660,0,0,8,5,2,15
191218661,3,2,8,5,1,19
191218662,7,7,8,0,7,29
191218663,6,0,4,5,7,22
191218664,6,2,9,3,6,26
191218665,0,8,6,5,7,26
191218666,4,4,1,8,6,23
191218667,7,3,4,8,3,25
191218668,7,7,2,6,1,23
191218669,6,4,8,6,6,30
191218670,1,0,7,5,1,14
191218671,6,0,3,7,6,22
191218672,4,4,7,7,6,28
191218673,7,3,1,8,0,19
191218674,9,5,6,0,2,22
191218675,5,0,2,3,3,13
191218676,2,2,7,4,6,21
191218677,6,8,5,7,6,32
191218678,6,3,5,5,0,19
191218679,7,1,7,2,2,19
191218680,0,6,7,8,4,25
191218681,0,4,8,7,3,22
191218682,6,4,8,9,6,33
191218683,8,6,6,5,7,32
191218684,0,5,1,0,4,10
191218685,5,3,0,2,0,10
191218686,8,2,1,6,5,22
191218687,7,0,2,7,1,17
191218688,0,6,7,6,3,22
191218689,6,5,2,6,7,26
191218690,5,7,2,4,7,25
191218691,4,3,4,5,4,20
191218692,7,7,9,8,9,40
191218693,2,9,1,6,1,19
191218694,9,5,5,1,7,27
191218695,3,0,4,7,4,18
191218696,1,7,2,4,8,22
191218697,9,6,5,0,2,22
191218698,0,5,1,0,8,14
191218699,8,0,9,5,4,26
191218700,1,6,8,8,1,24
191218701,1,9,3,7,0,20
191218702,7,0,9,8,5,29
191218703,0,3,9,9,1,22
191218704,0,0,8,3,3,14
191218705,4,0,1,2,1,8
191218706,5,9,1,1,8,24
191218707,0,6,1,7,7,21
191218708,7,6,2,3,5,23
191218709,0,7,0,2,6,15
191218710,3,8,1,5,8,25
191218711,4,8,5,0,1,18
191218712,2,9,0,1,0,12
191218713,0,5,7,4,1,17
191218714,2,1,2,8,8,21
191218715,5,6,9,0,9,29
191218716,2,8,4,4,2,20
191218717,0,3,6,3,6,18
191218718,5,6,2,2,1,16
191218719,5,6,7,5,2,25
191218720,2,8,5,5,9,29
191218721,8,2,0,1,0,11
191218722,2,4,3,4,6,19
191218723,6,3,7,4,8,28
191218724,6,8,5,2,4,25
191218725,9,1,0,6,6,22
191218726,8,9,8,5,4,34
191218727,0,7,9,9,7,32
191218728,8,7,7,9,5,36
191218729,6,0,8,9,4,27
191218730,4,3,7,8,0,22
191218731,7,4,4,6,3,24
191218732,3,4,4,1,2,14
191218733,7,3,6,7,2,25
191218734,0,8,4,0,6,18
191218735,8,3,6,2,3,22
191218736,3,4,2,2,6,17
191218737,7,4,5,3,3,22
191218738,8,0,7,5,3,23
191218739,4,1,5,7,3,20
191218740,3,3,1,5,2,14
191218741,7,4,7,9,5,32
191218742,4,0,3,5,4,16
191218743,0,6,9,8,9,32
191218744,1,4,0,8,2,15
191218745,5,3,7,2,7,24
191218746,9,9,1,7,6,32
191218747,6,2,8,4,3,23
191218748,7,0,4,2,6,19
191218749,0,3,7,1,5,16
191218750,6,2,2,5,0,15
191218751,4,8,7,4,2,25
191218752,8,2,6,5,8,29
191218753,9,6,9,4,9,37
191218754,8,1,5,2,4,20
191218755,5,3,5,0,6,19
191218756,0,2,3,9,7,21
191218757,3,6,3,2,0,14
191218758,6,9,9,0,0,24
191218759,9,1,7,5,5,27
191218760,2,9,1,4,7,23
191218761,9,4,4,3,9,29
191218762,3,7,7,6,6,29
191218763,5,3,6,7,5,26
191218764,1,7,0,8,6,22
191218765,9,7,3,3,7,29
191218766,3,8,6,7,9,33
191218767,8,4,7,7,5,31
191218768,6,5,6,7,4,28
191218769,3,7,0,6,0,16
191218770,4,3,3,9,7,26
191218771,4,0,0,5,1,10
191218772,0,9,5,5,5,24
191218773,2,9,5,4,9,29
191218774,8,0,6,0,3,17
191218775,9,1,0,7,5,22
191218776,9,3,6,0,3,21
191218777,6,6,2,6,5,25
191218778,3,7,2,2,4,18
191218779,8,3,3,5,2,21
191218780,5,5,8,3,7,28
191218781,2,9,4,7,4,26
191218782,3,9,3,1,6,22
191218783,3,0,7,4,9,23
191218784,1,7,9,4,8,29
191218785,6,2,5,9,8,30
191218786,4,6,3,0,1,14
191218787,2,4,6,1,3,16
191218788,2,1,4,3,0,10
191218789,3,6,7,6,8,30
191218790,7,5,1,2,4,19
191218791,6,8,5,3,8,30
191218792,0,3,5,8,5,21
191218793,5,8,6,2,3,24
191218794,0,4,9,7,3,23
191218795,4,0,4,0,5,13
191218796,7,9,5,2,2,25
191218797,6,5,6,3,4,24
191218798,4,0,2,3,8,17
191218799,1,9,4,7,4,25
191218800,3,3,6,9,7,28
191218801,7,2,0,9,3,21
191218802,9,9,0,0,6,24
191218803,1,4,8,1,5,19
191218804,2,1,0,9,1,13
191218805,3,3,3,0,6,15
191218806,0,9,3,2,5,19
191218807,7,6,0,5,6,24
191218808,9,1,2,0,5,17
191218809,1,1,7,3,0,12
191218810,6,0,7,5,8,26
191218811,7,0,0,1,8,16
191218812,7,6,2,9,9,33
191218813,2,4,9,5,1,21
191218814,1,7,2,9,8,27
191218815,2,9,4,4,9,28
191218816,7,3,3,5,8,26
191218817,4,4,1,9,2,20
191218818,7,2,4,9,9,31
191218819,9,2,8,9,1,29
191218820,5,4,4,1,7,21
191218821,9,7,8,7,2,33
191218822,3,6,3,6,8,26
191218823,4,0,7,6,0,17
191218824,2,5,1,0,3,11
191218825,6,2,5,3,2,18
191218826,4,4,3,3,9,23
191218827,0,9,3,1,6,19
191218828,8,0,1,2,5,16
191218829,1,4,8,4,1,18
191218830,6,3,9,9,7,34
191218831,2,3,2,4,1,12
191218832,5,3,2,4,1,15
191218833,6,6,8,8,0,28
191218834,8,4,6,7,8,33
191218835,2,6,4,9,5,26
191218836,8,2,6,2,8,26
191218837,2,7,3,2,2,16
191218838,0,4,9,4,7,24
191218839,3,9,4,5,5,26
191218840,8,1,7,6,1,23
191218841,8,2,1,4,5,20
191218842,4,6,6,1,4,21
191218843,3,3,6,1,3,16
191218844,8,2,9,1,4,24
191218845,4,7,6,4,1,22
191218846,9,9,2,8,8,36
191218847,7,0,7,9,3,26
191218848,7,3,7,5,4,26
191218849,6,4,2,2,9,23
191218850,3,4,7,7,7,28
191218851,2,3,7,9,2,23
191218852,4,3,6,3,0,16
191218853,8,6,9,2,9,34
191218854,5,3,9,7,2,26
191218855,4,2,0,7,8,21
191218856,5,9,3,4,0,21
191218857,3,0,2,0,1,6
191218858,3,2,3,6,3,17
191218859,1,3,2,3,8,17
191218860,4,5,7,7,4,27
191218861,5,0,7,0,4,16
191218862,8,3,2,6,6,25
191218863,6,1,5,1,0,13
191218864,6,4,2,5,6,23
191218865,9,3,5,7,0,24
191218866,1,1,3,8,9,22
191218867,1,5,9,7,8,30
191218868,0,9,5,9,1,24
191218869,9,9,8,8,7,41
191218870,1,9,0,6,3,19
191218871,8,4,1,3,3,19
191218872,3,7,4,2,9,25
191218873,4,8,5,1,2,20
191218874,5,0,8,8,1,22
191218875,2,7,9,0,0,18
191218876,2,6,4,7,3,22
191218877,7,0,5,7,2,21
191218878,5,2,1,4,0,12
191218879,9,3,2,5,7,26
191218880,7,7,4,6,0,24
191218881,2,8,8,5,6,29
191218882,7,1,4,1,5,18
191218883,2,0,7,9,6,24
191218884,1,7,8,1,7,24
191218885,5,5,8,5,5,28
191218886,0,9,2,5,3,19
191218887,1,4,5,9,4,23
191218888,5,3,3,2,7,20
191218889,2,2,8,4,3,19
191218890,2,8,8,7,8,33
191218891,9,9,5,2,9,34
191218892,5,9,6,7,0,27
191218893,7,2,8,5,2,24
191218894,1,1,1,6,9,18
191218895,7,2,6,7,5,27
191218896,0,2,0,6,5,13
191218897,8,0,5,1,4,18
191218898,9,9,1,0,9,28
191218899,4,4,3,6,0,17
191218900,4,7,1,9,7,28
191218901,3,2,6,3,7,21
191218902,7,2,3,5,0,17
191218903,6,4,3,4,8,25
191218904,8,0,4,2,0,14
191218905,1,1,6,6,0,14
191218906,0,5,6,8,1,20
191218907,7,7,5,6,3,28
191218908,8,4,8,4,2,26
191218909,6,4,2,6,7,25
191218910,5,0,7,1,0,13
191218911,7,9,3,8,5,32
191218912,1,4,4,6,2,17
191218913,5,3,7,7,8,30
191218914,1,1,7,7,7,23
191218915,5,6,0,7,5,23
191218916,7,2,3,2,1,15
191218917,9,1,3,0,5,18
191218918,2,5,1,1,0,9
191218919,1,7,1,6,7,22
191218920,6,4,2,3,7,22
191218921,9,6,7,4,3,29
191218922,2,1,7,3,5,18
191218923,2,3,6,4,0,15
191218924,2,2,2,1,0,7
191218925,1,3,0,1,4,9
191218926,3,8,7,6,5,29
191218927,4,5,1,8,6,24
191218928,5,1,1,0,5,12
191218929,1,9,1,5,7,23
191218930,0,7,8,0,1,16
191218931,3,4,2,0,8,17
191218932,7,2,5,4,5,23
191218933,9,6,3,1,5,24
191218934,4,5,5,1,1,16
191218935,8,8,1,5,8,30
191218936,1,8,2,5,8,24
191218937,1,3,6,2,0,12
191218938,4,5,4,7,2,22
191218939,2,3,6,4,3,18
191218940,2,7,2,8,1,20
191218941,1,0,0,3,8,12
191218942,9,6,1,3,5,24
191218943,2,3,2,4,4,15
191218944,5,4,8,5,8,30
191218945,2,7,2,1,0,12
191218946,7,6,8,3,3,27
191218947,3,2,9,4,4,22
191218948,0,9,9,6,3,27
191218949,6,7,0,9,0,22
191218950,4,9,0,3,9,25
191218951,4,7,9,0,8,28
191218952,1,4,0,5,3,13
191218953,4,5,5,4,7,25
191218954,1,1,1,6,2,11
191218955,0,2,7,1,8,18
191218956,9,3,9,2,1,24
191218957,5,1,8,1,6,21
191218958,4,6,8,5,8,31
191218959,2,5,3,3,1,14
191218960,6,7,4,8,3,28
191218961,3,0,0,1,9,13
191218962,8,3,8,2,1,22
191218963,4,7,7,7,7,32
191218964,3,6,1,0,9,19
191218965,4,6,3,4,2,19
191218966,2,4,2,1,0,9
191218967,6,9,4,8,5,32
191218968,5,0,5,0,7,17
191218969,1,8,1,1,1,12
191218970,0,6,6,2,0,14
191218971,7,1,1,1,1,11
191218972,7,6,4,1,7,25
191218973,6,6,3,7,5,27
191218974,2,9,9,2,0,22
191218975,7,0,3,1,7,18
191218976,4,3,6,3,2,18
191218977,3,5,0,5,7,20
191218978,5,5,9,0,7,26
191218979,4,1,5,3,5,18
191218980,5,6,7,2,4,24
191218981,8,9,2,1,6,26
191218982,1,4,3,8,8,24
191218983,7,4,0,9,6,26
191218984,1,2,8,6,9,26
191218985,5,4,7,9,7,32
191218986,2,9,0,8,9,28
191218987,0,3,3,6,6,18
191218988,6,9,5,6,7,33
191218989,9,6,7,8,5,35
191218990,3,0,8,0,1,12
191218991,1,1,5,6,2,15
191218992,5,6,6,0,0,17
191218993,1,3,4,7,1,16
191218994,4,3,4,1,9,21
191218995,1,7,8,2,3,21
191218996,0,7,3,4,6,20
191218997,9,2,0,1,1,13
191218998,5,5,0,3,7,20
191218999,1,4,4,8,1,18
1912181000,1,0,4,7,5,17
1912181001,9,9,6,7,0,31
1912181002,2,1,9,9,2,23
1912181003,3,3,9,9,9,33
1912181004,5,2,1,0,6,14
1912181005,3,3,8,9,2,25
1912181006,4,8,6,7,8,33
1912181007,2,4,4,1,4,15
1912181008,4,9,5,1,4,23
1912181009,0,8,2,1,3,14
1912181010,5,5,0,9,2,21
1912181011,4,0,4,5,7,20
1912181012,4,5,1,5,3,18
1912181013,3,5,0,8,2,18
1912181014,3,1,3,0,7,14
1912181015,4,1,6,6,9,26
1912181016,2,3,4,9,0,18
1912181017,9,2,4,6,7,28
1912181018,6,2,1,3,0,12
1912181019,4,6,7,4,4,25
1912181020,4,6,4,1,0,15
1912181021,1,8,9,9,6,33
1912181022,9,2,3,7,5,26
1912181023,4,4,4,5,4,21
1912181024,2,7,9,9,4,31
1912181025,9,5,1,9,4,28
1912181026,2,0,3,1,8,14
1912181027,6,9,9,7,3,34
1912181028,9,6,8,9,3,35
1912181029,1,6,7,9,4,27
1912181030,6,5,3,8,2,24
1912181031,0,1,7,7,0,15
1912181032,3,1,5,2,7,18
1912181033,3,8,0,6,3,20
1912181034,8,1,0,5,1,15
1912181035,2,6,7,0,4,19
1912181036,9,5,4,0,1,19
1912181037,2,7,7,1,4,21
1912181038,6,8,4,3,8,29
1912181039,2,5,5,6,1,19
1912181040,5,1,6,0,3,15
1912181041,7,6,6,9,8,36
1912181042,4,9,4,3,9,29
1912181043,1,8,8,9,2,28
1912181044,5,6,2,7,1,21
1912181045,7,2,6,5,3,23
1912181046,2,3,6,0,4,15
1912181047,5,7,8,3,6,29
1912181048,6,2,4,3,6,21
1912181049,7,0,3,9,9,28
1912181050,6,2,8,9,8,33
1912181051,6,3,5,3,3,20
1912181052,2,3,7,0,8,20
1912181053,6,6,6,4,7,29
1912181054,1,7,1,5,9,23
1912181055,6,0,0,8,5,19
1912181056,6,3,9,3,5,26
1912181057,6,7,7,6,3,29
1912181058,9,7,7,4,8,35
1912181059,3,2,8,9,6,28
1912181060,9,3,8,2,5,27
1912181061,3,7,6,8,6,30
1912181062,6,3,8,6,4,27
1912181063,2,0,7,0,3,12
1912181064,4,2,6,0,4,16
1912181065,1,2,2,7,2,14
1912181066,2,4,2,9,7,24
1912181067,0,7,2,1,6,16
1912181068,7,9,9,4,4,33
1912181069,8,1,5,0,3,17
1912181070,7,2,8,1,3,21
1912181071,1,4,3,7,1,16
1912181072,6,1,7,1,4,19
1912181073,1,4,5,6,4,20
1912181074,1,3,7,0,5,16
1912181075,5,1,5,5,1,17
1912181076,2,4,9,9,9,33
1912181077,1,0,9,5,0,15
1912181078,8,3,8,1,1,21
1912181079,2,4,2,4,5,17
1912181080,3,6,1,9,9,28
1912181081,3,2,2,4,9,20
1912181082,7,6,7,3,7,30
1912181083,2,1,8,2,5,18
1912181084,9,7,4,1,4,25
1912181085,5,5,0,8,7,25
1912181086,6,7,6,7,9,35
1912181087,6,0,2,9,3,20
1912181088,6,2,5,6,2,21
1912181089,8,4,1,4,7,24
1912181090,7,1,5,0,8,21
1912181091,1,1,9,4,7,22
1912181092,0,6,3,1,5,15
1912181093,1,8,8,3,7,27
1912181094,9,7,9,7,2,34
1912181095,4,8,0,8,8,28
1912181096,9,0,0,7,7,23
1912181097,8,7,6,5,5,31
1912181098,6,2,2,6,5,21
1912181099,6,9,1,1,0,17
1912181100,7,7,9,4,3,30
1912181101,7,3,3,5,0,18
1912181102,7,0,8,4,1,20
1912181103,6,4,4,4,6,24
1912181104,0,3,8,3,7,21
1912181105,1,3,8,4,2,18
191219001,5,3,4,2,1,15
191219002,4,7,2,2,1,16
191219003,2,1,6,2,0,11
191219004,4,6,1,7,6,24
191219005,1,5,5,3,3,17
191219006,7,1,9,8,4,29
191219007,3,5,8,7,0,23
191219008,5,9,1,2,1,18
191219009,7,7,5,8,6,33
191219010,9,8,1,4,8,30
191219011,4,9,7,3,0,23
191219012,5,6,7,4,0,22
191219013,9,8,3,0,9,29
191219014,4,7,7,0,7,25
191219015,7,8,3,3,5,26
191219016,6,5,9,8,1,29
191219017,3,0,0,0,0,3
191219018,8,1,7,6,4,26
191219019,9,2,8,9,3,31
191219020,0,4,9,1,5,19
191219021,6,3,7,4,3,23
191219022,5,9,1,9,3,27
191219023,5,1,6,7,1,20
191219024,5,5,5,5,8,28
191219025,4,8,4,3,3,22
191219026,8,5,0,9,0,22
191219027,9,6,5,7,2,29
191219028,6,8,1,5,4,24
191219029,4,1,6,2,3,16
191219030,0,7,8,0,5,20
191219031,5,3,7,3,0,18
191219032,4,1,5,7,9,26
191219033,4,0,4,6,5,19
191219034,1,5,6,6,5,23
191219035,7,8,5,4,4,28
191219036,5,8,2,0,8,23
191219037,2,7,1,4,5,19
191219038,6,5,5,2,7,25
191219039,8,8,9,0,1,26
191219040,6,1,0,2,7,16
191219041,4,9,0,1,4,18
191219042,4,0,2,6,7,19
191219043,4,0,7,5,7,23
191219044,3,6,6,0,5,20
191219045,8,6,1,9,5,29
191219046,3,1,9,4,8,25
191219047,9,7,0,2,1,19
191219048,9,0,0,1,0,10
191219049,4,5,1,9,9,28
191219050,0,7,9,7,0,23
191219051,6,9,5,6,2,28
191219052,7,4,8,4,9,32
191219053,3,8,3,6,4,24
191219054,7,8,1,5,9,30
191219055,0,6,7,5,3,21
191219056,2,6,6,2,9,25
191219057,2,8,9,8,8,35
191219058,3,8,2,1,9,23
191219059,7,7,2,1,9,26
191219060,8,4,9,3,8,32
191219061,2,7,0,9,7,25
191219062,2,4,7,1,4,18
191219063,7,2,4,3,0,16
191219064,7,0,0,7,5,19
191219065,7,7,5,0,6,25
191219066,2,4,2,9,6,23
191219067,0,2,2,5,3,12
191219068,9,5,2,1,3,20
191219069,2,3,0,1,2,8
191219070,3,2,4,9,3,21
191219071,1,6,0,3,3,13
191219072,2,2,2,6,8,20
191219073,0,6,2,3,2,13
191219074,8,3,7,5,6,29
191219075,6,4,9,6,5,30
191219076,9,7,6,1,5,28
191219077,8,8,3,4,5,28
191219078,0,5,1,1,4,11
191219079,7,6,0,2,9,24
191219080,7,2,4,5,1,19
191219081,8,9,1,3,5,26
191219082,4,4,6,3,1,18
191219083,1,7,1,2,7,18
191219084,8,5,0,2,8,23
191219085,1,9,5,5,4,24
191219086,0,6,3,8,7,24
191219087,9,7,9,7,1,33
191219088,9,2,7,8,9,35
191219089,1,7,6,8,8,30
191219090,8,4,7,1,0,20
191219091,8,6,6,5,6,31
191219092,4,8,5,0,3,20
191219093,3,8,1,3,8,23
191219094,9,5,5,6,8,33
191219095,7,7,8,6,9,37
191219096,7,7,3,7,9,33
191219097,3,1,5,2,2,13
191219098,8,8,2,6,3,27
191219099,9,9,8,0,5,31
191219100,1,7,8,9,7,32
191219101,1,3,1,6,9,20
191219102,3,7,0,8,2,20
191219103,6,0,2,7,4,19
191219104,3,8,4,9,2,26
191219105,7,2,8,6,6,29
191219106,2,1,1,0,3,7
191219107,7,4,3,0,5,19
191219108,7,6,9,0,7,29
191219109,6,2,3,0,5,16
191219110,9,5,2,9,3,28
191219111,6,3,2,7,7,25
191219112,7,1,6,7,4,25
191219113,3,4,9,7,9,32
191219114,7,0,0,6,9,22
191219115,4,4,1,1,2,12
191219116,6,5,4,9,1,25
191219117,1,8,8,6,9,32
191219118,5,5,5,8,5,28
191219119,9,3,7,8,3,30
191219120,6,4,7,6,0,23
191219121,2,1,8,1,1,13
191219122,9,9,3,0,7,28
191219123,2,9,9,4,0,24
191219124,6,0,9,6,1,22
191219125,5,5,9,7,5,31
191219126,3,9,0,2,1,15
191219127,6,9,6,6,0,27
191219128,7,0,5,8,8,28
191219129,0,6,8,2,7,23
191219130,8,7,9,8,0,32
191219131,1,0,1,9,0,11
191219132,2,3,4,9,2,20
191219133,2,3,0,3,9,17
191219134,2,6,9,8,8,33
191219135,8,5,0,1,0,14
191219136,8,7,7,1,8,31
191219137,7,7,0,0,4,18
191219138,9,5,3,1,4,22
191219139,7,5,8,1,4,25
191219140,3,1,1,5,0,10
191219141,2,7,6,4,2,21
191219142,9,0,6,0,5,20
191219143,3,3,4,2,3,15
191219144,2,5,8,1,2,18
191219145,0,1,0,0,3,4
191219146,9,7,5,3,5,29
191219147,6,3,0,5,6,20
191219148,9,7,3,8,1,28
191219149,8,9,2,5,5,29
191219150,8,1,7,1,6,23
191219151,7,8,3,3,8,29
191219152,8,7,2,4,6,27
191219153,2,1,1,6,9,19
191219154,7,1,5,6,2,21
191219155,5,6,1,6,8,26
191219156,6,9,2,2,2,21
191219157,7,1,9,4,9,30
191219158,3,3,9,8,9,32
191219159,8,8,3,9,3,31
191219160,5,3,0,2,3,13
191219161,7,2,9,6,6,30
191219162,9,2,5,6,0,22
191219163,8,9,0,6,4,27
191219164,0,2,2,6,9,19
191219165,2,1,3,6,8,20
191219166,7,5,3,3,7,25
191219167,3,5,6,8,9,31
191219168,3,4,6,5,1,19
191219169,7,8,8,4,8,35
191219170,1,7,7,3,4,22
191219171,2,6,3,9,5,25
191219172,4,8,2,0,2,16
191219173,5,6,1,7,7,26
191219174,7,7,8,9,1,32
191219175,2,8,1,0,1,12
191219176,3,7,7,4,4,25
191219177,6,8,3,3,4,24
191219178,3,7,4,2,3,19
191219179,4,6,9,1,5,25
191219180,3,3,8,9,6,29
191219181,3,1,4,7,5,20
191219182,4,8,7,7,9,35
191219183,7,1,0,0,1,9
191219184,8,0,7,4,8,27
191219185,5,4,8,9,2,28
191219186,4,2,1,2,7,16
191219187,7,4,1,6,2,20
191219188,0,7,2,8,9,26
191219189,0,7,4,6,0,17
191219190,6,6,5,5,5,27
191219191,6,1,7,5,7,26
191219192,3,6,1,2,6,18
191219193,6,0,7,8,8,29
191219194,0,7,7,7,4,25
191219195,3,3,3,4,8,21
191219196,9,9,4,5,5,32
191219197,3,0,9,3,4,19
191219198,2,8,2,1,6,19
191219199,5,6,4,7,8,30
191219200,5,3,6,2,5,21
191219201,3,7,4,7,6,27
191219202,4,6,2,4,4,20
191219203,0,5,5,7,3,20
191219204,0,7,0,3,1,11
191219205,0,4,0,6,9,19
191219206,8,8,3,6,9,34
191219207,6,7,9,0,4,26
191219208,6,5,7,4,7,29
191219209,1,0,8,7,8,24
191219210,5,8,7,7,2,29
191219211,9,0,8,1,4,22
191219212,7,7,3,5,4,26
191219213,1,5,0,8,5,19
191219214,2,6,8,7,1,24
191219215,0,9,1,8,8,26
191219216,1,2,8,0,9,20
191219217,9,6,4,1,6,26
191219218,3,0,6,3,2,14
191219219,3,0,2,4,7,16
191219220,0,5,7,2,4,18
191219221,6,9,6,7,9,37
191219222,9,6,2,2,5,24
191219223,4,7,8,8,0,27
191219224,6,3,8,2,2,21
191219225,6,9,9,7,6,37
191219226,9,1,0,4,8,22
191219227,1,4,8,4,2,19
191219228,5,3,8,5,8,29
191219229,2,0,3,7,6,18
191219230,0,4,2,0,4,10
191219231,7,2,1,2,5,17
191219232,5,0,4,9,9,27
191219233,0,3,1,0,5,9
191219234,3,1,7,2,2,15
191219235,1,7,0,6,4,18
191219236,4,1,4,8,7,24
191219237,3,0,1,6,0,10
191219238,2,9,4,0,3,18
191219239,9,9,2,1,8,29
191219240,7,3,4,1,1,16
191219241,0,9,2,6,9,26
191219242,1,0,4,9,9,23
191219243,2,9,6,8,9,34
191219244,5,2,8,0,4,19
191219245,2,3,9,0,5,19
191219246,9,4,9,2,2,26
191219247,4,4,0,6,0,14
191219248,1,0,5,9,6,21
191219249,8,1,7,7,8,31
191219250,0,3,2,2,6,13
191219251,0,4,7,8,5,24
191219252,0,2,2,0,2,6
191219253,4,3,5,4,2,18
191219254,7,8,2,1,3,21
191219255,6,8,8,8,9,39
191219256,4,2,7,3,7,23
191219257,2,5,1,7,3,18
191219258,4,0,5,5,3,17
191219259,4,2,1,3,6,16
191219260,3,6,6,3,7,25
191219261,4,4,4,2,7,21
191219262,9,9,7,0,3,28
191219263,8,6,4,8,7,33
191219264,3,3,9,7,0,22
191219265,7,7,9,0,4,27
191219266,3,8,9,5,7,32
191219267,1,9,0,6,6,22
191219268,2,3,3,6,2,16
191219269,7,0,6,9,9,31
191219270,9,4,1,2,2,18
191219271,7,6,6,7,6,32
191219272,2,3,7,3,2,17
191219273,7,0,8,1,4,20
191219274,8,7,5,0,4,24
191219275,0,9,7,3,1,20
191219276,2,5,4,8,2,21
191219277,1,3,6,1,2,13
191219278,8,0,0,6,0,14
191219279,9,5,9,1,1,25
191219280,8,9,2,8,6,33
191219281,5,8,0,9,1,23
191219282,6,7,4,4,6,27
191219283,8,1,5,9,6,29
191219284,6,7,5,7,1,26
191219285,4,5,2,8,4,23
191219286,7,2,8,3,8,28
191219287,9,7,9,9,2,36
191219288,1,2,2,0,6,11
191219289,6,2,9,0,5,22
191219290,6,8,7,8,1,30
191219291,7,5,7,7,8,34
191219292,3,2,0,6,3,14
191219293,9,2,9,1,0,21
191219294,5,8,0,6,3,22
191219295,7,3,6,8,7,31
191219296,9,2,5,1,2,19
191219297,3,0,0,6,7,16
191219298,7,9,0,3,1,20
191219299,8,6,8,0,8,30
191219300,2,3,3,1,1,10
191219301,8,6,7,0,0,21
191219302,1,6,8,4,5,24
191219303,1,7,6,8,5,27
191219304,9,3,8,5,4,29
191219305,6,3,2,3,1,15
191219306,7,2,8,5,6,28
191219307,2,4,1,2,4,13
191219308,2,3,2,7,3,17
191219309,7,8,0,7,6,28
191219310,6,9,7,5,1,28
191219311,5,9,4,6,4,28
191219312,3,8,1,7,1,20
191219313,8,2,5,0,0,15
191219314,9,2,0,1,3,15
191219315,8,5,1,6,6,26
191219316,0,0,2,2,7,11
191219317,6,1,7,4,9,27
191219318,5,9,2,7,7,30
191219319,9,9,2,4,6,30
191219320,7,3,4,0,9,23
191219321,5,2,9,3,6,25
191219322,7,5,8,0,1,21
191219323,2,7,6,5,4,24
191219324,9,0,6,6,2,23
191219325,5,4,4,9,5,27
191219326,5,6,2,3,0,16
191219327,5,1,6,7,5,24
191219328,0,0,1,7,8,16
191219329,9,3,6,6,8,32
191219330,1,7,9,8,7,32
191219331,3,0,7,4,3,17
191219332,0,5,2,1,0,8
191219333,0,9,1,0,9,19
191219334,6,8,3,9,8,34
191219335,2,5,5,3,7,22
191219336,4,7,5,6,2,24
191219337,9,9,3,9,8,38
191219338,0,7,6,0,3,16
191219339,4,5,9,2,7,27
191219340,4,7,2,2,7,22
191219341,1,8,7,3,8,27
191219342,5,8,5,5,9,32
191219343,9,2,6,1,8,26
191219344,6,5,4,0,1,16
191219345,2,2,4,1,1,10
191219346,6,7,8,9,3,33
191219347,7,9,1,4,3,24
191219348,3,8,8,1,6,26
191219349,9,9,7,0,0,25
191219350,1,2,8,3,8,22
191219351,0,9,8,1,4,22
191219352,7,4,7,6,5,29
191219353,5,0,3,0,7,15
191219354,1,7,5,1,1,15
191219355,4,7,8,4,2,25
191219356,8,9,3,6,0,26
191219357,3,1,9,5,3,21
191219358,0,3,7,4,6,20
191219359,2,9,1,2,7,21
191219360,4,5,4,4,9,26
191219361,8,9,3,4,4,28
191219362,5,1,9,5,6,26
191219363,6,9,2,2,1,20
191219364,2,9,3,7,9,30
191219365,5,9,3,2,9,28
191219366,0,0,3,9,9,21
191219367,2,6,4,1,0,13
191219368,5,8,8,7,3,31
191219369,1,7,4,4,7,23
191219370,8,2,3,5,6,24
191219371,7,2,1,2,6,18
191219372,5,7,9,8,5,34
191219373,3,8,0,2,1,14
191219374,9,1,9,7,5,31
191219375,8,5,7,1,2,23
191219376,4,5,3,0,4,16
191219377,1,6,7,0,7,21
191219378,9,0,1,6,4,20
191219379,2,8,3,8,3,24
191219380,2,9,9,3,9,32
191219381,4,5,3,9,9,30
191219382,7,6,0,0,8,21
191219383,8,5,4,0,9,26
191219384,3,2,4,0,4,13
191219385,3,0,7,5,5,20
191219386,0,9,6,7,8,30
191219387,9,9,6,1,4,29
191219388,4,1,9,6,6,26
191219389,8,9,5,7,4,33
191219390,8,7,4,6,4,29
191219391,0,8,1,5,9,23
191219392,6,5,2,5,0,18
191219393,9,0,3,3,3,18
191219394,1,9,1,8,1,20
191219395,7,7,4,4,3,25
191219396,1,0,3,8,0,12
191219397,0,2,7,2,9,20
191219398,0,8,3,2,2,15
191219399,9,5,2,0,2,18
191219400,7,1,1,2,1,12
191219401,7,2,6,3,6,24
191219402,1,7,9,3,1,21
191219403,6,8,1,9,5,29
191219404,4,1,5,9,5,24
191219405,4,4,9,6,6,29
191219406,6,1,0,9,9,25
191219407,2,6,2,8,7,25
191219408,6,4,4,0,3,17
191219409,5,8,0,1,3,17
191219410,4,6,2,1,2,15
191219411,8,8,4,1,1,22
191219412,3,7,5,1,8,24
191219413,2,6,7,1,8,24
191219414,7,8,2,9,6,32
191219415,9,4,2,2,4,21
191219416,9,6,2,3,6,26
191219417,7,2,2,3,0,14
191219418,9,5,5,6,9,34
191219419,0,8,4,2,2,16
191219420,4,4,8,4,4,24
191219421,5,6,8,8,7,34
191219422,3,5,7,5,5,25
191219423,2,7,0,3,6,18
191219424,8,6,9,0,3,26
191219425,1,5,5,8,5,24
191219426,5,6,2,9,0,22
191219427,2,9,6,1,0,18
191219428,7,6,9,9,8,39
191219429,3,0,9,6,4,22
191219430,8,4,8,5,5,30
191219431,1,5,4,6,6,22
191219432,6,8,3,1,5,23
191219433,3,6,6,7,6,28
191219434,2,7,3,0,6,18
191219435,6,8,1,6,7,28
191219436,5,5,5,9,9,33
191219437,8,5,4,4,0,21
191219438,4,9,9,9,6,37
191219439,9,4,7,8,3,31
191219440,1,7,9,9,8,34
191219441,6,7,7,9,1,30
191219442,8,7,5,9,5,34
191219443,6,6,2,2,9,25
191219444,3,8,4,6,4,25
191219445,6,9,4,8,7,34
191219446,1,9,0,2,0,12
191219447,6,8,1,7,5,27
191219448,6,1,5,4,6,22
191219449,9,7,3,6,0,25
191219450,9,5,0,2,5,21
191219451,1,8,7,9,1,26
191219452,3,9,1,0,7,20
191219453,0,9,4,6,5,24
191219454,6,4,2,4,1,17
191219455,3,3,8,5,3,22
191219456,1,1,1,6,7,16
191219457,0,7,1,7,6,21
191219458,0,5,9,8,5,27
191219459,4,2,8,7,6,27
191219460,2,3,6,0,8,19
191219461,9,0,1,8,6,24
191219462,4,2,8,3,9,26
191219463,6,5,4,6,6,27
191219464,2,6,2,4,9,23
191219465,8,0,9,8,2,27
191219466,7,2,1,6,6,22
191219467,2,7,1,2,0,12
191219468,6,2,7,1,2,18
191219469,1,5,9,0,9,24
191219470,0,7,5,4,9,25
191219471,1,0,5,6,6,18
191219472,9,6,3,1,9,28
191219473,3,6,6,5,5,25
191219474,9,8,7,8,0,32
191219475,8,9,8,6,4,35
191219476,7,7,0,8,3,25
191219477,5,3,6,2,9,25
191219478,9,1,2,1,0,13
191219479,0,4,8,4,9,25
191219480,4,2,6,5,5,22
191219481,3,7,5,7,0,22
191219482,8,3,5,5,6,27
191219483,2,7,5,3,1,18
191219484,7,7,6,7,7,34
191219485,3,9,5,5,2,24
191219486,4,9,8,4,2,27
191219487,6,9,3,8,1,27
191219488,7,9,8,0,0,24
191219489,5,8,7,4,7,31
191219490,2,4,3,5,7,21
191219491,2,8,0,1,1,12
191219492,8,6,7,2,6,29
191219493,0,0,2,5,8,15
191219494,3,7,3,1,0,14
191219495,8,7,7,2,6,30
191219496,4,5,6,5,0,20
191219497,9,4,3,1,6,23
191219498,5,5,7,6,7,30
191219499,2,7,9,5,5,28
191219500,4,7,1,5,9,26
191219501,5,3,8,4,1,21
191219502,9,8,9,3,6,35
191219503,1,6,0,7,8,22
191219504,9,6,0,2,7,24
191219505,6,3,7,6,5,27
191219506,5,6,2,7,9,29
191219507,8,9,0,6,5,28
191219508,1,8,4,8,0,21
191219509,2,3,0,4,9,18
191219510,5,3,0,3,4,15
191219511,6,1,1,5,6,19
191219512,4,2,9,9,7,31
191219513,4,4,4,6,2,20
191219514,5,2,8,7,2,24
191219515,6,4,4,9,3,26
191219516,8,5,2,0,2,17
191219517,4,4,1,3,6,18
191219518,1,1,2,2,8,14
191219519,2,9,3,1,9,24
191219520,1,5,1,4,4,15
191219521,9,5,1,7,2,24
191219522,3,7,5,2,8,25
191219523,5,2,7,1,6,21
191219524,2,6,5,6,9,28
191219525,1,9,9,0,8,27
191219526,5,5,6,7,0,23
191219527,5,6,6,8,4,29
191219528,8,0,3,0,2,13
191219529,4,9,9,6,6,34
191219530,6,0,3,0,6,15
191219531,3,5,8,8,8,32
191219532,2,7,9,0,3,21
191219533,8,6,0,7,6,27
191219534,0,8,5,8,4,25
191219535,2,0,6,4,8,20
191219536,2,3,6,2,5,18
191219537,6,6,3,9,9,33
191219538,1,8,4,4,2,19
191219539,1,6,4,6,2,19
191219540,8,6,0,8,7,29
191219541,8,9,7,2,6,32
191219542,8,6,1,4,3,22
191219543,1,3,0,8,8,20
191219544,4,2,5,8,3,22
191219545,7,3,2,0,0,12
191219546,2,4,5,8,9,28
191219547,4,4,7,8,8,31
191219548,3,0,1,5,5,14
191219549,4,3,7,9,4,27
191219550,1,1,0,9,2,13
191219551,2,2,4,7,7,22
191219552,2,4,0,9,2,17
191219553,4,0,4,5,8,21
191219554,5,1,3,9,9,27
191219555,3,8,2,0,7,20
191219556,0,1,8,9,5,23
191219557,5,1,7,6,5,24
191219558,6,7,2,0,3,18
191219559,1,6,2,0,9,18
191219560,1,5,4,2,2,14
191219561,8,1,0,7,3,19
191219562,4,8,2,9,5,28
191219563,2,6,9,4,0,21
191219564,7,7,1,9,2,26
191219565,5,5,9,2,1,22
191219566,7,7,7,7,0,28
191219567,1,4,1,5,7,18
191219568,5,0,9,3,4,21
191219569,3,4,6,5,2,20
191219570,8,7,6,3,2,26
191219571,7,4,2,9,4,26
191219572,4,5,0,8,7,24
191219573,6,7,0,5,1,19
191219574,9,1,6,7,4,27
191219575,8,6,2,9,5,30
191219576,7,7,8,9,0,31
191219577,1,2,5,0,3,11
191219578,7,3,1,7,4,22
191219579,9,8,0,2,5,24
191219580,0,4,1,1,1,7
191219581,3,2,8,6,6,25
191219582,5,4,5,2,8,24
191219583,2,6,3,5,4,20
191219584,8,5,3,9,7,32
191219585,3,8,4,5,7,27
191219586,4,4,1,6,7,22
191219587,6,6,4,6,3,25
191219588,7,1,2,1,5,16
191219589,9,1,3,4,1,18
191219590,0,6,8,4,7,25
191219591,1,8,6,6,4,25
191219592,3,5,2,2,7,19
191219593,1,3,9,4,8,25
191219594,0,6,6,3,7,22
191219595,4,0,0,7,3,14
191219596,1,6,0,9,8,24
191219597,1,3,0,3,3,10
191219598,9,6,5,8,6,34
191219599,3,6,9,6,9,33
191219600,8,0,1,2,1,12
191219601,4,3,6,4,9,26
191219602,4,0,7,5,3,19
191219603,9,0,8,4,8,29
191219604,9,2,1,0,9,21
191219605,5,6,3,6,6,26
191219606,8,6,5,8,6,33
191219607,2,7,7,4,6,26
191219608,1,9,0,7,6,23
191219609,7,0,4,0,0,11
191219610,1,6,2,6,2,17
191219611,8,5,5,8,1,27
191219612,6,8,1,0,4,19
191219613,3,9,4,0,5,21
191219614,9,6,2,4,6,27
191219615,8,7,1,5,3,24
191219616,0,0,8,5,0,13
191219617,8,9,1,0,7,25
191219618,9,7,9,1,7,33
191219619,1,3,6,9,5,24
191219620,1,8,2,3,2,16
191219621,0,5,5,8,3,21
191219622,4,5,8,2,2,21
191219623,6,7,1,8,4,26
191219624,0,3,8,1,8,20
191219625,8,7,4,2,9,30
191219626,8,4,3,7,0,22
191219627,3,3,4,4,7,21
191219628,2,2,5,1,6,16
191219629,0,3,1,1,4,9
191219630,1,9,3,2,5,20
191219631,5,4,1,1,0,11
191219632,7,9,6,3,4,29
191219633,0,1,4,5,4,14
191219634,9,8,7,5,5,34
191219635,5,8,1,8,8,30
191219636,5,5,5,3,1,19
191219637,0,7,8,5,1,21
191219638,3,8,1,5,2,19
191219639,2,2,6,7,2,19
191219640,4,2,3,8,2,19
191219641,6,6,0,5,5,22
191219642,8,0,5,1,3,17
191219643,2,9,2,9,8,30
191219644,5,3,2,4,2,16
191219645,2,8,8,5,8,31
191219646,1,7,4,5,8,25
191219647,7,4,3,9,9,32
191219648,7,2,1,1,6,17
191219649,6,9,8,6,1,30
191219650,6,5,6,9,0,26
191219651,3,7,9,6,5,30
191219652,6,5,5,5,1,22
191219653,4,4,6,0,5,19
191219654,0,6,6,5,3,20
191219655,3,1,6,8,5,23
191219656,8,6,1,5,1,21
191219657,6,1,2,0,9,18
191219658,5,8,4,0,4,21
191219659,7,4,6,2,9,28
191219660,2,6,0,0,5,13
191219661,1,1,8,8,1,19
191219662,4,7,6,6,9,32
191219663,1,3,5,9,3,21
191219664,5,4,5,6,4,24
191219665,7,9,8,9,4,37
191219666,6,2,6,6,4,24
191219667,0,0,6,4,6,16
191219668,5,2,6,7,2,22
191219669,2,1,2,1,6,12
191219670,4,2,1,3,9,19
191219671,8,5,0,5,4,22
191219672,3,8,9,4,3,27
191219673,2,8,4,0,9,23
191219674,5,6,5,1,2,19
191219675,6,7,9,2,2,26
191219676,2,9,5,6,6,28
191219677,1,3,4,4,5,17
191219678,8,4,7,7,0,26
191219679,8,1,9,2,5,25
191219680,6,4,8,3,5,26
191219681,8,3,0,9,1,21
191219682,3,5,3,8,4,23
191219683,5,0,0,1,7,13
191219684,7,6,9,3,3,28
191219685,2,3,5,4,7,21
191219686,6,9,4,1,2,22
191219687,0,9,6,9,9,33
191219688,4,0,7,0,7,18
191219689,6,4,0,5,9,24
191219690,7,6,1,7,6,27
191219691,5,9,9,6,6,35
191219692,1,5,3,6,0,15
191219693,3,9,4,9,0,25
191219694,1,8,0,8,6,23
191219695,0,1,6,5,6,18
191219696,5,6,7,4,2,24
191219697,3,7,7,4,9,30
191219698,9,7,8,8,3,35
191219699,7,8,0,5,9,29
191219700,2,7,6,9,3,27
191219701,9,7,0,8,3,27
191219702,1,2,4,8,1,16
191219703,3,1,9,1,4,18
191219704,3,5,8,2,1,19
191219705,7,6,6,2,6,27
191219706,2,2,8,8,0,20
191219707,6,2,0,0,3,11
191219708,3,2,0,4,5,14
191219709,4,9,1,0,4,18
191219710,6,3,7,4,4,24
191219711,0,9,6,3,4,22
191219712,5,4,5,8,8,30
191219713,0,1,8,2,9,20
191219714,4,0,6,2,0,12
191219715,1,6,9,6,4,26
191219716,6,3,4,8,5,26
191219717,6,2,2,2,5,17
191219718,9,4,3,1,8,25
191219719,9,4,4,6,9,32
191219720,7,9,4,7,3,30
191219721,2,8,5,4,1,20
191219722,9,5,4,8,6,32
191219723,4,0,0,3,7,14
191219724,6,3,3,4,2,18
191219725,3,9,4,0,0,16
191219726,2,9,0,3,3,17
191219727,4,5,4,0,1,14
191219728,7,5,4,5,1,22
191219729,2,5,9,6,2,24
191219730,1,0,2,6,9,18
191219731,9,9,1,8,4,31
191219732,9,9,3,7,8,36
191219733,1,5,5,3,9,23
191219734,4,1,7,6,5,23
191219735,2,1,6,2,3,14
191219736,9,9,6,4,0,28
191219737,6,0,3,0,8,17
191219738,7,1,2,7,1,18
191219739,6,5,3,0,9,23
191219740,7,1,7,5,8,28
191219741,6,9,4,1,5,25
191219742,1,7,4,2,3,17
191219743,1,2,4,5,6,18
191219744,4,1,4,7,2,18
191219745,3,0,5,7,2,17
191219746,1,0,5,2,2,10
191219747,7,1,9,7,5,29
191219748,8,2,8,4,9,31
191219749,3,1,4,3,6,17
191219750,7,0,1,9,8,25
191219751,7,9,9,0,5,30
191219752,2,3,2,5,7,19
191219753,6,4,7,8,6,31
191219754,5,3,3,1,0,12
191219755,7,6,3,9,3,28
191219756,6,3,5,8,9,31
191219757,7,5,3,1,2,18
191219758,4,8,5,4,7,28
191219759,5,7,2,9,5,28
191219760,5,1,5,9,8,28
191219761,1,0,7,4,5,17
191219762,4,5,1,3,4,17
191219763,1,6,4,9,5,25
191219764,3,9,0,3,9,24
191219765,5,9,7,5,0,26
191219766,9,6,3,1,6,25
191219767,5,2,6,2,6,21
191219768,5,6,9,9,6,35
191219769,2,5,0,7,8,22
191219770,9,3,9,0,6,27
191219771,1,3,5,0,5,14
191219772,0,7,7,8,6,28
191219773,6,4,2,8,0,20
191219774,9,9,7,8,6,39
191219775,7,9,4,7,1,28
191219776,8,4,4,0,9,25
191219777,6,6,6,4,1,23
191219778,6,8,0,6,0,20
191219779,9,4,0,1,2,16
191219780,1,7,7,6,2,23
191219781,2,4,1,3,0,10
191219782,1,2,5,9,7,24
191219783,6,5,1,5,4,21
191219784,6,3,3,5,6,23
191219785,4,1,4,8,3,20
191219786,5,4,3,4,9,25
191219787,7,3,9,6,9,34
191219788,6,0,5,1,1,13
191219789,3,6,8,3,3,23
191219790,8,6,2,6,5,27
191219791,9,0,5,3,4,21
191219792,9,4,4,4,7,28
191219793,2,1,5,4,0,12
191219794,3,8,0,0,1,12
191219795,8,0,7,2,9,26
191219796,3,6,0,9,3,21
191219797,8,1,8,0,7,24
191219798,5,1,4,2,5,17
191219799,4,0,2,2,1,9
191219800,7,4,1,9,2,23
191219801,0,9,7,5,0,21
191219802,5,6,5,7,0,23
191219803,2,0,9,7,1,19
191219804,6,6,0,7,6,25
191219805,3,1,8,3,2,17
191219806,9,8,3,2,4,26
191219807,1,1,9,7,4,22
191219808,3,4,8,9,0,24
191219809,8,1,7,0,9,25
191219810,5,6,8,0,4,23
191219811,5,7,0,1,3,16
191219812,1,4,5,6,5,21
191219813,3,2,7,3,0,15
191219814,1,3,4,7,2,17
191219815,0,9,5,0,7,21
191219816,2,3,7,0,2,14
191219817,9,1,1,1,0,12
191219818,8,1,7,6,6,28
191219819,9,7,2,6,6,30
191219820,1,2,6,3,7,19
191219821,0,9,4,2,8,23
191219822,4,5,2,8,2,21
191219823,8,6,3,2,6,25
191219824,8,8,2,2,4,24
191219825,0,6,9,1,2,18
191219826,0,3,2,6,5,16
191219827,2,9,8,1,3,23
191219828,2,2,6,4,3,17
191219829,5,2,4,0,9,20
191219830,2,6,2,5,1,16
191219831,3,6,5,3,9,26
191219832,1,7,9,1,3,21
191219833,7,1,2,4,2,16
191219834,5,7,1,1,3,17
191219835,9,4,9,9,1,32
191219836,2,2,6,3,2,15
191219837,8,5,3,9,2,27
191219838,3,0,2,7,1,13
191219839,7,9,6,1,6,29
191219840,7,4,9,1,6,27
191219841,8,3,3,9,8,31
191219842,7,5,0,5,4,21
191219843,4,0,5,9,8,26
191219844,8,9,8,5,9,39
191219845,2,1,6,7,9,25
191219846,4,3,3,5,1,16
191219847,8,4,1,2,2,17
191219848,5,9,7,3,4,28
191219849,9,9,3,2,7,30
191219850,9,0,3,6,4,22
191219851,0,7,2,0,1,10
191219852,2,2,5,2,0,11
191219853,5,0,3,2,3,13
191219854,5,5,7,7,7,31
191219855,9,0,5,9,6,29
191219856,5,8,3,4,4,24
191219857,7,5,2,5,7,26
191219858,7,4,8,8,0,27
191219859,9,0,9,5,4,27
191219860,9,5,0,9,6,29
191219861,4,5,3,1,3,16
191219862,7,4,0,5,9,25
191219863,2,7,3,1,1,14
191219864,6,5,5,4,7,27
191219865,1,7,4,7,1,20
191219866,7,9,4,8,8,36
191219867,4,8,8,4,9,33
191219868,8,0,1,9,1,19
191219869,1,2,6,5,7,21
191219870,6,1,1,2,2,12
191219871,6,7,0,2,9,24
191219872,1,0,1,2,3,7
191219873,9,5,2,1,5,22
191219874,8,1,2,5,0,16
191219875,1,8,2,3,4,18
191219876,1,9,3,1,2,16
191219877,3,9,9,9,1,31
191219878,7,6,4,9,7,33
191219879,2,4,4,4,0,14
191219880,0,5,9,5,5,24
191219881,3,9,8,1,2,23
191219882,9,4,6,1,0,20
191219883,6,0,4,9,6,25
191219884,7,0,8,1,0,16
191219885,2,8,1,0,4,15
191219886,8,2,3,2,9,24
191219887,6,8,0,2,4,20
191219888,6,4,7,8,3,28
191219889,0,0,6,7,0,13
191219890,4,8,4,5,8,29
191219891,7,9,8,8,6,38
191219892,7,4,5,9,9,34
191219893,1,6,1,0,1,9
191219894,7,6,3,2,7,25
191219895,7,0,8,1,1,17
191219896,8,1,9,4,1,23
191219897,2,9,1,2,8,22
191219898,1,6,1,6,2,16
191219899,6,9,2,6,1,24
191219900,5,4,8,3,1,21
191219901,2,4,0,7,1,14
191219902,9,1,5,8,8,31
191219903,9,2,4,1,3,19
191219904,1,5,5,7,2,20
191219905,2,0,8,3,6,19
191219906,9,0,9,5,7,30
191219907,8,0,7,0,0,15
191219908,6,2,1,4,7,20
191219909,7,6,3,5,5,26
191219910,0,6,0,9,5,20
191219911,0,3,6,8,7,24
191219912,9,3,9,9,2,32
191219913,5,7,9,3,3,27
191219914,7,4,1,4,7,23
191219915,5,0,1,2,8,16
191219916,5,0,8,9,2,24
191219917,8,8,4,4,7,31
191219918,4,6,0,2,4,16
191219919,0,1,5,1,0,7
191219920,9,1,1,7,7,25
191219921,8,4,3,6,0,21
191219922,3,5,0,6,1,15
191219923,5,9,3,4,4,25
191219924,5,2,9,9,8,33
191219925,9,9,5,0,8,31
191219926,5,8,5,1,7,26
191219927,2,7,4,4,1,18
191219928,0,4,2,2,7,15
191219929,0,3,4,9,2,18
191219930,5,0,5,7,5,22
191219931,7,3,4,4,5,23
191219932,0,6,6,9,0,21
191219933,2,6,4,9,8,29
191219934,9,6,1,9,6,31
191219935,7,8,1,3,3,22
191219936,0,6,5,9,7,27
191219937,9,6,6,9,1,31
191219938,8,8,1,5,5,27
191219939,9,1,4,5,9,28
191219940,1,3,9,9,2,24
191219941,5,6,3,3,0,17
191219942,5,0,1,4,4,14
191219943,0,4,4,4,7,19
191219944,7,2,2,9,0,20
191219945,5,8,7,5,7,32
191219946,3,2,3,0,2,10
191219947,7,4,6,5,9,31
191219948,7,7,7,0,5,26
191219949,9,4,1,8,9,31
191219950,0,6,9,3,1,19
191219951,9,1,7,3,8,28
191219952,7,0,3,1,2,13
191219953,6,9,5,0,2,22
191219954,4,2,4,9,5,24
191219955,1,3,2,6,3,15
191219956,0,1,7,8,9,25
191219957,4,3,1,6,3,17
191219958,4,2,8,6,3,23
191219959,9,8,0,6,7,30
191219960,8,1,9,3,4,25
191219961,6,1,6,2,8,23
191219962,5,0,3,7,9,24
191219963,7,5,4,7,3,26
191219964,4,3,7,6,3,23
191219965,8,9,6,0,9,32
191219966,3,1,4,5,7,20
191219967,0,8,5,8,8,29
191219968,2,6,2,6,5,21
191219969,2,9,5,5,6,27
191219970,2,0,6,6,9,23
191219971,9,8,0,5,0,22
191219972,6,4,4,3,8,25
191219973,9,8,6,2,1,26
191219974,2,5,2,3,3,15
191219975,6,6,2,2,4,20
191219976,4,1,2,6,8,21
191219977,3,8,4,8,5,28
191219978,1,8,0,7,8,24
191219979,2,5,3,6,9,25
191219980,7,6,0,8,3,24
191219981,1,3,7,1,6,18
191219982,2,4,1,2,9,18
191219983,9,2,5,1,1,18
191219984,1,7,8,1,9,26
191219985,2,4,6,7,3,22
191219986,3,0,4,0,1,8
191219987,9,5,7,4,8,33
191219988,4,8,9,1,7,29
191219989,4,3,7,0,3,17
191219990,6,7,7,8,0,28
191219991,5,5,4,2,6,22
191219992,7,5,4,0,7,23
191219993,9,2,9,2,9,31
191219994,5,3,5,5,8,26
191219995,9,0,3,8,3,23
191219996,3,0,7,3,3,16
191219997,6,7,2,4,0,19
191219998,3,8,8,5,6,30
191219999,0,4,0,4,8,16
1912191000,9,8,1,3,2,23
1912191001,7,9,2,5,6,29
1912191002,7,9,4,9,5,34
1912191003,0,0,3,0,7,10
1912191004,5,6,7,9,3,30
1912191005,9,1,6,3,1,20
1912191006,6,2,2,1,4,15
1912191007,2,9,7,1,5,24
1912191008,0,3,4,4,8,19
1912191009,0,6,7,0,0,13
1912191010,0,0,8,3,5,16
1912191011,1,7,6,9,3,26
1912191012,2,7,1,2,4,16
1912191013,0,5,5,9,8,27
1912191014,4,1,3,4,1,13
1912191015,7,8,8,0,5,28
1912191016,1,2,0,4,4,11
1912191017,8,6,5,3,1,23
1912191018,5,9,4,0,4,22
1912191019,8,1,9,4,2,24
1912191020,2,4,2,7,9,24
1912191021,0,6,9,8,0,23
1912191022,3,3,1,6,1,14
1912191023,6,0,1,0,8,15
1912191024,3,1,4,8,2,18
1912191025,5,4,8,1,6,24
1912191026,5,3,7,2,8,25
1912191027,3,0,3,4,5,15
1912191028,8,9,6,5,1,29
1912191029,3,7,7,1,6,24
1912191030,1,4,4,0,5,14
1912191031,4,6,8,1,7,26
1912191032,5,4,0,2,5,16
1912191033,1,3,0,9,7,20
1912191034,7,4,4,9,9,33
1912191035,0,6,2,8,3,19
1912191036,3,7,8,1,9,28
1912191037,5,0,5,3,6,19
1912191038,9,6,8,3,2,28
1912191039,0,4,9,2,8,23
1912191040,5,6,2,9,1,23
1912191041,1,9,1,7,8,26
1912191042,9,8,2,0,5,24
1912191043,6,3,1,3,9,22
1912191044,8,6,9,1,3,27
1912191045,5,4,0,5,4,18
1912191046,5,6,3,8,2,24
1912191047,5,5,5,1,0,16
1912191048,5,8,4,7,9,33
1912191049,9,3,2,5,2,21
1912191050,5,6,5,3,7,26
1912191051,7,5,9,1,9,31
1912191052,4,9,7,6,6,32
1912191053,6,3,1,8,9,27
1912191054,0,7,6,3,4,20
1912191055,4,0,6,6,7,23
1912191056,6,7,9,1,3,26
1912191057,1,2,0,5,5,13
1912191058,2,3,2,3,3,13
1912191059,5,0,7,6,4,22
1912191060,7,9,2,6,2,26
1912191061,2,6,7,9,9,33
1912191062,0,2,6,9,7,24
1912191063,5,3,3,9,4,24
1912191064,3,7,2,5,9,26
1912191065,5,5,7,2,7,26
1912191066,4,7,7,5,3,26
1912191067,9,3,6,0,0,18
1912191068,5,3,9,7,8,32
1912191069,4,1,0,9,7,21
1912191070,7,5,7,0,9,28
1912191071,4,0,2,5,3,14
1912191072,8,6,5,4,3,26
1912191073,9,6,8,7,5,35
1912191074,8,5,4,7,6,30
1912191075,6,4,4,1,7,22
1912191076,1,8,3,6,6,24
1912191077,8,6,0,2,5,21
1912191078,9,8,4,9,1,31
1912191079,6,6,7,5,8,32
1912191080,5,1,8,1,9,24
1912191081,9,1,2,6,9,27
1912191082,4,2,3,6,9,24
1912191083,5,3,4,0,8,20
1912191084,9,0,7,5,7,28
1912191085,7,7,6,2,7,29
1912191086,1,5,6,5,5,22
1912191087,1,6,8,0,1,16
1912191088,9,0,0,7,6,22
1912191089,3,6,4,6,8,27
1912191090,8,5,3,0,7,23
1912191091,6,9,3,2,9,29
1912191092,7,2,2,7,5,23
1912191093,7,7,1,0,5,20
1912191094,4,7,6,0,1,18
1912191095,2,3,2,6,9,22
1912191096,7,4,7,3,3,24
1912191097,3,5,5,6,5,24
1912191098,7,5,9,6,3,30
1912191099,1,6,3,2,1,13
1912191100,3,8,0,3,1,15
1912191101,1,8,0,2,9,20
1912191102,5,8,9,8,0,30
1912191103,3,5,8,5,2,23
1912191104,3,8,1,1,1,14
1912191105,7,4,6,7,9,33
191220001,0,6,0,1,4,11
191220002,7,0,5,7,8,27
191220003,8,3,6,3,9,29
191220004,2,9,3,0,9,23
191220005,5,9,8,2,5,29
191220006,2,6,4,0,5,17
191220007,5,6,6,0,6,23
191220008,3,8,2,8,5,26
191220009,8,1,4,9,3,25
191220010,8,4,8,8,0,28
191220011,1,8,2,8,2,21
191220012,9,3,7,5,4,28
191220013,8,6,8,7,9,38
191220014,1,5,1,1,4,12
191220015,5,7,7,4,2,25
191220016,7,1,1,9,7,25
191220017,4,1,2,1,5,13
191220018,7,2,8,2,2,21
191220019,4,8,0,7,3,22
191220020,3,7,5,3,5,23
191220021,7,1,1,0,5,14
191220022,1,2,0,5,8,16
191220023,7,6,7,4,7,31
191220024,9,5,9,8,9,40
191220025,9,0,5,1,2,17
191220026,1,5,4,0,3,13
191220027,6,9,2,3,6,26
191220028,4,3,8,2,0,17
191220029,6,9,5,3,3,26
191220030,2,9,1,1,7,20
191220031,3,9,2,7,0,21
191220032,0,0,7,8,0,15
191220033,4,8,6,8,5,31
191220034,0,3,7,2,1,13
191220035,2,6,4,3,2,17
191220036,3,4,9,0,3,19
191220037,7,5,7,1,7,27
191220038,1,7,8,2,1,19
191220039,9,4,5,2,5,25
191220040,0,0,2,2,9,13
191220041,3,7,5,9,6,30
191220042,1,4,3,1,0,9
191220043,7,6,3,4,4,24
191220044,4,8,3,3,4,22
191220045,6,4,1,5,0,16
191220046,0,0,8,9,8,25
191220047,5,1,4,2,2,14
191220048,0,3,5,6,0,14
191220049,4,7,2,5,8,26
191220050,6,7,9,8,8,38
191220051,2,5,5,6,6,24
191220052,6,1,8,3,9,27
191220053,4,7,1,1,7,20
191220054,1,9,0,2,3,15
191220055,7,4,5,5,0,21
191220056,8,2,5,7,9,31
191220057,1,6,8,5,8,28
191220058,4,9,9,2,1,25
191220059,5,6,7,0,1,19
191220060,8,0,0,7,4,19
191220061,1,5,1,7,5,19
191220062,2,8,8,0,6,24
191220063,6,9,0,1,1,17
191220064,7,2,9,0,7,25
191220065,2,3,2,6,7,20
191220066,4,4,3,3,0,14
191220067,7,0,3,8,1,19
191220068,7,7,9,2,8,33
191220069,7,8,5,3,7,30
191220070,7,4,0,8,5,24
191220071,3,0,7,7,1,18
191220072,4,6,8,3,3,24
191220073,0,2,8,7,9,26
191220074,7,0,0,8,0,15
191220075,1,8,9,8,8,34
191220076,2,3,1,8,8,22
191220077,9,8,5,0,0,22
191220078,2,2,6,8,2,20
191220079,7,8,9,7,8,39
191220080,4,0,7,7,2,20
191220081,2,3,8,4,7,24
191220082,4,7,1,7,3,22
191220083,4,9,6,3,0,22
191220084,5,7,3,8,7,30
191220085,2,5,6,1,2,16
191220086,9,6,1,5,1,22
191220087,3,0,1,4,8,16
191220088,6,5,7,3,8,29
191220089,0,1,4,7,0,12
191220090,0,4,8,3,2,17
191220091,0,7,6,3,2,18
191220092,7,3,9,3,1,23
191220093,6,9,8,6,0,29
191220094,4,6,7,5,1,23
191220095,5,5,8,1,1,20
191220096,0,7,8,2,5,22
191220097,7,2,7,7,2,25
191220098,3,6,1,0,7,17
191220099,8,3,7,8,4,30
191220100,3,3,8,6,6,26
191220101,3,1,0,9,3,16
191220102,5,8,9,2,9,33
191220103,4,4,3,7,4,22
191220104,8,2,1,5,4,20
191220105,3,6,0,1,0,10
191220106,8,6,4,4,1,23
191220107,6,3,5,3,5,22
191220108,3,4,3,0,6,16
191220109,8,8,3,0,4,23
191220110,3,4,1,8,2,18
191220111,0,0,7,4,3,14
191220112,6,3,3,6,1,19
191220113,9,4,4,3,3,23
191220114,8,2,9,4,0,23
191220115,6,2,1,6,9,24
191220116,9,3,9,2,8,31
191220117,7,3,9,4,2,25
191220118,2,3,5,8,7,25
191220119,6,4,5,2,7,24
191220120,2,0,9,2,6,19
191220121,4,1,2,4,6,17
191220122,1,8,9,1,8,27
191220123,4,3,9,2,5,23
191220124,2,9,7,1,9,28
191220125,9,1,3,8,9,30
191220126,8,1,5,9,5,28
191220127,4,0,1,7,0,12
191220128,0,4,7,1,1,13
191220129,1,2,4,8,3,18
191220130,0,8,9,5,5,27
191220131,6,2,5,6,1,20
191220132,1,1,8,3,8,21
191220133,9,2,5,3,1,20
191220134,0,0,5,6,0,11
191220135,6,7,5,2,3,23
191220136,1,6,4,3,0,14
191220137,1,0,8,4,5,18
191220138,3,9,0,5,4,21
191220139,6,5,5,2,2,20
191220140,1,8,6,6,6,27
191220141,8,2,1,0,9,20
191220142,5,8,9,4,6,32
191220143,8,7,8,3,8,34
191220144,0,1,6,8,6,21
191220145,0,6,8,2,0,16
191220146,7,9,8,9,3,36
191220147,7,0,2,6,1,16
191220148,2,8,1,1,1,13
191220149,0,4,0,3,7,14
191220150,3,1,6,8,4,22
191220151,1,0,4,3,5,13
191220152,8,3,8,7,3,29
191220153,1,4,9,4,7,25
191220154,7,7,4,6,6,30
191220155,6,7,1,1,4,19
191220156,0,5,9,9,5,28
191220157,4,1,5,1,7,18
191220158,4,6,4,4,9,27
191220159,9,9,7,7,3,35
191220160,5,7,9,7,4,32
191220161,6,1,0,8,2,17
191220162,9,1,6,2,8,26
191220163,1,1,6,4,4,16
191220164,4,6,3,2,8,23
191220165,5,7,6,3,8,29
191220166,5,9,3,7,5,29
191220167,5,3,7,4,8,27
191220168,5,4,2,8,3,22
191220169,7,8,8,9,8,40
191220170,5,4,3,9,3,24
191220171,7,1,6,6,6,26
191220172,9,3,6,4,6,28
191220173,9,8,1,0,3,21
191220174,4,1,4,1,4,14
191220175,8,0,7,6,7,28
191220176,0,8,8,0,1,17
191220177,4,6,2,6,4,22
191220178,3,8,9,4,2,26
191220179,9,7,5,0,4,25
191220180,3,9,6,8,4,30
191220181,6,5,8,9,9,37
191220182,6,9,2,7,4,28
191220183,0,7,2,5,9,23
191220184,3,3,8,8,0,22
191220185,7,6,4,4,6,27
191220186,0,4,0,8,9,21
191220187,1,7,8,0,4,20
191220188,5,2,2,7,6,22
191220189,0,5,4,6,9,24
191220190,0,2,0,8,7,17
191220191,0,8,4,6,1,19
191220192,3,0,1,5,4,13
191220193,0,8,7,7,0,22
191220194,1,4,0,5,1,11
191220195,1,6,9,9,4,29
191220196,4,6,6,4,6,26
191220197,0,2,9,4,2,17
191220198,3,7,4,6,5,25
191220199,1,9,2,6,6,24
191220200,9,1,6,0,5,21
191220201,9,4,5,8,9,35
191220202,2,4,8,3,1,18
191220203,0,3,4,6,6,19
191220204,5,4,4,9,4,26
191220205,5,5,7,8,5,30
191220206,5,1,0,8,1,15
191220207,7,9,0,5,0,21
191220208,0,6,1,1,8,16
191220209,2,2,1,8,7,20
191220210,0,2,1,1,3,7
191220211,0,9,6,6,4,25
191220212,6,8,1,9,0,24
191220213,6,7,5,0,9,27
191220214,9,2,3,6,1,21
191220215,6,2,8,0,4,20
191220216,7,9,3,2,7,28
191220217,8,2,7,2,3,22
191220218,6,5,8,8,6,33
191220219,0,8,0,2,8,18
191220220,4,8,4,5,9,30
191220221,1,8,8,2,4,23
191220222,9,6,0,0,8,23
191220223,3,2,5,7,2,19
191220224,7,6,4,5,3,25
191220225,1,2,8,9,2,22
191220226,4,4,5,2,6,21
191220227,6,8,6,1,2,23
191220228,6,9,4,1,1,21
191220229,7,4,1,0,3,15
191220230,0,1,4,1,6,12
191220231,4,4,8,8,3,27
191220232,8,2,9,4,1,24
191220233,1,3,1,1,4,10
191220234,8,7,2,8,1,26
191220235,9,9,5,6,8,37
191220236,1,9,2,6,9,27
191220237,0,4,4,6,7,21
191220238,0,0,1,3,8,12
191220239,3,3,6,4,0,16
191220240,1,9,8,4,6,28
191220241,3,3,2,4,3,15
191220242,6,4,3,4,4,21
191220243,3,1,4,4,1,13
191220244,7,6,9,4,8,34
191220245,1,1,2,1,7,12
191220246,8,6,5,2,8,29
191220247,1,4,2,5,8,20
191220248,0,9,8,6,7,30
191220249,1,9,5,8,0,23
191220250,3,7,7,7,3,27
191220251,2,5,7,7,8,29
191220252,6,5,9,8,4,32
191220253,3,1,6,6,1,17
191220254,1,0,0,7,8,16
191220255,8,7,0,1,7,23
191220256,4,7,0,1,8,20
191220257,8,6,1,2,2,19
191220258,7,8,6,5,6,32
191220259,2,4,9,7,9,31
191220260,8,6,4,6,9,33
191220261,1,4,2,6,3,16
191220262,4,6,1,6,4,21
191220263,8,9,6,2,7,32
191220264,6,5,5,7,0,23
191220265,5,5,7,5,9,31
191220266,9,4,1,9,9,32
191220267,4,2,2,0,1,9
191220268,6,0,7,7,5,25
191220269,3,5,2,5,9,24
191220270,9,2,0,5,5,21
191220271,6,6,3,5,4,24
191220272,7,4,1,7,5,24
191220273,6,6,1,7,6,26
191220274,0,1,5,4,3,13
191220275,0,8,3,3,8,22
191220276,1,6,0,2,1,10
191220277,1,3,2,9,7,22
191220278,5,1,0,1,3,10
191220279,8,5,0,8,6,27
191220280,3,1,2,1,3,10
191220281,9,1,5,7,0,22
191220282,5,4,7,9,2,27
191220283,7,4,5,1,1,18
191220284,6,3,2,8,8,27
191220285,7,8,8,8,7,38
191220286,2,6,7,2,8,25
191220287,1,8,3,4,6,22
191220288,3,9,4,3,3,22
191220289,7,8,2,9,9,35
191220290,8,3,8,1,5,25
191220291,1,7,1,3,8,20
191220292,1,4,5,8,9,27
191220293,1,3,4,8,2,18
191220294,5,7,8,9,4,33
191220295,3,9,2,3,5,22
191220296,9,8,2,6,1,26
191220297,6,3,8,9,0,26
191220298,3,9,8,9,1,30
191220299,2,9,2,6,3,22
191220300,3,3,6,6,3,21
191220301,0,4,3,7,6,20
191220302,4,9,0,1,9,23
191220303,0,3,1,4,7,15
191220304,3,5,7,1,3,19
191220305,1,5,5,1,3,15
191220306,1,9,8,7,9,34
191220307,0,0,8,1,2,11
191220308,8,4,0,6,3,21
191220309,2,3,6,6,4,21
191220310,3,1,5,7,0,16
191220311,1,0,3,7,6,17
191220312,3,6,9,0,9,27
191220313,6,4,6,8,7,31
191220314,9,5,5,3,1,23
191220315,0,9,3,6,6,24
191220316,6,9,3,2,4,24
191220317,6,8,8,8,6,36
191220318,2,0,7,4,1,14
191220319,3,8,1,4,7,23
191220320,1,7,1,8,8,25
191220321,0,7,2,2,7,18
191220322,2,4,8,8,9,31
191220323,3,6,3,4,4,20
191220324,5,0,4,2,2,13
191220325,1,6,2,8,2,19
191220326,9,1,1,4,9,24
191220327,4,4,6,5,1,20
191220328,5,5,4,5,2,21
191220329,4,2,5,7,0,18
191220330,0,1,4,3,9,17
191220331,5,1,4,0,8,18
191220332,8,8,6,4,5,31
191220333,5,8,5,6,5,29
191220334,5,1,2,6,8,22
191220335,3,9,2,0,2,16
191220336,0,5,1,3,0,9
191220337,9,4,7,7,4,31
191220338,7,7,6,9,9,38
191220339,5,2,2,1,5,15
191220340,7,8,0,1,5,21
191220341,0,4,8,0,6,18
191220342,4,6,9,5,0,24
191220343,2,7,4,9,9,31
191220344,4,4,0,2,3,13
191220345,8,1,7,2,4,22
191220346,3,1,9,2,0,15
191220347,7,9,9,8,2,35
191220348,4,4,0,5,9,22
191220349,7,7,0,0,8,22
191220350,8,8,5,8,8,37
191220351,2,0,3,7,4,16
191220352,1,3,4,4,4,16
191220353,8,8,9,4,5,34
191220354,9,0,2,7,1,19
191220355,5,0,2,7,5,19
191220356,4,8,9,4,1,26
191220357,9,2,4,4,7,26
191220358,1,1,5,7,4,18
191220359,1,3,7,9,0,20
191220360,8,5,4,7,2,26
191220361,2,6,1,6,5,20
191220362,1,4,1,5,9,20
191220363,3,4,2,1,9,19
191220364,0,9,9,4,5,27
191220365,0,4,3,1,8,16
191220366,2,5,2,7,6,22
191220367,5,6,4,4,6,25
191220368,0,3,8,7,4,22
191220369,2,2,3,7,9,23
191220370,7,1,5,5,8,26
191220371,3,5,6,8,4,26
191220372,0,6,7,3,6,22
191220373,8,3,0,2,6,19
191220374,9,0,6,6,4,25
191220375,1,1,8,4,0,14
191220376,3,5,1,5,4,18
191220377,4,7,1,8,9,29
191220378,3,4,0,4,3,14
191220379,2,2,0,1,5,10
191220380,2,0,2,4,8,16
191220381,3,5,8,4,0,20
191220382,0,8,9,8,7,32
191220383,1,6,1,3,8,19
191220384,8,5,2,0,6,21
191220385,2,5,4,9,1,21
191220386,9,1,8,3,2,23
191220387,1,8,1,8,8,26
191220388,5,4,2,7,7,25
191220389,8,8,5,9,7,37
191220390,4,8,5,7,3,27
191220391,8,2,6,4,9,29
191220392,5,1,1,4,1,12
191220393,7,7,5,9,2,30
191220394,3,9,6,3,6,27
191220395,0,9,8,5,0,22
191220396,0,8,0,8,2,18
191220397,4,8,1,2,3,18
191220398,0,1,4,8,1,14
191220399,4,0,1,9,6,20
191220400,6,8,5,8,9,36
191220401,0,5,2,4,8,19
191220402,6,3,0,8,6,23
191220403,1,0,3,4,0,8
191220404,7,1,5,5,5,23
191220405,1,5,0,6,2,14
191220406,0,1,3,6,6,16
191220407,2,5,3,6,4,20
191220408,6,3,1,1,9,20
191220409,5,5,1,0,7,18
191220410,1,2,3,7,0,13
191220411,1,9,8,9,5,32
191220412,5,2,0,3,1,11
191220413,8,4,6,4,3,25
191220414,7,5,6,2,6,26
191220415,3,3,7,0,6,19
191220416,9,8,1,6,9,33
191220417,8,1,0,0,9,18
191220418,1,8,6,8,2,25
191220419,9,5,5,3,2,24
191220420,2,8,5,1,4,20
191220421,1,8,9,9,0,27
191220422,3,9,1,5,1,19
191220423,7,3,3,0,0,13
191220424,5,7,6,5,8,31
191220425,1,8,9,2,9,29
191220426,5,4,8,1,2,20
191220427,7,4,3,9,6,29
191220428,3,1,7,3,2,16
191220429,0,8,6,5,5,24
191220430,2,2,9,8,7,28
191220431,5,4,1,6,1,17
191220432,5,5,9,2,9,30
191220433,8,3,3,1,1,16
191220434,3,8,0,7,1,19
191220435,0,8,5,0,7,20
191220436,4,8,8,2,5,27
191220437,0,8,6,2,4,20
191220438,1,3,3,2,8,17
191220439,7,0,5,4,4,20
191220440,3,5,0,0,3,11
191220441,5,1,9,2,8,25
191220442,0,0,4,9,7,20
191220443,0,0,7,4,6,17
191220444,5,1,3,8,3,20
191220445,5,1,3,8,4,21
191220446,6,1,3,3,4,17
191220447,5,6,8,5,1,25
191220448,9,0,4,7,3,23
191220449,7,6,2,3,2,20
191220450,0,6,1,6,9,22
191220451,9,9,1,7,8,34
191220452,3,4,0,1,5,13
191220453,9,1,9,1,1,21
191220454,3,2,5,8,7,25
191220455,4,8,8,4,5,29
191220456,0,4,1,0,5,10
191220457,5,2,3,7,9,26
191220458,7,9,6,0,9,31
191220459,5,0,2,8,9,24
191220460,5,0,3,4,1,13
191220461,2,7,7,0,1,17
191220462,4,9,7,7,4,31
191220463,2,1,4,1,6,14
191220464,6,1,3,6,9,25
191220465,1,6,0,1,4,12
191220466,7,7,2,9,5,30
191220467,5,1,5,0,7,18
191220468,2,5,9,8,5,29
191220469,8,9,0,1,9,27
191220470,0,8,9,1,4,22
191220471,5,6,3,6,8,28
191220472,5,5,6,3,9,28
191220473,8,1,1,8,1,19
191220474,1,1,3,0,4,9
191220475,1,3,9,9,4,26
191220476,3,9,3,3,9,27
191220477,4,1,0,5,5,15
191220478,5,7,5,6,7,30
191220479,7,6,7,5,8,33
191220480,2,3,5,6,0,16
191220481,6,3,0,3,9,21
191220482,5,9,4,0,6,24
191220483,3,8,5,6,6,28
191220484,8,2,2,4,4,20
191220485,8,3,5,7,9,32
191220486,2,0,8,2,9,21
191220487,6,7,5,9,3,30
191220488,0,4,5,6,9,24
191220489,3,7,3,0,3,16
191220490,5,7,8,5,9,34
191220491,0,2,0,7,7,16
191220492,9,0,8,7,5,29
191220493,6,6,6,3,8,29
191220494,0,4,5,4,0,13
191220495,8,1,1,3,4,17
191220496,1,5,3,5,7,21
191220497,0,5,5,1,7,18
191220498,5,3,9,5,5,27
191220499,1,5,5,4,0,15
191220500,0,5,2,3,8,18
191220501,0,0,5,9,9,23
191220502,3,8,2,1,7,21
191220503,8,3,5,1,9,26
191220504,9,9,2,5,7,32
191220505,5,3,5,1,4,18
191220506,5,9,9,8,5,36
191220507,5,0,7,8,7,27
191220508,1,3,6,6,4,20
191220509,1,1,4,2,5,13
191220510,0,0,8,6,3,17
191220511,7,5,1,0,0,13
191220512,1,3,0,4,7,15
191220513,7,3,2,4,6,22
191220514,7,6,9,7,1,30
191220515,0,4,8,7,9,28
191220516,4,2,1,6,1,14
191220517,7,1,0,1,3,12
191220518,2,1,7,7,8,25
191220519,0,9,1,8,0,18
191220520,2,5,0,9,4,20
191220521,5,7,1,9,1,23
191220522,7,0,6,8,5,26
191220523,2,2,1,6,8,19
191220524,6,8,3,5,2,24
191220525,0,5,2,2,2,11
191220526,2,9,4,7,8,30
191220527,4,1,6,3,8,22
191220528,6,2,4,5,7,24
191220529,8,9,4,0,0,21
191220530,2,3,0,8,7,20
191220531,4,7,8,3,1,23
191220532,9,7,5,5,5,31
191220533,9,5,6,4,0,24
191220534,6,3,9,5,3,26
191220535,5,8,8,4,8,33
191220536,1,3,4,0,3,11
191220537,9,8,0,2,7,26
191220538,8,9,6,0,4,27
191220539,9,9,5,6,9,38
191220540,0,1,3,4,2,10
191220541,3,4,1,8,1,17
191220542,0,2,9,3,2,16
191220543,3,0,4,9,0,16
191220544,1,9,9,7,0,26
191220545,2,1,6,1,8,18
191220546,2,4,0,3,1,10
191220547,7,5,5,4,2,23
191220548,8,2,4,7,4,25
191220549,7,6,2,0,3,18
191220550,7,8,1,8,0,24
191220551,1,7,4,7,3,22
191220552,6,0,0,6,4,16
191220553,1,5,7,5,0,18
191220554,4,4,5,6,4,23
191220555,8,8,3,3,6,28
191220556,8,7,2,8,3,28
191220557,6,8,6,1,9,30
191220558,4,9,3,1,3,20
191220559,2,3,1,3,8,17
191220560,2,3,8,8,5,26
191220561,5,7,9,1,3,25
191220562,1,9,4,4,0,18
191220563,6,9,1,4,6,26
191220564,8,6,3,2,2,21
191220565,2,2,7,3,0,14
191220566,0,3,6,3,4,16
191220567,6,3,5,2,9,25
191220568,5,6,8,6,4,29
191220569,5,4,2,0,7,18
191220570,3,2,4,9,5,23
191220571,6,6,0,2,8,22
191220572,3,9,6,1,9,28
191220573,7,8,0,3,8,26
191220574,0,7,2,8,1,18
191220575,3,7,0,8,5,23
191220576,4,9,5,7,0,25
191220577,5,3,3,6,5,22
191220578,9,5,0,1,3,18
191220579,7,6,9,5,2,29
191220580,8,7,4,7,2,28
191220581,3,3,8,6,9,29
191220582,5,2,6,9,4,26
191220583,1,6,6,0,0,13
191220584,3,7,3,9,8,30
191220585,0,2,2,8,2,14
191220586,1,9,0,9,3,22
191220587,8,7,1,1,1,18
191220588,4,9,4,3,0,20
191220589,6,9,1,8,1,25
191220590,2,4,4,1,1,12
191220591,2,0,5,4,9,20
191220592,6,9,0,9,2,26
191220593,2,4,9,6,2,23
191220594,9,0,9,3,4,25
191220595,9,3,0,7,7,26
191220596,2,6,6,0,5,19
191220597,1,9,6,4,5,25
191220598,8,4,7,4,3,26
191220599,7,8,8,1,9,33
191220600,9,2,1,0,2,14
191220601,4,6,8,1,3,22
191220602,1,2,1,7,7,18
191220603,3,9,3,7,2,24
191220604,3,4,3,9,0,19
191220605,1,9,7,5,2,24
191220606,0,7,9,9,1,26
191220607,8,3,6,3,6,26
191220608,4,4,5,2,3,18
191220609,3,6,5,7,5,26
191220610,2,1,0,0,3,6
191220611,4,7,2,2,6,21
191220612,8,7,7,0,6,28
191220613,1,3,5,0,7,16
191220614,2,7,2,6,9,26
191220615,0,7,9,4,5,25
191220616,8,1,3,6,6,24
191220617,8,9,4,1,8,30
191220618,2,1,2,0,2,7
191220619,6,7,1,3,2,19
191220620,9,6,8,3,5,31
191220621,3,3,5,8,8,27
191220622,8,6,7,2,9,32
191220623,2,6,4,4,9,25
191220624,6,7,9,6,4,32
191220625,6,4,6,7,0,23
191220626,4,0,9,5,3,21
191220627,6,6,2,2,0,16
191220628,0,0,2,8,4,14
191220629,3,1,6,4,5,19
191220630,6,8,8,8,8,38
191220631,6,0,4,4,9,23
191220632,6,0,8,2,2,18
191220633,3,4,3,6,0,16
191220634,0,1,8,1,2,12
191220635,3,5,8,8,2,26
191220636,1,0,0,8,0,9
191220637,6,0,8,7,3,24
191220638,3,9,0,4,8,24
191220639,1,6,5,8,3,23
191220640,3,8,7,8,9,35
191220641,9,1,4,5,8,27
191220642,9,5,3,7,7,31
191220643,3,6,7,8,1,25
191220644,4,3,9,6,1,23
191220645,0,1,0,2,2,5
191220646,5,5,8,9,4,31
191220647,3,5,1,8,2,19
191220648,8,2,4,1,7,22
191220649,9,6,6,9,3,33
191220650,3,1,6,7,9,26
191220651,2,2,6,9,3,22
191220652,7,7,2,2,6,24
191220653,7,5,5,1,9,27
191220654,1,1,5,9,9,25
191220655,3,7,3,9,1,23
191220656,6,3,2,7,0,18
191220657,6,1,4,2,5,18
191220658,2,6,2,2,6,18
191220659,3,7,6,2,8,26
191220660,1,3,3,5,3,15
191220661,0,5,9,3,3,20
191220662,8,2,6,1,6,23
191220663,2,2,5,3,2,14
191220664,0,2,1,9,7,19
191220665,1,4,8,1,6,20
191220666,4,5,4,0,5,18
191220667,3,0,9,1,0,13
191220668,5,8,5,4,5,27
191220669,9,0,8,8,5,30
191220670,9,5,2,6,8,30
191220671,2,6,5,5,0,18
191220672,7,8,4,0,4,23
191220673,6,7,1,5,8,27
191220674,2,2,4,3,8,19
191220675,8,0,5,0,7,20
191220676,6,6,9,8,5,34
191220677,7,5,8,4,7,31
191220678,4,8,3,6,9,30
191220679,4,0,4,8,6,22
191220680,2,6,2,7,2,19
191220681,5,2,5,2,5,19
191220682,0,9,5,9,4,27
191220683,0,2,7,3,1,13
191220684,3,1,3,1,4,12
191220685,8,9,9,6,5,37
191220686,5,5,7,4,7,28
191220687,2,9,2,3,2,18
191220688,0,0,9,7,5,21
191220689,9,7,8,6,9,39
191220690,3,3,6,1,1,14
191220691,1,2,3,8,1,15
191220692,9,2,7,9,7,34
191220693,6,4,7,9,4,30
191220694,8,5,3,7,1,24
191220695,8,5,9,5,8,35
191220696,7,6,5,7,8,33
191220697,8,2,9,8,8,35
191220698,1,3,9,9,8,30
191220699,7,3,3,1,3,17
191220700,9,4,6,9,9,37
191220701,8,4,4,2,4,22
191220702,4,1,3,7,3,18
191220703,4,3,5,1,9,22
191220704,2,4,9,9,5,29
191220705,9,6,8,9,6,38
191220706,2,6,1,5,2,16
191220707,1,4,3,8,9,25
191220708,4,6,5,6,2,23
191220709,9,5,2,4,1,21
191220710,9,2,0,0,2,13
191220711,4,6,2,7,6,25
191220712,8,3,2,0,9,22
191220713,8,0,4,3,0,15
191220714,6,0,6,2,4,18
191220715,8,0,1,3,2,14
191220716,8,7,6,7,0,28
191220717,6,6,0,9,1,22
191220718,8,1,8,6,3,26
191220719,8,7,8,1,6,30
191220720,2,5,7,1,0,15
191220721,1,0,3,8,1,13
191220722,2,7,5,2,0,16
191220723,4,9,2,0,6,21
191220724,8,8,4,8,5,33
191220725,6,1,9,0,2,18
191220726,0,4,8,5,9,26
191220727,4,9,9,5,3,30
191220728,2,8,3,8,9,30
191220729,9,0,9,3,9,30
191220730,8,9,6,6,8,37
191220731,2,0,4,4,2,12
191220732,5,8,2,2,3,20
191220733,2,9,5,0,8,24
191220734,2,0,7,4,2,15
191220735,5,2,4,8,5,24
191220736,0,2,1,2,5,10
191220737,7,3,7,6,5,28
191220738,3,0,4,7,0,14
191220739,9,2,8,0,0,19
191220740,6,8,5,8,3,30
191220741,1,1,5,7,5,19
191220742,7,4,0,4,7,22
191220743,9,3,3,3,8,26
191220744,5,8,8,0,4,25
191220745,4,5,9,1,3,22
191220746,9,3,9,3,8,32
191220747,8,8,4,7,9,36
191220748,5,3,3,3,4,18
191220749,7,9,2,1,2,21
191220750,4,0,9,8,4,25
191220751,6,5,7,5,7,30
191220752,3,5,7,5,8,28
191220753,4,5,0,7,2,18
191220754,1,0,8,5,5,19
191220755,7,8,0,1,9,25
191220756,8,8,8,5,9,38
191220757,2,4,6,7,7,26
191220758,2,5,3,2,1,13
191220759,8,4,5,4,1,22
191220760,7,6,5,8,2,28
191220761,1,7,9,0,5,22
191220762,7,7,0,9,0,23
191220763,6,5,3,2,9,25
191220764,5,5,7,5,5,27
191220765,7,1,2,5,1,16
191220766,3,3,6,8,4,24
191220767,4,6,5,3,7,25
191220768,4,4,4,9,8,29
191220769,7,1,3,7,7,25
191220770,3,3,5,5,5,21
191220771,2,8,4,4,2,20
191220772,2,3,7,5,5,22
191220773,8,0,5,7,8,28
191220774,8,5,8,8,4,33
191220775,7,1,8,8,6,30
191220776,9,4,8,8,1,30
191220777,4,3,8,7,1,23
191220778,3,5,1,9,0,18
191220779,8,3,2,1,0,14
191220780,1,6,0,7,7,21
191220781,3,6,6,8,2,25
191220782,9,9,5,5,7,35
191220783,3,5,1,0,0,9
191220784,8,5,5,4,2,24
191220785,8,3,3,7,1,22
191220786,1,2,6,3,9,21
191220787,6,8,2,5,2,23
191220788,0,4,2,7,2,15
191220789,8,2,4,8,3,25
191220790,5,0,4,7,9,25
191220791,0,4,3,2,7,16
191220792,3,7,2,8,6,26
191220793,2,2,0,4,5,13
191220794,8,4,9,9,6,36
191220795,0,8,8,8,8,32
191220796,3,7,9,8,2,29
191220797,9,7,0,1,4,21
191220798,6,5,6,0,4,21
191220799,0,0,9,3,9,21
191220800,1,1,5,3,4,14
191220801,4,0,8,8,9,29
191220802,0,7,4,3,8,22
191220803,2,2,9,9,7,29
191220804,4,6,7,4,8,29
191220805,6,0,2,7,7,22
191220806,3,6,7,4,6,26
191220807,1,1,3,4,7,16
191220808,5,2,6,2,0,15
191220809,2,8,8,4,9,31
191220810,2,3,3,9,4,21
191220811,6,0,9,8,7,30
191220812,2,4,9,2,7,24
191220813,5,8,8,5,1,27
191220814,6,5,4,2,5,22
191220815,2,7,9,6,7,31
191220816,8,4,3,3,3,21
191220817,4,0,9,9,4,26
191220818,2,0,0,0,9,11
191220819,9,5,3,6,4,27
191220820,1,9,3,4,1,18
191220821,9,6,8,1,5,29
191220822,4,7,5,6,1,23
191220823,2,2,1,6,9,20
191220824,3,8,2,8,7,28
191220825,0,1,6,8,1,16
191220826,3,2,8,5,5,23
191220827,8,3,2,9,1,23
191220828,8,2,5,8,9,32
191220829,8,9,3,3,6,29
191220830,7,2,0,4,9,22
191220831,2,0,7,8,8,25
191220832,6,2,7,1,1,17
191220833,5,0,6,2,8,21
191220834,7,9,7,8,9,40
191220835,1,2,2,3,9,17
191220836,3,4,2,2,5,16
191220837,2,8,7,9,9,35
191220838,0,1,0,1,6,8
191220839,3,1,9,7,4,24
191220840,3,4,5,7,4,23
191220841,1,9,2,1,6,19
191220842,0,2,7,5,1,15
191220843,6,6,2,0,6,20
191220844,0,3,3,1,7,14
191220845,7,0,5,3,2,17
191220846,2,5,9,0,4,20
191220847,1,3,7,5,0,16
191220848,2,2,8,7,1,20
191220849,3,1,3,9,4,20
191220850,0,7,1,6,7,21
191220851,3,7,7,2,8,27
191220852,1,1,8,9,6,25
191220853,4,0,2,2,0,8
191220854,3,7,5,6,8,29
191220855,5,2,2,1,9,19
191220856,4,1,9,4,4,22
191220857,5,8,5,2,9,29
191220858,1,9,3,8,9,30
191220859,6,7,8,7,3,31
191220860,9,2,3,8,2,24
191220861,2,2,7,3,6,20
191220862,4,4,1,8,8,25
191220863,1,6,1,2,4,14
191220864,9,5,6,8,3,31
191220865,0,6,0,4,8,18
191220866,0,4,2,4,9,19
191220867,8,8,3,1,3,23
191220868,7,2,8,0,5,22
191220869,8,4,1,2,3,18
191220870,1,4,2,6,9,22
191220871,3,4,4,8,7,26
191220872,1,9,6,1,5,22
191220873,7,8,5,7,3,30
191220874,9,4,6,9,1,29
191220875,2,7,4,9,5,27
191220876,9,5,1,5,5,25
191220877,6,2,2,4,5,19
191220878,1,5,9,3,3,21
191220879,9,2,3,4,2,20
191220880,0,1,6,7,6,20
191220881,9,8,2,0,7,26
191220882,4,1,8,0,1,14
191220883,9,6,1,8,7,31
191220884,2,2,5,0,6,15
191220885,0,2,9,1,2,14
191220886,5,5,9,0,5,24
191220887,3,2,2,1,1,9
191220888,5,2,8,4,1,20
191220889,9,4,0,7,3,23
191220890,4,3,7,6,7,27
191220891,7,9,2,2,9,29
191220892,6,6,3,9,7,31
191220893,2,1,9,4,8,24
191220894,7,4,3,6,4,24
191220895,9,4,1,0,0,14
191220896,0,6,9,1,1,17
191220897,8,7,0,9,9,33
191220898,1,6,3,3,1,14
191220899,6,7,7,3,1,24
191220900,4,0,0,1,4,9
191220901,3,2,6,5,1,17
191220902,2,9,4,6,3,24
191220903,1,7,6,1,2,17
191220904,0,4,0,8,6,18
191220905,4,2,9,7,2,24
191220906,7,3,4,3,6,23
191220907,0,4,8,2,5,19
191220908,7,7,8,1,0,23
191220909,6,6,9,5,9,35
191220910,0,3,2,3,3,11
191220911,8,2,1,9,6,26
191220912,1,1,3,8,0,13
191220913,5,5,6,3,4,23
191220914,1,4,6,8,2,21
191220915,8,6,0,5,9,28
191220916,0,5,7,6,4,22
191220917,7,8,1,2,2,20
191220918,2,6,4,6,5,23
191220919,6,1,2,9,3,21
191220920,3,8,1,6,1,19
191220921,2,3,8,7,9,29
191220922,9,9,6,7,9,40
191220923,0,4,2,3,4,13
191220924,1,5,0,2,1,9
191220925,1,9,6,1,2,19
191220926,2,2,7,7,5,23
191220927,7,8,9,7,3,34
191220928,4,6,3,2,3,18
191220929,3,5,0,7,5,20
191220930,6,2,9,1,8,26
191220931,1,1,2,1,6,11
191220932,6,0,4,4,5,19
191220933,5,1,6,4,3,19
191220934,2,7,7,5,7,28
191220935,9,0,1,0,0,10
191220936,2,3,0,1,0,6
191220937,1,2,2,0,1,6
191220938,5,5,8,6,6,30
191220939,2,4,4,7,4,21
191220940,2,6,7,8,6,29
191220941,9,6,5,6,3,29
191220942,9,7,4,3,0,23
191220943,5,6,9,7,0,27
191220944,5,5,3,5,1,19
191220945,5,4,3,2,1,15
191220946,1,0,4,8,3,16
191220947,2,1,1,0,1,5
191220948,2,6,0,5,8,21
191220949,9,1,5,3,7,25
191220950,5,9,5,3,7,29
191220951,9,9,9,4,6,37
191220952,4,5,2,7,9,27
191220953,1,5,3,9,6,24
191220954,6,7,5,7,3,28
191220955,8,8,8,7,4,35
191220956,1,7,4,6,4,22
191220957,9,6,0,4,3,22
191220958,7,0,2,9,6,24
191220959,3,1,3,8,9,24
191220960,0,1,6,8,5,20
191220961,1,7,5,0,2,15
191220962,9,1,5,8,7,30
191220963,2,8,5,3,8,26
191220964,1,8,1,9,2,21
191220965,3,6,0,6,9,24
191220966,2,6,9,3,2,22
191220967,3,6,7,2,5,23
191220968,6,5,0,4,2,17
191220969,1,4,1,4,1,11
191220970,7,3,8,3,3,24
191220971,8,2,3,4,3,20
191220972,1,2,0,9,5,17
191220973,8,8,3,8,8,35
191220974,1,1,7,3,2,14
191220975,5,5,4,7,6,27
191220976,1,8,8,7,3,27
191220977,6,1,3,3,8,21
191220978,1,2,6,9,3,21
191220979,9,3,7,5,5,29
191220980,7,9,7,8,2,33
191220981,1,8,0,4,0,13
191220982,3,2,0,5,5,15
191220983,3,9,6,5,5,28
191220984,9,1,2,6,2,20
191220985,3,5,7,1,5,21
191220986,0,9,4,1,6,20
191220987,5,0,3,6,5,19
191220988,4,2,1,1,7,15
191220989,2,3,6,9,7,27
191220990,5,2,8,2,4,21
191220991,6,2,9,4,9,30
191220992,9,0,5,6,8,28
191220993,2,2,9,6,8,27
191220994,0,2,1,6,2,11
191220995,5,3,3,5,6,22
191220996,6,4,0,9,3,22
191220997,1,6,5,9,2,23
191220998,9,2,3,7,3,24
191220999,7,9,3,8,3,30
1912201000,6,8,1,2,0,17
1912201001,7,7,0,5,1,20
1912201002,1,7,9,8,1,26
1912201003,2,6,0,5,1,14
1912201004,1,5,4,3,2,15
1912201005,0,6,8,7,3,24
1912201006,1,9,6,7,6,29
1912201007,4,6,8,6,2,26
1912201008,6,5,0,1,4,16
1912201009,4,3,0,8,2,17
1912201010,8,5,6,6,1,26
1912201011,9,4,7,2,9,31
1912201012,8,0,7,6,2,23
1912201013,7,5,6,9,4,31
1912201014,1,2,8,2,1,14
1912201015,1,0,9,3,9,22
1912201016,6,9,7,2,5,29
1912201017,4,4,2,6,9,25
1912201018,8,0,4,9,5,26
1912201019,8,1,8,2,7,26
1912201020,0,9,7,5,5,26
1912201021,3,1,5,7,7,23
1912201022,7,8,0,0,7,22
1912201023,4,8,0,8,6,26
1912201024,9,9,9,5,6,38
1912201025,2,7,6,2,2,19
1912201026,4,0,5,4,6,19
1912201027,6,3,3,8,7,27
1912201028,3,4,6,2,1,16
1912201029,0,8,2,1,5,16
1912201030,2,0,2,0,2,6
1912201031,3,9,9,4,9,34
1912201032,5,9,8,4,7,33
1912201033,9,7,5,7,1,29
1912201034,1,8,3,6,0,18
1912201035,5,9,7,4,1,26
1912201036,8,7,5,6,2,28
1912201037,1,3,1,1,1,7
1912201038,4,4,4,6,8,26
1912201039,7,0,9,1,5,22
1912201040,2,9,8,0,9,28
1912201041,7,4,3,7,0,21
1912201042,6,7,5,2,6,26
1912201043,0,5,0,4,3,12
1912201044,5,9,4,7,4,29
1912201045,3,0,1,5,2,11
1912201046,5,0,4,3,7,19
1912201047,3,5,3,5,9,25
1912201048,7,8,4,8,3,30
1912201049,5,4,9,8,4,30
1912201050,3,9,3,5,6,26
1912201051,6,9,6,2,0,23
1912201052,7,4,2,9,6,28
1912201053,4,7,4,7,8,30
1912201054,6,4,6,8,0,24
1912201055,6,7,4,5,6,28
1912201056,4,1,1,5,9,20
1912201057,4,3,0,3,5,15
1912201058,2,7,9,5,3,26
1912201059,6,6,0,9,3,24
1912201060,4,2,9,5,7,27
1912201061,5,9,3,6,2,25
1912201062,8,2,2,0,1,13
1912201063,8,2,5,2,4,21
1912201064,7,7,4,2,7,27
1912201065,5,2,6,9,3,25
1912201066,0,2,8,1,0,11
1912201067,0,7,4,1,8,20
1912201068,0,1,3,5,2,11
1912201069,3,3,4,7,6,23
1912201070,6,5,1,8,4,24
1912201071,3,4,5,4,8,24
1912201072,7,0,1,5,4,17
1912201073,2,8,9,1,2,22
1912201074,2,0,5,7,3,17
1912201075,3,2,8,8,9,30
1912201076,5,8,7,4,2,26
1912201077,5,2,8,3,1,19
1912201078,8,9,8,7,5,37
1912201079,0,8,1,2,9,20
1912201080,2,9,7,2,6,26
1912201081,4,1,7,1,5,18
1912201082,6,8,8,3,0,25
1912201083,1,3,4,5,5,18
1912201084,5,8,8,3,3,27
1912201085,5,7,8,4,5,29
1912201086,1,5,6,9,1,22
1912201087,6,1,9,8,6,30
1912201088,2,9,9,6,3,29
1912201089,2,2,1,3,4,12
1912201090,5,5,2,1,2,15
1912201091,0,2,3,5,7,17
1912201092,5,9,4,0,5,23
1912201093,8,6,8,3,9,34
1912201094,9,3,4,5,3,24
1912201095,9,6,8,8,4,35
1912201096,0,5,2,2,9,18
1912201097,5,4,2,8,5,24
1912201098,8,5,1,2,4,20
1912201099,6,4,2,3,3,18
1912201100,6,2,6,4,9,27
1912201101,6,7,4,3,1,21
1912201102,3,1,2,1,1,8
1912201103,0,0,8,2,6,16
1912201104,1,1,8,1,3,14
1912201105,8,5,9,8,6,36
191221001,0,5,2,1,9,17
191221002,7,2,0,9,2,20
191221003,2,6,3,5,2,18
191221004,8,2,7,6,2,25
191221005,4,5,9,8,9,35
191221006,9,8,4,6,9,36
191221007,2,2,5,7,8,24
191221008,4,2,4,4,7,21
191221009,9,6,9,3,0,27
191221010,9,7,6,7,4,33
191221011,9,7,6,2,8,32
191221012,2,4,7,9,6,28
191221013,9,1,6,7,7,30
191221014,8,6,8,4,6,32
191221015,6,6,3,9,4,28
191221016,5,0,1,9,0,15
191221017,1,2,6,0,0,9
191221018,4,4,0,2,1,11
191221019,5,8,6,7,9,35
191221020,3,0,9,7,3,22
191221021,3,6,4,3,6,22
191221022,6,5,9,9,4,33
191221023,9,8,3,1,9,30
191221024,4,8,0,1,8,21
191221025,7,0,8,0,1,16
191221026,0,9,6,9,2,26
191221027,9,5,8,5,0,27
191221028,9,4,5,7,2,27
191221029,1,0,7,4,3,15
191221030,3,9,9,0,1,22
191221031,7,2,7,1,7,24
191221032,4,1,5,2,6,18
191221033,6,8,1,5,6,26
191221034,0,0,4,2,3,9
191221035,7,7,1,9,6,30
191221036,1,8,1,6,9,25
191221037,2,7,2,5,9,25
191221038,9,4,6,2,2,23
191221039,7,6,0,8,6,27
191221040,9,8,1,9,7,34
191221041,5,0,7,7,6,25
191221042,1,6,0,8,6,21
191221043,7,9,2,5,2,25
191221044,1,2,7,3,9,22
191221045,2,2,8,5,9,26
191221046,0,2,6,8,9,25
191221047,2,1,2,9,9,23
191221048,6,0,4,3,7,20
191221049,2,2,6,4,2,16
191221050,0,0,5,7,1,13
191221051,8,6,9,7,9,39
191221052,9,8,4,4,2,27
191221053,7,7,0,9,6,29
191221054,0,3,3,4,0,10
191221055,3,1,4,9,9,26
191221056,3,8,2,6,2,21
191221057,2,8,2,7,6,25
191221058,6,2,9,3,7,27
191221059,5,0,2,5,3,15
191221060,2,5,6,8,2,23
191221061,8,4,8,4,8,32
191221062,4,4,2,4,6,20
191221063,0,0,1,5,2,8
191221064,8,3,9,4,9,33
191221065,1,4,3,4,0,12
191221066,7,0,8,1,7,23
191221067,2,7,4,5,8,26
191221068,7,3,3,7,5,25
191221069,2,4,2,8,5,21
191221070,5,8,5,0,3,21
191221071,2,6,7,2,0,17
191221072,4,7,6,4,7,28
191221073,6,1,7,0,5,19
191221074,0,8,3,3,3,17
191221075,9,2,6,7,5,29
191221076,6,7,9,6,0,28
191221077,8,0,8,9,9,34
191221078,7,0,9,7,1,24
191221079,1,7,7,6,6,27
191221080,0,8,2,7,5,22
191221081,0,3,8,6,2,19
191221082,6,8,9,3,7,33
191221083,0,2,2,3,2,9
191221084,8,0,3,7,9,27
191221085,0,9,8,1,9,27
191221086,6,8,1,0,8,23
191221087,6,5,2,4,0,17
191221088,0,1,5,0,8,14
191221089,6,4,3,7,4,24
191221090,3,9,0,6,5,23
191221091,9,8,8,2,4,31
191221092,7,6,5,3,9,30
191221093,7,8,4,9,6,34
191221094,9,7,2,4,0,22
191221095,4,8,6,8,8,34
191221096,9,7,7,5,4,32
191221097,8,9,2,9,7,35
191221098,1,2,4,3,0,10
191221099,0,9,9,1,2,21
191221100,0,5,2,4,6,17
191221101,2,8,7,2,8,27
191221102,1,3,3,5,9,21
191221103,9,0,6,9,4,28
191221104,9,2,2,4,3,20
191221105,9,3,0,2,3,17
191221106,5,1,7,1,5,19
191221107,6,2,8,9,2,27
191221108,7,9,4,3,1,24
191221109,4,2,3,2,7,18
191221110,6,9,8,7,0,30
191221111,4,2,0,3,9,18
191221112,6,8,2,9,9,34
191221113,4,0,6,3,1,14
191221114,3,3,3,4,6,19
191221115,6,5,4,9,0,24
191221116,8,3,7,2,2,22
191221117,7,9,7,3,5,31
191221118,0,2,6,5,2,15
191221119,5,3,1,3,5,17
191221120,5,1,0,6,9,21
191221121,3,7,1,6,1,18
191221122,3,8,7,6,2,26
191221123,6,0,5,1,3,15
191221124,0,1,5,4,8,18
191221125,4,4,7,7,9,31
191221126,5,9,9,1,1,25
191221127,3,6,7,3,4,23
191221128,9,2,4,4,2,21
191221129,3,1,3,8,8,23
191221130,9,7,4,4,3,27
191221131,3,0,0,4,2,9
191221132,9,2,6,9,1,27
191221133,5,6,6,5,6,28
191221134,7,7,8,6,1,29
191221135,6,9,9,2,4,30
191221136,3,2,9,4,9,27
191221137,5,3,9,1,5,23
191221138,8,3,4,5,9,29
191221139,0,7,5,4,5,21
191221140,1,9,9,6,0,25
191221141,6,6,8,7,9,36
191221142,9,4,1,5,8,27
191221143,0,7,2,7,2,18
191221144,0,9,6,2,4,21
191221145,6,3,2,5,1,17
191221146,2,5,3,2,8,20
191221147,7,0,0,7,9,23
191221148,6,1,2,2,4,15
191221149,6,1,5,3,2,17
191221150,7,5,6,4,3,25
191221151,5,5,7,5,6,28
191221152,4,6,8,5,4,27
191221153,0,1,1,5,5,12
191221154,0,9,4,3,1,17
191221155,4,6,2,8,4,24
191221156,1,1,8,1,8,19
191221157,2,7,3,5,1,18
191221158,8,8,1,4,1,22
191221159,5,2,3,6,1,17
191221160,2,5,5,7,8,27
191221161,4,6,6,7,9,32
191221162,6,6,5,8,1,26
191221163,8,2,6,2,1,19
191221164,8,7,6,2,1,24
191221165,5,4,6,5,8,28
191221166,2,4,7,9,0,22
191221167,9,1,0,3,7,20
191221168,4,5,1,5,1,16
191221169,9,6,5,2,7,29
191221170,2,0,3,7,5,17
191221171,8,8,8,8,7,39
191221172,3,0,5,3,2,13
191221173,6,2,3,1,5,17
191221174,2,3,4,6,8,23
191221175,3,4,4,4,6,21
191221176,7,5,6,2,5,25
191221177,6,2,2,3,8,21
191221178,2,6,5,8,6,27
191221179,2,8,9,0,3,22
191221180,2,2,1,7,3,15
191221181,6,6,7,9,7,35
191221182,0,9,3,6,8,26
191221183,2,2,1,9,5,19
191221184,5,2,2,5,6,20
191221185,2,4,1,9,7,23
191221186,1,7,0,8,2,18
191221187,1,1,7,7,8,24
191221188,2,4,8,4,5,23
191221189,1,9,0,8,0,18
191221190,6,9,4,4,5,28
191221191,9,6,1,6,5,27
191221192,1,7,0,2,6,16
191221193,0,8,6,3,2,19
191221194,8,4,8,4,1,25
191221195,9,1,8,8,0,26
191221196,7,3,2,2,7,21
191221197,5,6,6,7,1,25
191221198,1,2,6,8,6,23
191221199,8,6,8,3,6,31
191221200,6,1,8,5,4,24
191221201,4,4,1,2,1,12
191221202,5,8,2,3,8,26
191221203,2,2,6,8,1,19
191221204,4,2,2,2,2,12
191221205,2,6,9,3,5,25
191221206,7,7,5,3,3,25
191221207,8,2,2,7,9,28
191221208,7,0,2,5,9,23
191221209,1,7,2,3,8,21
191221210,0,8,5,5,4,22
191221211,2,5,0,1,2,10
191221212,2,1,7,5,7,22
191221213,0,1,3,2,0,6
191221214,2,2,2,5,5,16
191221215,6,1,9,8,9,33
191221216,5,7,4,3,6,25
191221217,6,5,7,6,8,32
191221218,2,9,0,4,4,19
191221219,1,9,5,8,2,25
191221220,0,7,8,6,6,27
191221221,8,0,7,4,9,28
191221222,3,1,6,6,6,22
191221223,5,0,2,8,6,21
191221224,7,7,9,5,1,29
191221225,9,4,8,0,9,30
191221226,7,9,9,0,8,33
191221227,1,5,4,3,7,20
191221228,0,4,1,2,5,12
191221229,9,5,0,1,4,19
191221230,7,4,8,4,9,32
191221231,3,1,6,6,2,18
191221232,4,3,4,8,7,26
191221233,6,0,0,6,5,17
191221234,4,1,6,4,2,17
191221235,2,7,3,5,5,22
191221236,6,2,2,0,9,19
191221237,3,1,0,5,7,16
191221238,3,7,7,3,2,22
191221239,7,7,0,0,6,20
191221240,1,6,3,9,1,20
191221241,6,5,6,4,5,26
191221242,4,0,8,7,1,20
191221243,6,4,7,5,5,27
191221244,4,3,5,0,7,19
191221245,8,5,3,0,3,19
191221246,0,2,0,6,0,8
191221247,0,7,6,6,3,22
191221248,7,6,7,7,7,34
191221249,1,6,1,1,1,10
191221250,8,6,3,4,3,24
191221251,4,8,5,4,9,30
191221252,0,6,3,7,1,17
191221253,2,9,5,8,0,24
191221254,4,1,5,7,1,18
191221255,9,1,5,9,2,26
191221256,5,2,2,6,4,19
191221257,5,7,6,0,2,20
191221258,1,0,5,9,3,18
191221259,6,5,5,3,3,22
191221260,0,9,0,7,3,19
191221261,0,9,9,9,4,31
191221262,9,8,8,2,3,30
191221263,8,1,4,4,6,23
191221264,3,2,1,0,0,6
191221265,4,6,5,1,1,17
191221266,1,5,2,4,2,14
191221267,3,9,8,1,4,25
191221268,8,1,7,7,3,26
191221269,0,4,9,3,5,21
191221270,6,3,5,4,4,22
191221271,5,8,9,9,3,34
191221272,9,9,9,1,8,36
191221273,7,9,4,0,5,25
191221274,9,2,6,5,0,22
191221275,9,8,6,7,8,38
191221276,2,9,3,6,9,29
191221277,5,6,7,4,5,27
191221278,2,5,3,5,1,16
191221279,0,0,6,0,7,13
191221280,8,9,9,2,7,35
191221281,6,6,8,0,1,21
191221282,5,9,0,7,3,24
191221283,9,6,9,6,9,39
191221284,9,5,6,6,0,26
191221285,6,6,1,2,6,21
191221286,9,0,1,3,6,19
191221287,4,3,6,1,7,21
191221288,5,2,7,2,9,25
191221289,5,0,7,3,9,24
191221290,0,2,7,4,8,21
191221291,1,7,5,7,8,28
191221292,9,0,7,7,2,25
191221293,9,6,6,3,4,28
191221294,9,8,7,4,9,37
191221295,6,0,8,6,1,21
191221296,2,2,6,4,6,20
191221297,8,1,0,6,4,19
191221298,1,9,3,3,1,17
191221299,1,5,2,7,9,24
191221300,2,7,0,3,8,20
191221301,3,5,0,1,3,12
191221302,1,1,1,5,8,16
191221303,8,6,7,0,6,27
191221304,0,3,0,6,6,15
191221305,7,3,7,2,5,24
191221306,5,0,9,6,3,23
191221307,8,7,9,8,5,37
191221308,7,0,0,9,6,22
191221309,1,8,2,1,3,15
191221310,4,1,7,0,0,12
191221311,8,4,2,7,6,27
191221312,4,9,4,2,9,28
191221313,4,6,4,2,2,18
191221314,2,3,6,6,1,18
191221315,1,3,3,1,9,17
191221316,2,0,8,4,3,17
191221317,3,8,3,8,4,26
191221318,1,4,2,6,5,18
191221319,1,6,5,3,5,20
191221320,7,3,2,6,4,22
191221321,3,6,0,9,7,25
191221322,7,2,5,7,6,27
191221323,0,2,4,4,6,16
191221324,8,6,9,7,6,36
191221325,3,8,9,3,7,30
191221326,1,6,7,3,0,17
191221327,7,3,7,6,2,25
191221328,0,5,4,6,2,17
191221329,9,5,4,3,1,22
191221330,0,2,8,0,0,10
191221331,4,2,4,3,9,22
191221332,4,2,8,5,0,19
191221333,1,1,9,9,0,20
191221334,8,1,4,3,6,22
191221335,2,0,9,2,0,13
191221336,6,3,9,9,0,27
191221337,0,3,6,1,9,19
191221338,6,4,8,2,1,21
191221339,2,7,1,7,4,21
191221340,7,9,1,5,0,22
191221341,9,3,7,7,6,32
191221342,6,3,2,5,4,20
191221343,6,3,4,1,7,21
191221344,1,8,5,4,1,19
191221345,7,3,7,7,5,29
191221346,0,8,8,2,3,21
191221347,0,1,1,1,4,7
191221348,9,8,8,2,1,28
191221349,5,0,4,9,4,22
191221350,7,4,3,6,2,22
191221351,5,6,3,8,6,28
191221352,5,7,4,0,7,23
191221353,3,3,2,2,8,18
191221354,3,9,7,9,4,32
191221355,7,7,6,4,2,26
191221356,3,9,1,5,9,27
191221357,6,3,1,5,7,22
191221358,1,3,8,0,3,15
191221359,6,1,6,9,0,22
191221360,4,6,0,4,5,19
191221361,3,4,5,0,4,16
191221362,5,7,1,4,1,18
191221363,8,6,1,4,2,21
191221364,1,4,5,2,1,13
191221365,9,9,0,8,4,30
191221366,6,1,3,2,9,21
191221367,1,7,0,6,8,22
191221368,2,2,3,9,7,23
191221369,0,1,2,5,8,16
191221370,7,8,1,0,7,23
191221371,4,8,6,2,8,28
191221372,5,3,5,9,5,27
191221373,8,9,7,9,6,39
191221374,3,3,8,4,9,27
191221375,1,2,4,0,8,15
191221376,3,3,5,9,4,24
191221377,0,5,6,1,8,20
191221378,2,1,6,1,0,10
191221379,4,0,2,0,0,6
191221380,0,4,2,9,2,17
191221381,5,1,3,1,8,18
191221382,5,5,3,9,6,28
191221383,8,1,1,6,1,17
191221384,3,6,4,6,6,25
191221385,8,7,0,6,3,24
191221386,7,7,7,0,8,29
191221387,3,6,8,5,7,29
191221388,3,9,6,8,3,29
191221389,9,2,3,4,7,25
191221390,9,1,6,6,7,29
191221391,0,9,3,9,9,30
191221392,8,3,2,3,8,24
191221393,6,0,0,2,0,8
191221394,1,7,6,6,9,29
191221395,3,5,1,6,6,21
191221396,7,4,1,0,0,12
191221397,2,7,6,3,6,24
191221398,7,0,3,8,9,27
191221399,9,2,1,5,8,25
191221400,9,6,9,3,1,28
191221401,1,3,8,2,8,22
191221402,1,7,1,5,7,21
191221403,4,0,0,3,3,10
191221404,7,8,9,0,7,31
191221405,0,0,3,5,8,16
191221406,2,6,9,8,3,28
191221407,8,1,9,1,9,28
191221408,3,2,5,5,0,15
191221409,2,1,8,0,7,18
191221410,4,0,9,5,5,23
191221411,7,2,2,1,4,16
191221412,2,3,4,2,6,17
191221413,7,9,9,5,3,33
191221414,6,5,7,4,9,31
191221415,3,4,9,8,2,26
191221416,4,0,1,2,5,12
191221417,5,8,9,5,0,27
191221418,6,9,3,9,5,32
191221419,5,7,0,2,5,19
191221420,7,3,1,0,1,12
191221421,9,8,5,3,5,30
191221422,5,6,0,8,2,21
191221423,6,9,2,6,6,29
191221424,3,6,1,6,7,23
191221425,0,4,6,1,7,18
191221426,1,9,5,2,7,24
191221427,6,3,7,4,3,23
191221428,4,8,8,0,5,25
191221429,5,7,8,6,3,29
191221430,8,6,0,4,9,27
191221431,7,9,7,0,1,24
191221432,8,6,0,5,8,27
191221433,0,1,1,1,9,12
191221434,2,0,5,4,0,11
191221435,6,5,8,5,3,27
191221436,0,6,0,1,9,16
191221437,8,3,1,8,3,23
191221438,0,7,4,3,4,18
191221439,2,9,9,9,9,38
191221440,7,5,5,1,6,24
191221441,9,9,2,0,9,29
191221442,2,1,7,0,6,16
191221443,8,8,0,0,6,22
191221444,5,4,2,7,1,19
191221445,8,9,5,8,4,34
191221446,7,4,3,0,4,18
191221447,7,7,3,5,8,30
191221448,1,1,4,9,7,22
191221449,2,9,6,7,7,31
191221450,8,4,5,9,2,28
191221451,2,9,2,1,9,23
191221452,1,3,2,7,8,21
191221453,0,5,8,5,8,26
191221454,2,0,8,6,8,24
191221455,6,3,7,8,8,32
191221456,2,4,4,2,7,19
191221457,2,5,9,7,5,28
191221458,8,5,9,7,2,31
191221459,9,4,9,2,2,26
191221460,8,4,1,0,4,17
191221461,5,2,4,4,9,24
191221462,8,9,8,1,8,34
191221463,6,7,1,6,0,20
191221464,8,2,1,0,6,17
191221465,9,9,2,0,5,25
191221466,9,4,6,9,5,33
191221467,8,4,7,8,4,31
191221468,6,4,2,0,9,21
191221469,4,0,2,8,4,18
191221470,0,5,0,5,2,12
191221471,5,0,8,0,3,16
191221472,6,8,1,4,5,24
191221473,9,9,2,5,2,27
191221474,3,6,7,9,4,29
191221475,1,7,3,7,0,18
191221476,2,5,9,5,5,26
191221477,3,5,7,7,4,26
191221478,8,8,5,7,2,30
191221479,0,8,3,2,8,21
191221480,6,1,7,8,6,28
191221481,9,0,2,5,0,16
191221482,9,8,4,8,1,30
191221483,9,1,5,3,5,23
191221484,5,0,6,0,0,11
191221485,4,4,9,3,5,25
191221486,9,4,5,3,9,30
191221487,1,1,1,8,7,18
191221488,9,4,0,1,3,17
191221489,3,9,0,6,7,25
191221490,2,6,3,4,8,23
191221491,8,3,0,1,2,14
191221492,9,2,8,4,5,28
191221493,3,9,7,9,1,29
191221494,2,7,0,9,2,20
191221495,8,5,3,3,6,25
191221496,0,7,9,3,5,24
191221497,5,8,1,6,2,22
191221498,8,7,8,5,3,31
191221499,1,8,1,8,3,21
191221500,5,4,1,8,5,23
191221501,0,7,4,0,9,20
191221502,4,0,8,5,4,21
191221503,9,0,2,0,8,19
191221504,6,1,6,3,5,21
191221505,3,6,7,6,3,25
191221506,5,9,2,4,5,25
191221507,3,4,6,2,8,23
191221508,9,9,1,9,3,31
191221509,2,4,1,8,6,21
191221510,2,2,6,4,5,19
191221511,8,5,4,5,7,29
191221512,1,7,2,6,5,21
191221513,4,8,4,1,2,19
191221514,8,4,1,6,5,24
191221515,8,4,3,0,6,21
191221516,7,4,6,4,6,27
191221517,6,2,4,0,3,15
191221518,6,3,9,7,7,32
191221519,1,1,8,0,5,15
191221520,5,1,5,0,5,16
191221521,1,3,6,4,2,16
191221522,6,1,4,3,1,15
191221523,2,9,9,7,6,33
191221524,7,1,7,2,9,26
191221525,8,4,0,3,5,20
191221526,9,8,9,3,7,36
191221527,2,9,2,8,4,25
191221528,7,2,5,3,9,26
191221529,2,2,1,3,2,10
191221530,0,8,6,5,0,19
191221531,7,9,8,6,4,34
191221532,5,4,6,0,7,22
191221533,2,4,6,1,0,13
191221534,2,1,7,8,3,21
191221535,2,1,7,1,0,11
191221536,6,4,4,7,6,27
191221537,1,4,3,9,2,19
191221538,4,9,7,5,0,25
191221539,0,7,1,7,9,24
191221540,4,6,1,7,2,20
191221541,8,5,2,1,9,25
191221542,3,3,0,1,7,14
191221543,7,8,6,2,1,24
191221544,5,1,6,6,5,23
191221545,3,2,7,4,8,24
191221546,6,3,4,0,6,19
191221547,6,3,9,9,7,34
191221548,2,4,1,5,4,16
191221549,1,7,6,2,4,20
191221550,0,8,2,1,3,14
191221551,7,7,6,4,4,28
191221552,7,9,4,0,9,29
191221553,0,0,5,1,5,11
191221554,7,1,3,7,8,26
191221555,4,2,1,0,3,10
191221556,7,1,2,8,1,19
191221557,7,3,8,6,8,32
191221558,1,2,8,1,1,13
191221559,9,4,5,9,3,30
191221560,3,0,5,8,2,18
191221561,5,9,9,7,0,30
191221562,8,6,7,9,7,37
191221563,6,2,8,8,4,28
191221564,7,6,4,1,3,21
191221565,0,4,1,7,1,13
191221566,4,4,5,5,8,26
191221567,6,8,2,0,4,20
191221568,0,1,8,0,6,15
191221569,3,4,7,8,0,22
191221570,3,7,8,1,4,23
191221571,9,4,5,4,6,28
191221572,0,5,2,6,7,20
191221573,8,1,9,9,6,33
191221574,6,7,1,2,0,16
191221575,7,3,6,2,2,20
191221576,1,1,8,8,6,24
191221577,4,6,7,6,6,29
191221578,7,6,7,6,2,28
191221579,4,6,8,2,1,21
191221580,2,8,8,0,1,19
191221581,3,9,0,3,7,22
191221582,1,4,6,1,1,13
191221583,6,4,6,7,3,26
191221584,6,0,7,4,9,26
191221585,0,2,7,1,4,14
191221586,6,0,7,0,5,18
191221587,8,1,7,3,1,20
191221588,4,6,3,6,0,19
191221589,8,5,6,1,6,26
191221590,6,1,4,0,5,16
191221591,7,6,7,5,3,28
191221592,1,5,0,1,0,7
191221593,6,2,0,2,2,12
191221594,1,3,7,1,5,17
191221595,9,2,7,4,6,28
191221596,9,0,4,8,5,26
191221597,3,4,3,5,6,21
191221598,7,8,6,5,3,29
191221599,1,1,6,7,9,24
191221600,0,3,7,9,4,23
191221601,6,0,8,2,9,25
191221602,6,3,9,8,6,32
191221603,6,0,1,1,3,11
191221604,8,6,7,2,5,28
191221605,8,3,2,2,0,15
191221606,3,6,0,7,3,19
191221607,4,0,5,2,9,20
191221608,5,4,8,8,9,34
191221609,6,4,2,1,5,18
191221610,7,1,4,9,2,23
191221611,2,1,2,7,8,20
191221612,9,0,7,8,1,25
191221613,3,1,2,2,0,8
191221614,8,8,5,8,3,32
191221615,7,8,1,5,5,26
191221616,1,2,2,6,6,17
191221617,5,8,3,7,7,30
191221618,3,5,4,8,0,20
191221619,3,3,2,1,5,14
191221620,9,6,9,0,8,32
191221621,6,0,0,8,9,23
191221622,6,7,4,5,3,25
191221623,2,5,3,0,4,14
191221624,6,8,3,0,4,21
191221625,0,1,3,4,7,15
191221626,3,6,1,5,3,18
191221627,0,5,5,5,1,16
191221628,5,0,6,8,2,21
191221629,1,9,6,8,4,28
191221630,7,1,7,4,7,26
191221631,6,5,2,0,0,13
191221632,1,4,4,6,2,17
191221633,0,5,6,8,3,22
191221634,6,5,9,7,7,34
191221635,6,2,6,8,3,25
191221636,6,6,2,9,9,32
191221637,4,4,1,1,3,13
191221638,6,1,0,4,4,15
191221639,4,0,9,1,1,15
191221640,3,1,0,3,5,12
191221641,6,7,9,4,7,33
191221642,3,9,1,4,3,20
191221643,0,3,7,3,0,13
191221644,2,8,9,7,2,28
191221645,2,6,7,2,3,20
191221646,9,3,0,5,9,26
191221647,6,0,7,8,7,28
191221648,9,3,4,1,5,22
191221649,2,6,0,3,0,11
191221650,8,2,8,6,5,29
191221651,2,6,5,4,7,24
191221652,1,3,3,6,1,14
191221653,9,5,2,6,4,26
191221654,8,8,8,9,4,37
191221655,2,3,6,9,1,21
191221656,5,5,2,0,4,16
191221657,2,4,2,6,1,15
191221658,6,7,4,4,7,28
191221659,6,9,6,3,5,29
191221660,9,3,3,6,8,29
191221661,9,9,5,8,3,34
191221662,2,3,7,0,1,13
191221663,0,0,1,3,5,9
191221664,4,4,7,5,7,27
191221665,3,6,0,3,1,13
191221666,8,1,1,8,5,23
191221667,6,4,0,1,9,20
191221668,7,2,1,9,3,22
191221669,5,3,6,1,4,19
191221670,5,0,8,8,2,23
191221671,5,8,3,7,2,25
191221672,1,5,0,6,7,19
191221673,8,2,5,8,4,27
191221674,5,5,5,8,8,31
191221675,7,8,4,1,0,20
191221676,8,9,9,0,8,34
191221677,0,3,4,5,3,15
191221678,7,6,9,3,8,33
191221679,2,9,2,4,7,24
191221680,0,9,8,2,2,21
191221681,6,2,9,3,6,26
191221682,7,7,5,3,1,23
191221683,0,7,6,4,4,21
191221684,1,8,3,6,9,27
191221685,2,1,6,0,2,11
191221686,6,5,6,5,8,30
191221687,1,2,9,5,8,25
191221688,4,0,4,6,2,16
191221689,3,3,6,1,6,19
191221690,9,4,9,6,9,37
191221691,6,1,0,6,5,18
191221692,7,6,1,1,2,17
191221693,5,1,0,2,0,8
191221694,8,1,6,3,1,19
191221695,1,8,0,5,5,19
191221696,2,8,9,6,2,27
191221697,8,1,4,4,9,26
191221698,4,1,8,1,3,17
191221699,6,9,7,8,4,34
191221700,3,1,0,4,2,10
191221701,9,3,4,7,0,23
191221702,2,8,0,7,7,24
191221703,5,4,5,8,0,22
191221704,0,0,6,2,2,10
191221705,6,2,4,3,5,20
191221706,5,5,9,5,4,28
191221707,4,4,0,1,3,12
191221708,4,6,0,9,3,22
191221709,4,1,4,3,8,20
191221710,4,5,1,0,7,17
191221711,0,8,4,5,0,17
191221712,8,2,5,7,1,23
191221713,1,3,8,8,9,29
191221714,7,6,2,9,6,30
191221715,1,6,7,8,6,28
191221716,1,1,3,5,0,10
191221717,0,5,7,2,2,16
191221718,3,9,1,2,0,15
191221719,6,9,5,7,9,36
191221720,2,5,9,5,0,21
191221721,5,9,1,0,4,19
191221722,5,1,7,4,2,19
191221723,2,1,5,9,9,26
191221724,2,5,4,9,6,26
191221725,9,4,3,0,8,24
191221726,5,8,5,7,9,34
191221727,1,6,2,7,7,23
191221728,7,2,8,0,9,26
191221729,9,0,4,7,9,29
191221730,6,3,6,6,9,30
191221731,2,7,7,3,2,21
191221732,0,0,3,7,4,14
191221733,5,0,2,9,5,21
191221734,1,4,4,8,5,22
191221735,3,1,4,1,0,9
191221736,1,5,9,0,8,23
191221737,2,0,5,7,9,23
191221738,9,7,9,1,9,35
191221739,2,6,1,4,5,18
191221740,5,5,2,6,2,20
191221741,6,7,9,3,6,31
191221742,0,3,0,6,2,11
191221743,0,3,0,4,2,9
191221744,9,0,8,4,7,28
191221745,2,1,4,3,2,12
191221746,1,3,5,8,5,22
191221747,3,9,3,4,7,26
191221748,3,0,9,2,2,16
191221749,5,0,8,9,3,25
191221750,7,6,1,4,6,24
191221751,9,6,1,3,9,28
191221752,5,6,7,5,4,27
191221753,4,6,9,8,1,28
191221754,4,0,6,5,5,20
191221755,3,8,7,9,5,32
191221756,2,6,7,5,9,29
191221757,6,2,3,6,2,19
191221758,9,9,3,6,4,31
191221759,5,4,0,7,0,16
191221760,4,6,2,1,8,21
191221761,1,5,0,5,3,14
191221762,3,0,6,6,7,22
191221763,5,8,0,7,3,23
191221764,7,0,7,3,9,26
191221765,6,6,9,7,0,28
191221766,1,0,3,0,6,10
191221767,8,2,1,7,9,27
191221768,3,4,0,6,8,21
191221769,5,9,8,6,2,30
191221770,7,8,1,6,2,24
191221771,6,9,3,9,8,35
191221772,4,7,2,2,7,22
191221773,7,5,0,7,0,19
191221774,3,8,8,9,8,36
191221775,0,5,9,0,9,23
191221776,5,2,9,7,8,31
191221777,1,2,1,0,6,10
191221778,2,0,1,1,4,8
191221779,8,7,9,0,0,24
191221780,0,4,3,8,5,20
191221781,1,5,4,9,9,28
191221782,7,2,3,7,6,25
191221783,0,2,1,8,2,13
191221784,2,5,4,2,9,22
191221785,4,6,2,6,8,26
191221786,3,8,0,6,8,25
191221787,9,7,4,7,2,29
191221788,6,1,5,1,5,18
191221789,7,1,8,9,8,33
191221790,6,8,7,9,6,36
191221791,3,1,8,9,9,30
191221792,0,9,8,5,9,31
191221793,9,6,1,1,0,17
191221794,1,7,7,4,0,19
191221795,3,8,4,6,8,29
191221796,0,0,5,4,5,14
191221797,0,2,4,7,7,20
191221798,7,7,7,1,4,26
191221799,3,5,8,7,5,28
191221800,0,3,4,8,5,20
191221801,3,6,5,6,6,26
191221802,5,5,4,2,4,20
191221803,4,8,8,8,8,36
191221804,4,5,8,7,3,27
191221805,9,5,6,8,4,32
191221806,1,2,9,5,3,20
191221807,9,8,4,7,7,35
191221808,8,0,2,2,9,21
191221809,3,6,7,6,7,29
191221810,7,1,2,5,2,17
191221811,6,6,3,0,5,20
191221812,7,5,9,8,8,37
191221813,4,6,1,4,6,21
191221814,6,9,3,7,3,28
191221815,3,7,4,3,0,17
191221816,0,3,8,6,1,18
191221817,4,2,5,4,7,22
191221818,7,6,8,1,1,23
191221819,3,3,4,9,5,24
191221820,0,2,1,4,0,7
191221821,1,7,7,2,1,18
191221822,3,7,2,7,9,28
191221823,5,5,2,2,7,21
191221824,6,7,4,0,2,19
191221825,0,1,3,2,2,8
191221826,5,8,4,7,6,30
191221827,3,5,2,4,2,16
191221828,6,2,0,1,3,12
191221829,8,9,5,6,1,29
191221830,1,6,2,6,4,19
191221831,4,0,0,2,4,10
191221832,1,0,3,9,1,14
191221833,1,9,4,4,8,26
191221834,2,6,8,7,8,31
191221835,6,7,5,1,7,26
191221836,9,3,4,9,2,27
191221837,6,0,2,3,4,15
191221838,3,7,2,1,0,13
191221839,8,9,1,1,3,22
191221840,9,2,1,8,2,22
191221841,4,9,6,1,9,29
191221842,4,0,0,3,9,16
191221843,0,0,5,5,7,17
191221844,7,6,0,3,6,22
191221845,7,4,2,1,2,16
191221846,9,0,8,1,5,23
191221847,7,9,0,5,3,24
191221848,3,6,3,6,5,23
191221849,6,4,1,4,0,15
191221850,2,3,1,9,4,19
191221851,4,9,4,6,0,23
191221852,7,5,8,4,4,28
191221853,3,9,3,7,9,31
191221854,8,2,0,7,2,19
191221855,5,7,1,4,3,20
191221856,0,9,2,5,9,25
191221857,0,5,5,9,9,28
191221858,7,3,3,5,3,21
191221859,8,5,7,8,0,28
191221860,3,8,9,9,7,36
191221861,2,6,9,0,6,23
191221862,2,3,6,4,8,23
191221863,3,4,7,2,1,17
191221864,9,0,1,4,9,23
191221865,2,7,4,3,5,21
191221866,2,5,2,6,2,17
191221867,1,3,9,5,7,25
191221868,0,4,7,5,5,21
191221869,9,4,9,0,4,26
191221870,6,7,0,5,9,27
191221871,3,7,4,7,8,29
191221872,2,9,4,8,9,32
191221873,3,4,6,8,1,22
191221874,3,6,0,0,7,16
191221875,4,4,6,5,8,27
191221876,0,0,3,2,1,6
191221877,7,9,1,5,9,31
191221878,5,3,9,4,0,21
191221879,2,5,1,0,0,8
191221880,9,9,9,8,9,44
191221881,3,4,8,1,4,20
191221882,0,7,6,1,0,14
191221883,2,2,9,9,1,23
191221884,7,1,5,8,2,23
191221885,9,1,8,4,6,28
191221886,5,5,7,1,7,25
191221887,4,8,7,5,1,25
191221888,1,4,5,6,2,18
191221889,8,3,7,8,2,28
191221890,1,8,6,3,1,19
191221891,3,1,1,4,9,18
191221892,2,9,3,2,5,21
191221893,0,2,2,6,6,16
191221894,3,1,1,6,5,16
191221895,3,7,5,7,7,29
191221896,1,6,7,8,2,24
191221897,0,7,9,7,4,27
191221898,2,8,2,5,3,20
191221899,7,2,7,9,7,32
191221900,1,6,9,5,0,21
191221901,2,7,0,7,9,25
191221902,0,7,9,3,0,19
191221903,6,3,3,3,3,18
191221904,1,9,2,3,2,17
191221905,1,0,8,6,9,24
191221906,1,5,5,8,2,21
191221907,5,8,0,8,5,26
191221908,2,3,6,7,1,19
191221909,7,2,9,7,5,30
191221910,9,8,6,7,0,30
191221911,2,5,6,6,6,25
191221912,0,4,1,8,1,14
191221913,3,5,9,4,1,22
191221914,6,2,3,1,2,14
191221915,9,7,4,9,0,29
191221916,3,9,8,5,5,30
191221917,8,7,5,6,3,29
191221918,0,1,8,5,6,20
191221919,0,7,5,0,7,19
191221920,3,3,3,8,4,21
191221921,7,6,1,2,7,23
191221922,9,2,8,4,0,23
191221923,1,8,8,3,0,20
191221924,0,7,7,5,7,26
191221925,8,4,1,6,2,21
191221926,4,1,6,3,9,23
191221927,8,5,6,8,4,31
191221928,8,7,4,6,0,25
191221929,9,9,1,0,3,22
191221930,1,1,9,0,4,15
191221931,9,8,1,8,1,27
191221932,4,8,1,4,4,21
191221933,8,4,9,5,7,33
191221934,9,2,3,5,4,23
191221935,2,7,2,8,5,24
191221936,8,2,7,7,0,24
191221937,1,8,1,2,9,21
191221938,1,1,2,9,1,14
191221939,3,0,5,5,3,16
191221940,9,6,6,9,4,34
191221941,2,0,8,7,7,24
191221942,4,3,6,3,8,24
191221943,1,0,0,7,1,9
191221944,4,5,4,7,0,20
191221945,4,7,2,5,5,23
191221946,7,4,2,5,4,22
191221947,2,3,8,9,8,30
191221948,6,2,7,0,4,19
191221949,7,2,0,5,7,21
191221950,7,1,2,1,5,16
191221951,5,2,0,0,5,12
191221952,2,7,0,2,0,11
191221953,1,3,2,8,5,19
191221954,0,0,7,8,3,18
191221955,2,7,2,5,8,24
191221956,1,2,8,0,8,19
191221957,3,9,0,5,0,17
191221958,4,8,4,5,6,27
191221959,8,7,3,5,0,23
191221960,3,5,7,2,6,23
191221961,6,8,9,0,5,28
191221962,6,7,3,2,0,18
191221963,7,1,4,7,1,20
191221964,4,4,3,8,0,19
191221965,9,3,0,7,8,27
191221966,2,2,0,1,6,11
191221967,0,2,6,4,9,21
191221968,9,8,6,4,3,30
191221969,6,3,7,4,8,28
191221970,9,3,7,4,8,31
191221971,1,8,9,3,4,25
191221972,0,7,3,7,8,25
191221973,1,2,6,0,7,16
191221974,2,0,9,1,6,18
191221975,9,8,2,1,3,23
191221976,6,1,4,9,3,23
191221977,4,0,2,8,2,16
191221978,2,1,9,7,7,26
191221979,7,1,5,9,0,22
191221980,4,4,4,8,5,25
191221981,1,5,2,0,7,15
191221982,6,4,8,4,7,29
191221983,2,2,7,8,5,24
191221984,8,1,3,4,9,25
191221985,3,8,5,6,7,29
191221986,3,3,2,1,8,17
191221987,7,7,6,9,4,33
191221988,3,4,8,2,4,21
191221989,6,3,7,2,5,23
191221990,8,3,2,2,8,23
191221991,6,6,0,2,7,21
191221992,4,5,3,3,5,20
191221993,2,0,5,1,7,15
191221994,3,3,9,1,2,18
191221995,2,7,7,8,9,33
191221996,2,2,4,8,5,21
191221997,8,4,7,5,0,24
191221998,4,5,7,4,1,21
191221999,3,4,6,4,7,24
1912211000,0,3,2,3,9,17
1912211001,4,2,7,3,8,24
1912211002,5,7,0,7,5,24
1912211003,4,7,2,0,0,13
1912211004,8,4,5,1,9,27
1912211005,7,6,5,7,1,26
1912211006,6,1,5,0,3,15
1912211007,6,7,4,2,3,22
1912211008,0,7,0,5,8,20
1912211009,8,4,6,0,9,27
1912211010,3,0,0,4,4,11
1912211011,6,4,5,4,1,20
1912211012,7,3,8,5,8,31
1912211013,9,6,7,4,6,32
1912211014,2,7,4,0,7,20
1912211015,6,2,7,7,1,23
1912211016,0,9,6,9,6,30
1912211017,7,8,6,3,9,33
1912211018,5,6,6,6,0,23
1912211019,2,3,0,7,2,14
1912211020,2,5,4,1,9,21
1912211021,0,8,9,9,7,33
1912211022,5,9,1,5,0,20
1912211023,2,5,6,1,0,14
1912211024,2,8,8,7,4,29
1912211025,7,3,9,3,6,28
1912211026,3,6,5,1,6,21
1912211027,5,3,1,2,2,13
1912211028,4,2,4,9,0,19
1912211029,7,4,8,6,3,28
1912211030,1,4,4,9,5,23
1912211031,4,2,0,9,2,17
1912211032,3,6,8,9,4,30
1912211033,2,4,5,9,0,20
1912211034,3,3,9,8,5,28
1912211035,0,3,2,4,2,11
1912211036,5,3,0,2,4,14
1912211037,7,8,1,2,9,27
1912211038,6,6,7,0,8,27
1912211039,6,9,1,0,7,23
1912211040,1,2,4,7,7,21
1912211041,2,5,7,5,7,26
1912211042,7,8,9,4,5,33
1912211043,3,6,3,9,5,26
1912211044,9,2,5,0,2,18
1912211045,7,7,5,0,2,21
1912211046,2,9,2,3,0,16
1912211047,4,8,3,2,1,18
1912211048,8,6,1,6,7,28
1912211049,9,1,3,1,5,19
1912211050,8,6,2,6,5,27
1912211051,3,1,4,0,4,12
1912211052,4,3,6,3,3,19
1912211053,1,8,2,6,0,17
1912211054,4,1,3,3,9,20
1912211055,1,7,7,3,6,24
1912211056,6,5,5,2,7,25
1912211057,0,7,4,0,3,14
1912211058,5,8,6,9,6,34
1912211059,8,6,7,6,6,33
1912211060,5,2,6,1,5,19
1912211061,7,7,2,2,4,22
1912211062,7,7,5,5,0,24
1912211063,0,5,7,7,9,28
1912211064,1,5,6,8,0,20
1912211065,5,0,3,2,7,17
1912211066,0,3,0,8,2,13
1912211067,5,0,6,6,8,25
1912211068,5,3,7,0,8,23
1912211069,4,2,4,4,5,19
1912211070,8,3,3,4,3,21
1912211071,0,8,7,1,3,19
1912211072,1,1,9,5,9,25
1912211073,0,0,7,3,8,18
1912211074,5,8,8,3,7,31
1912211075,1,6,8,2,4,21
1912211076,8,3,1,8,0,20
1912211077,2,5,9,7,4,27
1912211078,1,8,4,0,4,17
1912211079,3,5,6,4,3,21
1912211080,2,6,0,4,0,12
1912211081,9,5,9,0,2,25
1912211082,7,0,2,1,0,10
1912211083,6,3,9,7,0,25
1912211084,9,0,8,7,4,28
1912211085,2,2,3,6,3,16
1912211086,4,4,6,6,7,27
1912211087,5,0,9,9,6,29
1912211088,8,4,8,2,7,29
1912211089,1,4,6,9,4,24
1912211090,2,6,8,6,6,28
1912211091,6,5,2,9,0,22
1912211092,4,5,2,8,9,28
1912211093,2,9,5,8,1,25
1912211094,6,4,1,7,9,27
1912211095,1,0,3,1,1,6
1912211096,5,0,1,0,5,11
1912211097,5,9,4,4,6,28
1912211098,4,4,7,6,8,29
1912211099,0,1,4,9,5,19
1912211100,0,4,5,9,0,18
1912211101,1,0,9,8,4,22
1912211102,7,1,6,9,2,25
1912211103,7,6,5,5,7,30
1912211104,8,6,6,9,7,36
1912211105,5,4,4,0,8,21
191222001,8,6,5,1,4,24
191222002,1,3,0,8,3,15
191222003,5,4,3,2,0,14
191222004,5,7,5,9,0,26
191222005,9,5,3,8,1,26
191222006,0,1,5,8,2,16
191222007,8,7,6,3,4,28
191222008,3,3,5,9,6,26
191222009,5,4,3,2,7,21
191222010,3,8,1,4,0,16
191222011,1,3,3,4,1,12
191222012,7,4,2,3,9,25
191222013,7,6,1,3,0,17
191222014,6,5,6,1,5,23
191222015,0,4,7,5,6,22
191222016,0,2,7,8,0,17
191222017,6,6,4,4,4,24
191222018,8,4,3,6,3,24
191222019,3,7,5,2,2,19
191222020,4,8,3,2,8,25
191222021,9,8,8,1,3,29
191222022,8,0,4,1,0,13
191222023,5,9,9,0,6,29
191222024,5,7,4,8,2,26
191222025,4,5,1,5,5,20
191222026,8,9,7,4,1,29
191222027,6,6,9,7,8,36
191222028,1,7,6,6,7,27
191222029,5,8,3,5,1,22
191222030,3,9,4,0,2,18
191222031,3,5,7,9,9,33
191222032,2,2,8,6,4,22
191222033,6,5,7,1,8,27
191222034,1,1,7,7,1,17
191222035,4,5,9,1,4,23
191222036,0,4,5,3,2,14
191222037,9,0,5,8,7,29
191222038,6,0,4,7,3,20
191222039,8,9,3,7,8,35
191222040,3,3,9,7,4,26
191222041,8,1,4,9,2,24
191222042,6,1,2,8,1,18
191222043,0,0,7,5,1,13
191222044,7,5,7,9,0,28
191222045,5,5,6,3,8,27
191222046,7,1,4,0,4,16
191222047,5,3,9,3,5,25
191222048,4,4,3,9,1,21
191222049,4,2,1,6,9,22
191222050,5,7,9,3,7,31
191222051,3,4,6,1,1,15
191222052,3,4,6,0,2,15
191222053,5,4,0,5,7,21
191222054,7,2,6,4,1,20
191222055,9,5,5,1,3,23
191222056,1,1,0,9,0,11
191222057,5,4,2,3,4,18
191222058,5,4,6,6,5,26
191222059,6,2,9,6,9,32
191222060,1,4,7,7,3,22
191222061,3,9,5,5,7,29
191222062,7,0,1,6,2,16
191222063,5,4,4,9,8,30
191222064,7,7,8,8,1,31
191222065,6,2,4,7,6,25
191222066,0,5,4,7,7,23
191222067,9,9,0,1,2,21
191222068,0,4,3,2,8,17
191222069,5,8,9,1,3,26
191222070,3,3,9,0,8,23
191222071,8,3,4,5,2,22
191222072,7,2,4,4,3,20
191222073,5,5,1,1,9,21
191222074,0,5,4,6,4,19
191222075,4,7,5,0,5,21
191222076,8,6,2,0,7,23
191222077,8,9,3,2,7,29
191222078,3,1,5,2,1,12
191222079,8,9,3,0,9,29
191222080,5,0,2,9,8,24
191222081,5,9,5,4,5,28
191222082,7,8,2,8,7,32
191222083,1,5,8,3,4,21
191222084,8,9,0,6,6,29
191222085,2,5,1,2,6,16
191222086,0,8,5,0,8,21
191222087,4,4,8,8,6,30
191222088,1,4,4,8,0,17
191222089,0,8,0,9,9,26
191222090,2,9,8,0,8,27
191222091,2,1,3,0,2,8
191222092,7,3,1,3,3,17
191222093,3,1,5,2,4,15
191222094,0,5,3,8,2,18
191222095,9,0,2,7,3,21
191222096,8,9,3,4,8,32
191222097,4,5,8,9,1,27
191222098,6,0,8,0,9,23
191222099,4,9,2,3,6,24
191222100,2,9,3,4,7,25
191222101,0,9,8,6,1,24
191222102,8,8,0,6,5,27
191222103,8,8,5,0,2,23
191222104,8,4,9,9,9,39
191222105,4,8,2,6,4,24
191222106,0,8,2,4,4,18
191222107,8,0,4,4,4,20
191222108,2,2,3,5,2,14
191222109,8,6,6,0,3,23
191222110,0,6,5,3,4,18
191222111,8,9,0,3,6,26
191222112,9,5,3,4,6,27
191222113,1,5,2,1,3,12
191222114,0,4,9,7,8,28
191222115,9,8,2,6,2,27
191222116,3,2,7,7,1,20
191222117,0,4,2,0,3,9
191222118,9,7,9,1,0,26
191222119,1,2,2,1,4,10
191222120,1,7,2,6,4,20
191222121,2,6,3,6,0,17
191222122,4,1,4,8,1,18
191222123,8,3,8,2,6,27
191222124,7,8,0,0,2,17
191222125,9,9,5,4,3,30
191222126,5,4,4,0,6,19
191222127,1,0,5,2,3,11
191222128,0,3,1,5,4,13
191222129,8,9,0,5,2,24
191222130,3,7,5,9,9,33
191222131,0,1,1,6,2,10
191222132,6,6,9,1,6,28
191222133,5,7,0,5,2,19
191222134,6,3,6,1,7,23
191222135,5,6,5,6,7,29
191222136,6,6,2,6,7,27
191222137,2,8,3,8,0,21
191222138,4,3,6,4,2,19
191222139,4,3,0,7,3,17
191222140,6,4,2,2,4,18
191222141,6,1,6,0,0,13
191222142,3,5,3,0,5,16
191222143,2,0,8,5,7,22
191222144,3,3,4,5,1,16
191222145,0,3,2,8,2,15
191222146,8,8,1,3,9,29
191222147,4,2,0,2,1,9
191222148,4,3,4,9,0,20
191222149,9,7,4,0,3,23
191222150,1,1,9,4,1,16
191222151,1,7,1,1,2,12
191222152,5,3,8,0,4,20
191222153,8,1,6,4,4,23
191222154,3,6,3,0,9,21
191222155,0,8,1,6,4,19
191222156,3,0,4,3,6,16
191222157,3,4,2,6,2,17
191222158,1,2,9,2,2,16
191222159,7,9,3,8,2,29
191222160,1,5,0,9,0,15
191222161,6,7,2,0,1,16
191222162,4,1,3,2,1,11
191222163,4,0,7,8,2,21
191222164,5,2,6,9,0,22
191222165,4,1,5,0,3,13
191222166,0,5,8,1,3,17
191222167,8,5,4,3,1,21
191222168,8,9,7,3,6,33
191222169,9,5,2,7,9,32
191222170,3,4,9,3,4,23
191222171,5,6,0,8,8,27
191222172,2,0,5,8,3,18
191222173,7,3,0,7,9,26
191222174,4,7,4,7,1,23
191222175,9,6,7,3,3,28
191222176,7,1,3,9,5,25
191222177,8,7,0,6,9,30
191222178,5,6,4,5,7,27
191222179,6,6,4,6,2,24
191222180,8,4,3,0,3,18
191222181,6,2,3,5,2,18
191222182,5,3,1,0,2,11
191222183,0,3,6,4,6,19
191222184,9,8,8,6,4,35
191222185,9,5,5,6,1,26
191222186,4,1,6,2,9,22
191222187,2,1,7,3,9,22
191222188,7,0,0,3,5,15
191222189,3,1,9,7,3,23
191222190,1,4,7,3,9,24
191222191,6,5,9,2,5,27
191222192,9,0,9,2,0,20
191222193,2,8,8,7,5,30
191222194,6,2,4,9,3,24
191222195,6,8,2,2,6,24
191222196,5,9,3,2,1,20
191222197,4,1,9,2,8,24
191222198,1,7,2,8,0,18
191222199,3,4,8,4,9,28
191222200,5,5,5,2,3,20
191222201,6,0,0,2,2,10
191222202,8,3,2,4,2,19
191222203,1,3,3,1,4,12
191222204,8,1,8,0,3,20
191222205,3,8,0,8,6,25
191222206,3,3,5,2,2,15
191222207,2,3,2,1,7,15
191222208,5,3,2,8,1,19
191222209,7,7,0,8,1,23
191222210,3,5,1,5,2,16
191222211,1,8,4,1,3,17
191222212,6,4,5,6,8,29
191222213,8,1,6,5,5,25
191222214,8,3,9,4,6,30
191222215,3,6,1,5,2,17
191222216,6,8,9,8,4,35
191222217,2,1,5,2,3,13
191222218,6,9,2,2,9,28
191222219,9,4,8,7,4,32
191222220,2,5,9,7,6,29
191222221,0,0,6,5,8,19
191222222,0,1,8,7,8,24
191222223,7,5,1,3,1,17
191222224,3,9,3,2,0,17
191222225,2,3,2,8,8,23
191222226,7,5,1,2,3,18
191222227,5,4,4,5,3,21
191222228,5,2,6,8,7,28
191222229,5,3,2,6,8,24
191222230,9,6,7,9,1,32
191222231,4,0,9,7,4,24
191222232,8,9,3,4,9,33
191222233,9,9,1,8,3,30
191222234,3,9,7,8,6,33
191222235,5,0,6,7,6,24
191222236,9,0,8,6,2,25
191222237,2,2,3,0,8,15
191222238,6,4,3,6,5,24
191222239,1,0,1,3,9,14
191222240,2,3,3,2,7,17
191222241,5,8,5,2,2,22
191222242,3,7,3,0,7,20
191222243,4,4,9,1,4,22
191222244,8,7,3,1,4,23
191222245,1,3,1,9,0,14
191222246,0,3,6,3,0,12
191222247,1,2,3,1,8,15
191222248,2,2,3,4,5,16
191222249,1,9,4,2,1,17
191222250,5,2,9,5,2,23
191222251,7,9,8,2,5,31
191222252,5,7,6,1,6,25
191222253,4,9,5,9,6,33
191222254,8,0,6,5,3,22
191222255,6,8,6,7,4,31
191222256,5,6,9,4,6,30
191222257,3,2,3,5,4,17
191222258,6,2,5,2,2,17
191222259,6,0,7,1,2,16
191222260,5,9,0,8,9,31
191222261,8,0,7,6,9,30
191222262,9,3,1,8,0,21
191222263,2,4,2,5,2,15
191222264,7,9,8,8,9,41
191222265,2,1,7,6,5,21
191222266,8,7,2,4,3,24
191222267,8,9,9,0,1,27
191222268,2,7,5,5,2,21
191222269,9,6,7,5,2,29
191222270,8,8,3,4,4,27
191222271,5,4,3,1,5,18
191222272,0,0,6,1,6,13
191222273,0,0,6,5,0,11
191222274,9,5,9,0,4,27
191222275,8,5,1,9,1,24
191222276,4,5,5,4,3,21
191222277,8,0,4,8,8,28
191222278,6,5,9,9,9,38
191222279,0,0,6,5,1,12
191222280,7,5,3,3,0,18
191222281,8,2,0,1,7,18
191222282,1,8,7,8,6,30
191222283,3,8,0,8,4,23
191222284,2,0,8,3,6,19
191222285,3,8,5,4,8,28
191222286,8,0,2,0,2,12
191222287,9,1,1,5,3,19
191222288,3,9,4,9,9,34
191222289,2,3,9,4,5,23
191222290,5,8,6,5,8,32
191222291,7,8,8,4,5,32
191222292,7,1,4,9,5,26
191222293,6,8,6,6,2,28
191222294,5,7,2,3,0,17
191222295,4,4,0,7,4,19
191222296,5,3,2,3,2,15
191222297,2,1,0,8,3,14
191222298,0,7,7,4,2,20
191222299,3,7,9,8,6,33
191222300,4,6,0,3,6,19
191222301,8,3,5,3,6,25
191222302,4,8,0,3,4,19
191222303,1,0,7,6,0,14
191222304,7,4,0,6,3,20
191222305,4,0,1,7,8,20
191222306,4,0,8,4,9,25
191222307,6,3,7,6,8,30
191222308,1,5,7,4,8,25
191222309,1,2,2,4,3,12
191222310,2,5,6,0,8,21
191222311,6,8,6,9,9,38
191222312,0,6,8,4,0,18
191222313,4,5,6,4,2,21
191222314,1,5,8,2,1,17
191222315,8,2,7,4,7,28
191222316,9,1,2,4,5,21
191222317,6,5,1,5,0,17
191222318,9,7,2,4,5,27
191222319,2,5,8,7,3,25
191222320,5,4,0,2,0,11
191222321,1,0,6,5,4,16
191222322,8,9,1,9,6,33
191222323,2,1,2,3,0,8
191222324,1,6,0,9,9,25
191222325,3,0,0,2,2,7
191222326,4,7,5,9,5,30
191222327,5,0,5,8,3,21
191222328,2,7,0,1,5,15
191222329,3,6,3,0,7,19
191222330,9,6,1,5,1,22
191222331,2,7,4,3,0,16
191222332,7,4,2,0,5,18
191222333,1,6,2,3,0,12
191222334,8,9,2,8,4,31
191222335,7,2,2,3,2,16
191222336,8,1,0,9,6,24
191222337,2,2,3,2,5,14
191222338,6,0,3,3,0,12
191222339,4,2,9,6,9,30
191222340,6,7,8,0,7,28
191222341,3,3,4,5,7,22
191222342,8,6,0,5,4,23
191222343,2,8,2,2,6,20
191222344,0,1,7,7,4,19
191222345,6,3,6,4,6,25
191222346,7,9,5,4,2,27
191222347,4,8,7,3,1,23
191222348,8,5,0,0,8,21
191222349,4,7,0,0,7,18
191222350,6,3,3,0,3,15
191222351,5,8,7,3,4,27
191222352,5,9,9,3,7,33
191222353,3,2,4,4,2,15
191222354,2,7,2,3,6,20
191222355,0,4,1,6,9,20
191222356,2,3,8,2,2,17
191222357,1,7,9,2,3,22
191222358,7,2,5,8,4,26
191222359,5,2,6,8,2,23
191222360,9,3,0,1,4,17
191222361,2,1,1,2,8,14
191222362,3,6,9,1,9,28
191222363,9,2,6,8,8,33
191222364,0,5,8,6,3,22
191222365,7,5,4,1,5,22
191222366,8,3,2,6,5,24
191222367,3,7,6,5,0,21
191222368,7,7,7,9,4,34
191222369,9,1,0,4,7,21
191222370,8,8,6,8,4,34
191222371,2,5,3,6,5,21
191222372,0,4,0,8,4,16
191222373,5,7,2,9,3,26
191222374,8,5,4,2,6,25
191222375,3,8,8,5,0,24
191222376,2,0,2,4,1,9
191222377,8,6,7,6,0,27
191222378,1,4,4,9,1,19
191222379,3,5,9,7,4,28
191222380,3,8,5,4,0,20
191222381,4,9,3,9,5,30
191222382,0,8,2,6,1,17
191222383,6,4,7,8,6,31
191222384,0,6,2,2,5,15
191222385,8,7,0,8,3,26
191222386,2,0,5,8,8,23
191222387,8,2,2,6,4,22
191222388,6,8,5,0,9,28
191222389,6,2,7,0,1,16
191222390,8,0,1,0,7,16
191222391,7,0,2,4,4,17
191222392,9,7,5,1,6,28
191222393,3,8,8,0,4,23
191222394,7,4,5,9,0,25
191222395,8,8,1,9,7,33
191222396,2,2,7,7,4,22
191222397,5,1,1,6,5,18
191222398,3,8,6,0,7,24
191222399,8,5,3,0,7,23
191222400,4,5,2,8,2,21
191222401,3,5,9,6,3,26
191222402,2,8,0,7,9,26
191222403,5,8,1,0,6,20
191222404,8,6,2,6,0,22
191222405,0,5,6,4,0,15
191222406,4,1,0,8,7,20
191222407,2,4,1,9,3,19
191222408,5,8,0,0,2,15
191222409,7,2,1,7,8,25
191222410,5,7,6,1,0,19
191222411,8,3,8,7,4,30
191222412,6,2,5,9,4,26
191222413,6,8,7,1,9,31
191222414,0,6,8,0,0,14
191222415,0,5,8,7,7,27
191222416,4,9,0,1,9,23
191222417,3,2,8,5,6,24
191222418,0,0,6,5,4,15
191222419,0,0,1,2,0,3
191222420,4,6,6,7,2,25
191222421,6,4,0,2,4,16
191222422,2,7,1,1,7,18
191222423,2,2,1,9,2,16
191222424,7,9,4,5,4,29
191222425,9,3,5,2,5,24
191222426,0,9,8,6,7,30
191222427,1,2,4,2,3,12
191222428,1,7,0,8,0,16
191222429,6,1,1,4,9,21
191222430,1,1,1,8,6,17
191222431,9,6,1,3,3,22
191222432,8,8,0,0,8,24
191222433,9,1,6,4,9,29
191222434,5,1,3,8,1,18
191222435,4,8,6,5,0,23
191222436,6,8,4,9,8,35
191222437,4,2,3,5,7,21
191222438,0,3,2,4,5,14
191222439,6,6,9,8,2,31
191222440,5,1,5,3,2,16
191222441,9,0,7,2,9,27
191222442,8,3,1,5,4,21
191222443,4,7,2,1,8,22
191222444,1,7,0,3,3,14
191222445,7,7,6,5,5,30
191222446,6,6,0,2,9,23
191222447,8,0,1,6,8,23
191222448,0,9,1,6,0,16
191222449,6,8,2,0,7,23
191222450,9,9,2,1,1,22
191222451,5,4,1,3,2,15
191222452,8,8,3,7,3,29
191222453,0,8,0,2,9,19
191222454,8,9,4,6,9,36
191222455,7,1,2,1,7,18
191222456,9,3,5,5,1,23
191222457,3,9,5,1,0,18
191222458,6,3,6,4,3,22
191222459,0,3,9,1,6,19
191222460,9,6,0,1,1,17
191222461,5,4,0,5,6,20
191222462,2,7,6,0,4,19
191222463,9,8,7,0,1,25
191222464,1,6,1,9,1,18
191222465,9,2,1,4,4,20
191222466,1,1,2,6,1,11
191222467,5,4,7,4,0,20
191222468,2,5,9,3,6,25
191222469,7,2,6,0,2,17
191222470,7,9,0,5,0,21
191222471,9,7,5,9,2,32
191222472,8,7,6,7,3,31
191222473,8,4,1,9,7,29
191222474,2,6,4,2,7,21
191222475,3,5,2,4,1,15
191222476,0,4,9,4,0,17
191222477,4,8,8,9,7,36
191222478,8,3,2,2,9,24
191222479,2,5,8,4,8,27
191222480,6,1,6,8,8,29
191222481,9,0,6,1,9,25
191222482,6,8,6,0,3,23
191222483,9,7,4,3,2,25
191222484,3,9,2,0,3,17
191222485,3,3,5,2,3,16
191222486,1,3,4,5,3,16
191222487,0,5,6,7,8,26
191222488,0,5,8,7,0,20
191222489,1,7,5,9,4,26
191222490,5,9,3,2,6,25
191222491,0,5,9,5,6,25
191222492,9,8,4,0,6,27
191222493,3,5,1,1,8,18
191222494,4,7,9,0,4,24
191222495,5,0,9,7,4,25
191222496,5,0,6,4,0,15
191222497,0,0,0,1,9,10
191222498,8,7,1,6,7,29
191222499,1,5,1,1,3,11
191222500,6,1,6,9,1,23
191222501,5,5,2,1,0,13
191222502,0,8,4,4,4,20
191222503,4,0,3,9,0,16
191222504,9,8,3,7,8,35
191222505,8,9,5,5,6,33
191222506,7,6,7,3,7,30
191222507,7,4,3,1,7,22
191222508,8,1,4,0,7,20
191222509,2,3,5,5,8,23
191222510,7,8,8,2,1,26
191222511,7,9,5,4,1,26
191222512,1,4,1,4,7,17
191222513,4,4,5,6,9,28
191222514,4,9,0,1,0,14
191222515,0,7,0,0,0,7
191222516,7,7,4,2,9,29
191222517,3,7,5,5,7,27
191222518,2,4,2,1,1,10
191222519,1,4,2,4,0,11
191222520,6,5,9,0,7,27
191222521,5,2,4,1,9,21
191222522,8,3,5,5,0,21
191222523,5,6,3,6,0,20
191222524,8,6,4,3,7,28
191222525,4,8,9,7,3,31
191222526,5,2,8,4,7,26
191222527,0,3,7,7,2,19
191222528,4,8,1,3,1,17
191222529,1,4,6,3,8,22
191222530,8,1,6,9,9,33
191222531,9,7,8,8,9,41
191222532,1,6,9,2,1,19
191222533,9,9,3,2,9,32
191222534,1,6,5,0,8,20
191222535,8,3,2,7,4,24
191222536,4,6,0,2,0,12
191222537,0,0,1,8,7,16
191222538,9,6,5,8,5,33
191222539,1,7,7,3,3,21
191222540,8,7,0,4,7,26
191222541,0,8,3,0,8,19
191222542,0,0,5,3,8,16
191222543,8,0,5,3,2,18
191222544,4,2,2,5,0,13
191222545,8,0,8,6,0,22
191222546,1,0,0,5,0,6
191222547,9,8,1,8,8,34
191222548,6,6,7,7,8,34
191222549,6,0,0,6,2,14
191222550,9,7,4,2,2,24
191222551,9,0,0,1,1,11
191222552,5,4,9,1,0,19
191222553,4,6,7,5,6,28
191222554,0,7,2,2,1,12
191222555,2,0,0,4,9,15
191222556,9,3,4,4,2,22
191222557,5,3,4,4,7,23
191222558,2,6,4,8,2,22
191222559,9,0,4,2,7,22
191222560,2,2,0,2,1,7
191222561,9,7,6,8,0,30
191222562,7,4,4,0,6,21
191222563,0,5,6,5,4,20
191222564,3,0,2,2,7,14
191222565,1,6,5,0,1,13
191222566,4,5,0,4,0,13
191222567,2,7,8,9,9,35
191222568,4,0,7,8,1,20
191222569,8,9,2,4,3,26
191222570,7,2,8,8,5,30
191222571,5,6,4,3,3,21
191222572,3,8,2,0,6,19
191222573,3,7,3,7,9,29
191222574,8,2,5,4,7,26
191222575,3,6,1,0,5,15
191222576,2,8,9,9,8,36
191222577,8,3,2,8,9,30
191222578,0,0,7,2,5,14
191222579,3,4,5,1,4,17
191222580,1,3,9,0,7,20
191222581,5,5,4,5,0,19
191222582,5,6,8,5,0,24
191222583,8,6,0,6,8,28
191222584,1,5,0,9,1,16
191222585,6,9,9,4,6,34
191222586,8,8,4,4,1,25
191222587,0,1,6,4,7,18
191222588,6,0,5,9,9,29
191222589,5,4,0,1,7,17
191222590,0,5,7,5,5,22
191222591,5,9,2,4,0,20
191222592,2,9,0,7,0,18
191222593,7,8,0,5,0,20
191222594,0,3,5,9,0,17
191222595,4,0,0,6,8,18
191222596,3,3,8,3,6,23
191222597,6,6,5,7,3,27
191222598,0,1,1,8,8,18
191222599,5,1,0,3,1,10
191222600,0,1,1,9,5,16
191222601,9,9,3,9,8,38
191222602,4,0,7,4,2,17
191222603,0,4,8,2,4,18
191222604,7,4,0,8,2,21
191222605,9,0,3,9,6,27
191222606,0,0,5,1,4,10
191222607,8,4,7,1,7,27
191222608,7,6,4,6,7,30
191222609,4,1,3,1,9,18
191222610,9,8,3,7,3,30
191222611,0,2,9,7,5,23
191222612,4,4,9,3,8,28
191222613,8,6,3,5,5,27
191222614,5,4,1,2,5,17
191222615,2,9,1,3,0,15
191222616,1,4,2,7,4,18
191222617,8,7,7,2,5,29
191222618,4,0,9,0,1,14
191222619,9,8,6,6,5,34
191222620,4,0,6,7,5,22
191222621,9,0,0,7,9,25
191222622,0,3,8,4,9,24
191222623,6,7,6,2,2,23
191222624,4,1,3,7,6,21
191222625,3,5,6,9,3,26
191222626,2,5,2,1,7,17
191222627,4,4,6,2,2,18
191222628,7,2,8,3,0,20
191222629,9,2,0,8,4,23
191222630,4,5,2,9,7,27
191222631,2,6,9,4,7,28
191222632,1,9,6,4,4,24
191222633,5,0,7,4,4,20
191222634,2,6,8,0,8,24
191222635,4,6,3,8,1,22
191222636,0,5,3,0,6,14
191222637,2,1,8,4,1,16
191222638,6,7,6,4,9,32
191222639,6,4,5,7,7,29
191222640,4,5,2,1,1,13
191222641,5,9,7,0,6,27
191222642,3,3,6,9,6,27
191222643,4,7,6,9,0,26
191222644,6,6,8,9,9,38
191222645,8,6,2,1,8,25
191222646,9,0,9,8,2,28
191222647,5,5,9,8,2,29
191222648,3,9,0,5,1,18
191222649,7,9,8,2,4,30
191222650,5,6,0,2,3,16
191222651,9,9,9,9,9,45
191222652,5,6,2,6,6,25
191222653,2,6,9,0,4,21
191222654,5,8,3,4,9,29
191222655,3,7,1,7,3,21
191222656,1,6,0,9,4,20
191222657,1,2,2,1,7,13
191222658,2,1,5,2,0,10
191222659,0,5,3,6,0,14
191222660,8,3,4,2,7,24
191222661,8,1,8,8,3,28
191222662,8,5,6,8,6,33
191222663,0,5,4,0,5,14
191222664,6,5,6,5,1,23
191222665,6,8,8,1,0,23
191222666,1,8,3,2,0,14
191222667,2,0,6,4,1,13
191222668,2,9,2,5,0,18
191222669,0,8,2,2,2,14
191222670,4,0,4,9,9,26
191222671,5,0,0,6,2,13
191222672,4,9,1,4,1,19
191222673,1,7,3,7,3,21
191222674,3,3,4,0,6,16
191222675,2,7,9,7,4,29
191222676,8,3,5,7,0,23
191222677,2,0,0,4,5,11
191222678,6,6,3,1,6,22
191222679,5,9,7,0,5,26
191222680,0,7,0,4,3,14
191222681,5,0,0,2,9,16
191222682,3,1,4,4,9,21
191222683,7,8,6,3,6,30
191222684,0,5,2,4,4,15
191222685,1,4,8,5,8,26
191222686,7,4,8,8,7,34
191222687,5,4,4,2,2,17
191222688,9,9,0,8,9,35
191222689,4,6,6,0,2,18
191222690,8,3,8,9,2,30
191222691,8,8,5,8,4,33
191222692,1,0,2,7,0,10
191222693,2,3,1,4,5,15
191222694,3,1,2,1,9,16
191222695,8,6,3,9,5,31
191222696,0,1,1,5,4,11
191222697,7,8,4,2,4,25
191222698,8,6,4,0,6,24
191222699,8,8,9,2,1,28
191222700,8,4,4,6,7,29
191222701,6,4,8,8,4,30
191222702,8,7,2,0,7,24
191222703,5,0,6,7,7,25
191222704,3,3,9,0,4,19
191222705,7,6,0,2,6,21
191222706,0,7,3,9,7,26
191222707,9,6,4,9,8,36
191222708,1,5,1,6,2,15
191222709,5,9,3,3,5,25
191222710,3,3,7,6,0,19
191222711,2,7,0,7,1,17
191222712,4,0,3,9,1,17
191222713,8,3,2,5,0,18
191222714,0,0,9,8,0,17
191222715,8,0,8,8,7,31
191222716,2,8,7,9,5,31
191222717,7,1,8,2,8,26
191222718,3,1,6,6,9,25
191222719,3,9,3,3,9,27
191222720,6,1,2,3,3,15
191222721,6,4,0,7,2,19
191222722,1,1,1,2,0,5
191222723,6,0,2,9,6,23
191222724,7,9,5,9,1,31
191222725,1,0,1,0,2,4
191222726,6,3,3,5,8,25
191222727,3,8,1,4,7,23
191222728,0,7,3,7,4,21
191222729,8,5,7,3,1,24
191222730,3,5,3,6,9,26
191222731,4,1,3,9,6,23
191222732,9,9,8,5,2,33
191222733,6,0,4,2,3,15
191222734,9,9,5,2,1,26
191222735,7,7,7,6,6,33
191222736,7,0,3,9,0,19
191222737,0,6,0,8,2,16
191222738,5,5,1,0,4,15
191222739,0,0,2,5,7,14
191222740,0,0,4,3,8,15
191222741,1,0,9,4,9,23
191222742,6,7,2,3,8,26
191222743,7,6,8,4,0,25
191222744,4,1,4,1,6,16
191222745,9,1,8,3,6,27
191222746,7,4,5,6,1,23
191222747,4,8,8,9,5,34
191222748,3,5,8,4,4,24
191222749,5,2,4,8,7,26
191222750,9,6,3,6,0,24
191222751,8,5,9,5,5,32
191222752,3,3,5,2,7,20
191222753,8,1,8,9,5,31
191222754,9,1,8,0,2,20
191222755,4,0,2,8,3,17
191222756,9,2,9,9,2,31
191222757,7,4,5,4,5,25
191222758,7,2,9,3,7,28
191222759,1,6,7,4,5,23
191222760,7,3,5,0,0,15
191222761,2,1,0,7,8,18
191222762,8,1,5,4,8,26
191222763,6,8,9,2,0,25
191222764,2,3,1,0,1,7
191222765,7,4,4,4,3,22
191222766,4,3,9,4,8,28
191222767,7,8,4,2,1,22
191222768,7,4,5,5,9,30
191222769,2,6,5,0,1,14
191222770,4,9,0,0,0,13
191222771,0,8,7,7,0,22
191222772,1,1,1,8,8,19
191222773,1,4,3,9,6,23
191222774,5,9,6,9,2,31
191222775,7,0,0,4,1,12
191222776,2,7,1,2,3,15
191222777,6,8,7,0,3,24
191222778,6,1,9,8,0,24
191222779,2,6,1,2,1,12
191222780,3,3,4,7,7,24
191222781,0,0,6,3,7,16
191222782,7,1,3,5,9,25
191222783,2,4,5,0,4,15
191222784,6,9,7,5,6,33
191222785,3,4,3,8,5,23
191222786,6,1,2,5,1,15
191222787,3,5,5,6,5,24
191222788,6,8,2,0,6,22
191222789,8,1,5,0,1,15
191222790,7,4,9,4,6,30
191222791,5,3,7,4,5,24
191222792,6,8,3,9,1,27
191222793,8,3,0,9,2,22
191222794,0,0,6,2,1,9
191222795,4,9,2,2,9,26
191222796,4,2,9,9,8,32
191222797,6,4,7,7,1,25
191222798,9,6,8,2,7,32
191222799,3,1,4,5,1,14
191222800,0,6,7,9,4,26
191222801,0,6,0,4,0,10
191222802,2,8,2,6,5,23
191222803,9,8,6,6,9,38
191222804,2,9,2,8,8,29
191222805,4,9,6,8,8,35
191222806,5,2,3,9,4,23
191222807,7,7,9,7,6,36
191222808,4,2,8,2,4,20
191222809,3,5,2,6,7,23
191222810,1,4,9,1,8,23
191222811,2,2,4,3,9,20
191222812,0,0,1,4,8,13
191222813,5,8,3,2,2,20
191222814,4,8,1,1,1,15
191222815,0,8,6,7,8,29
191222816,8,9,8,3,2,30
191222817,7,5,9,6,5,32
191222818,7,5,6,3,4,25
191222819,7,5,0,4,0,16
191222820,7,1,8,2,2,20
191222821,7,7,0,7,9,30
191222822,2,8,3,4,2,19
191222823,6,1,0,1,6,14
191222824,2,8,4,6,1,21
191222825,5,3,6,3,5,22
191222826,7,6,6,4,3,26
191222827,2,8,0,1,7,18
191222828,5,3,7,5,0,20
191222829,1,3,7,4,6,21
191222830,5,4,0,3,0,12
191222831,4,6,9,4,3,26
191222832,4,2,1,4,2,13
191222833,0,1,7,5,0,13
191222834,3,9,0,6,9,27
191222835,5,2,4,4,1,16
191222836,1,8,8,3,3,23
191222837,7,8,1,8,1,25
191222838,7,7,3,4,9,30
191222839,6,8,3,0,2,19
191222840,0,2,6,7,3,18
191222841,2,8,9,6,7,32
191222842,1,1,7,3,5,17
191222843,6,3,6,0,9,24
191222844,4,2,6,4,1,17
191222845,6,9,5,2,2,24
191222846,6,8,2,0,0,16
191222847,8,0,5,8,8,29
191222848,6,1,8,6,4,25
191222849,5,0,6,5,5,21
191222850,9,5,4,3,7,28
191222851,8,3,5,4,5,25
191222852,3,8,4,9,5,29
191222853,3,1,2,4,6,16
191222854,9,4,4,9,8,34
191222855,2,8,8,8,7,33
191222856,1,6,4,7,8,26
191222857,4,8,0,8,0,20
191222858,4,5,9,5,6,29
191222859,3,5,3,9,9,29
191222860,9,8,5,1,5,28
191222861,1,0,9,0,4,14
191222862,4,7,7,8,1,27
191222863,9,4,4,1,5,23
191222864,1,8,5,0,0,14
191222865,8,2,5,6,9,30
191222866,3,7,7,8,8,33
191222867,2,3,6,1,4,16
191222868,4,8,2,0,3,17
191222869,7,9,0,9,3,28
191222870,2,4,5,8,2,21
191222871,8,9,4,4,9,34
191222872,3,4,9,7,4,27
191222873,4,2,4,6,5,21
191222874,2,5,6,0,9,22
191222875,7,8,9,8,5,37
191222876,7,4,5,2,0,18
191222877,7,1,5,0,5,18
191222878,5,5,6,1,1,18
191222879,6,4,6,3,9,28
191222880,3,5,7,1,6,22
191222881,2,3,3,7,2,17
191222882,6,4,5,1,1,17
191222883,1,9,9,2,6,27
191222884,7,1,6,2,7,23
191222885,2,7,6,9,1,25
191222886,8,5,8,5,4,30
191222887,9,7,1,6,4,27
191222888,2,8,6,7,5,28
191222889,1,6,6,7,4,24
191222890,9,1,8,0,4,22
191222891,7,2,0,1,9,19
191222892,1,0,5,6,7,19
191222893,6,3,5,7,0,21
191222894,5,9,2,3,8,27
191222895,6,0,1,3,9,19
191222896,2,6,7,7,6,28
191222897,1,6,0,3,2,12
191222898,1,3,7,4,0,15
191222899,7,3,9,2,7,28
191222900,5,8,0,8,9,30
191222901,1,0,0,7,0,8
191222902,3,3,4,3,4,17
191222903,1,0,2,6,7,16
191222904,9,4,7,5,5,30
191222905,3,1,9,7,7,27
191222906,3,0,8,6,5,22
191222907,3,0,4,1,5,13
191222908,0,2,7,5,9,23
191222909,0,0,3,1,1,5
191222910,0,0,1,4,7,12
191222911,4,1,7,6,9,27
191222912,8,3,0,4,0,15
191222913,8,2,0,1,2,13
191222914,8,3,5,0,4,20
191222915,3,1,1,8,8,21
191222916,6,2,0,0,2,10
191222917,4,1,6,9,6,26
191222918,6,4,9,4,6,29
191222919,7,3,7,0,5,22
191222920,9,7,9,7,7,39
191222921,8,1,7,5,3,24
191222922,9,5,5,1,2,22
191222923,5,1,5,6,5,22
191222924,6,5,3,6,2,22
191222925,0,6,4,0,7,17
191222926,5,9,5,8,1,28
191222927,1,5,3,6,3,18
191222928,9,9,8,2,6,34
191222929,6,9,9,5,0,29
191222930,2,4,4,1,5,16
191222931,3,2,7,2,1,15
191222932,8,5,2,3,2,20
191222933,7,1,8,6,0,22
191222934,2,4,0,2,0,8
191222935,3,0,3,4,8,18
191222936,3,5,7,4,5,24
191222937,7,7,9,7,9,39
191222938,6,9,6,7,2,30
191222939,7,4,3,7,2,23
191222940,6,2,9,6,0,23
191222941,5,9,8,9,0,31
191222942,6,6,4,0,8,24
191222943,9,5,4,2,3,23
191222944,6,6,9,5,5,31
191222945,9,3,7,1,4,24
191222946,6,7,4,7,4,28
191222947,5,1,8,5,9,28
191222948,2,3,9,1,0,15
191222949,9,7,9,4,6,35
191222950,7,5,0,4,5,21
191222951,3,9,1,8,8,29
191222952,7,8,9,3,1,28
191222953,3,4,6,0,0,13
191222954,0,9,0,6,8,23
191222955,6,8,3,5,2,24
191222956,5,2,4,6,1,18
191222957,8,9,3,3,5,28
191222958,9,1,6,7,6,29
191222959,3,8,5,8,8,32
191222960,2,0,9,1,8,20
191222961,9,3,5,8,6,31
191222962,4,5,3,0,1,13
191222963,2,3,4,5,2,16
191222964,4,1,1,9,4,19
191222965,9,1,3,7,5,25
191222966,9,2,3,0,7,21
191222967,6,1,3,8,6,24
191222968,6,1,2,4,2,15
191222969,3,6,9,8,1,27
191222970,5,1,6,8,7,27
191222971,1,0,1,1,9,12
191222972,3,0,3,1,6,13
191222973,8,1,8,8,4,29
191222974,0,8,0,2,1,11
191222975,2,6,5,1,2,16
191222976,3,7,0,9,2,21
191222977,9,3,1,2,6,21
191222978,2,3,4,1,6,16
191222979,7,1,2,6,8,24
191222980,8,8,2,5,0,23
191222981,2,3,0,6,3,14
191222982,7,1,6,8,6,28
191222983,2,7,2,8,1,20
191222984,9,2,5,5,1,22
191222985,6,5,0,2,6,19
191222986,4,5,6,8,9,32
191222987,2,6,5,3,8,24
191222988,5,0,4,5,3,17
191222989,0,6,6,4,1,17
191222990,0,2,8,2,3,15
191222991,4,8,4,3,9,28
191222992,4,0,2,5,1,12
191222993,8,8,4,7,4,31
191222994,9,7,0,7,2,25
191222995,5,2,3,4,3,17
191222996,4,9,9,4,8,34
191222997,7,9,9,5,8,38
191222998,2,6,7,3,0,18
191222999,4,6,4,2,3,19
1912221000,4,5,1,4,9,23
1912221001,9,0,7,1,9,26
1912221002,7,4,8,5,1,25
1912221003,7,7,2,5,0,21
1912221004,4,6,2,8,2,22
1912221005,9,3,5,5,9,31
1912221006,3,2,7,4,3,19
1912221007,7,6,3,5,0,21
1912221008,0,7,1,2,1,11
1912221009,8,2,7,9,7,33
1912221010,1,2,1,8,8,20
1912221011,8,7,3,7,2,27
1912221012,2,5,8,9,7,31
1912221013,9,9,5,7,5,35
1912221014,5,8,2,1,9,25
1912221015,3,1,9,2,0,15
1912221016,8,3,2,1,9,23
1912221017,8,3,9,7,4,31
1912221018,8,0,5,8,1,22
1912221019,8,1,6,4,5,24
1912221020,0,6,4,3,3,16
1912221021,2,7,5,3,8,25
1912221022,4,6,3,7,7,27
1912221023,8,9,3,8,2,30
1912221024,3,6,8,8,6,31
1912221025,5,4,5,4,8,26
1912221026,0,2,4,0,0,6
1912221027,9,4,6,5,8,32
1912221028,2,4,5,3,4,18
1912221029,9,0,3,7,0,19
1912221030,4,8,0,3,7,22
1912221031,4,3,0,7,5,19
1912221032,7,9,4,8,3,31
1912221033,5,6,6,7,4,28
1912221034,3,3,8,5,2,21
1912221035,2,9,7,5,4,27
1912221036,5,0,0,7,3,15
1912221037,7,2,8,3,1,21
1912221038,2,9,0,3,5,19
1912221039,9,6,7,0,4,26
1912221040,4,0,0,9,5,18
1912221041,8,6,2,9,3,28
1912221042,5,0,4,1,9,19
1912221043,7,5,8,6,9,35
1912221044,8,5,4,3,9,29
1912221045,5,5,4,5,9,28
1912221046,2,4,9,7,5,27
1912221047,9,5,4,1,5,24
1912221048,1,0,5,2,0,8
1912221049,2,3,3,3,3,14
1912221050,2,1,1,2,9,15
1912221051,3,9,2,2,3,19
1912221052,7,0,9,6,0,22
1912221053,1,6,8,4,1,20
1912221054,9,8,5,5,4,31
1912221055,7,1,6,8,2,24
1912221056,3,9,7,5,4,28
1912221057,4,0,2,5,3,14
1912221058,5,1,6,4,2,18
1912221059,2,9,5,7,1,24
1912221060,9,5,3,2,0,19
1912221061,4,4,7,9,2,26
1912221062,9,6,4,2,5,26
1912221063,4,2,2,3,6,17
1912221064,4,5,2,3,9,23
1912221065,1,6,0,6,8,21
1912221066,9,3,5,3,7,27
1912221067,9,3,3,0,0,15
1912221068,8,5,4,3,3,23
1912221069,7,8,2,5,7,29
1912221070,7,8,6,8,7,36
1912221071,6,4,0,5,0,15
1912221072,3,4,3,6,4,20
1912221073,1,6,9,2,5,23
1912221074,7,7,5,0,3,22
1912221075,4,9,3,4,7,27
1912221076,9,6,0,9,9,33
1912221077,3,4,8,6,9,30
1912221078,7,1,4,3,0,15
1912221079,0,1,0,5,3,9
1912221080,0,8,1,5,3,17
1912221081,5,6,5,8,8,32
1912221082,0,0,0,2,1,3
1912221083,4,2,2,5,3,16
1912221084,3,2,6,3,6,20
1912221085,8,0,2,5,2,17
1912221086,4,9,2,5,0,20
1912221087,0,0,1,8,0,9
1912221088,6,6,0,6,1,19
1912221089,5,5,8,3,2,23
1912221090,6,1,2,6,5,20
1912221091,7,1,8,0,8,24
1912221092,7,5,6,5,0,23
1912221093,7,4,2,2,2,17
1912221094,0,3,6,9,2,20
1912221095,3,6,5,8,2,24
1912221096,0,8,1,2,1,12
1912221097,0,6,2,5,3,16
1912221098,5,3,5,7,3,23
1912221099,2,3,8,7,2,22
1912221100,4,1,2,4,9,20
1912221101,6,9,2,5,5,27
1912221102,9,0,0,6,7,22
1912221103,5,6,8,6,1,26
1912221104,1,3,6,2,4,16
1912221105,4,9,1,8,1,23
191223001,5,8,6,4,8,31
191223002,0,1,9,5,2,17
191223003,5,2,9,1,3,20
191223004,0,9,0,8,8,25
191223005,0,5,1,3,5,14
191223006,2,3,3,1,9,18
191223007,6,6,3,4,6,25
191223008,7,9,4,4,1,25
191223009,0,2,4,3,8,17
191223010,5,5,6,4,3,23
191223011,6,7,3,5,9,30
191223012,8,9,3,5,3,28
191223013,7,9,3,1,2,22
191223014,1,9,9,6,8,33
191223015,8,0,9,9,5,31
191223016,1,8,2,9,6,26
191223017,7,3,1,7,5,23
191223018,4,1,6,6,0,17
191223019,8,7,7,7,2,31
191223020,5,8,6,3,2,24
191223021,3,8,2,8,4,25
191223022,4,7,3,6,8,28
191223023,6,7,9,5,7,34
191223024,4,7,2,3,6,22
191223025,9,6,3,2,9,29
191223026,8,2,4,9,0,23
191223027,6,2,8,0,8,24
191223028,3,8,1,8,6,26
191223029,1,4,7,0,2,14
191223030,0,6,6,1,1,14
191223031,0,1,5,2,5,13
191223032,1,0,3,3,6,13
191223033,0,9,6,1,0,16
191223034,7,3,5,1,7,23
191223035,8,7,5,4,4,28
191223036,8,8,6,8,8,38
191223037,6,7,9,2,6,30
191223038,0,1,7,1,2,11
191223039,7,6,5,4,5,27
191223040,5,1,3,0,8,17
191223041,7,2,9,1,8,27
191223042,0,6,5,1,3,15
191223043,4,1,1,3,2,11
191223044,3,6,2,9,8,28
191223045,0,0,2,6,1,9
191223046,8,6,3,3,7,27
191223047,0,1,8,3,7,19
191223048,3,7,5,1,4,20
191223049,6,5,0,3,8,22
191223050,4,0,7,4,5,20
191223051,4,0,8,6,4,22
191223052,0,6,0,3,9,18
191223053,6,7,6,7,0,26
191223054,1,9,6,1,6,23
191223055,8,9,6,4,6,33
191223056,2,3,1,4,0,10
191223057,0,1,5,5,8,19
191223058,5,9,1,6,7,28
191223059,6,3,3,1,0,13
191223060,8,5,8,8,5,34
191223061,8,5,6,1,5,25
191223062,4,1,1,8,1,15
191223063,0,9,2,7,7,25
191223064,6,4,7,8,2,27
191223065,1,4,2,5,3,15
191223066,7,8,8,7,0,30
191223067,3,8,7,4,6,28
191223068,7,7,1,3,1,19
191223069,9,6,3,3,8,29
191223070,1,4,5,8,8,26
191223071,1,3,6,9,7,26
191223072,9,6,6,9,5,35
191223073,9,7,6,0,1,23
191223074,5,1,2,6,2,16
191223075,9,6,8,8,4,35
191223076,6,3,7,4,1,21
191223077,0,0,1,0,8,9
191223078,8,1,0,8,9,26
191223079,3,3,0,4,4,14
191223080,3,1,4,5,6,19
191223081,9,9,1,3,9,31
191223082,8,5,7,5,7,32
191223083,3,7,6,9,5,30
191223084,6,6,8,3,2,25
191223085,0,7,6,3,6,22
191223086,6,5,8,1,2,22
191223087,8,6,8,3,0,25
191223088,5,0,0,1,1,7
191223089,8,4,3,8,0,23
191223090,8,2,5,9,3,27
191223091,7,4,3,9,8,31
191223092,6,3,4,8,1,22
191223093,9,0,8,6,7,30
191223094,8,9,7,1,3,28
191223095,7,1,5,2,3,18
191223096,0,5,2,0,8,15
191223097,1,6,4,9,1,21
191223098,6,9,3,7,9,34
191223099,7,6,8,4,5,30
191223100,6,9,7,7,0,29
191223101,1,4,4,0,3,12
191223102,5,9,9,9,3,35
191223103,8,1,8,5,1,23
191223104,1,8,8,2,8,27
191223105,8,8,9,1,1,27
191223106,4,8,0,0,2,14
191223107,6,0,4,2,4,16
191223108,1,4,1,0,6,12
191223109,3,7,9,6,6,31
191223110,5,0,3,7,7,22
191223111,6,0,3,7,3,19
191223112,2,5,5,4,9,25
191223113,7,9,1,0,1,18
191223114,7,2,6,5,0,20
191223115,9,5,7,9,5,35
191223116,8,4,3,9,2,26
191223117,9,9,4,2,0,24
191223118,6,8,5,6,5,30
191223119,5,4,9,1,4,23
191223120,1,6,5,9,5,26
191223121,4,2,5,8,3,22
191223122,9,0,4,1,2,16
191223123,2,8,3,6,9,28
191223124,8,9,7,7,7,38
191223125,3,3,1,1,8,16
191223126,3,8,1,2,4,18
191223127,3,0,1,6,7,17
191223128,6,6,2,4,8,26
191223129,6,9,5,0,9,29
191223130,3,8,0,5,9,25
191223131,0,9,8,6,2,25
191223132,1,8,2,7,1,19
191223133,9,7,1,2,9,28
191223134,1,5,0,6,5,17
191223135,1,4,6,6,7,24
191223136,4,2,7,5,5,23
191223137,9,4,5,1,5,24
191223138,6,0,4,4,0,14
191223139,6,9,3,4,2,24
191223140,5,2,1,9,8,25
191223141,7,2,6,2,9,26
191223142,0,5,1,6,9,21
191223143,0,8,9,4,5,26
191223144,1,5,2,0,6,14
191223145,9,3,8,3,8,31
191223146,2,1,7,7,2,19
191223147,6,7,0,3,9,25
191223148,7,9,6,9,5,36
191223149,4,7,2,3,7,23
191223150,9,8,0,0,6,23
191223151,2,1,3,3,7,16
191223152,1,4,3,1,3,12
191223153,3,8,1,4,4,20
191223154,3,1,2,7,7,20
191223155,3,5,0,6,2,16
191223156,8,8,3,0,0,19
191223157,7,6,3,2,8,26
191223158,9,3,1,4,2,19
191223159,3,8,9,8,5,33
191223160,5,0,7,2,6,20
191223161,5,7,7,4,8,31
191223162,8,5,4,4,2,23
191223163,8,2,8,9,0,27
191223164,5,4,6,8,5,28
191223165,9,9,8,1,4,31
191223166,9,0,6,6,2,23
191223167,2,0,5,8,0,15
191223168,1,6,4,1,0,12
191223169,4,7,7,4,1,23
191223170,4,2,9,6,8,29
191223171,1,3,0,6,5,15
191223172,0,3,6,0,1,10
191223173,3,6,1,7,0,17
191223174,9,6,6,3,3,27
191223175,2,2,7,2,0,13
191223176,5,5,9,7,7,33
191223177,0,8,3,4,0,15
191223178,4,0,1,7,7,19
191223179,5,8,8,9,3,33
191223180,4,9,8,9,3,33
191223181,5,6,7,4,4,26
191223182,6,7,6,3,9,31
191223183,0,2,8,4,0,14
191223184,1,6,3,3,3,16
191223185,1,6,7,9,2,25
191223186,5,7,6,3,9,30
191223187,7,2,8,8,9,34
191223188,8,0,5,4,8,25
191223189,2,0,6,2,4,14
191223190,3,1,7,9,0,20
191223191,1,5,1,7,9,23
191223192,5,6,1,3,6,21
191223193,7,3,2,7,5,24
191223194,8,3,5,3,7,26
191223195,5,8,9,3,9,34
191223196,5,2,1,2,3,13
191223197,0,9,9,2,8,28
191223198,7,8,7,8,8,38
191223199,5,5,3,4,4,21
191223200,0,2,0,7,2,11
191223201,2,8,5,8,6,29
191223202,8,3,3,3,0,17
191223203,7,0,7,9,1,24
191223204,4,7,8,0,8,27
191223205,6,3,8,3,6,26
191223206,5,8,9,1,0,23
191223207,6,1,7,3,0,17
191223208,2,5,2,7,3,19
191223209,6,8,1,4,9,28
191223210,1,7,2,0,2,12
191223211,5,4,3,2,9,23
191223212,1,6,2,0,5,14
191223213,1,2,2,2,3,10
191223214,4,6,6,3,1,20
191223215,2,0,9,1,3,15
191223216,2,8,4,4,6,24
191223217,8,3,3,5,6,25
191223218,0,9,7,4,2,22
191223219,4,7,6,1,5,23
191223220,2,5,9,9,1,26
191223221,5,1,9,8,8,31
191223222,1,7,2,0,6,16
191223223,7,5,1,3,4,20
191223224,6,0,3,6,2,17
191223225,0,9,6,9,8,32
191223226,8,3,8,6,1,26
191223227,1,6,2,6,2,17
191223228,9,1,4,0,5,19
191223229,6,7,7,8,2,30
191223230,7,7,8,1,6,29
191223231,8,5,4,4,4,25
191223232,3,8,6,2,1,20
191223233,3,4,9,3,3,22
191223234,9,7,8,2,8,34
191223235,7,4,2,9,9,31
191223236,9,9,0,4,6,28
191223237,2,6,6,9,1,24
191223238,2,9,7,5,6,29
191223239,7,3,7,2,1,20
191223240,6,1,0,3,0,10
191223241,3,3,0,6,9,21
191223242,5,1,8,0,6,20
191223243,0,2,6,6,5,19
191223244,7,1,8,8,2,26
191223245,7,7,4,0,2,20
191223246,8,4,4,7,8,31
191223247,1,9,5,6,2,23
191223248,4,6,6,8,9,33
191223249,0,3,3,5,2,13
191223250,2,7,3,4,9,25
191223251,5,8,8,8,7,36
191223252,2,1,3,4,8,18
191223253,6,2,9,3,4,24
191223254,1,2,7,9,9,28
191223255,9,7,1,0,2,19
191223256,8,2,7,7,8,32
191223257,8,1,3,8,4,24
191223258,3,9,3,1,0,16
191223259,1,5,8,7,4,25
191223260,3,3,5,4,0,15
191223261,5,2,9,4,0,20
191223262,0,5,9,1,1,16
191223263,1,1,3,3,3,11
191223264,3,3,2,9,9,26
191223265,2,0,5,2,7,16
191223266,0,5,0,0,1,6
191223267,2,3,8,3,7,23
191223268,9,9,7,3,3,31
191223269,1,8,6,4,9,28
191223270,9,9,5,2,9,34
191223271,7,2,5,8,0,22
191223272,8,1,2,7,7,25
191223273,3,0,1,0,1,5
191223274,2,0,5,3,5,15
191223275,3,0,1,1,8,13
191223276,3,8,9,0,2,22
191223277,9,6,8,4,0,27
191223278,9,0,2,5,1,17
191223279,4,9,4,6,4,27
191223280,7,5,4,4,1,21
191223281,2,6,5,6,7,26
191223282,0,5,2,3,2,12
191223283,9,0,7,0,7,23
191223284,7,6,2,9,2,26
191223285,3,6,2,4,9,24
191223286,0,6,1,6,3,16
191223287,5,1,8,2,1,17
191223288,4,3,0,8,4,19
191223289,1,4,9,3,1,18
191223290,9,0,4,9,3,25
191223291,5,9,9,8,1,32
191223292,6,7,7,5,5,30
191223293,4,5,1,1,7,18
191223294,3,2,5,1,9,20
191223295,9,7,5,1,2,24
191223296,6,8,4,1,2,21
191223297,2,5,8,5,1,21
191223298,3,9,7,1,7,27
191223299,8,1,5,0,0,14
191223300,3,4,8,6,8,29
191223301,0,7,2,6,5,20
191223302,7,8,8,6,7,36
191223303,7,3,8,0,1,19
191223304,1,1,6,9,3,20
191223305,7,9,7,4,8,35
191223306,7,4,0,7,8,26
191223307,5,4,2,8,8,27
191223308,3,2,7,5,7,24
191223309,9,1,2,1,2,15
191223310,4,1,9,9,1,24
191223311,9,5,7,5,3,29
191223312,9,3,7,5,9,33
191223313,3,0,7,8,1,19
191223314,4,0,9,5,4,22
191223315,5,2,7,7,2,23
191223316,3,7,3,3,3,19
191223317,1,0,2,3,7,13
191223318,1,0,9,6,1,17
191223319,4,7,0,8,8,27
191223320,5,3,0,9,2,19
191223321,8,0,1,8,7,24
191223322,0,3,2,2,7,14
191223323,4,9,4,5,9,31
191223324,9,5,9,4,1,28
191223325,9,1,9,1,8,28
191223326,2,8,1,0,5,16
191223327,2,6,5,0,0,13
191223328,1,9,8,9,5,32
191223329,9,0,1,5,4,19
191223330,9,4,8,6,4,31
191223331,1,0,3,4,8,16
191223332,2,7,8,6,6,29
191223333,4,9,2,4,5,24
191223334,5,8,9,1,9,32
191223335,4,4,5,6,5,24
191223336,1,1,6,3,7,18
191223337,5,6,2,5,3,21
191223338,9,1,9,4,7,30
191223339,1,0,1,7,7,16
191223340,8,0,5,9,4,26
191223341,9,5,5,4,5,28
191223342,4,9,7,0,8,28
191223343,8,2,7,6,1,24
191223344,7,2,4,2,3,18
191223345,7,9,3,5,0,24
191223346,0,9,4,7,6,26
191223347,1,3,0,9,3,16
191223348,8,9,3,1,8,29
191223349,2,8,9,5,2,26
191223350,7,1,6,4,6,24
191223351,1,6,7,7,4,25
191223352,2,8,3,4,3,20
191223353,5,5,7,4,9,30
191223354,8,1,2,6,6,23
191223355,7,0,3,7,9,26
191223356,0,5,4,0,1,10
191223357,4,0,9,4,4,21
191223358,2,4,7,6,4,23
191223359,4,7,8,9,9,37
191223360,6,2,6,1,8,23
191223361,7,8,3,0,2,20
191223362,3,0,8,0,6,17
191223363,1,4,0,0,7,12
191223364,8,5,3,7,9,32
191223365,8,7,9,7,4,35
191223366,1,6,3,8,9,27
191223367,1,7,3,6,7,24
191223368,1,0,4,6,7,18
191223369,3,6,5,2,6,22
191223370,3,2,2,8,4,19
191223371,0,7,2,5,3,17
191223372,8,2,4,1,8,23
191223373,5,0,7,4,5,21
191223374,0,8,1,9,9,27
191223375,1,0,8,6,4,19
191223376,6,3,7,2,1,19
191223377,3,9,7,7,3,29
191223378,3,9,0,3,8,23
191223379,5,9,6,5,4,29
191223380,4,9,4,9,0,26
191223381,7,6,4,9,1,27
191223382,5,3,6,9,2,25
191223383,6,8,4,1,8,27
191223384,7,1,7,5,0,20
191223385,9,6,1,6,0,22
191223386,7,0,0,8,9,24
191223387,0,0,1,5,3,9
191223388,8,3,8,8,9,36
191223389,1,3,6,0,7,17
191223390,5,9,6,3,3,26
191223391,2,7,6,7,7,29
191223392,3,4,2,9,8,26
191223393,6,8,5,7,1,27
191223394,6,3,0,7,5,21
191223395,9,2,5,5,2,23
191223396,8,0,5,6,9,28
191223397,9,9,0,3,2,23
191223398,3,6,0,0,3,12
191223399,6,8,9,0,6,29
191223400,5,0,5,4,1,15
191223401,0,0,5,8,0,13
191223402,2,5,1,4,3,15
191223403,0,3,8,6,6,23
191223404,6,6,4,5,2,23
191223405,7,5,0,1,4,17
191223406,4,9,8,9,4,34
191223407,3,8,1,2,6,20
191223408,8,3,1,3,8,23
191223409,9,3,9,4,7,32
191223410,3,4,3,2,6,18
191223411,1,6,8,5,6,26
191223412,2,0,2,2,2,8
191223413,2,6,3,4,7,22
191223414,2,1,9,3,4,19
191223415,5,6,6,2,0,19
191223416,1,2,1,8,7,19
191223417,4,1,3,8,3,19
191223418,4,2,1,0,2,9
191223419,9,4,4,4,0,21
191223420,5,9,4,8,5,31
191223421,5,0,2,8,1,16
191223422,7,7,9,4,6,33
191223423,5,0,4,7,9,25
191223424,8,0,7,5,1,21
191223425,8,2,9,2,1,22
191223426,5,6,8,4,9,32
191223427,5,7,2,7,8,29
191223428,0,0,9,4,1,14
191223429,6,6,2,0,0,14
191223430,7,7,9,1,5,29
191223431,9,7,5,9,0,30
191223432,9,3,9,9,0,30
191223433,5,0,8,6,1,20
191223434,8,9,4,1,6,28
191223435,2,1,0,0,7,10
191223436,2,5,3,0,9,19
191223437,6,3,5,7,2,23
191223438,7,1,3,4,5,20
191223439,6,2,2,0,8,18
191223440,7,2,3,1,0,13
191223441,7,5,0,9,6,27
191223442,5,4,1,7,6,23
191223443,8,0,1,9,2,20
191223444,1,5,2,0,5,13
191223445,7,5,8,3,1,24
191223446,8,1,0,6,4,19
191223447,9,7,9,4,7,36
191223448,6,1,2,1,9,19
191223449,1,8,5,7,1,22
191223450,7,6,4,8,9,34
191223451,2,9,6,7,7,31
191223452,7,7,9,1,2,26
191223453,6,8,5,3,3,25
191223454,8,0,3,8,8,27
191223455,2,4,1,2,5,14
191223456,9,2,8,5,0,24
191223457,6,8,0,2,1,17
191223458,7,2,0,0,5,14
191223459,3,5,1,0,5,14
191223460,2,3,1,2,2,10
191223461,1,0,3,8,5,17
191223462,1,7,9,2,4,23
191223463,2,3,5,5,5,20
191223464,9,1,1,9,3,23
191223465,4,5,1,5,3,18
191223466,5,3,7,3,0,18
191223467,1,6,2,7,4,20
191223468,2,9,2,9,0,22
191223469,8,1,3,2,5,19
191223470,2,9,6,1,7,25
191223471,2,7,8,9,1,27
191223472,3,6,0,6,5,20
191223473,1,4,5,6,0,16
191223474,2,4,7,2,7,22
191223475,9,4,8,9,4,34
191223476,0,2,8,7,5,22
191223477,5,4,2,2,3,16
191223478,7,9,2,6,5,29
191223479,5,3,1,2,6,17
191223480,8,1,3,9,9,30
191223481,5,3,3,7,6,24
191223482,1,5,2,8,7,23
191223483,2,7,2,0,2,13
191223484,3,9,4,1,0,17
191223485,9,7,0,1,4,21
191223486,7,4,2,6,0,19
191223487,8,5,7,1,0,21
191223488,7,6,8,3,7,31
191223489,1,5,9,7,5,27
191223490,9,3,5,4,9,30
191223491,8,8,0,1,1,18
191223492,4,1,3,9,2,19
191223493,3,0,3,6,7,19
191223494,6,7,5,6,3,27
191223495,7,5,5,0,9,26
191223496,9,3,3,5,7,27
191223497,2,9,8,7,1,27
191223498,3,8,0,7,0,18
191223499,8,8,2,3,0,21
191223500,9,0,8,2,4,23
191223501,6,0,0,2,8,16
191223502,2,3,5,2,0,12
191223503,4,4,7,1,1,17
191223504,7,9,0,8,6,30
191223505,3,0,3,0,2,8
191223506,5,2,6,1,1,15
191223507,4,2,9,7,9,31
191223508,4,3,2,6,2,17
191223509,1,9,2,4,6,22
191223510,1,4,4,4,0,13
191223511,9,3,8,5,9,34
191223512,3,3,8,6,6,26
191223513,0,0,6,0,1,7
191223514,2,7,6,4,3,22
191223515,8,2,7,0,9,26
191223516,8,8,4,6,4,30
191223517,9,1,5,7,8,30
191223518,5,5,6,5,9,30
191223519,6,1,1,1,1,10
191223520,1,3,0,3,5,12
191223521,1,5,4,2,0,12
191223522,4,8,2,8,0,22
191223523,1,0,8,7,2,18
191223524,4,9,6,5,6,30
191223525,0,9,5,5,7,26
191223526,2,1,3,8,4,18
191223527,8,9,0,3,0,20
191223528,5,2,0,2,1,10
191223529,8,3,4,4,5,24
191223530,6,0,4,2,0,12
191223531,3,9,4,0,4,20
191223532,1,7,5,7,7,27
191223533,3,8,7,7,8,33
191223534,6,2,7,9,4,28
191223535,5,8,4,1,1,19
191223536,0,1,4,8,4,17
191223537,3,4,9,5,1,22
191223538,1,7,1,8,4,21
191223539,6,4,6,0,4,20
191223540,3,2,6,4,5,20
191223541,8,2,4,5,2,21
191223542,5,1,4,5,2,17
191223543,9,3,1,4,7,24
191223544,4,4,7,6,1,22
191223545,1,7,6,1,0,15
191223546,6,1,6,2,0,15
191223547,5,4,6,1,2,18
191223548,8,3,3,0,7,21
191223549,5,3,1,1,3,13
191223550,4,1,3,7,9,24
191223551,1,5,6,0,2,14
191223552,9,8,2,2,4,25
191223553,8,6,6,3,4,27
191223554,6,4,7,1,3,21
191223555,1,1,5,8,5,20
191223556,8,1,9,5,5,28
191223557,2,3,7,4,8,24
191223558,3,3,9,7,2,24
191223559,3,2,2,3,5,15
191223560,2,0,1,8,2,13
191223561,5,0,4,2,7,18
191223562,9,7,9,5,8,38
191223563,4,8,3,1,1,17
191223564,5,9,9,2,9,34
191223565,6,8,1,6,4,25
191223566,5,0,2,8,8,23
191223567,6,5,4,6,7,28
191223568,0,2,7,9,0,18
191223569,8,7,0,8,0,23
191223570,4,1,8,3,4,20
191223571,9,1,5,2,0,17
191223572,5,4,2,9,6,26
191223573,4,2,3,6,8,23
191223574,1,3,5,1,6,16
191223575,6,7,3,6,9,31
191223576,3,5,3,2,6,19
191223577,6,1,6,6,3,22
191223578,2,6,6,3,4,21
191223579,3,5,2,4,7,21
191223580,2,3,5,3,1,14
191223581,2,3,1,3,5,14
191223582,2,9,8,2,4,25
191223583,3,5,5,6,7,26
191223584,6,1,9,7,1,24
191223585,7,2,9,6,1,25
191223586,0,8,0,4,8,20
191223587,4,8,8,7,2,29
191223588,8,9,3,7,7,34
191223589,4,8,6,4,7,29
191223590,0,5,3,5,1,14
191223591,6,7,5,3,1,22
191223592,3,7,7,0,3,20
191223593,4,6,5,2,2,19
191223594,3,6,0,8,6,23
191223595,9,2,3,4,3,21
191223596,6,1,4,2,9,22
191223597,1,1,1,0,0,3
191223598,2,8,0,4,7,21
191223599,9,3,8,5,0,25
191223600,2,6,6,0,3,17
191223601,8,3,8,2,0,21
191223602,7,7,0,8,5,27
191223603,6,9,6,5,8,34
191223604,6,0,4,6,9,25
191223605,4,5,0,4,8,21
191223606,9,8,5,1,4,27
191223607,4,5,0,0,5,14
191223608,8,8,2,4,3,25
191223609,7,3,2,1,2,15
191223610,6,4,2,2,0,14
191223611,0,7,1,9,6,23
191223612,4,2,4,5,0,15
191223613,9,0,9,2,8,28
191223614,4,7,6,8,0,25
191223615,6,8,5,5,0,24
191223616,7,9,7,4,7,34
191223617,3,9,9,1,0,22
191223618,1,6,9,2,0,18
191223619,0,9,3,8,2,22
191223620,2,4,4,3,2,15
191223621,3,1,5,8,4,21
191223622,4,4,8,3,6,25
191223623,0,9,3,9,1,22
191223624,7,1,6,5,4,23
191223625,8,2,4,9,6,29
191223626,1,1,4,5,4,15
191223627,1,7,8,5,4,25
191223628,3,5,5,6,9,28
191223629,7,2,7,6,3,25
191223630,5,8,5,4,7,29
191223631,5,8,8,3,0,24
191223632,9,7,9,0,2,27
191223633,6,4,7,2,1,20
191223634,3,8,5,8,0,24
191223635,3,0,9,2,1,15
191223636,9,9,7,9,6,40
191223637,3,9,0,4,8,24
191223638,3,7,3,5,1,19
191223639,9,1,6,8,6,30
191223640,9,1,8,8,9,35
191223641,5,7,4,3,5,24
191223642,8,8,1,4,5,26
191223643,1,7,9,1,0,18
191223644,8,5,1,7,2,23
191223645,4,0,1,4,7,16
191223646,5,8,8,7,3,31
191223647,9,9,2,5,1,26
191223648,4,7,3,2,6,22
191223649,1,9,9,1,5,25
191223650,7,0,1,7,0,15
191223651,3,1,0,3,5,12
191223652,4,3,0,9,7,23
191223653,1,5,2,7,4,19
191223654,1,7,5,5,2,20
191223655,7,0,9,3,9,28
191223656,5,6,9,1,3,24
191223657,2,8,5,7,3,25
191223658,5,7,7,5,5,29
191223659,6,1,2,3,4,16
191223660,0,1,9,7,4,21
191223661,6,1,7,5,1,20
191223662,9,3,6,9,4,31
191223663,0,6,7,7,4,24
191223664,2,4,7,3,4,20
191223665,1,0,2,9,4,16
191223666,4,4,5,1,4,18
191223667,4,4,6,5,1,20
191223668,5,6,8,7,0,26
191223669,4,6,3,5,2,20
191223670,1,9,4,7,1,22
191223671,0,4,6,9,0,19
191223672,3,9,5,9,6,32
191223673,4,5,1,7,6,23
191223674,7,4,5,3,9,28
191223675,1,9,9,9,1,29
191223676,9,5,9,3,0,26
191223677,2,8,6,0,4,20
191223678,5,2,3,9,1,20
191223679,8,8,3,1,2,22
191223680,7,9,5,9,8,38
191223681,4,4,9,2,5,24
191223682,1,1,7,8,5,22
191223683,6,0,3,2,0,11
191223684,0,0,0,0,2,2
191223685,7,5,8,9,4,33
191223686,9,2,2,9,3,25
191223687,9,1,3,4,5,22
191223688,2,4,3,0,1,10
191223689,9,3,1,6,0,19
191223690,4,2,3,7,1,17
191223691,2,5,2,8,2,19
191223692,4,3,1,4,5,17
191223693,2,8,6,6,9,31
191223694,5,0,8,2,2,17
191223695,4,2,0,8,5,19
191223696,8,1,0,0,5,14
191223697,7,5,8,7,5,32
191223698,8,7,8,4,3,30
191223699,3,6,3,2,0,14
191223700,1,2,7,2,6,18
191223701,6,7,9,8,3,33
191223702,0,4,6,3,8,21
191223703,0,3,7,4,6,20
191223704,1,2,7,3,4,17
191223705,1,9,5,7,8,30
191223706,9,7,6,7,6,35
191223707,6,1,4,3,4,18
191223708,9,9,3,0,9,30
191223709,5,8,0,4,8,25
191223710,6,3,8,3,3,23
191223711,7,5,8,8,9,37
191223712,0,6,6,8,6,26
191223713,0,0,2,5,8,15
191223714,4,0,7,8,4,23
191223715,5,1,8,5,0,19
191223716,3,5,6,5,7,26
191223717,5,0,9,1,2,17
191223718,4,3,7,1,0,15
191223719,5,2,9,4,5,25
191223720,7,5,0,2,3,17
191223721,7,4,2,4,2,19
191223722,7,3,1,4,4,19
191223723,1,7,3,0,2,13
191223724,8,5,9,3,5,30
191223725,2,7,1,7,0,17
191223726,9,3,4,6,7,29
191223727,9,7,8,5,8,37
191223728,5,2,2,8,6,23
191223729,5,2,3,1,9,20
191223730,0,2,4,5,7,18
191223731,0,8,4,9,8,29
191223732,6,5,7,5,0,23
191223733,2,9,5,6,2,24
191223734,6,6,9,3,3,27
191223735,4,6,4,6,5,25
191223736,8,6,0,3,8,25
191223737,8,4,2,6,0,20
191223738,1,5,8,1,3,18
191223739,2,7,6,4,0,19
191223740,9,5,5,7,3,29
191223741,1,2,0,2,9,14
191223742,3,3,8,8,8,30
191223743,3,5,0,8,7,23
191223744,8,1,1,0,1,11
191223745,2,9,6,1,0,18
191223746,4,2,3,1,5,15
191223747,0,8,5,9,5,27
191223748,1,3,1,8,2,15
191223749,7,4,7,7,6,31
191223750,7,2,9,0,7,25
191223751,8,7,4,2,0,21
191223752,7,8,9,2,9,35
191223753,4,3,2,6,7,22
191223754,4,0,3,4,7,18
191223755,8,8,7,4,0,27
191223756,1,9,2,5,7,24
191223757,0,2,1,0,4,7
191223758,1,9,8,9,6,33
191223759,9,1,4,2,8,24
191223760,0,7,6,1,8,22
191223761,2,9,9,9,8,37
191223762,8,7,4,6,3,28
191223763,8,6,8,9,8,39
191223764,9,8,9,1,9,36
191223765,9,7,6,3,3,28
191223766,3,1,8,8,0,20
191223767,9,0,4,9,5,27
191223768,5,2,3,8,3,21
191223769,0,5,5,9,3,22
191223770,3,0,5,8,3,19
191223771,9,0,2,1,5,17
191223772,8,8,9,4,8,37
191223773,0,2,7,4,0,13
191223774,2,1,0,1,8,12
191223775,8,8,4,3,0,23
191223776,9,3,3,6,4,25
191223777,3,5,7,7,2,24
191223778,7,7,3,3,5,25
191223779,3,4,4,2,3,16
191223780,6,1,9,0,5,21
191223781,5,4,4,2,9,24
191223782,5,7,6,1,7,26
191223783,9,0,2,3,0,14
191223784,5,1,8,7,7,28
191223785,6,9,1,0,2,18
191223786,6,9,4,5,8,32
191223787,8,5,1,1,8,23
191223788,7,6,8,5,5,31
191223789,7,6,3,8,2,26
191223790,5,2,6,6,4,23
191223791,1,8,0,5,2,16
191223792,3,1,0,2,0,6
191223793,6,8,8,6,8,36
191223794,0,9,2,4,8,23
191223795,8,5,9,5,3,30
191223796,6,7,0,2,8,23
191223797,6,2,4,3,4,19
191223798,2,5,9,0,4,20
191223799,6,0,7,8,9,30
191223800,3,7,1,7,9,27
191223801,9,6,8,9,9,41
191223802,1,1,8,3,6,19
191223803,7,4,1,2,7,21
191223804,3,1,2,2,9,17
191223805,5,4,5,0,7,21
191223806,6,8,5,1,5,25
191223807,5,3,3,2,0,13
191223808,8,1,2,1,5,17
191223809,0,4,5,6,1,16
191223810,0,6,3,3,9,21
191223811,4,0,4,9,6,23
191223812,9,3,3,7,7,29
191223813,5,2,6,9,6,28
191223814,6,4,4,8,2,24
191223815,5,4,1,1,8,19
191223816,5,6,0,5,8,24
191223817,7,0,2,5,9,23
191223818,5,3,1,5,7,21
191223819,0,2,2,1,8,13
191223820,4,6,5,3,8,26
191223821,0,6,5,3,2,16
191223822,1,7,2,2,1,13
191223823,7,1,1,4,7,20
191223824,6,1,6,6,4,23
191223825,8,2,3,9,9,31
191223826,7,8,4,6,8,33
191223827,7,5,4,7,9,32
191223828,1,9,5,3,7,25
191223829,6,9,2,1,4,22
191223830,0,6,4,5,0,15
191223831,5,0,8,8,2,23
191223832,2,8,6,3,5,24
191223833,1,8,3,2,5,19
191223834,7,9,8,8,1,33
191223835,2,2,1,3,6,14
191223836,3,5,6,9,5,28
191223837,0,1,6,5,5,17
191223838,8,8,3,9,8,36
191223839,6,3,7,4,4,24
191223840,1,7,1,1,5,15
191223841,1,2,4,8,9,24
191223842,7,3,1,7,8,26
191223843,6,8,1,2,8,25
191223844,3,3,5,1,4,16
191223845,5,3,2,4,8,22
191223846,3,2,7,4,5,21
191223847,8,5,7,5,1,26
191223848,5,6,1,3,7,22
191223849,9,8,1,6,7,31
191223850,9,2,6,1,3,21
191223851,3,8,2,0,8,21
191223852,8,9,7,6,8,38
191223853,4,2,8,1,7,22
191223854,1,7,7,1,4,20
191223855,9,8,9,5,0,31
191223856,7,6,7,4,7,31
191223857,4,0,2,0,0,6
191223858,5,1,7,0,8,21
191223859,9,4,7,9,8,37
191223860,2,8,4,5,4,23
191223861,5,9,4,3,3,24
191223862,9,9,2,3,5,28
191223863,0,1,4,0,3,8
191223864,1,2,8,0,4,15
191223865,6,3,5,4,9,27
191223866,5,7,6,6,5,29
191223867,5,3,8,4,5,25
191223868,6,2,7,6,8,29
191223869,2,5,4,1,7,19
191223870,2,1,3,8,3,17
191223871,6,1,4,7,1,19
191223872,8,7,2,1,3,21
191223873,4,0,1,6,2,13
191223874,9,2,2,8,9,30
191223875,5,9,7,1,0,22
191223876,6,0,7,5,8,26
191223877,1,7,2,1,0,11
191223878,4,2,7,3,4,20
191223879,5,4,2,6,0,17
191223880,7,4,0,2,6,19
191223881,4,3,0,0,5,12
191223882,5,1,9,8,2,25
191223883,1,7,4,5,7,24
191223884,0,9,9,8,3,29
191223885,2,9,2,6,1,20
191223886,2,3,4,3,2,14
191223887,2,9,4,9,7,31
191223888,7,6,9,3,7,32
191223889,2,8,2,8,1,21
191223890,5,9,1,5,8,28
191223891,8,2,8,6,8,32
191223892,4,7,9,2,5,27
191223893,5,9,4,9,1,28
191223894,8,5,8,0,2,23
191223895,9,7,3,7,9,35
191223896,2,3,3,3,4,15
191223897,3,9,2,4,3,21
191223898,0,3,3,1,4,11
191223899,2,8,0,7,3,20
191223900,5,3,6,5,8,27
191223901,4,3,4,4,2,17
191223902,7,0,7,1,0,15
191223903,6,8,6,1,0,21
191223904,7,5,0,1,8,21
191223905,3,5,2,3,1,14
191223906,3,4,5,3,4,19
191223907,0,5,1,0,0,6
191223908,8,7,8,8,8,39
191223909,3,4,4,5,0,16
191223910,0,8,9,6,0,23
191223911,4,2,0,1,2,9
191223912,7,5,2,1,1,16
191223913,2,8,7,4,6,27
191223914,5,5,8,7,6,31
191223915,1,0,2,3,9,15
191223916,0,2,2,3,6,13
191223917,8,4,4,7,1,24
191223918,6,6,1,8,3,24
191223919,2,7,9,5,0,23
191223920,2,8,0,9,6,25
191223921,1,4,8,4,2,19
191223922,0,7,9,4,1,21
191223923,5,8,5,5,9,32
191223924,4,1,2,3,0,10
191223925,4,3,8,4,1,20
191223926,4,0,7,2,7,20
191223927,7,8,4,7,9,35
191223928,4,1,3,9,4,21
191223929,4,1,8,6,1,20
191223930,2,6,2,0,0,10
191223931,8,1,1,2,6,18
191223932,0,6,9,5,0,20
191223933,5,5,5,9,4,28
191223934,4,7,0,5,2,18
191223935,5,1,2,0,2,10
191223936,6,0,6,0,9,21
191223937,1,7,5,8,7,28
191223938,7,0,8,1,2,18
191223939,4,8,7,0,4,23
191223940,3,0,6,3,0,12
191223941,3,9,9,8,6,35
191223942,8,1,9,0,0,18
191223943,1,7,3,8,1,20
191223944,8,0,5,5,3,21
191223945,8,2,7,9,6,32
191223946,8,4,8,2,0,22
191223947,3,5,0,2,5,15
191223948,9,3,2,4,0,18
191223949,6,7,4,9,3,29
191223950,7,1,1,3,3,15
191223951,9,2,5,7,5,28
191223952,8,6,1,6,6,27
191223953,4,3,3,0,0,10
191223954,7,8,0,3,1,19
191223955,6,8,1,0,4,19
191223956,0,3,1,2,9,15
191223957,7,2,0,4,1,14
191223958,1,6,9,7,0,23
191223959,5,7,0,2,1,15
191223960,9,9,0,1,5,24
191223961,3,4,0,8,0,15
191223962,4,1,1,6,0,12
191223963,2,4,2,2,0,10
191223964,6,8,7,5,0,26
191223965,0,4,0,6,3,13
191223966,9,3,7,6,8,33
191223967,8,3,4,4,0,19
191223968,3,2,3,0,1,9
191223969,6,3,0,3,5,17
191223970,2,2,3,0,9,16
191223971,7,6,6,2,5,26
191223972,3,9,9,9,9,39
191223973,3,8,9,0,5,25
191223974,1,5,8,6,3,23
191223975,7,9,0,6,4,26
191223976,6,7,9,2,4,28
191223977,0,8,2,6,3,19
191223978,7,3,2,5,6,23
191223979,1,6,4,9,6,26
191223980,4,3,1,6,6,20
191223981,5,0,5,5,5,20
191223982,7,8,1,5,8,29
191223983,1,1,2,2,1,7
191223984,9,9,9,3,3,33
191223985,8,3,3,1,3,18
191223986,1,8,6,0,8,23
191223987,9,5,6,3,3,26
191223988,5,1,2,7,2,17
191223989,5,0,2,7,0,14
191223990,9,8,8,8,2,35
191223991,6,4,8,9,7,34
191223992,0,2,3,6,5,16
191223993,4,5,2,3,8,22
191223994,9,8,5,0,2,24
191223995,5,9,7,1,3,25
191223996,2,8,9,9,4,32
191223997,0,7,3,2,1,13
191223998,9,3,0,6,3,21
191223999,7,0,7,0,3,17
1912231000,3,9,1,0,6,19
1912231001,7,3,7,1,1,19
1912231002,5,8,3,1,4,21
1912231003,3,9,6,7,0,25
1912231004,3,4,9,8,2,26
1912231005,9,8,6,5,3,31
1912231006,5,0,0,4,7,16
1912231007,3,8,3,1,9,24
1912231008,1,7,2,1,2,13
1912231009,2,9,3,3,7,24
1912231010,7,8,3,8,5,31
1912231011,5,1,5,2,0,13
1912231012,8,8,0,2,2,20
1912231013,9,3,1,0,8,21
1912231014,1,5,9,0,9,24
1912231015,1,4,8,3,3,19
1912231016,2,6,4,2,2,16
1912231017,7,2,8,9,2,28
1912231018,2,2,0,4,0,8
1912231019,4,8,8,4,9,33
1912231020,2,3,7,1,7,20
1912231021,7,5,8,8,2,30
1912231022,2,3,9,7,0,21
1912231023,5,0,7,5,2,19
1912231024,1,8,3,1,1,14
1912231025,8,5,1,7,8,29
1912231026,3,1,3,9,1,17
1912231027,0,9,4,8,8,29
1912231028,6,4,6,5,9,30
1912231029,7,6,6,6,2,27
1912231030,3,0,7,0,0,10
1912231031,7,3,1,0,3,14
1912231032,4,8,5,9,5,31
1912231033,7,3,7,8,4,29
1912231034,9,6,1,6,2,24
1912231035,1,3,9,3,7,23
1912231036,7,1,0,7,7,22
1912231037,4,1,4,7,4,20
1912231038,1,2,3,0,2,8
1912231039,5,3,7,7,1,23
1912231040,9,8,1,5,9,32
1912231041,7,4,8,0,9,28
1912231042,9,3,1,5,9,27
1912231043,6,9,7,2,4,28
1912231044,6,0,1,1,4,12
1912231045,5,3,4,7,0,19
1912231046,8,6,3,8,0,25
1912231047,2,6,4,2,3,17
1912231048,0,6,7,8,6,27
1912231049,1,5,5,0,5,16
1912231050,0,1,0,4,1,6
1912231051,0,3,2,3,7,15
1912231052,8,8,3,5,0,24
1912231053,0,3,3,6,6,18
1912231054,5,9,4,7,2,27
1912231055,5,8,6,6,3,28
1912231056,9,0,1,8,3,21
1912231057,7,3,4,9,5,28
1912231058,9,7,2,0,0,18
1912231059,3,0,1,7,6,17
1912231060,6,1,3,5,5,20
1912231061,7,4,8,8,2,29
1912231062,9,2,3,9,0,23
1912231063,8,8,3,3,2,24
1912231064,0,1,4,9,4,18
1912231065,1,4,8,9,3,25
1912231066,3,3,1,6,7,20
1912231067,6,4,9,5,3,27
1912231068,5,0,2,4,7,18
1912231069,7,3,7,4,8,29
1912231070,8,7,2,9,7,33
1912231071,2,9,4,4,8,27
1912231072,4,3,0,0,6,13
1912231073,4,4,1,2,1,12
1912231074,4,4,8,0,1,17
1912231075,8,4,6,8,7,33
1912231076,3,1,9,4,3,20
1912231077,3,6,3,3,4,19
1912231078,5,6,3,0,1,15
1912231079,9,5,1,4,4,23
1912231080,9,6,9,8,2,34
1912231081,0,0,9,1,5,15
1912231082,9,7,0,0,6,22
1912231083,8,3,8,0,2,21
1912231084,0,0,4,9,6,19
1912231085,3,7,6,3,5,24
1912231086,0,5,9,9,9,32
1912231087,7,6,6,9,9,37
1912231088,9,3,7,4,7,30
1912231089,5,2,4,0,5,16
1912231090,1,9,7,2,7,26
1912231091,0,5,3,6,6,20
1912231092,3,3,9,9,9,33
1912231093,2,6,7,1,3,19
1912231094,1,8,4,5,9,27
1912231095,2,6,1,3,9,21
1912231096,1,1,7,9,1,19
1912231097,1,7,5,5,8,26
1912231098,9,7,7,7,8,38
1912231099,4,9,1,2,9,25
1912231100,0,8,8,4,9,29
1912231101,2,4,4,0,3,13
1912231102,4,3,9,2,2,20
1912231103,9,3,5,3,1,21
1912231104,0,4,1,7,7,19
1912231105,5,2,9,4,7,27
191224001,9,8,0,0,9,26
191224002,8,6,7,6,1,28
191224003,6,8,0,6,7,27
191224004,2,9,5,3,7,26
191224005,2,6,6,8,0,22
191224006,0,9,5,4,5,23
191224007,7,9,5,7,6,34
191224008,6,1,2,7,8,24
191224009,6,8,3,1,4,22
191224010,1,3,4,8,5,21
191224011,7,6,0,1,5,19
191224012,9,9,7,2,5,32
191224013,8,5,6,3,1,23
191224014,7,5,0,5,3,20
191224015,2,6,6,9,8,31
191224016,0,9,3,5,0,17
191224017,2,4,4,8,6,24
191224018,5,9,4,1,2,21
191224019,9,7,4,8,6,34
191224020,8,4,5,5,1,23
191224021,8,3,4,3,0,18
191224022,1,5,9,5,3,23
191224023,1,6,1,1,1,10
191224024,8,7,4,5,5,29
191224025,9,7,8,2,4,30
191224026,6,1,8,0,2,17
191224027,4,7,9,3,3,26
191224028,8,9,8,5,5,35
191224029,4,8,3,0,1,16
191224030,3,7,4,3,5,22
191224031,4,4,8,4,2,22
191224032,3,2,1,4,7,17
191224033,5,1,5,2,1,14
191224034,3,6,3,0,8,20
191224035,6,8,0,7,0,21
191224036,4,7,6,2,6,25
191224037,6,8,8,7,4,33
191224038,3,2,9,7,2,23
191224039,1,9,8,6,1,25
191224040,2,4,3,5,6,20
191224041,4,8,0,4,8,24
191224042,5,2,1,1,9,18
191224043,5,7,8,5,2,27
191224044,7,3,9,9,1,29
191224045,4,0,0,3,8,15
191224046,0,1,1,0,3,5
191224047,3,7,6,9,6,31
191224048,9,4,0,1,8,22
191224049,3,6,7,0,6,22
191224050,5,0,2,2,0,9
191224051,3,4,3,8,0,18
191224052,3,1,7,1,2,14
191224053,4,7,1,9,9,30
191224054,0,4,5,2,5,16
191224055,9,5,9,2,2,27
191224056,9,3,7,7,8,34
191224057,2,5,0,1,4,12
191224058,3,3,3,9,7,25
191224059,4,2,1,0,0,7
191224060,2,9,0,8,2,21
191224061,4,4,1,9,8,26
191224062,9,2,9,0,8,28
191224063,2,0,8,2,4,16
191224064,4,8,0,0,0,12
191224065,4,8,3,6,2,23
191224066,0,1,1,7,4,13
191224067,8,3,6,2,2,21
191224068,7,9,6,3,0,25
191224069,2,9,4,1,6,22
191224070,1,8,1,7,7,24
191224071,5,0,5,4,2,16
191224072,2,1,1,1,5,10
191224073,1,9,8,8,2,28
191224074,7,0,1,9,1,18
191224075,4,5,8,9,8,34
191224076,1,7,9,3,9,29
191224077,6,7,3,9,7,32
191224078,0,9,2,3,9,23
191224079,4,3,2,8,7,24
191224080,5,4,0,4,2,15
191224081,5,2,8,8,3,26
191224082,0,1,1,2,4,8
191224083,4,1,9,1,4,19
191224084,8,3,6,6,2,25
191224085,5,2,5,8,9,29
191224086,4,9,2,2,5,22
191224087,1,7,8,9,8,33
191224088,5,7,9,4,7,32
191224089,5,1,3,2,5,16
191224090,9,3,6,0,2,20
191224091,1,7,5,4,1,18
191224092,9,9,3,0,4,25
191224093,3,4,8,8,6,29
191224094,8,5,3,5,3,24
191224095,0,4,5,8,0,17
191224096,2,7,1,2,5,17
191224097,4,6,0,9,7,26
191224098,0,9,9,0,7,25
191224099,1,0,8,3,1,13
191224100,0,2,8,9,2,21
191224101,3,4,9,4,3,23
191224102,9,8,5,3,5,30
191224103,4,2,7,9,9,31
191224104,3,7,7,4,4,25
191224105,0,7,7,4,6,24
191224106,2,7,9,4,9,31
191224107,4,0,0,7,1,12
191224108,6,8,9,4,3,30
191224109,0,4,9,9,1,23
191224110,3,0,8,1,4,16
191224111,6,3,6,5,3,23
191224112,6,6,0,7,8,27
191224113,1,5,3,5,0,14
191224114,4,2,4,2,3,15
191224115,1,9,1,7,2,20
191224116,4,4,7,2,9,26
191224117,1,7,2,0,7,17
191224118,7,6,8,0,8,29
191224119,1,6,4,2,9,22
191224120,0,0,7,2,3,12
191224121,8,2,4,7,4,25
191224122,9,4,1,1,7,22
191224123,0,4,3,2,7,16
191224124,0,3,6,2,4,15
191224125,6,1,4,9,2,22
191224126,8,0,0,3,2,13
191224127,4,7,4,6,2,23
191224128,9,0,0,2,7,18
191224129,0,9,6,5,5,25
191224130,8,0,8,2,4,22
191224131,0,3,9,8,1,21
191224132,2,2,7,1,0,12
191224133,0,9,6,1,3,19
191224134,1,6,3,2,5,17
191224135,4,5,9,1,1,20
191224136,8,3,2,0,8,21
191224137,4,8,1,8,5,26
191224138,0,1,6,7,2,16
191224139,0,2,2,9,1,14
191224140,0,8,1,3,7,19
191224141,7,0,5,2,7,21
191224142,3,3,6,3,8,23
191224143,1,0,3,1,9,14
191224144,4,1,2,4,2,13
191224145,0,6,2,3,8,19
191224146,9,0,6,3,7,25
191224147,8,9,7,9,0,33
191224148,5,7,6,1,2,21
191224149,4,4,8,3,9,28
191224150,8,1,0,2,0,11
191224151,4,7,3,2,7,23
191224152,8,1,7,2,4,22
191224153,1,3,6,5,1,16
191224154,8,0,4,7,7,26
191224155,7,4,2,4,5,22
191224156,3,3,1,5,7,19
191224157,1,4,3,9,1,18
191224158,4,9,3,2,0,18
191224159,1,4,6,1,7,19
191224160,0,2,5,6,8,21
191224161,3,6,4,0,3,16
191224162,0,3,6,9,3,21
191224163,6,6,2,3,2,19
191224164,7,1,0,4,0,12
191224165,4,8,5,5,9,31
191224166,5,7,6,4,1,23
191224167,6,8,1,3,4,22
191224168,1,7,1,7,3,19
191224169,8,8,0,9,2,27
191224170,2,3,1,8,5,19
191224171,3,9,7,9,3,31
191224172,9,2,3,9,2,25
191224173,6,5,2,8,0,21
191224174,0,1,6,1,8,16
191224175,0,6,5,1,5,17
191224176,1,8,2,3,9,23
191224177,1,6,8,6,9,30
191224178,0,0,6,6,5,17
191224179,5,7,5,0,2,19
191224180,1,9,3,5,5,23
191224181,2,0,8,6,7,23
191224182,8,4,3,6,2,23
191224183,7,3,9,0,0,19
191224184,0,3,9,4,2,18
191224185,8,5,2,9,1,25
191224186,2,7,0,3,7,19
191224187,8,4,6,6,9,33
191224188,8,2,7,6,4,27
191224189,8,1,4,2,1,16
191224190,2,9,1,2,9,23
191224191,9,0,8,7,1,25
191224192,4,6,9,5,6,30
191224193,4,6,1,3,9,23
191224194,8,8,9,9,2,36
191224195,5,8,7,9,1,30
191224196,4,8,1,6,2,21
191224197,5,5,7,2,8,27
191224198,2,5,5,2,3,17
191224199,6,5,6,9,8,34
191224200,1,3,0,6,0,10
191224201,1,1,3,8,2,15
191224202,4,3,0,2,7,16
191224203,6,0,7,9,1,23
191224204,0,0,9,1,6,16
191224205,0,4,9,9,4,26
191224206,7,9,5,1,2,24
191224207,0,0,6,1,7,14
191224208,7,6,7,2,6,28
191224209,9,9,2,0,0,20
191224210,5,4,3,3,8,23
191224211,1,3,1,0,6,11
191224212,7,2,7,8,4,28
191224213,4,6,2,6,4,22
191224214,5,6,4,0,4,19
191224215,7,8,2,5,1,23
191224216,7,8,0,1,5,21
191224217,6,3,7,9,2,27
191224218,0,2,0,2,1,5
191224219,6,2,3,2,2,15
191224220,5,6,1,2,0,14
191224221,0,0,1,2,7,10
191224222,4,1,6,2,7,20
191224223,0,9,7,6,2,24
191224224,9,7,6,5,9,36
191224225,7,1,6,8,4,26
191224226,4,1,5,0,2,12
191224227,6,1,5,0,7,19
191224228,4,4,7,2,7,24
191224229,8,4,7,2,4,25
191224230,3,2,1,9,8,23
191224231,0,4,9,0,4,17
191224232,5,6,2,2,2,17
191224233,1,8,6,4,0,19
191224234,0,6,7,2,5,20
191224235,9,2,9,5,1,26
191224236,9,7,5,7,5,33
191224237,9,8,2,3,0,22
191224238,8,8,5,3,5,29
191224239,7,7,0,9,8,31
191224240,3,7,2,6,5,23
191224241,5,5,6,8,3,27
191224242,8,4,9,2,4,27
191224243,1,4,0,0,9,14
191224244,3,0,0,5,7,15
191224245,5,8,2,9,2,26
191224246,0,5,9,6,1,21
191224247,8,9,6,4,9,36
191224248,9,9,2,0,1,21
191224249,4,5,9,2,0,20
191224250,4,2,1,0,8,15
191224251,0,4,9,5,6,24
191224252,4,7,6,7,0,24
191224253,5,1,6,1,3,16
191224254,3,1,4,6,3,17
191224255,0,6,2,8,3,19
191224256,0,3,5,5,9,22
191224257,3,1,7,2,2,15
191224258,6,4,5,7,1,23
191224259,1,0,3,5,9,18
191224260,1,7,9,7,2,26
191224261,8,5,4,9,2,28
191224262,3,0,9,7,7,26
191224263,2,4,5,6,1,18
191224264,1,9,2,9,1,22
191224265,0,9,8,3,7,27
191224266,0,4,8,9,5,26
191224267,2,8,5,4,5,24
191224268,1,8,6,1,5,21
191224269,8,7,9,0,2,26
191224270,7,1,5,2,6,21
191224271,0,6,0,2,4,12
191224272,4,3,2,8,5,22
191224273,5,8,2,2,0,17
191224274,4,4,2,9,6,25
191224275,1,4,1,3,6,15
191224276,8,0,8,6,4,26
191224277,7,5,7,6,9,34
191224278,4,8,2,4,2,20
191224279,2,7,5,1,1,16
191224280,5,0,3,4,4,16
191224281,2,4,2,4,9,21
191224282,9,6,3,9,6,33
191224283,0,4,4,4,8,20
191224284,7,9,2,0,8,26
191224285,5,8,6,9,9,37
191224286,9,1,3,4,4,21
191224287,0,3,5,5,4,17
191224288,2,7,2,9,3,23
191224289,2,4,3,4,0,13
191224290,5,2,5,0,5,17
191224291,9,9,9,9,8,44
191224292,9,8,5,7,0,29
191224293,4,1,1,0,8,14
191224294,7,5,1,2,8,23
191224295,6,5,9,5,4,29
191224296,3,6,0,1,8,18
191224297,0,7,4,3,0,14
191224298,5,6,2,2,1,16
191224299,3,3,8,5,4,23
191224300,9,4,4,1,7,25
191224301,7,1,6,6,0,20
191224302,3,0,5,3,0,11
191224303,9,9,5,4,0,27
191224304,4,4,2,7,5,22
191224305,6,7,0,4,7,24
191224306,2,5,7,8,3,25
191224307,7,3,1,3,3,17
191224308,9,7,2,5,7,30
191224309,2,7,8,1,1,19
191224310,3,5,0,0,0,8
191224311,0,3,0,1,0,4
191224312,0,7,6,3,2,18
191224313,2,5,7,9,7,30
191224314,3,7,1,9,5,25
191224315,0,8,9,9,4,30
191224316,5,3,4,7,9,28
191224317,1,0,5,9,1,16
191224318,8,0,2,5,8,23
191224319,2,0,8,2,9,21
191224320,5,4,7,0,2,18
191224321,8,7,9,2,7,33
191224322,3,8,7,7,2,27
191224323,0,9,2,8,1,20
191224324,0,7,1,8,3,19
191224325,5,7,5,5,5,27
191224326,2,4,1,5,9,21
191224327,1,6,1,1,3,12
191224328,9,5,4,7,6,31
191224329,4,9,8,8,1,30
191224330,5,5,5,2,9,26
191224331,8,2,0,9,8,27
191224332,6,2,7,2,9,26
191224333,8,8,3,3,4,26
191224334,6,1,7,8,9,31
191224335,8,5,1,2,5,21
191224336,3,6,5,5,0,19
191224337,7,2,9,5,5,28
191224338,4,8,3,3,9,27
191224339,9,9,1,0,2,21
191224340,6,8,5,3,4,26
191224341,3,8,5,2,4,22
191224342,2,3,8,2,0,15
191224343,0,9,1,2,9,21
191224344,6,6,6,7,3,28
191224345,8,0,0,1,9,18
191224346,8,7,2,2,2,21
191224347,7,3,2,7,9,28
191224348,3,4,4,2,2,15
191224349,0,1,0,8,5,14
191224350,1,6,2,4,7,20
191224351,5,5,2,2,9,23
191224352,8,5,1,6,1,21
191224353,0,5,3,6,4,18
191224354,1,8,9,3,6,27
191224355,9,7,8,1,1,26
191224356,2,1,5,1,0,9
191224357,2,2,3,2,9,18
191224358,1,8,7,1,1,18
191224359,8,9,8,1,0,26
191224360,8,8,1,0,0,17
191224361,8,0,0,9,3,20
191224362,4,3,1,7,5,20
191224363,6,4,3,1,8,22
191224364,1,9,7,2,4,23
191224365,5,8,0,3,2,18
191224366,4,3,5,9,3,24
191224367,2,8,2,1,5,18
191224368,3,2,1,1,4,11
191224369,3,2,3,3,2,13
191224370,2,6,0,4,0,12
191224371,7,2,0,2,3,14
191224372,1,6,5,1,8,21
191224373,6,5,6,1,1,19
191224374,8,2,0,7,2,19
191224375,7,6,4,2,8,27
191224376,3,8,3,9,6,29
191224377,7,0,0,7,1,15
191224378,7,4,7,8,8,34
191224379,0,5,0,7,5,17
191224380,1,0,8,4,7,20
191224381,3,9,6,3,2,23
191224382,3,2,7,7,3,22
191224383,3,7,8,4,2,24
191224384,3,8,6,5,4,26
191224385,9,1,8,7,8,33
191224386,7,7,4,3,8,29
191224387,8,8,4,6,2,28
191224388,4,9,4,0,2,19
191224389,1,4,8,3,9,25
191224390,8,1,2,4,4,19
191224391,1,9,6,9,0,25
191224392,0,5,3,8,9,25
191224393,3,7,2,2,1,15
191224394,1,2,0,2,5,10
191224395,1,1,0,5,3,10
191224396,8,1,1,3,3,16
191224397,0,8,9,3,1,21
191224398,2,5,5,9,2,23
191224399,7,5,2,5,6,25
191224400,7,4,6,8,6,31
191224401,1,0,0,4,8,13
191224402,3,2,1,2,6,14
191224403,9,8,6,5,7,35
191224404,6,0,0,9,5,20
191224405,0,8,2,5,0,15
191224406,9,8,8,3,1,29
191224407,9,7,5,7,7,35
191224408,6,1,0,9,8,24
191224409,8,6,3,7,6,30
191224410,8,3,2,9,5,27
191224411,7,6,3,1,5,22
191224412,6,0,4,0,6,16
191224413,6,6,5,6,3,26
191224414,8,9,3,7,3,30
191224415,4,7,9,4,9,33
191224416,6,7,6,1,7,27
191224417,2,7,8,0,0,17
191224418,9,7,2,0,4,22
191224419,8,3,3,1,5,20
191224420,0,1,4,9,5,19
191224421,0,9,2,0,4,15
191224422,3,2,7,7,4,23
191224423,5,6,2,3,6,22
191224424,8,9,2,0,8,27
191224425,6,7,7,0,1,21
191224426,3,3,3,0,4,13
191224427,3,8,3,2,2,18
191224428,0,8,8,1,9,26
191224429,6,6,8,1,1,22
191224430,3,4,2,9,0,18
191224431,6,3,5,7,1,22
191224432,6,2,3,8,7,26
191224433,9,7,6,6,0,28
191224434,2,9,7,7,1,26
191224435,5,4,4,2,8,23
191224436,9,3,4,5,2,23
191224437,1,9,5,2,3,20
191224438,3,7,7,7,4,28
191224439,2,3,2,4,2,13
191224440,1,1,0,1,2,5
191224441,2,4,5,5,0,16
191224442,7,2,2,7,1,19
191224443,0,2,6,4,2,14
191224444,5,9,5,9,2,30
191224445,8,5,0,7,8,28
191224446,1,2,4,6,7,20
191224447,3,6,9,7,6,31
191224448,6,4,8,1,8,27
191224449,5,1,3,5,7,21
191224450,3,6,0,1,2,12
191224451,3,2,2,7,7,21
191224452,5,8,7,7,8,35
191224453,4,9,2,2,0,17
191224454,2,1,3,8,8,22
191224455,7,1,6,8,1,23
191224456,1,8,3,4,6,22
191224457,1,1,6,7,2,17
191224458,6,5,4,8,0,23
191224459,2,1,4,8,8,23
191224460,3,2,0,5,6,16
191224461,7,6,4,3,9,29
191224462,3,0,7,7,3,20
191224463,4,6,0,0,3,13
191224464,2,1,4,2,0,9
191224465,2,7,0,4,1,14
191224466,9,8,2,5,7,31
191224467,7,6,9,5,0,27
191224468,0,2,1,0,7,10
191224469,8,9,4,3,2,26
191224470,1,6,0,3,8,18
191224471,7,3,8,5,3,26
191224472,4,4,2,3,4,17
191224473,4,9,1,7,1,22
191224474,9,8,1,7,1,26
191224475,0,7,5,4,6,22
191224476,1,5,9,7,2,24
191224477,9,8,2,0,6,25
191224478,2,2,6,2,7,19
191224479,8,3,9,7,9,36
191224480,2,2,5,4,1,14
191224481,0,5,3,4,8,20
191224482,6,9,7,3,0,25
191224483,9,5,7,6,9,36
191224484,2,7,8,0,9,26
191224485,2,6,9,3,6,26
191224486,3,9,1,5,4,22
191224487,0,2,7,8,7,24
191224488,2,0,8,6,3,19
191224489,7,9,7,6,7,36
191224490,7,1,0,3,7,18
191224491,0,9,1,8,8,26
191224492,0,5,7,4,7,23
191224493,9,9,9,5,1,33
191224494,3,6,2,4,1,16
191224495,6,0,8,1,1,16
191224496,7,2,0,0,6,15
191224497,5,8,2,8,0,23
191224498,8,4,5,6,5,28
191224499,9,4,4,4,5,26
191224500,8,2,4,7,8,29
191224501,2,8,6,9,3,28
191224502,0,6,3,6,2,17
191224503,7,3,0,4,3,17
191224504,9,4,4,7,7,31
191224505,9,7,3,5,3,27
191224506,9,7,4,7,8,35
191224507,1,5,3,0,3,12
191224508,9,9,0,4,0,22
191224509,6,4,1,7,0,18
191224510,9,3,5,1,0,18
191224511,5,5,2,2,0,14
191224512,3,9,2,3,4,21
191224513,2,1,6,3,5,17
191224514,9,8,4,3,6,30
191224515,7,8,3,2,3,23
191224516,6,6,3,2,3,20
191224517,1,7,5,4,9,26
191224518,0,6,5,9,4,24
191224519,7,1,6,2,2,18
191224520,5,3,0,1,0,9
191224521,6,2,0,4,9,21
191224522,8,3,9,5,1,26
191224523,8,9,4,3,5,29
191224524,6,0,4,9,3,22
191224525,4,2,0,0,9,15
191224526,7,7,4,7,4,29
191224527,6,3,2,9,8,28
191224528,0,0,5,2,6,13
191224529,8,7,1,6,8,30
191224530,7,3,9,1,1,21
191224531,4,5,8,1,2,20
191224532,1,1,1,6,1,10
191224533,1,6,4,4,6,21
191224534,7,5,0,0,2,14
191224535,6,4,1,3,3,17
191224536,8,0,1,5,3,17
191224537,2,3,6,8,6,25
191224538,4,2,2,8,3,19
191224539,5,1,1,3,8,18
191224540,5,0,3,5,5,18
191224541,9,6,6,2,2,25
191224542,8,8,1,7,7,31
191224543,0,1,8,5,0,14
191224544,8,3,5,7,2,25
191224545,7,7,0,1,7,22
191224546,0,7,9,0,5,21
191224547,5,1,8,8,9,31
191224548,0,7,2,8,4,21
191224549,8,5,0,7,3,23
191224550,7,3,4,1,0,15
191224551,2,7,2,2,6,19
191224552,1,0,1,2,7,11
191224553,3,9,9,2,4,27
191224554,7,3,6,5,8,29
191224555,4,7,6,4,9,30
191224556,3,9,8,7,2,29
191224557,2,2,3,0,1,8
191224558,3,2,0,0,0,5
191224559,0,4,7,0,3,14
191224560,6,8,0,6,5,25
191224561,1,3,7,6,6,23
191224562,2,4,0,3,5,14
191224563,9,3,4,8,5,29
191224564,8,3,4,9,6,30
191224565,4,2,5,5,4,20
191224566,8,9,8,6,7,38
191224567,6,8,6,1,9,30
191224568,9,9,9,1,5,33
191224569,8,5,1,5,3,22
191224570,7,7,8,4,6,32
191224571,2,9,6,6,4,27
191224572,0,3,1,7,6,17
191224573,9,4,7,4,2,26
191224574,2,7,7,2,2,20
191224575,8,6,5,3,7,29
191224576,3,8,9,3,0,23
191224577,7,5,8,1,1,22
191224578,5,1,6,3,5,20
191224579,4,8,7,6,3,28
191224580,2,0,6,0,4,12
191224581,8,7,8,7,5,35
191224582,9,3,7,1,6,26
191224583,9,8,2,2,1,22
191224584,2,8,9,4,0,23
191224585,6,0,1,7,3,17
191224586,0,7,2,6,8,23
191224587,2,5,9,4,8,28
191224588,2,0,9,3,5,19
191224589,7,5,3,8,1,24
191224590,9,6,3,8,8,34
191224591,0,4,0,0,3,7
191224592,5,4,7,9,5,30
191224593,0,3,6,3,6,18
191224594,7,8,9,3,0,27
191224595,4,3,3,2,7,19
191224596,8,8,3,4,0,23
191224597,8,3,7,4,7,29
191224598,7,0,0,7,9,23
191224599,3,9,4,2,2,20
191224600,4,7,8,6,3,28
191224601,9,4,4,1,1,19
191224602,5,6,1,7,8,27
191224603,0,1,1,6,4,12
191224604,3,2,6,4,1,16
191224605,9,3,5,0,5,22
191224606,0,7,3,9,9,28
191224607,1,1,9,2,1,14
191224608,0,8,6,3,2,19
191224609,8,7,2,3,4,24
191224610,4,7,1,2,6,20
191224611,4,5,7,4,0,20
191224612,8,3,7,3,7,28
191224613,4,0,9,7,1,21
191224614,8,7,0,7,6,28
191224615,4,9,7,5,0,25
191224616,9,2,0,2,0,13
191224617,6,2,9,1,0,18
191224618,6,4,9,3,5,27
191224619,8,3,0,4,6,21
191224620,4,7,9,8,2,30
191224621,1,6,7,7,3,24
191224622,7,4,6,0,9,26
191224623,6,7,6,4,4,27
191224624,4,1,6,4,3,18
191224625,5,3,8,6,6,28
191224626,3,0,6,0,4,13
191224627,2,5,6,1,7,21
191224628,3,7,2,1,2,15
191224629,8,4,9,0,0,21
191224630,7,8,8,8,5,36
191224631,2,3,2,0,4,11
191224632,2,4,4,7,5,22
191224633,5,3,9,2,1,20
191224634,7,7,3,1,1,19
191224635,3,3,5,2,5,18
191224636,6,4,1,5,9,25
191224637,2,9,1,8,2,22
191224638,7,1,6,7,5,26
191224639,7,5,5,3,1,21
191224640,0,4,2,3,1,10
191224641,5,0,6,2,1,14
191224642,0,3,6,6,8,23
191224643,5,2,5,9,0,21
191224644,9,5,7,1,3,25
191224645,5,8,8,1,9,31
191224646,6,0,2,4,2,14
191224647,3,3,0,9,3,18
191224648,2,8,2,0,3,15
191224649,2,9,4,8,9,32
191224650,7,3,7,1,3,21
191224651,5,6,6,7,5,29
191224652,7,0,5,4,9,25
191224653,5,8,7,1,1,22
191224654,0,8,6,9,5,28
191224655,8,7,6,5,0,26
191224656,0,2,5,7,0,14
191224657,2,2,5,2,7,18
191224658,6,5,3,1,4,19
191224659,5,2,3,8,4,22
191224660,5,3,0,6,4,18
191224661,8,5,7,9,8,37
191224662,9,4,4,2,6,25
191224663,5,5,6,0,6,22
191224664,4,8,9,6,8,35
191224665,8,7,3,9,7,34
191224666,4,2,2,8,2,18
191224667,1,1,4,1,9,16
191224668,2,6,0,3,4,15
191224669,5,5,2,3,9,24
191224670,4,5,5,4,2,20
191224671,4,9,9,1,9,32
191224672,0,4,9,2,1,16
191224673,1,9,4,9,5,28
191224674,5,6,9,3,5,28
191224675,4,4,2,1,1,12
191224676,0,1,6,4,9,20
191224677,7,2,4,0,4,17
191224678,5,2,5,6,7,25
191224679,2,0,5,4,0,11
191224680,8,9,4,4,5,30
191224681,9,5,4,2,1,21
191224682,0,9,0,7,2,18
191224683,6,2,1,0,5,14
191224684,7,4,6,8,3,28
191224685,2,7,8,3,1,21
191224686,0,8,5,4,3,20
191224687,6,0,0,0,2,8
191224688,9,7,6,9,4,35
191224689,0,9,7,8,9,33
191224690,5,2,5,5,2,19
191224691,7,5,5,7,6,30
191224692,2,7,8,8,2,27
191224693,1,4,9,7,4,25
191224694,6,9,0,9,3,27
191224695,8,0,9,8,1,26
191224696,2,5,1,1,2,11
191224697,6,6,4,7,9,32
191224698,6,5,6,7,5,29
191224699,2,8,2,3,6,21
191224700,3,5,3,8,3,22
191224701,7,3,7,7,3,27
191224702,6,8,4,7,1,26
191224703,1,1,8,0,3,13
191224704,7,2,3,2,6,20
191224705,5,9,1,3,5,23
191224706,9,8,6,1,6,30
191224707,3,9,7,0,2,21
191224708,4,2,9,8,1,24
191224709,8,6,0,5,6,25
191224710,6,9,5,6,8,34
191224711,8,3,4,1,2,18
191224712,6,6,2,3,8,25
191224713,0,9,5,0,9,23
191224714,2,3,0,3,4,12
191224715,3,4,5,1,6,19
191224716,3,4,8,8,4,27
191224717,2,7,8,6,5,28
191224718,3,0,5,0,5,13
191224719,8,2,7,8,1,26
191224720,4,5,3,4,3,19
191224721,8,4,6,5,7,30
191224722,7,5,4,6,7,29
191224723,1,4,4,4,5,18
191224724,8,7,0,6,3,24
191224725,0,5,4,6,0,15
191224726,8,2,6,1,6,23
191224727,5,7,8,9,9,38
191224728,8,4,3,1,7,23
191224729,7,5,7,7,8,34
191224730,6,3,3,2,9,23
191224731,1,4,9,4,7,25
191224732,1,6,7,6,7,27
191224733,2,7,4,1,7,21
191224734,6,5,4,6,3,24
191224735,3,1,3,5,1,13
191224736,7,0,2,4,0,13
191224737,4,1,6,8,3,22
191224738,2,8,6,2,9,27
191224739,4,5,4,0,0,13
191224740,6,7,3,0,4,20
191224741,6,6,7,1,5,25
191224742,3,7,8,8,9,35
191224743,4,3,2,2,6,17
191224744,5,5,0,5,8,23
191224745,1,8,6,7,6,28
191224746,7,5,2,7,5,26
191224747,2,0,1,5,1,9
191224748,4,0,7,3,1,15
191224749,5,5,2,8,0,20
191224750,7,9,8,8,4,36
191224751,9,4,7,3,8,31
191224752,3,1,8,2,6,20
191224753,0,7,8,5,3,23
191224754,1,1,4,7,4,17
191224755,5,8,4,7,2,26
191224756,0,5,2,4,6,17
191224757,0,5,7,7,2,21
191224758,1,4,7,5,5,22
191224759,8,3,0,2,5,18
191224760,8,3,3,6,1,21
191224761,5,4,9,9,5,32
191224762,2,6,9,0,3,20
191224763,9,3,6,1,0,19
191224764,2,7,2,5,8,24
191224765,3,9,7,3,2,24
191224766,9,0,2,0,1,12
191224767,4,8,0,5,7,24
191224768,5,1,0,6,0,12
191224769,6,9,1,8,5,29
191224770,9,5,0,5,5,24
191224771,9,4,7,8,6,34
191224772,8,4,9,6,3,30
191224773,7,3,0,8,3,21
191224774,0,4,8,4,6,22
191224775,0,3,8,3,7,21
191224776,8,4,3,2,6,23
191224777,9,6,7,3,0,25
191224778,1,2,4,8,8,23
191224779,5,7,5,6,2,25
191224780,1,5,4,8,5,23
191224781,6,1,5,4,1,17
191224782,7,1,9,4,5,26
191224783,6,9,0,3,3,21
191224784,9,5,6,1,5,26
191224785,8,9,2,1,8,28
191224786,3,9,0,2,5,19
191224787,6,2,2,6,0,16
191224788,3,8,8,0,1,20
191224789,4,4,6,9,7,30
191224790,6,1,8,8,0,23
191224791,0,5,8,3,0,16
191224792,5,3,2,7,2,19
191224793,2,1,3,0,8,14
191224794,7,7,3,6,1,24
191224795,0,4,8,1,1,14
191224796,5,6,1,6,5,23
191224797,2,8,2,4,9,25
191224798,1,8,7,8,5,29
191224799,7,5,6,2,8,28
191224800,0,1,2,3,5,11
191224801,4,6,3,6,8,27
191224802,6,3,0,0,5,14
191224803,2,5,5,8,0,20
191224804,4,9,6,9,8,36
191224805,2,6,5,9,0,22
191224806,9,4,2,9,8,32
191224807,8,4,5,4,1,22
191224808,0,3,7,5,9,24
191224809,9,2,0,5,8,24
191224810,6,3,4,8,2,23
191224811,0,2,9,1,2,14
191224812,1,6,2,9,4,22
191224813,6,6,1,2,9,24
191224814,1,8,6,3,4,22
191224815,4,2,9,0,6,21
191224816,0,2,1,7,8,18
191224817,9,9,0,3,9,30
191224818,4,5,9,6,2,26
191224819,5,6,5,0,9,25
191224820,5,9,2,5,9,30
191224821,6,1,8,0,4,19
191224822,5,4,2,9,3,23
191224823,0,9,9,2,3,23
191224824,7,4,1,1,3,16
191224825,8,4,5,9,4,30
191224826,3,4,7,0,9,23
191224827,0,0,6,3,6,15
191224828,4,5,1,2,3,15
191224829,5,5,8,6,0,24
191224830,9,8,5,4,3,29
191224831,1,7,8,0,6,22
191224832,7,1,6,5,5,24
191224833,9,6,0,3,0,18
191224834,0,5,7,6,6,24
191224835,6,4,8,3,5,26
191224836,6,9,4,5,1,25
191224837,6,0,7,1,3,17
191224838,1,4,9,2,3,19
191224839,4,4,3,7,6,24
191224840,0,6,8,6,1,21
191224841,8,7,2,6,9,32
191224842,7,1,9,6,7,30
191224843,1,2,2,5,7,17
191224844,5,8,3,7,7,30
191224845,4,3,9,3,1,20
191224846,9,1,3,5,5,23
191224847,1,1,0,8,9,19
191224848,1,5,9,2,0,17
191224849,2,3,7,8,3,23
191224850,3,4,1,3,2,13
191224851,8,2,0,3,6,19
191224852,1,1,1,2,8,13
191224853,4,3,6,0,7,20
191224854,9,5,1,9,0,24
191224855,0,7,3,5,3,18
191224856,9,2,2,0,3,16
191224857,9,8,3,2,6,28
191224858,6,5,4,6,0,21
191224859,4,9,0,8,1,22
191224860,7,4,1,9,8,29
191224861,5,5,3,2,4,19
191224862,2,9,3,1,1,16
191224863,6,6,9,2,5,28
191224864,9,0,5,5,2,21
191224865,9,0,0,6,9,24
191224866,9,8,0,7,8,32
191224867,4,2,0,7,4,17
191224868,9,6,8,2,7,32
191224869,2,4,0,3,6,15
191224870,9,8,9,0,5,31
191224871,6,1,3,6,8,24
191224872,2,4,0,8,8,22
191224873,4,8,8,7,3,30
191224874,4,4,5,0,1,14
191224875,3,3,8,2,2,18
191224876,5,4,8,0,3,20
191224877,2,0,7,0,3,12
191224878,3,8,2,3,1,17
191224879,9,6,3,5,5,28
191224880,6,4,1,2,6,19
191224881,1,6,8,0,8,23
191224882,3,4,8,1,5,21
191224883,5,1,1,6,0,13
191224884,9,8,8,2,1,28
191224885,0,4,6,1,4,15
191224886,3,4,5,4,2,18
191224887,3,7,0,2,3,15
191224888,6,2,8,6,9,31
191224889,0,4,3,5,8,20
191224890,4,4,8,4,7,27
191224891,0,8,8,3,1,20
191224892,8,1,0,5,7,21
191224893,3,1,0,7,2,13
191224894,3,4,0,9,4,20
191224895,2,4,9,8,9,32
191224896,6,4,5,9,2,26
191224897,4,2,9,3,9,27
191224898,6,0,8,9,1,24
191224899,1,2,0,0,9,12
191224900,7,3,8,3,2,23
191224901,6,8,6,4,1,25
191224902,4,0,5,1,6,16
191224903,0,6,5,0,4,15
191224904,0,7,2,9,9,27
191224905,4,3,9,3,2,21
191224906,8,1,4,5,0,18
191224907,7,2,1,6,1,17
191224908,5,9,1,6,2,23
191224909,6,7,0,7,1,21
191224910,6,7,4,2,6,25
191224911,2,5,1,6,6,20
191224912,0,0,4,1,1,6
191224913,3,3,6,2,8,22
191224914,9,9,2,0,6,26
191224915,9,1,5,5,9,29
191224916,9,3,6,7,7,32
191224917,4,1,8,7,3,23
191224918,5,7,8,2,0,22
191224919,2,7,7,8,5,29
191224920,2,9,3,4,6,24
191224921,9,6,0,1,8,24
191224922,3,3,7,5,8,26
191224923,6,0,8,5,6,25
191224924,9,5,8,3,8,33
191224925,9,7,0,6,3,25
191224926,3,6,3,0,3,15
191224927,6,0,6,1,4,17
191224928,2,9,8,5,5,29
191224929,3,7,7,4,1,22
191224930,0,0,5,0,7,12
191224931,7,7,3,0,1,18
191224932,9,6,9,6,4,34
191224933,8,9,4,6,4,31
191224934,5,9,7,4,3,28
191224935,8,3,1,1,5,18
191224936,8,2,5,7,8,30
191224937,6,6,1,2,6,21
191224938,1,8,1,2,7,19
191224939,5,9,0,2,9,25
191224940,6,5,2,0,7,20
191224941,7,6,2,3,1,19
191224942,1,2,5,8,8,24
191224943,9,9,4,6,3,31
191224944,8,1,9,1,2,21
191224945,4,3,4,1,0,12
191224946,0,6,1,3,9,19
191224947,7,3,3,0,0,13
191224948,5,0,1,2,4,12
191224949,9,6,7,8,5,35
191224950,3,1,7,4,2,17
191224951,2,8,6,3,8,27
191224952,2,3,7,7,1,20
191224953,8,1,0,5,2,16
191224954,2,5,9,8,0,24
191224955,9,4,4,6,3,26
191224956,3,2,6,9,6,26
191224957,2,4,8,9,4,27
191224958,7,7,3,3,2,22
191224959,3,5,6,3,0,17
191224960,0,5,7,4,4,20
191224961,6,2,0,8,0,16
191224962,0,7,7,0,5,19
191224963,9,8,3,4,2,26
191224964,7,5,9,5,3,29
191224965,7,1,4,5,3,20
191224966,2,5,0,1,3,11
191224967,2,4,2,5,8,21
191224968,8,4,8,0,4,24
191224969,8,8,0,7,9,32
191224970,3,3,8,8,5,27
191224971,8,0,3,8,7,26
191224972,2,1,2,6,1,12
191224973,8,3,9,6,3,29
191224974,1,8,6,1,6,22
191224975,3,9,0,9,0,21
191224976,7,4,1,6,8,26
191224977,9,8,3,8,2,30
191224978,4,9,9,3,7,32
191224979,3,6,5,9,4,27
191224980,6,3,7,8,6,30
191224981,4,8,4,5,5,26
191224982,1,0,6,8,8,23
191224983,8,6,5,1,4,24
191224984,9,2,2,3,5,21
191224985,7,7,5,7,0,26
191224986,6,0,8,0,1,15
191224987,5,0,2,7,3,17
191224988,7,4,3,5,2,21
191224989,7,0,6,6,4,23
191224990,4,4,4,8,4,24
191224991,9,6,5,3,4,27
191224992,2,0,1,9,4,16
191224993,1,6,7,3,9,26
191224994,4,9,9,0,6,28
191224995,6,4,8,0,9,27
191224996,8,0,0,9,1,18
191224997,1,0,4,3,8,16
191224998,0,0,8,4,2,14
191224999,9,5,6,6,9,35
1912241000,2,5,6,6,6,25
1912241001,8,8,5,6,7,34
1912241002,4,0,9,0,1,14
1912241003,4,6,5,4,9,28
1912241004,2,3,3,5,9,22
1912241005,0,9,6,0,4,19
1912241006,9,1,3,6,8,27
1912241007,6,2,1,7,8,24
1912241008,8,7,3,3,4,25
1912241009,9,1,0,1,9,20
1912241010,4,5,0,4,4,17
1912241011,8,4,1,9,5,27
1912241012,2,0,5,2,4,13
1912241013,6,7,5,2,5,25
1912241014,9,4,3,7,0,23
1912241015,4,8,4,1,1,18
1912241016,1,8,6,4,6,25
1912241017,3,7,9,2,0,21
1912241018,1,2,2,0,4,9
1912241019,5,9,9,9,6,38
1912241020,9,3,4,0,7,23
1912241021,8,8,5,6,9,36
1912241022,4,4,3,2,8,21
1912241023,6,9,3,7,3,28
1912241024,7,0,5,1,0,13
1912241025,5,4,8,9,3,29
1912241026,8,3,2,5,5,23
1912241027,3,3,7,4,2,19
1912241028,4,2,5,1,9,21
1912241029,4,8,2,4,8,26
1912241030,5,0,3,4,6,18
1912241031,8,2,3,0,8,21
1912241032,5,7,3,6,6,27
1912241033,2,5,9,3,0,19
1912241034,5,6,5,9,8,33
1912241035,6,9,2,1,6,24
1912241036,9,6,4,6,2,27
1912241037,3,4,2,9,4,22
1912241038,9,4,3,7,6,29
1912241039,9,5,2,9,9,34
1912241040,2,5,8,7,5,27
1912241041,9,2,7,7,5,30
1912241042,9,6,9,3,6,33
1912241043,8,1,0,3,2,14
1912241044,4,8,6,8,1,27
1912241045,8,0,1,6,0,15
1912241046,9,1,4,7,7,28
1912241047,7,6,7,8,1,29
1912241048,2,9,9,3,2,25
1912241049,3,6,2,8,6,25
1912241050,8,2,1,4,8,23
1912241051,3,3,6,1,3,16
1912241052,2,2,3,1,8,16
1912241053,5,3,1,1,1,11
1912241054,8,8,4,8,7,35
1912241055,8,6,9,5,8,36
1912241056,0,8,3,3,5,19
1912241057,6,9,5,3,8,31
1912241058,5,5,9,0,4,23
1912241059,3,0,6,3,2,14
1912241060,5,0,8,8,1,22
1912241061,8,4,5,1,6,24
1912241062,7,0,2,1,1,11
1912241063,5,5,1,4,3,18
1912241064,4,1,9,3,2,19
1912241065,2,0,0,7,9,18
1912241066,3,0,4,7,4,18
1912241067,0,5,1,5,6,17
1912241068,0,9,1,6,7,23
1912241069,7,1,0,7,8,23
1912241070,7,0,3,2,7,19
1912241071,3,0,1,0,0,4
1912241072,0,4,8,0,4,16
1912241073,2,3,9,3,3,20
1912241074,8,7,5,7,9,36
1912241075,3,4,5,8,6,26
1912241076,4,7,0,3,2,16
1912241077,6,9,0,5,1,21
1912241078,4,1,0,7,4,16
1912241079,9,6,6,4,2,27
1912241080,4,3,1,9,7,24
1912241081,3,8,6,7,7,31
1912241082,1,9,9,4,9,32
1912241083,3,9,0,8,1,21
1912241084,3,2,9,7,1,22
1912241085,9,6,4,4,6,29
1912241086,5,2,1,5,8,21
1912241087,4,7,2,2,9,24
1912241088,5,4,3,9,8,29
1912241089,5,9,6,8,3,31
1912241090,3,4,1,9,6,23
1912241091,2,2,4,7,3,18
1912241092,9,8,1,9,7,34
1912241093,7,2,0,1,8,18
1912241094,2,4,2,1,3,12
1912241095,5,6,9,5,7,32
1912241096,0,2,5,2,2,11
1912241097,4,4,8,9,6,31
1912241098,0,5,0,6,5,16
1912241099,7,4,4,0,6,21
1912241100,0,3,5,5,5,18
1912241101,7,2,9,3,5,26
1912241102,2,5,1,6,3,17
1912241103,5,1,2,0,6,14
1912241104,8,6,2,1,9,26
1912241105,7,3,0,1,3,14
191225001,9,9,2,9,8,37
191225002,4,1,6,1,4,16
191225003,4,9,9,0,1,23
191225004,1,4,8,7,8,28
191225005,7,8,5,0,9,29
191225006,5,6,9,7,8,35
191225007,1,5,6,2,7,21
191225008,4,2,0,7,7,20
191225009,0,8,3,1,2,14
191225010,8,1,1,2,0,12
191225011,2,6,3,9,6,26
191225012,6,8,4,1,4,23
191225013,9,6,4,8,5,32
191225014,6,5,8,4,0,23
191225015,8,1,4,0,6,19
191225016,8,3,8,7,6,32
191225017,0,4,5,5,4,18
191225018,8,2,0,1,2,13
191225019,5,3,7,3,5,23
191225020,4,0,3,7,4,18
191225021,1,7,5,0,1,14
191225022,2,2,0,2,4,10
191225023,9,8,1,5,1,24
191225024,4,7,7,9,2,29
191225025,8,5,3,9,7,32
191225026,5,0,9,9,7,30
191225027,7,0,9,7,0,23
191225028,2,1,5,2,5,15
191225029,6,0,8,7,8,29
191225030,2,6,6,5,0,19
191225031,5,0,8,7,2,22
191225032,7,0,7,7,6,27
191225033,5,9,3,5,3,25
191225034,4,5,8,3,6,26
191225035,3,9,5,9,8,34
191225036,2,2,9,0,3,16
191225037,7,3,5,3,0,18
191225038,4,6,8,3,3,24
191225039,9,6,4,0,4,23
191225040,3,1,4,3,4,15
191225041,7,2,6,8,3,26
191225042,7,7,5,2,4,25
191225043,8,0,1,1,3,13
191225044,7,6,0,2,5,20
191225045,8,7,3,0,6,24
191225046,4,0,9,2,4,19
191225047,9,3,4,1,8,25
191225048,5,7,5,0,0,17
191225049,0,9,1,3,1,14
191225050,5,2,6,6,7,26
191225051,9,5,5,5,1,25
191225052,9,6,6,0,9,30
191225053,3,6,9,7,4,29
191225054,7,5,6,9,3,30
191225055,7,2,4,8,7,28
191225056,0,3,4,4,0,11
191225057,4,9,7,9,3,32
191225058,5,7,7,4,7,30
191225059,4,2,6,7,6,25
191225060,6,8,6,0,0,20
191225061,7,9,3,6,2,27
191225062,1,6,5,0,8,20
191225063,2,7,3,0,0,12
191225064,2,5,5,6,8,26
191225065,1,7,8,8,5,29
191225066,7,0,6,2,4,19
191225067,7,1,6,0,7,21
191225068,4,2,1,2,8,17
191225069,9,6,0,9,8,32
191225070,4,8,6,8,0,26
191225071,1,1,2,9,4,17
191225072,0,7,8,4,4,23
191225073,9,7,2,4,7,29
191225074,5,4,0,3,6,18
191225075,3,1,6,0,5,15
191225076,0,2,2,3,2,9
191225077,4,5,3,4,7,23
191225078,2,4,0,5,9,20
191225079,7,8,1,2,1,19
191225080,0,7,2,0,0,9
191225081,3,2,3,9,8,25
191225082,9,8,8,2,5,32
191225083,8,3,8,4,0,23
191225084,5,2,8,9,7,31
191225085,0,8,5,5,1,19
191225086,7,0,3,1,2,13
191225087,8,4,3,2,0,17
191225088,2,6,5,4,9,26
191225089,6,0,9,9,8,32
191225090,9,3,4,4,7,27
191225091,0,6,8,1,7,22
191225092,3,7,6,5,6,27
191225093,7,7,7,2,9,32
191225094,0,4,5,0,4,13
191225095,0,2,6,4,1,13
191225096,4,5,9,1,2,21
191225097,9,8,0,5,2,24
191225098,2,6,0,7,2,17
191225099,4,2,9,7,7,29
191225100,2,6,5,9,2,24
191225101,2,7,4,1,9,23
191225102,4,7,9,4,6,30
191225103,6,2,5,3,7,23
191225104,2,1,1,6,4,14
191225105,5,0,8,6,6,25
191225106,0,4,5,8,6,23
191225107,4,0,5,8,1,18
191225108,0,9,7,0,5,21
191225109,8,8,4,9,3,32
191225110,1,7,6,4,7,25
191225111,5,5,9,1,9,29
191225112,2,4,2,0,4,12
191225113,9,1,0,5,9,24
191225114,6,6,2,7,6,27
191225115,9,5,7,7,7,35
191225116,4,1,2,5,3,15
191225117,9,3,1,8,7,28
191225118,7,7,9,5,9,37
191225119,0,5,1,9,2,17
191225120,7,5,3,1,6,22
191225121,1,0,9,9,0,19
191225122,1,2,1,4,8,16
191225123,8,6,9,1,9,33
191225124,3,1,2,6,9,21
191225125,0,2,9,3,4,18
191225126,6,4,7,0,5,22
191225127,4,7,6,8,8,33
191225128,2,9,5,9,4,29
191225129,2,4,2,5,5,18
191225130,1,7,4,6,8,26
191225131,8,9,0,0,3,20
191225132,2,4,8,5,1,20
191225133,6,0,9,7,4,26
191225134,3,4,0,2,4,13
191225135,3,2,9,3,3,20
191225136,3,6,9,3,6,27
191225137,1,2,2,5,9,19
191225138,8,9,7,7,0,31
191225139,4,7,2,3,9,25
191225140,3,9,4,0,8,24
191225141,6,6,0,7,5,24
191225142,0,4,6,4,5,19
191225143,3,8,0,8,8,27
191225144,1,8,8,4,9,30
191225145,7,5,5,3,5,25
191225146,5,0,9,4,8,26
191225147,5,4,1,4,8,22
191225148,1,0,5,9,4,19
191225149,7,7,6,4,8,32
191225150,8,6,2,7,6,29
191225151,3,4,9,9,4,29
191225152,5,9,8,8,9,39
191225153,9,9,9,1,9,37
191225154,7,7,0,2,3,19
191225155,7,9,5,9,7,37
191225156,8,0,7,7,4,26
191225157,9,6,2,4,6,27
191225158,7,8,7,4,0,26
191225159,7,1,0,3,9,20
191225160,8,2,2,6,2,20
191225161,5,9,5,8,5,32
191225162,4,9,0,2,1,16
191225163,0,8,6,2,7,23
191225164,3,7,5,4,2,21
191225165,2,8,5,2,5,22
191225166,0,1,9,3,0,13
191225167,4,8,0,4,1,17
191225168,3,8,5,6,6,28
191225169,6,4,2,4,2,18
191225170,8,8,8,5,2,31
191225171,3,0,4,5,1,13
191225172,2,2,3,3,9,19
191225173,5,0,9,3,8,25
191225174,2,8,9,3,6,28
191225175,8,2,7,7,1,25
191225176,4,2,2,5,9,22
191225177,2,9,4,5,5,25
191225178,7,2,4,3,0,16
191225179,7,8,6,4,5,30
191225180,8,9,0,5,5,27
191225181,3,2,5,9,8,27
191225182,5,0,1,0,7,13
191225183,0,8,2,3,7,20
191225184,2,3,8,3,3,19
191225185,1,4,7,8,4,24
191225186,8,3,1,6,7,25
191225187,9,3,8,6,3,29
191225188,8,9,9,5,5,36
191225189,2,0,7,9,3,21
191225190,1,0,1,3,6,11
191225191,0,4,9,1,6,20
191225192,8,0,1,0,8,17
191225193,3,0,5,8,5,21
191225194,8,6,2,7,0,23
191225195,0,0,7,2,7,16
191225196,9,5,9,0,4,27
191225197,9,1,3,5,7,25
191225198,4,0,3,3,6,16
191225199,2,1,5,0,4,12
191225200,5,5,5,1,6,22
191225201,5,1,3,8,3,20
191225202,2,4,4,6,7,23
191225203,6,1,4,7,9,27
191225204,3,4,7,6,1,21
191225205,2,8,3,4,4,21
191225206,9,3,6,7,5,30
191225207,9,1,9,3,6,28
191225208,7,1,2,6,1,17
191225209,5,3,4,7,4,23
191225210,8,8,9,5,1,31
191225211,0,4,8,8,3,23
191225212,3,9,5,6,2,25
191225213,8,1,5,4,7,25
191225214,2,9,4,4,1,20
191225215,2,7,5,0,5,19
191225216,9,0,6,0,0,15
191225217,9,2,9,9,1,30
191225218,7,8,8,2,8,33
191225219,3,0,1,3,4,11
191225220,3,1,2,4,3,13
191225221,4,5,6,1,9,25
191225222,7,7,2,2,5,23
191225223,4,7,9,1,9,30
191225224,4,2,3,2,2,13
191225225,4,4,1,0,2,11
191225226,0,4,3,6,3,16
191225227,2,4,7,0,6,19
191225228,5,8,7,2,3,25
191225229,3,7,9,4,9,32
191225230,4,9,6,9,0,28
191225231,9,4,3,1,8,25
191225232,0,9,1,4,8,22
191225233,8,4,2,0,1,15
191225234,6,0,0,5,0,11
191225235,8,8,9,5,8,38
191225236,2,4,4,5,3,18
191225237,3,0,1,1,5,10
191225238,1,4,0,0,6,11
191225239,9,9,2,4,1,25
191225240,5,5,2,9,0,21
191225241,9,1,9,4,9,32
191225242,4,6,1,6,2,19
191225243,6,8,7,8,9,38
191225244,1,8,1,3,6,19
191225245,0,7,0,2,2,11
191225246,6,9,5,5,3,28
191225247,5,0,6,8,8,27
191225248,4,4,0,2,0,10
191225249,1,9,8,5,8,31
191225250,5,7,4,3,9,28
191225251,0,0,9,0,8,17
191225252,0,4,3,9,9,25
191225253,4,4,6,5,6,25
191225254,1,1,8,9,1,20
191225255,7,7,3,7,5,29
191225256,9,1,7,7,4,28
191225257,6,2,4,1,6,19
191225258,7,4,0,8,6,25
191225259,8,9,6,4,6,33
191225260,7,8,5,4,9,33
191225261,4,8,3,9,7,31
191225262,2,6,3,1,6,18
191225263,2,8,0,1,9,20
191225264,6,9,3,5,2,25
191225265,1,7,7,3,4,22
191225266,7,4,3,0,6,20
191225267,0,1,8,6,8,23
191225268,1,1,3,0,4,9
191225269,6,7,1,3,8,25
191225270,3,1,4,1,4,13
191225271,1,0,8,7,3,19
191225272,6,1,2,2,3,14
191225273,3,8,7,5,3,26
191225274,4,5,8,5,0,22
191225275,0,1,2,9,0,12
191225276,0,5,8,6,2,21
191225277,5,7,7,4,9,32
191225278,3,7,8,9,2,29
191225279,9,6,5,0,0,20
191225280,6,0,9,1,8,24
191225281,0,9,1,8,7,25
191225282,1,8,9,6,9,33
191225283,7,5,6,4,6,28
191225284,2,3,2,5,5,17
191225285,0,8,4,1,5,18
191225286,0,5,4,2,2,13
191225287,9,6,1,9,2,27
191225288,2,5,7,5,0,19
191225289,9,9,2,8,2,30
191225290,8,4,4,7,4,27
191225291,1,1,1,6,0,9
191225292,8,5,6,3,0,22
191225293,2,8,4,2,7,23
191225294,1,9,1,3,3,17
191225295,9,7,8,5,7,36
191225296,6,8,7,4,0,25
191225297,4,5,3,3,8,23
191225298,0,4,2,8,4,18
191225299,2,8,3,0,9,22
191225300,0,8,0,6,4,18
191225301,5,5,1,4,7,22
191225302,9,5,1,5,6,26
191225303,6,7,0,4,6,23
191225304,1,9,3,2,1,16
191225305,1,5,2,6,9,23
191225306,9,2,3,8,7,29
191225307,9,0,5,8,3,25
191225308,3,7,9,7,6,32
191225309,7,3,1,3,8,22
191225310,0,3,3,2,6,14
191225311,8,0,0,3,9,20
191225312,9,8,5,1,5,28
191225313,5,9,9,3,0,26
191225314,4,7,7,1,0,19
191225315,4,3,8,0,9,24
191225316,8,1,0,8,1,18
191225317,1,0,9,7,0,17
191225318,1,6,2,4,5,18
191225319,8,8,6,3,5,30
191225320,8,4,7,3,6,28
191225321,0,1,1,6,8,16
191225322,7,1,7,4,7,26
191225323,6,5,3,4,1,19
191225324,0,4,9,4,8,25
191225325,1,2,2,9,5,19
191225326,2,7,6,1,9,25
191225327,5,8,1,4,7,25
191225328,4,7,4,9,6,30
191225329,9,5,1,6,9,30
191225330,8,3,8,1,9,29
191225331,3,1,8,1,3,16
191225332,0,1,5,8,4,18
191225333,0,5,8,9,7,29
191225334,0,4,2,5,6,17
191225335,3,5,5,8,2,23
191225336,3,8,8,1,6,26
191225337,5,4,8,7,8,32
191225338,3,0,3,6,1,13
191225339,5,7,2,7,7,28
191225340,9,0,5,2,2,18
191225341,7,7,2,0,5,21
191225342,9,0,1,4,0,14
191225343,1,3,3,4,4,15
191225344,3,1,7,1,7,19
191225345,3,8,2,3,3,19
191225346,6,5,3,7,3,24
191225347,0,8,1,9,4,22
191225348,4,1,7,5,4,21
191225349,3,1,5,2,5,16
191225350,3,9,9,6,0,27
191225351,1,2,2,8,8,21
191225352,6,4,3,0,1,14
191225353,9,6,9,1,3,28
191225354,2,4,0,6,7,19
191225355,1,4,2,0,8,15
191225356,9,9,7,0,2,27
191225357,5,2,9,7,6,29
191225358,4,4,0,0,5,13
191225359,6,4,9,5,2,26
191225360,9,5,9,6,4,33
191225361,9,7,0,8,1,25
191225362,8,4,9,3,0,24
191225363,6,3,4,4,1,18
191225364,2,4,7,1,1,15
191225365,9,6,6,2,3,26
191225366,4,6,6,1,4,21
191225367,2,0,2,2,8,14
191225368,6,7,0,1,6,20
191225369,1,7,2,2,8,20
191225370,0,3,7,7,7,24
191225371,2,2,6,9,4,23
191225372,2,4,9,9,9,33
191225373,0,8,8,9,2,27
191225374,4,4,6,9,6,29
191225375,7,7,1,7,1,23
191225376,9,7,0,9,7,32
191225377,8,8,2,6,8,32
191225378,0,8,8,5,0,21
191225379,3,8,6,2,4,23
191225380,2,0,3,7,3,15
191225381,7,2,5,2,7,23
191225382,8,5,6,3,4,26
191225383,0,9,8,2,4,23
191225384,1,1,1,2,9,14
191225385,9,4,4,9,2,28
191225386,9,8,3,9,8,37
191225387,1,6,4,5,0,16
191225388,6,6,5,6,6,29
191225389,8,1,4,6,5,24
191225390,3,7,1,8,1,20
191225391,3,6,8,9,8,34
191225392,9,3,2,5,1,20
191225393,6,5,0,1,6,18
191225394,2,1,9,9,8,29
191225395,5,2,0,0,0,7
191225396,0,8,1,4,2,15
191225397,9,2,0,9,8,28
191225398,7,5,8,2,0,22
191225399,7,2,3,8,5,25
191225400,2,7,0,4,4,17
191225401,5,3,7,4,6,25
191225402,8,2,0,5,8,23
191225403,1,1,5,6,5,18
191225404,6,6,1,4,3,20
191225405,0,8,0,2,0,10
191225406,9,7,8,8,4,36
191225407,6,3,8,3,9,29
191225408,5,7,4,2,7,25
191225409,9,5,9,8,9,40
191225410,3,1,1,5,0,10
191225411,3,9,3,2,3,20
191225412,2,1,2,3,8,16
191225413,7,2,1,7,9,26
191225414,7,4,4,5,6,26
191225415,6,0,0,2,5,13
191225416,4,2,9,8,7,30
191225417,2,0,1,6,2,11
191225418,3,1,9,6,7,26
191225419,7,1,5,1,1,15
191225420,7,2,5,2,6,22
191225421,1,5,5,1,3,15
191225422,6,3,7,7,0,23
191225423,2,3,2,0,7,14
191225424,5,7,7,6,8,33
191225425,0,9,3,8,6,26
191225426,1,6,5,1,5,18
191225427,7,9,3,3,8,30
191225428,6,3,8,6,8,31
191225429,8,8,7,8,1,32
191225430,8,5,8,7,2,30
191225431,8,2,0,6,5,21
191225432,9,9,2,3,1,24
191225433,4,7,8,0,4,23
191225434,4,0,1,1,6,12
191225435,3,1,7,4,1,16
191225436,2,3,2,9,4,20
191225437,0,9,8,3,1,21
191225438,4,3,5,4,3,19
191225439,4,8,4,4,5,25
191225440,4,2,0,0,6,12
191225441,4,8,6,2,2,22
191225442,8,8,0,9,9,34
191225443,8,9,7,5,7,36
191225444,0,5,3,0,8,16
191225445,0,0,0,9,9,18
191225446,4,6,7,3,0,20
191225447,5,4,9,8,9,35
191225448,1,4,8,6,7,26
191225449,6,1,3,9,9,28
191225450,3,9,3,8,7,30
191225451,0,4,0,1,6,11
191225452,9,4,5,9,7,34
191225453,5,5,8,3,8,29
191225454,0,4,8,6,1,19
191225455,5,1,2,8,9,25
191225456,5,9,8,4,1,27
191225457,8,4,5,0,4,21
191225458,0,4,3,1,2,10
191225459,7,4,2,5,9,27
191225460,1,9,3,0,2,15
191225461,7,3,7,8,6,31
191225462,3,2,9,3,7,24
191225463,2,6,9,5,8,30
191225464,0,3,5,9,6,23
191225465,4,6,4,8,6,28
191225466,8,0,7,2,3,20
191225467,8,3,7,2,2,22
191225468,0,9,4,9,1,23
191225469,0,0,0,9,1,10
191225470,7,8,1,9,8,33
191225471,2,6,0,1,2,11
191225472,4,9,6,9,6,34
191225473,3,9,7,2,9,30
191225474,6,1,7,0,4,18
191225475,5,5,4,0,7,21
191225476,7,4,6,9,5,31
191225477,1,4,2,1,8,16
191225478,2,1,9,4,4,20
191225479,0,1,6,0,7,14
191225480,4,4,7,9,8,32
191225481,0,3,6,6,0,15
191225482,7,6,0,7,2,22
191225483,3,8,6,9,9,35
191225484,8,0,1,9,2,20
191225485,5,8,0,5,8,26
191225486,9,7,6,2,7,31
191225487,9,7,6,7,1,30
191225488,3,1,4,4,6,18
191225489,4,9,1,6,2,22
191225490,2,3,4,4,6,19
191225491,7,8,9,1,2,27
191225492,7,7,7,8,0,29
191225493,5,3,6,7,9,30
191225494,9,1,7,0,5,22
191225495,9,2,6,0,9,26
191225496,3,2,1,9,0,15
191225497,9,9,4,0,5,27
191225498,8,9,7,3,4,31
191225499,4,0,9,4,1,18
191225500,8,6,4,9,5,32
191225501,6,4,7,2,8,27
191225502,6,0,5,6,7,24
191225503,7,3,6,1,5,22
191225504,5,5,9,3,8,30
191225505,1,2,6,7,5,21
191225506,7,4,7,0,5,23
191225507,4,6,1,7,4,22
191225508,8,5,0,8,5,26
191225509,3,6,0,4,4,17
191225510,6,2,3,1,0,12
191225511,6,1,7,9,1,24
191225512,2,7,0,6,3,18
191225513,5,1,2,1,2,11
191225514,9,7,1,2,4,23
191225515,7,3,8,7,3,28
191225516,6,7,6,8,9,36
191225517,1,1,3,3,7,15
191225518,8,4,8,3,9,32
191225519,5,0,8,6,7,26
191225520,5,3,6,5,4,23
191225521,6,2,1,6,2,17
191225522,5,2,7,2,6,22
191225523,5,9,1,6,7,28
191225524,8,5,6,2,9,30
191225525,1,7,8,5,8,29
191225526,7,5,5,4,7,28
191225527,2,3,7,3,2,17
191225528,0,4,3,2,5,14
191225529,5,7,5,8,8,33
191225530,7,6,3,1,8,25
191225531,1,8,7,4,6,26
191225532,2,1,8,6,1,18
191225533,4,9,0,2,5,20
191225534,2,1,3,1,5,12
191225535,2,3,0,3,6,14
191225536,1,6,9,6,5,27
191225537,6,4,1,3,2,16
191225538,7,5,8,8,4,32
191225539,0,5,6,7,0,18
191225540,8,0,9,2,0,19
191225541,8,1,2,6,6,23
191225542,8,5,2,5,6,26
191225543,9,1,6,1,6,23
191225544,6,8,3,8,9,34
191225545,2,0,3,6,8,19
191225546,6,5,2,4,9,26
191225547,5,7,4,1,0,17
191225548,8,4,5,1,3,21
191225549,2,6,5,8,4,25
191225550,0,7,7,8,3,25
191225551,0,3,7,8,4,22
191225552,7,3,6,6,8,30
191225553,7,7,4,6,6,30
191225554,7,6,3,3,9,28
191225555,1,9,7,2,8,27
191225556,5,6,1,1,0,13
191225557,9,7,7,1,2,26
191225558,1,9,0,1,9,20
191225559,2,7,5,9,7,30
191225560,9,9,6,8,2,34
191225561,5,5,8,7,4,29
191225562,5,8,6,7,9,35
191225563,3,2,0,8,3,16
191225564,6,8,8,0,6,28
191225565,1,5,9,1,3,19
191225566,0,2,9,0,8,19
191225567,5,3,6,6,2,22
191225568,5,4,1,9,3,22
191225569,1,4,6,7,6,24
191225570,4,4,9,4,1,22
191225571,4,6,3,0,5,18
191225572,9,5,3,1,0,18
191225573,5,9,6,1,6,27
191225574,1,2,0,7,7,17
191225575,9,5,5,6,5,30
191225576,3,4,8,0,3,18
191225577,7,6,2,1,7,23
191225578,2,2,0,9,5,18
191225579,2,9,6,6,5,28
191225580,0,2,5,1,5,13
191225581,3,6,7,6,5,27
191225582,4,9,5,3,0,21
191225583,3,6,9,3,5,26
191225584,3,1,3,2,0,9
191225585,0,1,0,7,3,11
191225586,6,3,9,0,3,21
191225587,7,1,8,1,5,22
191225588,7,2,2,5,0,16
191225589,5,0,7,8,6,26
191225590,6,6,7,3,9,31
191225591,8,2,9,7,5,31
191225592,7,9,4,9,3,32
191225593,3,4,5,6,1,19
191225594,5,1,9,9,9,33
191225595,9,2,4,2,1,18
191225596,7,3,2,5,4,21
191225597,1,4,8,1,1,15
191225598,1,9,6,5,2,23
191225599,8,4,3,5,5,25
191225600,9,1,1,6,1,18
191225601,6,2,6,4,0,18
191225602,1,3,3,7,9,23
191225603,3,0,7,3,6,19
191225604,8,5,5,2,3,23
191225605,2,7,4,4,3,20
191225606,1,0,5,6,8,20
191225607,3,6,8,3,4,24
191225608,7,1,4,2,1,15
191225609,1,6,2,3,3,15
191225610,1,0,6,0,5,12
191225611,7,5,1,9,3,25
191225612,9,9,3,0,2,23
191225613,0,8,2,1,7,18
191225614,4,7,4,5,9,29
191225615,2,6,7,1,1,17
191225616,6,6,0,0,6,18
191225617,0,8,7,1,6,22
191225618,1,8,5,7,7,28
191225619,9,0,9,3,1,22
191225620,9,0,2,8,8,27
191225621,3,2,4,3,3,15
191225622,7,6,5,6,5,29
191225623,1,7,1,7,2,18
191225624,8,0,3,5,0,16
191225625,9,0,4,1,8,22
191225626,9,7,1,4,3,24
191225627,1,2,5,3,2,13
191225628,2,3,3,7,9,24
191225629,1,8,1,9,2,21
191225630,4,9,2,6,5,26
191225631,4,0,5,2,8,19
191225632,9,5,1,6,2,23
191225633,9,0,8,3,4,24
191225634,1,4,4,4,8,21
191225635,4,8,6,9,6,33
191225636,2,6,5,9,3,25
191225637,9,9,1,6,5,30
191225638,7,1,0,1,7,16
191225639,0,3,0,7,7,17
191225640,6,3,1,1,9,20
191225641,7,7,0,3,2,19
191225642,5,1,0,0,4,10
191225643,9,6,6,4,4,29
191225644,1,4,5,9,1,20
191225645,4,6,2,4,3,19
191225646,2,9,2,8,2,23
191225647,2,4,8,0,9,23
191225648,0,5,0,0,9,14
191225649,5,6,9,9,7,36
191225650,3,3,2,0,0,8
191225651,4,5,0,1,3,13
191225652,0,9,9,1,5,24
191225653,3,5,8,2,6,24
191225654,3,6,2,7,6,24
191225655,0,3,1,4,2,10
191225656,3,0,4,8,7,22
191225657,7,4,3,6,2,22
191225658,7,7,8,6,8,36
191225659,2,8,1,1,5,17
191225660,8,4,6,6,7,31
191225661,8,1,8,5,8,30
191225662,4,3,5,7,0,19
191225663,0,0,2,1,6,9
191225664,5,1,6,9,4,25
191225665,8,2,1,7,0,18
191225666,0,0,5,7,0,12
191225667,8,7,4,4,3,26
191225668,1,6,6,5,6,24
191225669,7,4,1,0,1,13
191225670,7,9,9,8,2,35
191225671,0,9,9,9,6,33
191225672,6,4,8,0,1,19
191225673,6,8,7,8,2,31
191225674,1,8,4,1,3,17
191225675,6,6,7,1,3,23
191225676,5,9,5,7,6,32
191225677,6,5,2,4,7,24
191225678,0,2,8,5,5,20
191225679,4,3,9,7,3,26
191225680,8,2,9,2,5,26
191225681,5,2,2,6,7,22
191225682,7,0,9,7,3,26
191225683,0,4,7,7,7,25
191225684,9,6,9,5,8,37
191225685,4,0,2,7,3,16
191225686,0,7,3,7,3,20
191225687,9,0,5,2,9,25
191225688,8,4,8,4,7,31
191225689,5,2,3,7,1,18
191225690,0,4,1,8,8,21
191225691,2,4,2,5,0,13
191225692,5,3,6,3,8,25
191225693,6,0,6,6,6,24
191225694,2,5,4,6,8,25
191225695,9,9,3,4,0,25
191225696,7,5,9,8,6,35
191225697,8,7,7,2,6,30
191225698,6,7,4,7,7,31
191225699,3,8,2,1,2,16
191225700,9,7,7,9,7,39
191225701,0,5,2,3,4,14
191225702,1,1,9,1,7,19
191225703,9,1,6,0,5,21
191225704,0,4,0,6,9,19
191225705,9,9,5,6,0,29
191225706,6,1,2,4,2,15
191225707,4,9,3,6,7,29
191225708,0,9,6,4,7,26
191225709,5,9,5,4,8,31
191225710,7,4,3,8,7,29
191225711,9,0,6,1,4,20
191225712,8,4,2,4,6,24
191225713,5,0,4,1,2,12
191225714,3,4,6,7,8,28
191225715,1,0,6,9,2,18
191225716,1,1,1,7,0,10
191225717,7,8,5,5,4,29
191225718,3,7,5,9,9,33
191225719,8,0,2,7,8,25
191225720,6,5,6,9,2,28
191225721,0,1,5,2,4,12
191225722,2,9,3,1,5,20
191225723,1,9,0,8,8,26
191225724,7,9,4,7,7,34
191225725,7,2,7,4,7,27
191225726,6,2,9,0,8,25
191225727,0,2,4,9,1,16
191225728,8,8,0,1,4,21
191225729,9,0,7,7,8,31
191225730,1,0,2,7,6,16
191225731,4,5,3,1,4,17
191225732,7,0,9,7,2,25
191225733,2,8,4,1,2,17
191225734,7,6,2,4,4,23
191225735,0,6,2,7,9,24
191225736,3,1,6,6,9,25
191225737,2,2,9,5,6,24
191225738,9,1,2,1,0,13
191225739,8,8,8,3,4,31
191225740,2,0,9,0,8,19
191225741,4,7,2,9,4,26
191225742,8,6,5,8,6,33
191225743,7,7,3,8,0,25
191225744,5,0,2,8,8,23
191225745,2,5,0,3,3,13
191225746,7,1,1,9,0,18
191225747,9,0,0,6,0,15
191225748,9,8,3,0,3,23
191225749,1,3,0,5,7,16
191225750,2,8,3,8,4,25
191225751,5,5,9,0,8,27
191225752,3,8,3,4,2,20
191225753,2,8,9,0,4,23
191225754,5,3,4,7,3,22
191225755,7,5,9,7,6,34
191225756,7,3,2,8,2,22
191225757,1,0,8,6,9,24
191225758,5,1,1,5,1,13
191225759,0,5,6,9,4,24
191225760,1,3,7,0,1,12
191225761,5,7,8,2,6,28
191225762,0,6,2,9,3,20
191225763,5,8,3,6,5,27
191225764,2,3,1,3,9,18
191225765,7,8,1,4,1,21
191225766,2,3,2,5,0,12
191225767,2,9,4,6,4,25
191225768,2,8,4,5,3,22
191225769,1,8,0,8,6,23
191225770,9,3,9,1,9,31
191225771,2,8,6,7,7,30
191225772,5,0,0,3,9,17
191225773,6,1,6,0,9,22
191225774,1,4,7,3,1,16
191225775,1,2,3,2,5,13
191225776,2,9,9,5,8,33
191225777,1,9,5,5,8,28
191225778,2,3,7,2,6,20
191225779,0,5,6,5,7,23
191225780,1,3,4,3,5,16
191225781,6,6,8,9,3,32
191225782,3,4,1,9,2,19
191225783,8,6,3,9,5,31
191225784,1,0,1,3,0,5
191225785,3,0,6,2,3,14
191225786,7,7,5,5,9,33
191225787,3,7,4,2,4,20
191225788,3,1,2,3,8,17
191225789,1,8,5,2,3,19
191225790,9,0,2,4,5,20
191225791,7,7,8,0,0,22
191225792,6,9,2,6,2,25
191225793,7,8,9,0,2,26
191225794,2,7,7,1,8,25
191225795,7,1,8,7,2,25
191225796,2,6,7,6,7,28
191225797,0,9,4,6,8,27
191225798,6,6,6,1,2,21
191225799,4,3,5,5,7,24
191225800,4,0,2,6,7,19
191225801,1,4,2,6,5,18
191225802,8,2,1,6,3,20
191225803,6,3,7,2,2,20
191225804,4,6,5,7,8,30
191225805,9,5,5,3,0,22
191225806,4,8,2,6,2,22
191225807,3,7,6,1,9,26
191225808,7,9,3,6,8,33
191225809,2,6,2,2,4,16
191225810,2,1,6,6,1,16
191225811,6,5,7,5,6,29
191225812,9,5,1,9,9,33
191225813,3,7,1,8,4,23
191225814,7,6,1,9,6,29
191225815,2,5,5,3,4,19
191225816,8,1,9,6,1,25
191225817,6,2,1,0,4,13
191225818,9,0,9,2,0,20
191225819,1,8,4,5,4,22
191225820,5,3,4,5,0,17
191225821,6,9,0,0,1,16
191225822,0,0,1,1,2,4
191225823,8,5,4,2,0,19
191225824,8,4,7,4,2,25
191225825,9,5,7,9,5,35
191225826,5,0,8,1,1,15
191225827,0,0,2,5,2,9
191225828,9,5,7,9,6,36
191225829,7,1,6,4,1,19
191225830,8,5,8,5,8,34
191225831,0,8,9,5,3,25
191225832,6,2,8,5,8,29
191225833,4,6,9,5,8,32
191225834,7,1,1,2,1,12
191225835,3,3,5,9,3,23
191225836,9,9,4,4,1,27
191225837,8,8,0,2,1,19
191225838,4,1,8,6,7,26
191225839,0,4,2,3,2,11
191225840,6,6,7,5,1,25
191225841,8,8,6,1,2,25
191225842,4,9,5,6,0,24
191225843,2,7,9,9,2,29
191225844,0,2,1,7,5,15
191225845,7,4,1,5,3,20
191225846,3,4,5,1,4,17
191225847,7,0,0,0,0,7
191225848,8,1,3,3,5,20
191225849,5,4,6,7,2,24
191225850,3,3,3,1,9,19
191225851,2,0,4,8,4,18
191225852,6,6,4,2,3,21
191225853,4,6,1,0,8,19
191225854,6,5,6,8,4,29
191225855,9,5,6,1,1,22
191225856,0,5,9,6,8,28
191225857,6,4,9,1,7,27
191225858,6,1,9,9,4,29
191225859,1,0,5,2,0,8
191225860,7,2,0,7,4,20
191225861,3,7,1,7,8,26
191225862,0,8,9,6,2,25
191225863,3,1,8,6,2,20
191225864,4,9,8,1,5,27
191225865,6,2,8,1,2,19
191225866,0,3,8,1,1,13
191225867,4,6,2,9,5,26
191225868,4,5,1,8,2,20
191225869,0,9,5,8,6,28
191225870,1,5,8,4,9,27
191225871,1,8,2,7,7,25
191225872,8,6,4,2,2,22
191225873,0,1,2,9,5,17
191225874,1,3,0,0,1,5
191225875,0,2,9,5,0,16
191225876,4,2,8,5,9,28
191225877,7,9,4,0,6,26
191225878,2,6,2,0,7,17
191225879,4,6,1,4,2,17
191225880,2,0,5,7,7,21
191225881,3,2,5,8,3,21
191225882,4,2,4,6,1,17
191225883,2,4,0,1,1,8
191225884,3,7,2,1,8,21
191225885,5,9,3,9,6,32
191225886,5,7,6,2,2,22
191225887,6,4,2,6,5,23
191225888,0,3,0,6,9,18
191225889,0,4,4,5,6,19
191225890,6,3,7,9,5,30
191225891,3,4,5,6,4,22
191225892,7,1,0,7,5,20
191225893,1,2,4,9,8,24
191225894,4,8,8,3,0,23
191225895,8,8,2,7,8,33
191225896,3,4,7,9,5,28
191225897,2,5,1,7,0,15
191225898,7,9,2,7,9,34
191225899,4,5,4,9,9,31
191225900,2,4,7,3,1,17
191225901,8,9,1,6,9,33
191225902,4,7,9,3,2,25
191225903,0,7,7,4,9,27
191225904,2,9,0,8,3,22
191225905,9,3,1,7,7,27
191225906,4,3,8,5,0,20
191225907,0,6,7,7,2,22
191225908,6,8,3,8,4,29
191225909,3,8,2,4,3,20
191225910,6,3,9,8,2,28
191225911,3,4,9,7,4,27
191225912,5,4,8,4,0,21
191225913,1,6,6,4,2,19
191225914,5,2,5,4,9,25
191225915,4,8,3,1,0,16
191225916,2,5,9,8,8,32
191225917,4,2,0,4,4,14
191225918,3,6,6,8,6,29
191225919,2,1,7,3,5,18
191225920,7,0,8,0,3,18
191225921,1,2,3,0,8,14
191225922,6,9,7,1,6,29
191225923,2,3,1,8,6,20
191225924,4,3,0,2,4,13
191225925,8,6,8,6,7,35
191225926,5,8,1,5,4,23
191225927,4,5,6,6,9,30
191225928,3,0,6,8,4,21
191225929,5,1,7,1,2,16
191225930,2,5,2,6,4,19
191225931,8,0,9,8,2,27
191225932,3,9,1,8,3,24
191225933,7,7,7,6,4,31
191225934,6,0,2,9,5,22
191225935,0,8,0,4,1,13
191225936,7,6,2,6,1,22
191225937,7,9,8,0,3,27
191225938,5,4,4,4,3,20
191225939,7,4,0,8,4,23
191225940,2,3,1,2,1,9
191225941,6,6,2,7,3,24
191225942,0,4,8,1,2,15
191225943,8,3,5,6,4,26
191225944,8,1,8,3,1,21
191225945,5,5,3,1,4,18
191225946,1,4,6,8,7,26
191225947,1,7,3,9,7,27
191225948,4,8,4,4,8,28
191225949,3,0,2,0,3,8
191225950,1,5,2,1,3,12
191225951,3,3,4,8,3,21
191225952,3,8,6,4,3,24
191225953,9,6,8,3,1,27
191225954,3,8,9,0,9,29
191225955,6,4,4,7,7,28
191225956,4,1,8,3,8,24
191225957,1,2,1,8,3,15
191225958,3,3,7,7,6,26
191225959,0,9,3,0,6,18
191225960,9,1,7,5,3,25
191225961,8,8,1,6,5,28
191225962,6,7,5,7,7,32
191225963,3,6,2,2,2,15
191225964,0,7,3,3,4,17
191225965,1,9,0,9,7,26
191225966,4,8,5,2,8,27
191225967,4,2,5,4,0,15
191225968,4,9,5,2,8,28
191225969,1,9,0,2,2,14
191225970,7,6,5,5,0,23
191225971,3,3,7,7,8,28
191225972,8,2,0,2,0,12
191225973,4,6,0,4,7,21
191225974,4,9,7,2,5,27
191225975,1,0,8,6,1,16
191225976,8,8,5,3,4,28
191225977,9,3,0,7,4,23
191225978,8,8,5,9,2,32
191225979,3,0,4,2,7,16
191225980,6,5,1,5,8,25
191225981,6,8,5,4,4,27
191225982,3,4,3,1,5,16
191225983,9,7,3,3,6,28
191225984,9,0,0,5,1,15
191225985,3,0,3,7,1,14
191225986,2,4,5,3,5,19
191225987,1,4,5,0,5,15
191225988,0,9,5,7,1,22
191225989,2,3,4,4,7,20
191225990,1,9,6,4,2,22
191225991,7,5,6,9,6,33
191225992,3,9,3,9,5,29
191225993,0,0,1,2,3,6
191225994,6,2,0,1,1,10
191225995,6,1,9,8,0,24
191225996,6,7,4,5,1,23
191225997,4,8,5,9,8,34
191225998,2,0,9,7,7,25
191225999,0,9,0,3,6,18
1912251000,7,5,3,9,2,26
1912251001,7,8,3,1,9,28
1912251002,9,6,5,5,3,28
1912251003,2,1,3,6,5,17
1912251004,7,5,6,9,2,29
1912251005,3,0,8,5,9,25
1912251006,0,0,6,2,9,17
1912251007,3,4,7,7,3,24
1912251008,2,8,5,6,9,30
1912251009,7,8,4,3,8,30
1912251010,0,0,4,8,9,21
1912251011,4,8,9,0,3,24
1912251012,3,3,0,6,9,21
1912251013,8,3,8,2,4,25
1912251014,1,0,0,1,7,9
1912251015,1,2,3,2,3,11
1912251016,5,7,0,0,9,21
1912251017,9,5,5,3,1,23
1912251018,1,7,2,9,4,23
1912251019,0,0,7,5,8,20
1912251020,4,2,1,3,7,17
1912251021,6,1,0,8,4,19
1912251022,6,2,9,8,2,27
1912251023,9,7,5,2,4,27
1912251024,4,9,3,6,1,23
1912251025,4,2,9,4,1,20
1912251026,8,5,0,1,4,18
1912251027,0,5,7,4,9,25
1912251028,7,6,4,2,2,21
1912251029,1,2,8,5,8,24
1912251030,3,3,1,8,1,16
1912251031,1,6,1,4,0,12
1912251032,9,4,0,6,0,19
1912251033,6,1,8,9,8,32
1912251034,1,0,7,5,1,14
1912251035,5,8,4,5,5,27
1912251036,6,2,0,0,8,16
1912251037,8,8,9,5,9,39
1912251038,2,4,2,6,5,19
1912251039,2,8,7,9,8,34
1912251040,7,4,5,0,7,23
1912251041,4,7,6,6,5,28
1912251042,3,9,1,3,3,19
1912251043,2,7,2,5,9,25
1912251044,6,9,8,8,8,39
1912251045,0,7,5,1,3,16
1912251046,7,3,9,4,9,32
1912251047,9,8,4,3,8,32
1912251048,0,6,8,4,8,26
1912251049,4,5,3,8,0,20
1912251050,0,4,1,4,6,15
1912251051,7,1,7,2,5,22
1912251052,2,3,8,6,9,28
1912251053,2,3,7,3,7,22
1912251054,6,4,4,0,5,19
1912251055,0,7,7,8,0,22
1912251056,9,4,6,8,4,31
1912251057,9,9,0,5,8,31
1912251058,5,0,2,2,7,16
1912251059,1,0,2,3,5,11
1912251060,1,5,8,9,5,28
1912251061,2,6,8,1,2,19
1912251062,6,7,6,3,2,24
1912251063,9,0,7,6,8,30
1912251064,1,7,5,2,2,17
1912251065,3,2,3,6,2,16
1912251066,3,4,0,8,1,16
1912251067,1,2,3,0,5,11
1912251068,7,8,7,2,3,27
1912251069,3,5,5,5,9,27
1912251070,5,0,8,2,8,23
1912251071,6,5,8,7,9,35
1912251072,7,4,9,8,7,35
1912251073,8,7,0,2,5,22
1912251074,1,6,9,8,0,24
1912251075,5,8,0,0,7,20
1912251076,2,9,2,3,2,18
1912251077,5,6,6,1,2,20
1912251078,2,0,8,2,6,18
1912251079,8,7,4,1,4,24
1912251080,8,8,8,0,3,27
1912251081,8,0,0,7,9,24
1912251082,2,9,1,1,7,20
1912251083,4,6,8,1,8,27
1912251084,0,0,9,7,4,20
1912251085,1,3,5,3,1,13
1912251086,9,4,9,9,1,32
1912251087,4,1,8,0,7,20
1912251088,9,8,7,1,1,26
1912251089,2,5,7,2,3,19
1912251090,4,0,8,7,8,27
1912251091,4,9,1,9,8,31
1912251092,2,8,6,0,4,20
1912251093,3,6,8,7,1,25
1912251094,3,6,9,0,7,25
1912251095,4,4,8,6,9,31
1912251096,8,3,5,3,5,24
1912251097,0,3,6,1,1,11
1912251098,5,2,4,0,5,16
1912251099,3,8,7,5,6,29
1912251100,4,3,8,5,6,26
1912251101,2,9,2,1,2,16
1912251102,3,7,0,5,7,22
1912251103,0,3,4,1,4,12
1912251104,1,9,1,6,7,24
1912251105,0,7,6,9,6,28
191226001,9,0,4,8,6,27
191226002,2,6,3,8,8,27
191226003,4,8,8,8,6,34
191226004,0,0,8,6,8,22
191226005,3,3,3,4,1,14
191226006,1,1,0,0,7,9
191226007,0,0,0,2,2,4
191226008,8,0,0,9,2,19
191226009,7,9,5,7,4,32
191226010,4,8,4,2,1,19
191226011,5,4,4,4,8,25
191226012,8,3,3,8,9,31
191226013,2,6,4,3,1,16
191226014,7,4,3,7,5,26
191226015,8,4,7,7,2,28
191226016,1,8,1,1,5,16
191226017,3,5,3,8,6,25
191226018,8,7,4,1,1,21
191226019,8,2,0,8,0,18
191226020,5,6,6,6,7,30
191226021,5,8,1,1,1,16
191226022,1,8,1,2,5,17
191226023,8,4,2,2,2,18
191226024,8,7,8,7,4,34
191226025,3,1,6,2,0,12
191226026,9,9,2,4,2,26
191226027,8,1,9,4,0,22
191226028,4,4,8,9,2,27
191226029,2,4,7,1,6,20
191226030,9,9,4,8,3,33
191226031,6,6,2,3,5,22
191226032,4,9,8,4,7,32
191226033,5,8,3,0,6,22
191226034,8,3,5,1,5,22
191226035,8,4,6,2,0,20
191226036,3,6,5,2,3,19
191226037,8,3,6,4,0,21
191226038,5,0,4,7,2,18
191226039,5,9,4,4,3,25
191226040,1,0,6,6,3,16
191226041,8,8,2,4,0,22
191226042,8,3,7,4,5,27
191226043,3,0,5,9,0,17
191226044,9,6,9,0,5,29
191226045,6,5,1,9,7,28
191226046,7,9,4,9,2,31
191226047,9,2,2,6,6,25
191226048,1,3,7,1,5,17
191226049,8,1,4,8,1,22
191226050,8,0,4,6,1,19
191226051,3,8,0,1,0,12
191226052,4,9,9,8,3,33
191226053,2,8,0,2,0,12
191226054,3,9,2,0,6,20
191226055,1,8,1,8,1,19
191226056,0,0,4,6,4,14
191226057,2,6,2,2,8,20
191226058,9,2,0,4,8,23
191226059,3,2,4,2,9,20
191226060,3,0,1,1,3,8
191226061,1,6,2,9,3,21
191226062,0,7,8,3,4,22
191226063,3,9,8,6,5,31
191226064,2,9,1,5,0,17
191226065,5,0,6,6,9,26
191226066,5,1,7,7,7,27
191226067,7,1,0,5,3,16
191226068,4,9,9,1,4,27
191226069,6,1,0,9,4,20
191226070,5,0,4,6,2,17
191226071,4,2,1,9,0,16
191226072,2,0,5,3,3,13
191226073,2,7,2,2,3,16
191226074,6,9,4,3,5,27
191226075,3,2,2,5,2,14
191226076,1,6,9,1,5,22
191226077,6,9,3,1,3,22
191226078,8,1,7,1,2,19
191226079,6,9,3,8,3,29
191226080,0,1,0,3,1,5
191226081,8,7,8,2,6,31
191226082,0,7,8,1,3,19
191226083,2,3,2,1,9,17
191226084,4,0,7,6,0,17
191226085,2,2,9,6,2,21
191226086,0,7,5,0,4,16
191226087,7,3,4,9,2,25
191226088,0,2,2,6,3,13
191226089,9,3,2,0,5,19
191226090,4,4,2,7,7,24
191226091,2,1,7,7,1,18
191226092,8,0,9,5,5,27
191226093,4,5,5,9,2,25
191226094,9,2,0,8,2,21
191226095,9,2,6,6,3,26
191226096,4,0,4,5,1,14
191226097,0,9,5,0,1,15
191226098,3,9,7,0,3,22
191226099,6,2,1,2,4,15
191226100,7,9,7,8,4,35
191226101,0,1,1,4,4,10
191226102,0,9,7,9,0,25
191226103,9,6,2,0,4,21
191226104,0,7,4,4,0,15
191226105,4,2,3,3,9,21
191226106,5,0,5,5,2,17
191226107,1,0,4,7,5,17
191226108,4,2,7,8,8,29
191226109,0,9,5,5,8,27
191226110,5,6,5,7,3,26
191226111,4,0,3,3,9,19
191226112,1,0,9,4,0,14
191226113,6,9,1,0,7,23
191226114,5,4,6,7,1,23
191226115,6,3,2,7,8,26
191226116,7,8,1,5,3,24
191226117,3,6,5,6,0,20
191226118,4,4,4,1,8,21
191226119,2,7,9,4,3,25
191226120,6,1,7,1,5,20
191226121,4,9,2,8,4,27
191226122,3,0,2,8,1,14
191226123,3,3,0,7,4,17
191226124,9,9,7,9,4,38
191226125,3,8,8,0,7,26
191226126,4,3,2,0,7,16
191226127,8,2,7,2,6,25
191226128,5,0,4,4,1,14
191226129,0,8,1,3,4,16
191226130,8,3,5,1,2,19
191226131,9,6,4,7,1,27
191226132,7,7,2,4,0,20
191226133,4,7,6,2,5,24
191226134,8,2,1,4,1,16
191226135,8,6,0,5,9,28
191226136,5,0,6,1,7,19
191226137,0,6,7,1,9,23
191226138,7,7,6,0,9,29
191226139,5,2,6,6,5,24
191226140,8,5,9,5,5,32
191226141,3,6,4,3,8,24
191226142,5,1,1,2,5,14
191226143,8,6,3,4,2,23
191226144,9,2,8,4,5,28
191226145,0,1,2,1,0,4
191226146,4,6,3,7,5,25
191226147,3,4,2,2,5,16
191226148,0,3,6,8,3,20
191226149,7,5,8,8,0,28
191226150,9,8,2,7,4,30
191226151,1,8,1,1,6,17
191226152,7,7,1,3,2,20
191226153,3,3,4,6,7,23
191226154,9,2,1,2,6,20
191226155,1,4,9,3,7,24
191226156,9,3,5,8,2,27
191226157,5,0,3,5,7,20
191226158,1,9,6,5,7,28
191226159,8,1,7,0,8,24
191226160,3,4,4,6,2,19
191226161,0,3,7,0,1,11
191226162,7,4,0,0,8,19
191226163,3,4,2,1,9,19
191226164,9,9,4,2,0,24
191226165,3,9,9,7,3,31
191226166,2,4,8,6,0,20
191226167,0,8,4,8,4,24
191226168,5,7,6,5,1,24
191226169,9,2,2,4,6,23
191226170,2,3,9,8,6,28
191226171,2,5,9,3,3,22
191226172,6,7,1,3,1,18
191226173,4,2,1,7,8,22
191226174,5,8,3,8,0,24
191226175,4,8,2,4,1,19
191226176,2,7,6,4,1,20
191226177,4,0,9,0,8,21
191226178,5,9,5,9,5,33
191226179,9,5,4,1,2,21
191226180,0,6,4,1,9,20
191226181,6,0,2,1,6,15
191226182,3,3,5,7,8,26
191226183,1,3,2,5,9,20
191226184,8,7,7,2,2,26
191226185,9,7,9,7,8,40
191226186,1,3,5,4,6,19
191226187,6,7,8,9,9,39
191226188,7,1,9,7,4,28
191226189,9,6,4,7,6,32
191226190,0,4,3,2,8,17
191226191,3,4,5,1,5,18
191226192,5,8,9,3,2,27
191226193,6,0,1,4,9,20
191226194,6,6,4,9,1,26
191226195,2,8,1,2,0,13
191226196,6,9,4,6,3,28
191226197,5,5,8,2,0,20
191226198,8,4,3,8,1,24
191226199,7,3,7,6,6,29
191226200,2,0,0,5,0,7
191226201,3,6,4,2,4,19
191226202,7,8,2,7,9,33
191226203,7,5,3,3,3,21
191226204,6,5,9,9,4,33
191226205,1,5,9,6,2,23
191226206,8,9,0,8,6,31
191226207,2,4,2,7,7,22
191226208,2,4,2,0,6,14
191226209,8,4,5,1,9,27
191226210,4,2,5,6,7,24
191226211,1,0,9,2,4,16
191226212,1,7,3,6,1,18
191226213,5,2,8,6,7,28
191226214,0,3,7,0,9,19
191226215,8,1,6,2,9,26
191226216,1,6,5,9,8,29
191226217,1,6,5,1,6,19
191226218,8,9,4,6,0,27
191226219,7,3,7,4,0,21
191226220,7,0,5,6,4,22
191226221,3,8,1,9,4,25
191226222,5,6,7,1,8,27
191226223,1,2,4,5,8,20
191226224,6,2,3,9,3,23
191226225,9,0,5,1,0,15
191226226,5,4,5,0,2,16
191226227,7,9,4,3,3,26
191226228,8,0,4,7,1,20
191226229,5,1,7,1,0,14
191226230,9,4,9,1,3,26
191226231,7,1,0,2,8,18
191226232,9,0,7,1,4,21
191226233,5,0,6,0,1,12
191226234,4,1,8,1,5,19
191226235,0,6,4,0,2,12
191226236,5,7,3,0,4,19
191226237,1,6,0,3,4,14
191226238,0,0,7,1,1,9
191226239,0,6,9,0,2,17
191226240,0,4,2,1,0,7
191226241,1,7,0,6,9,23
191226242,7,8,2,0,3,20
191226243,9,6,5,8,7,35
191226244,2,9,8,6,0,25
191226245,8,6,6,9,7,36
191226246,2,2,3,0,2,9
191226247,9,3,0,5,8,25
191226248,7,2,6,2,2,19
191226249,5,2,6,0,1,14
191226250,8,8,4,6,4,30
191226251,0,2,9,4,4,19
191226252,7,6,3,7,1,24
191226253,4,6,4,0,2,16
191226254,6,0,9,7,7,29
191226255,1,7,6,7,4,25
191226256,9,6,0,2,4,21
191226257,3,9,6,8,9,35
191226258,2,2,6,4,4,18
191226259,4,4,4,4,4,20
191226260,5,5,2,3,3,18
191226261,1,6,3,1,4,15
191226262,6,6,4,5,7,28
191226263,7,7,3,5,4,26
191226264,9,7,8,6,1,31
191226265,7,9,1,6,2,25
191226266,5,7,6,3,3,24
191226267,1,5,4,5,2,17
191226268,7,6,8,0,7,28
191226269,0,3,1,1,4,9
191226270,0,0,2,8,3,13
191226271,5,3,6,7,5,26
191226272,6,8,4,1,2,21
191226273,0,9,8,4,5,26
191226274,9,2,5,5,8,29
191226275,0,8,2,0,4,14
191226276,5,1,0,4,4,14
191226277,5,3,9,2,6,25
191226278,8,0,3,4,3,18
191226279,0,2,3,5,8,18
191226280,1,7,2,2,2,14
191226281,3,9,2,9,1,24
191226282,2,0,8,0,7,17
191226283,6,1,9,2,9,27
191226284,5,0,7,6,2,20
191226285,0,2,3,8,6,19
191226286,7,9,2,7,0,25
191226287,3,0,6,9,9,27
191226288,1,4,5,1,5,16
191226289,3,3,0,9,2,17
191226290,2,2,8,1,7,20
191226291,5,8,8,3,6,30
191226292,1,6,4,3,6,20
191226293,4,2,2,8,0,16
191226294,2,5,7,4,0,18
191226295,3,4,5,4,8,24
191226296,3,4,7,7,2,23
191226297,4,7,0,2,3,16
191226298,9,2,8,3,0,22
191226299,7,2,4,5,5,23
191226300,5,1,2,2,9,19
191226301,7,2,6,4,0,19
191226302,7,9,9,2,6,33
191226303,5,7,2,9,9,32
191226304,5,8,8,0,1,22
191226305,7,0,8,4,6,25
191226306,8,5,2,0,6,21
191226307,5,1,6,8,1,21
191226308,7,4,6,4,6,27
191226309,3,3,1,1,1,9
191226310,4,9,9,4,4,30
191226311,1,1,0,5,4,11
191226312,7,7,0,5,9,28
191226313,7,6,2,6,9,30
191226314,7,2,1,1,4,15
191226315,4,1,6,0,4,15
191226316,7,1,1,8,9,26
191226317,2,7,2,4,2,17
191226318,3,1,4,6,2,16
191226319,6,0,7,5,7,25
191226320,1,7,8,8,3,27
191226321,6,3,0,4,0,13
191226322,4,0,8,1,3,16
191226323,1,7,1,9,3,21
191226324,8,5,4,1,1,19
191226325,9,3,8,1,3,24
191226326,4,7,9,1,1,22
191226327,4,0,8,7,7,26
191226328,7,8,6,6,4,31
191226329,6,1,6,0,6,19
191226330,1,3,9,9,2,24
191226331,1,1,6,7,8,23
191226332,1,9,1,6,8,25
191226333,8,6,3,4,6,27
191226334,5,4,7,4,6,26
191226335,7,7,2,0,9,25
191226336,2,3,4,0,0,9
191226337,3,8,6,1,4,22
191226338,7,8,1,4,2,22
191226339,8,0,4,5,2,19
191226340,4,3,3,4,5,19
191226341,6,8,9,7,1,31
191226342,0,1,4,6,2,13
191226343,5,6,5,2,1,19
191226344,3,2,4,4,4,17
191226345,8,5,0,6,2,21
191226346,6,3,8,5,2,24
191226347,7,6,9,2,3,27
191226348,6,7,4,9,0,26
191226349,6,6,0,5,6,23
191226350,5,9,7,6,6,33
191226351,9,4,8,2,8,31
191226352,5,3,0,1,6,15
191226353,8,1,1,3,6,19
191226354,8,9,5,9,0,31
191226355,5,0,4,5,6,20
191226356,7,8,8,2,2,27
191226357,3,4,1,0,1,9
191226358,5,6,1,6,4,22
191226359,2,0,2,6,0,10
191226360,5,4,6,0,4,19
191226361,1,4,6,9,0,20
191226362,1,6,9,9,7,32
191226363,7,8,7,0,0,22
191226364,5,1,1,0,7,14
191226365,9,4,3,3,5,24
191226366,6,6,1,6,8,27
191226367,0,1,8,2,8,19
191226368,1,8,7,0,1,17
191226369,1,7,7,5,2,22
191226370,3,5,6,9,5,28
191226371,5,3,6,5,6,25
191226372,3,9,8,8,8,36
191226373,3,7,8,4,9,31
191226374,9,7,2,9,4,31
191226375,8,5,9,8,4,34
191226376,2,8,7,3,4,24
191226377,0,2,0,3,1,6
191226378,3,7,4,6,7,27
191226379,6,0,1,0,1,8
191226380,2,2,2,9,5,20
191226381,5,3,0,4,1,13
191226382,8,6,2,0,0,16
191226383,6,3,8,1,3,21
191226384,7,3,4,4,8,26
191226385,2,4,2,5,6,19
191226386,1,2,7,6,6,22
191226387,1,9,3,0,3,16
191226388,1,5,6,7,1,20
191226389,2,5,8,0,8,23
191226390,6,4,0,8,7,25
191226391,8,2,3,7,9,29
191226392,1,3,4,1,5,14
191226393,5,8,2,0,7,22
191226394,8,2,7,2,9,28
191226395,1,3,5,2,0,11
191226396,3,6,0,1,3,13
191226397,7,3,6,3,0,19
191226398,9,0,6,1,9,25
191226399,6,0,7,1,9,23
191226400,9,4,5,9,2,29
191226401,0,0,2,9,9,20
191226402,6,1,8,0,2,17
191226403,3,2,2,9,5,21
191226404,2,4,3,8,1,18
191226405,4,4,6,3,7,24
191226406,5,2,7,1,9,24
191226407,9,5,8,4,8,34
191226408,6,0,7,6,1,20
191226409,9,6,8,0,2,25
191226410,8,8,1,0,2,19
191226411,7,6,6,5,5,29
191226412,6,0,7,1,8,22
191226413,4,2,1,3,1,11
191226414,7,3,9,8,4,31
191226415,8,5,6,5,2,26
191226416,5,3,1,6,9,24
191226417,7,2,3,9,1,22
191226418,5,7,7,5,2,26
191226419,9,5,2,4,9,29
191226420,2,7,6,3,2,20
191226421,8,1,8,3,8,28
191226422,6,9,2,3,7,27
191226423,4,2,3,9,9,27
191226424,1,0,2,8,7,18
191226425,6,6,1,8,5,26
191226426,8,3,6,5,8,30
191226427,2,8,1,2,5,18
191226428,6,7,2,7,0,22
191226429,7,7,2,9,6,31
191226430,5,4,9,4,0,22
191226431,5,0,8,0,2,15
191226432,3,9,3,0,0,15
191226433,9,3,4,4,0,20
191226434,3,2,9,8,7,29
191226435,0,6,1,3,0,10
191226436,9,4,4,7,4,28
191226437,3,7,7,1,6,24
191226438,0,8,1,7,7,23
191226439,6,1,9,7,2,25
191226440,9,1,5,9,9,33
191226441,4,6,8,1,6,25
191226442,1,6,0,1,1,9
191226443,7,3,2,0,3,15
191226444,4,7,9,3,5,28
191226445,7,3,4,0,9,23
191226446,2,3,4,1,6,16
191226447,6,0,3,7,5,21
191226448,2,3,8,7,0,20
191226449,3,9,2,4,1,19
191226450,4,8,4,6,9,31
191226451,0,6,1,5,7,19
191226452,2,4,3,6,1,16
191226453,8,9,0,9,3,29
191226454,0,3,2,2,0,7
191226455,8,3,5,0,6,22
191226456,5,0,3,1,6,15
191226457,7,0,8,7,4,26
191226458,2,0,2,6,7,17
191226459,0,6,7,7,0,20
191226460,7,2,1,5,9,24
191226461,9,1,7,9,4,30
191226462,2,0,4,8,3,17
191226463,2,6,4,7,4,23
191226464,3,0,9,0,0,12
191226465,7,4,3,0,5,19
191226466,4,2,5,3,5,19
191226467,9,0,9,2,8,28
191226468,5,5,4,3,9,26
191226469,6,7,1,3,2,19
191226470,0,7,9,5,5,26
191226471,2,9,9,7,4,31
191226472,5,2,8,5,8,28
191226473,6,6,7,9,5,33
191226474,4,5,7,6,0,22
191226475,9,5,1,2,7,24
191226476,5,5,9,1,6,26
191226477,2,1,5,3,3,14
191226478,5,7,7,0,4,23
191226479,4,6,5,9,8,32
191226480,0,8,1,0,8,17
191226481,7,4,6,5,3,25
191226482,9,0,5,9,4,27
191226483,1,8,5,2,1,17
191226484,3,5,4,4,4,20
191226485,2,2,1,7,1,13
191226486,2,6,1,3,8,20
191226487,6,8,2,4,5,25
191226488,7,9,1,0,2,19
191226489,4,3,6,8,5,26
191226490,3,7,1,7,6,24
191226491,1,7,4,3,1,16
191226492,0,3,2,8,1,14
191226493,8,7,1,4,2,22
191226494,0,6,2,7,6,21
191226495,1,9,9,2,4,25
191226496,6,6,2,5,5,24
191226497,1,1,0,8,1,11
191226498,5,4,5,7,4,25
191226499,0,1,3,7,5,16
191226500,1,0,7,0,0,8
191226501,0,6,6,4,4,20
191226502,0,2,7,3,6,18
191226503,4,0,7,0,9,20
191226504,9,9,3,3,4,28
191226505,1,1,7,3,2,14
191226506,5,4,6,0,1,16
191226507,0,1,4,0,3,8
191226508,8,1,7,1,7,24
191226509,6,7,5,4,1,23
191226510,3,4,9,2,7,25
191226511,6,8,4,5,7,30
191226512,0,4,9,7,9,29
191226513,2,5,0,3,1,11
191226514,6,2,7,2,6,23
191226515,3,5,2,8,7,25
191226516,3,7,4,5,6,25
191226517,8,9,9,2,4,32
191226518,8,6,5,3,1,23
191226519,2,3,6,7,0,18
191226520,1,8,4,0,6,19
191226521,5,6,1,3,3,18
191226522,3,7,9,4,4,27
191226523,6,9,9,8,5,37
191226524,3,2,3,1,1,10
191226525,3,8,5,4,0,20
191226526,5,2,0,5,2,14
191226527,3,8,5,1,4,21
191226528,3,1,4,9,0,17
191226529,2,7,9,0,8,26
191226530,3,3,5,3,2,16
191226531,9,3,2,5,8,27
191226532,8,9,2,3,0,22
191226533,9,4,1,0,0,14
191226534,6,4,8,2,6,26
191226535,3,7,2,5,0,17
191226536,6,4,3,4,5,22
191226537,4,1,7,2,9,23
191226538,2,5,8,9,4,28
191226539,8,6,6,1,6,27
191226540,8,6,9,3,2,28
191226541,8,7,5,9,2,31
191226542,0,8,5,2,2,17
191226543,1,1,9,8,1,20
191226544,2,2,8,4,6,22
191226545,1,7,3,8,7,26
191226546,6,3,2,2,5,18
191226547,9,7,6,3,5,30
191226548,9,6,2,8,1,26
191226549,5,8,2,2,3,20
191226550,9,1,1,6,7,24
191226551,4,9,7,5,3,28
191226552,4,9,0,8,9,30
191226553,7,0,6,5,2,20
191226554,0,4,4,4,5,17
191226555,1,3,3,0,6,13
191226556,4,9,7,8,4,32
191226557,6,1,6,5,2,20
191226558,3,1,0,3,3,10
191226559,1,0,4,2,9,16
191226560,9,0,5,8,2,24
191226561,1,3,5,3,3,15
191226562,9,9,3,3,1,25
191226563,2,4,2,5,7,20
191226564,4,6,3,0,0,13
191226565,5,1,3,4,0,13
191226566,3,2,9,6,4,24
191226567,1,4,6,9,7,27
191226568,5,1,6,4,0,16
191226569,9,3,9,3,7,31
191226570,6,0,9,6,5,26
191226571,4,5,6,2,9,26
191226572,6,5,6,9,9,35
191226573,8,4,0,6,7,25
191226574,1,7,1,2,3,14
191226575,5,7,7,1,4,24
191226576,3,0,1,2,4,10
191226577,2,9,6,4,4,25
191226578,4,1,6,2,7,20
191226579,7,3,7,6,4,27
191226580,8,6,3,6,3,26
191226581,8,4,3,8,5,28
191226582,2,4,0,4,9,19
191226583,8,3,7,8,8,34
191226584,1,5,0,3,4,13
191226585,8,2,9,0,0,19
191226586,5,0,5,6,7,23
191226587,5,1,4,8,4,22
191226588,7,8,1,9,7,32
191226589,8,7,9,3,5,32
191226590,7,2,3,6,4,22
191226591,9,7,4,5,9,34
191226592,1,1,5,9,9,25
191226593,8,3,2,1,3,17
191226594,6,0,8,9,8,31
191226595,9,2,4,4,7,26
191226596,9,2,1,0,4,16
191226597,4,7,1,0,5,17
191226598,5,5,2,6,4,22
191226599,2,5,5,0,4,16
191226600,5,4,4,5,9,27
191226601,9,3,3,8,8,31
191226602,9,7,5,5,8,34
191226603,3,5,0,3,9,20
191226604,0,5,3,1,6,15
191226605,4,4,0,8,6,22
191226606,0,4,7,9,7,27
191226607,0,5,2,9,4,20
191226608,0,8,7,5,0,20
191226609,5,4,2,8,1,20
191226610,0,5,8,2,9,24
191226611,2,6,9,8,8,33
191226612,7,2,9,7,8,33
191226613,0,1,0,1,0,2
191226614,0,4,6,0,4,14
191226615,4,1,8,3,1,17
191226616,0,9,2,5,2,18
191226617,4,2,0,7,3,16
191226618,2,0,9,5,4,20
191226619,5,3,6,7,7,28
191226620,0,7,0,2,3,12
191226621,9,8,4,4,5,30
191226622,6,1,9,8,5,29
191226623,0,2,8,6,7,23
191226624,6,9,9,9,6,39
191226625,8,6,7,9,9,39
191226626,5,8,5,1,0,19
191226627,1,9,9,4,7,30
191226628,0,2,7,8,7,24
191226629,6,3,9,5,1,24
191226630,7,6,3,7,3,26
191226631,2,4,8,0,1,15
191226632,3,1,0,9,9,22
191226633,1,0,5,4,3,13
191226634,3,9,7,9,0,28
191226635,6,9,1,4,9,29
191226636,2,0,5,6,9,22
191226637,7,6,6,4,6,29
191226638,1,0,1,7,2,11
191226639,7,8,3,7,4,29
191226640,0,8,0,0,1,9
191226641,0,3,0,0,3,6
191226642,0,8,3,6,8,25
191226643,5,9,2,6,4,26
191226644,0,7,5,7,5,24
191226645,7,2,0,2,7,18
191226646,0,3,4,4,3,14
191226647,3,6,3,5,5,22
191226648,1,7,6,6,0,20
191226649,1,5,4,8,7,25
191226650,0,9,2,4,8,23
191226651,3,7,2,5,9,26
191226652,8,8,8,5,1,30
191226653,6,8,2,3,9,28
191226654,3,6,0,2,5,16
191226655,2,1,4,2,6,15
191226656,0,7,1,0,4,12
191226657,1,2,7,9,3,22
191226658,4,9,3,0,0,16
191226659,8,4,8,3,3,26
191226660,2,2,9,7,8,28
191226661,3,7,5,5,2,22
191226662,4,2,4,8,4,22
191226663,0,8,0,0,5,13
191226664,1,8,1,2,9,21
191226665,8,7,8,4,4,31
191226666,1,6,0,9,7,23
191226667,6,5,8,5,8,32
191226668,9,1,5,1,6,22
191226669,7,1,9,7,7,31
191226670,4,8,1,2,2,17
191226671,6,0,5,1,9,21
191226672,6,4,1,9,2,22
191226673,6,5,2,0,9,22
191226674,6,4,6,5,7,28
191226675,9,7,5,8,6,35
191226676,0,6,1,8,0,15
191226677,5,4,9,9,6,33
191226678,3,9,5,2,2,21
191226679,8,5,8,7,7,35
191226680,9,1,8,4,7,29
191226681,4,4,1,4,7,20
191226682,5,8,2,1,7,23
191226683,2,8,8,0,5,23
191226684,4,2,3,5,2,16
191226685,4,9,6,2,0,21
191226686,0,6,8,0,5,19
191226687,7,1,9,8,3,28
191226688,6,2,3,9,2,22
191226689,4,9,3,4,3,23
191226690,0,2,5,5,9,21
191226691,9,2,4,0,6,21
191226692,8,4,4,2,2,20
191226693,0,3,8,5,2,18
191226694,3,0,5,8,0,16
191226695,3,6,3,4,5,21
191226696,9,3,3,2,7,24
191226697,4,5,9,0,0,18
191226698,0,3,8,7,7,25
191226699,8,6,6,7,8,35
191226700,1,9,3,1,2,16
191226701,2,9,5,9,0,25
191226702,8,6,7,7,6,34
191226703,5,8,5,9,3,30
191226704,6,7,9,0,7,29
191226705,4,4,1,5,1,15
191226706,5,9,6,0,9,29
191226707,7,2,6,9,4,28
191226708,7,9,0,2,9,27
191226709,3,2,3,7,4,19
191226710,3,4,9,8,7,31
191226711,2,4,9,8,5,28
191226712,6,8,6,2,1,23
191226713,9,3,2,3,4,21
191226714,6,9,7,9,2,33
191226715,1,9,6,6,0,22
191226716,8,9,3,0,1,21
191226717,1,4,1,1,4,11
191226718,4,9,4,5,1,23
191226719,2,1,0,8,9,20
191226720,4,4,0,2,1,11
191226721,1,1,8,4,5,19
191226722,6,1,8,3,3,21
191226723,1,2,6,3,4,16
191226724,2,4,9,4,2,21
191226725,1,8,8,0,0,17
191226726,4,8,6,3,5,26
191226727,4,4,4,1,4,17
191226728,3,3,8,9,9,32
191226729,7,1,6,6,1,21
191226730,8,5,5,7,6,31
191226731,2,3,2,2,6,15
191226732,8,2,5,3,0,18
191226733,1,0,6,9,0,16
191226734,5,9,3,2,6,25
191226735,3,3,7,0,4,17
191226736,9,5,0,0,0,14
191226737,6,6,3,6,0,21
191226738,2,0,1,9,3,15
191226739,1,5,8,4,0,18
191226740,4,4,6,1,4,19
191226741,6,0,7,4,1,18
191226742,9,9,5,0,8,31
191226743,0,9,2,7,1,19
191226744,2,3,5,6,9,25
191226745,1,0,1,2,6,10
191226746,4,8,3,0,4,19
191226747,3,8,3,2,0,16
191226748,3,0,2,0,6,11
191226749,0,2,4,9,3,18
191226750,8,1,2,7,1,19
191226751,8,8,1,7,3,27
191226752,7,3,9,8,1,28
191226753,4,8,4,2,9,27
191226754,7,4,7,4,7,29
191226755,5,9,8,8,5,35
191226756,4,2,8,9,3,26
191226757,8,0,5,7,4,24
191226758,9,3,6,1,7,26
191226759,6,2,0,7,0,15
191226760,9,7,6,3,7,32
191226761,4,6,1,7,2,20
191226762,7,5,4,3,7,26
191226763,1,8,1,3,0,13
191226764,6,0,8,8,5,27
191226765,0,0,6,2,5,13
191226766,8,7,3,8,2,28
191226767,7,3,3,8,1,22
191226768,0,3,1,2,9,15
191226769,8,2,7,4,8,29
191226770,3,8,2,5,3,21
191226771,7,9,4,8,6,34
191226772,3,0,2,2,4,11
191226773,9,4,0,7,9,29
191226774,0,6,1,7,6,20
191226775,7,2,0,4,0,13
191226776,0,5,0,6,1,12
191226777,1,7,2,2,5,17
191226778,2,7,9,6,5,29
191226779,4,9,4,3,5,25
191226780,3,2,7,5,7,24
191226781,6,4,2,9,2,23
191226782,2,4,6,4,6,22
191226783,7,2,3,8,8,28
191226784,1,7,3,9,8,28
191226785,9,8,5,9,1,32
191226786,5,2,7,7,1,22
191226787,5,2,7,4,5,23
191226788,4,1,4,7,2,18
191226789,5,7,4,5,1,22
191226790,0,1,4,8,6,19
191226791,3,3,0,1,4,11
191226792,5,3,8,6,6,28
191226793,1,8,7,8,2,26
191226794,3,5,3,2,4,17
191226795,4,4,2,5,3,18
191226796,5,2,6,6,8,27
191226797,1,4,6,4,5,20
191226798,5,5,7,1,4,22
191226799,5,8,1,3,5,22
191226800,9,5,1,1,4,20
191226801,1,5,5,6,0,17
191226802,4,3,0,5,5,17
191226803,9,8,7,0,7,31
191226804,7,4,3,9,5,28
191226805,4,3,4,6,9,26
191226806,9,7,6,7,0,29
191226807,9,7,7,6,0,29
191226808,9,0,1,4,1,15
191226809,2,5,2,2,9,20
191226810,3,3,6,9,4,25
191226811,2,0,2,3,9,16
191226812,9,5,3,3,2,22
191226813,2,6,5,7,7,27
191226814,5,5,0,4,6,20
191226815,7,9,8,4,2,30
191226816,6,0,8,7,4,25
191226817,5,2,3,6,4,20
191226818,6,2,5,8,5,26
191226819,3,4,0,2,8,17
191226820,2,7,6,7,1,23
191226821,6,9,5,9,0,29
191226822,1,0,1,9,6,17
191226823,4,3,1,9,1,18
191226824,1,7,0,1,8,17
191226825,7,6,8,9,7,37
191226826,8,5,3,3,1,20
191226827,4,6,9,3,3,25
191226828,1,7,9,6,7,30
191226829,4,8,1,8,7,28
191226830,3,1,0,4,2,10
191226831,7,6,7,0,6,26
191226832,3,9,0,6,9,27
191226833,4,9,1,8,5,27
191226834,5,6,3,8,8,30
191226835,8,2,2,1,7,20
191226836,5,4,6,3,2,20
191226837,9,0,0,1,2,12
191226838,4,7,3,5,6,25
191226839,4,1,2,7,3,17
191226840,7,0,4,7,3,21
191226841,8,7,2,2,5,24
191226842,4,4,0,0,0,8
191226843,1,6,0,9,3,19
191226844,5,6,6,6,5,28
191226845,1,5,0,8,0,14
191226846,8,8,6,2,2,26
191226847,1,2,6,2,9,20
191226848,0,0,0,2,5,7
191226849,5,2,9,5,3,24
191226850,3,7,4,2,1,17
191226851,7,6,5,7,9,34
191226852,8,9,3,4,9,33
191226853,8,4,2,9,3,26
191226854,8,0,0,4,6,18
191226855,3,6,8,6,3,26
191226856,9,5,4,8,0,26
191226857,2,1,1,2,8,14
191226858,3,4,5,5,5,22
191226859,1,7,0,0,7,15
191226860,1,0,0,2,2,5
191226861,2,3,4,3,9,21
191226862,1,1,0,8,8,18
191226863,6,6,5,0,1,18
191226864,8,7,2,1,9,27
191226865,9,7,8,6,7,37
191226866,9,5,0,1,3,18
191226867,3,5,7,4,3,22
191226868,5,2,4,8,3,22
191226869,5,2,8,3,2,20
191226870,1,4,6,6,1,18
191226871,1,1,0,7,9,18
191226872,2,3,0,6,8,19
191226873,1,0,8,2,4,15
191226874,7,7,8,5,1,28
191226875,0,4,3,0,5,12
191226876,5,1,7,4,7,24
191226877,1,9,5,0,7,22
191226878,7,7,8,4,5,31
191226879,0,5,9,4,7,25
191226880,1,8,8,4,2,23
191226881,8,1,2,5,0,16
191226882,1,1,7,9,7,25
191226883,8,5,3,3,3,22
191226884,8,6,3,8,2,27
191226885,8,5,9,2,0,24
191226886,8,1,2,3,7,21
191226887,9,7,5,0,8,29
191226888,0,3,0,8,1,12
191226889,7,1,9,5,8,30
191226890,7,0,6,0,5,18
191226891,0,7,5,4,7,23
191226892,0,4,7,2,2,15
191226893,9,9,0,5,2,25
191226894,7,9,3,8,8,35
191226895,4,5,7,7,1,24
191226896,3,0,9,0,1,13
191226897,4,0,0,5,7,16
191226898,0,2,4,8,1,15
191226899,5,3,6,6,5,25
191226900,6,6,2,4,7,25
191226901,6,1,1,5,7,20
191226902,6,4,2,0,3,15
191226903,4,0,2,6,5,17
191226904,8,5,0,3,8,24
191226905,4,7,7,2,7,27
191226906,0,6,3,8,7,24
191226907,5,6,5,6,0,22
191226908,1,3,9,8,1,22
191226909,4,2,1,6,6,19
191226910,8,2,2,7,6,25
191226911,9,0,5,7,5,26
191226912,5,1,3,2,4,15
191226913,0,4,3,0,8,15
191226914,4,4,8,5,0,21
191226915,1,7,9,7,5,29
191226916,9,8,6,3,5,31
191226917,6,6,8,6,8,34
191226918,9,0,7,7,4,27
191226919,2,9,5,4,8,28
191226920,6,0,4,9,6,25
191226921,4,8,1,4,7,24
191226922,5,1,8,7,6,27
191226923,1,7,5,3,5,21
191226924,8,1,3,8,8,28
191226925,4,4,3,6,1,18
191226926,6,7,0,6,1,20
191226927,5,3,0,4,2,14
191226928,8,4,4,6,5,27
191226929,5,5,0,4,8,22
191226930,0,2,2,3,8,15
191226931,5,6,0,7,6,24
191226932,0,9,3,3,2,17
191226933,2,4,1,7,8,22
191226934,3,4,3,1,6,17
191226935,2,7,0,2,0,11
191226936,2,7,0,5,5,19
191226937,3,1,7,0,0,11
191226938,3,3,4,3,2,15
191226939,1,6,9,1,7,24
191226940,3,6,9,0,5,23
191226941,2,5,1,1,4,13
191226942,5,3,7,7,9,31
191226943,8,3,4,4,9,28
191226944,1,7,7,7,6,28
191226945,0,1,6,2,3,12
191226946,3,2,6,0,9,20
191226947,4,2,4,6,0,16
191226948,0,6,2,3,7,18
191226949,5,1,5,6,1,18
191226950,6,0,2,8,8,24
191226951,4,8,6,5,1,24
191226952,7,1,2,4,3,17
191226953,5,4,9,7,0,25
191226954,8,5,3,2,3,21
191226955,0,4,3,8,8,23
191226956,2,0,8,9,9,28
191226957,5,9,8,8,1,31
191226958,6,7,7,3,9,32
191226959,8,7,6,0,0,21
191226960,1,5,9,1,8,24
191226961,9,4,4,0,2,19
191226962,5,1,2,6,2,16
191226963,1,5,5,2,7,20
191226964,6,9,2,9,4,30
191226965,6,2,8,2,0,18
191226966,4,5,2,7,9,27
191226967,6,4,6,5,6,27
191226968,2,6,1,1,8,18
191226969,9,8,1,2,6,26
191226970,4,9,8,5,7,33
191226971,7,5,6,4,2,24
191226972,8,7,2,9,4,30
191226973,1,7,9,5,2,24
191226974,0,2,1,2,8,13
191226975,0,4,0,8,9,21
191226976,9,6,4,3,8,30
191226977,4,8,1,9,4,26
191226978,1,3,0,8,0,12
191226979,3,0,4,0,7,14
191226980,1,7,8,9,0,25
191226981,0,1,7,6,2,16
191226982,8,8,6,1,9,32
191226983,0,6,7,7,8,28
191226984,7,7,7,6,8,35
191226985,0,6,4,2,2,14
191226986,5,8,6,1,1,21
191226987,6,0,1,8,9,24
191226988,8,1,1,6,3,19
191226989,0,8,1,2,3,14
191226990,8,1,8,4,5,26
191226991,0,0,4,6,1,11
191226992,4,6,4,1,5,20
191226993,1,8,1,5,3,18
191226994,3,1,4,5,2,15
191226995,8,4,0,9,8,29
191226996,6,3,5,9,8,31
191226997,7,1,0,0,4,12
191226998,7,7,4,1,7,26
191226999,0,4,5,8,5,22
1912261000,4,4,8,8,2,26
1912261001,9,0,4,8,7,28
1912261002,7,4,0,6,8,25
1912261003,0,6,8,5,0,19
1912261004,0,4,0,3,9,16
1912261005,6,7,0,9,9,31
1912261006,4,3,6,0,0,13
1912261007,1,7,3,3,6,20
1912261008,7,1,1,0,7,16
1912261009,1,9,5,3,1,19
1912261010,3,9,0,4,3,19
1912261011,2,4,0,9,7,22
1912261012,8,0,7,3,9,27
1912261013,2,9,4,3,2,20
1912261014,5,6,6,9,1,27
1912261015,6,7,1,6,1,21
1912261016,6,2,6,6,1,21
1912261017,6,5,1,4,0,16
1912261018,8,9,1,9,6,33
1912261019,2,1,9,8,5,25
1912261020,4,3,2,6,0,15
1912261021,9,9,6,1,8,33
1912261022,0,5,0,7,2,14
1912261023,1,7,2,5,2,17
1912261024,1,8,1,9,3,22
1912261025,2,1,7,3,8,21
1912261026,5,5,7,8,5,30
1912261027,7,1,1,2,4,15
1912261028,9,3,2,7,4,25
1912261029,7,7,1,4,0,19
1912261030,2,8,9,0,8,27
1912261031,3,1,2,0,1,7
1912261032,5,9,0,9,6,29
1912261033,4,8,6,4,1,23
1912261034,1,4,1,7,2,15
1912261035,4,2,9,4,2,21
1912261036,6,6,3,3,5,23
1912261037,9,8,6,3,3,29
1912261038,1,6,3,5,8,23
1912261039,9,6,8,5,2,30
1912261040,2,9,8,9,9,37
1912261041,3,6,9,1,4,23
1912261042,6,2,4,8,7,27
1912261043,2,6,0,5,3,16
1912261044,7,1,4,7,5,24
1912261045,2,3,3,1,6,15
1912261046,9,6,1,4,3,23
1912261047,0,5,5,9,6,25
1912261048,3,5,8,0,8,24
1912261049,2,4,7,9,6,28
1912261050,9,6,2,5,1,23
1912261051,0,2,2,6,9,19
1912261052,8,9,5,8,3,33
1912261053,3,4,0,5,4,16
1912261054,4,5,5,7,2,23
1912261055,1,7,5,3,2,18
1912261056,4,3,6,4,2,19
1912261057,7,9,2,2,3,23
1912261058,2,4,0,3,7,16
1912261059,8,9,3,4,3,27
1912261060,0,0,0,7,0,7
1912261061,5,5,2,6,5,23
1912261062,5,2,9,5,8,29
1912261063,0,0,2,8,1,11
1912261064,8,9,3,4,7,31
1912261065,2,9,4,4,5,24
1912261066,2,9,3,3,7,24
1912261067,6,0,6,5,9,26
1912261068,5,4,9,0,1,19
1912261069,7,7,4,0,3,21
1912261070,7,5,3,6,6,27
1912261071,1,5,8,8,6,28
1912261072,5,3,7,3,7,25
1912261073,5,8,0,4,0,17
1912261074,4,9,7,4,1,25
1912261075,3,4,4,9,8,28
1912261076,8,7,4,8,1,28
1912261077,4,3,5,6,1,19
1912261078,5,6,7,8,5,31
1912261079,8,3,7,9,7,34
1912261080,5,4,2,7,7,25
1912261081,4,4,4,9,3,24
1912261082,2,3,8,1,5,19
1912261083,3,4,6,1,5,19
1912261084,3,1,5,1,4,14
1912261085,9,4,4,3,3,23
1912261086,7,8,6,0,3,24
1912261087,2,6,5,9,9,31
1912261088,1,1,7,8,0,17
1912261089,7,7,1,5,6,26
1912261090,4,2,5,4,7,22
1912261091,3,4,3,2,4,16
1912261092,7,1,5,2,4,19
1912261093,7,8,8,6,5,34
1912261094,8,1,2,4,5,20
1912261095,9,9,9,4,3,34
1912261096,7,6,0,2,8,23
1912261097,3,5,3,4,7,22
1912261098,2,7,5,4,5,23
1912261099,4,2,7,6,2,21
1912261100,6,2,6,0,1,15
1912261101,0,9,6,2,7,24
1912261102,5,3,8,8,2,26
1912261103,7,6,9,2,1,25
1912261104,1,1,8,7,9,26
1912261105,2,7,2,5,7,23
191227001,3,1,8,2,0,14
191227002,3,2,9,0,8,22
191227003,2,9,5,0,2,18
191227004,9,3,7,3,3,25
191227005,0,3,1,1,7,12
191227006,7,3,5,1,0,16
191227007,7,7,5,9,7,35
191227008,7,6,3,8,3,27
191227009,5,6,0,5,0,16
191227010,8,6,7,7,9,37
191227011,6,5,3,5,1,20
191227012,3,2,3,5,9,22
191227013,8,7,6,6,8,35
191227014,9,1,0,4,8,22
191227015,3,2,4,1,8,18
191227016,9,8,0,8,1,26
191227017,8,8,4,7,9,36
191227018,9,3,5,9,3,29
191227019,9,5,2,4,3,23
191227020,0,5,3,6,3,17
191227021,7,9,6,4,4,30
191227022,3,8,1,3,9,24
191227023,9,8,6,4,2,29
191227024,7,6,8,4,7,32
191227025,9,7,8,0,8,32
191227026,8,6,4,5,5,28
191227027,7,4,7,6,3,27
191227028,9,2,3,8,0,22
191227029,1,3,1,8,0,13
191227030,7,2,0,7,0,16
191227031,6,1,4,7,2,20
191227032,6,5,2,1,3,17
191227033,8,9,8,1,0,26
191227034,9,0,4,7,8,28
191227035,8,8,1,1,7,25
191227036,5,3,4,2,9,23
191227037,3,3,6,5,6,23
191227038,9,6,7,7,6,35
191227039,6,3,7,1,5,22
191227040,2,0,4,2,5,13
191227041,6,0,2,5,7,20
191227042,8,9,6,6,6,35
191227043,2,1,3,7,0,13
191227044,2,1,0,7,2,12
191227045,8,1,4,4,9,26
191227046,3,6,3,2,8,22
191227047,8,7,4,6,8,33
191227048,3,6,3,0,2,14
191227049,5,7,2,8,9,31
191227050,0,3,6,2,6,17
191227051,1,8,0,7,9,25
191227052,0,2,9,1,9,21
191227053,2,0,4,3,4,13
191227054,1,7,4,4,7,23
191227055,5,9,3,4,0,21
191227056,3,3,1,8,2,17
191227057,3,8,0,9,4,24
191227058,2,9,6,6,6,29
191227059,0,7,0,0,2,9
191227060,6,7,0,6,9,28
191227061,8,7,1,1,0,17
191227062,9,3,3,6,5,26
191227063,4,3,2,4,5,18
191227064,0,1,7,8,9,25
191227065,3,0,9,3,8,23
191227066,5,7,3,3,4,22
191227067,4,8,4,3,3,22
191227068,5,1,4,6,0,16
191227069,0,8,8,9,7,32
191227070,9,2,7,1,1,20
191227071,4,6,0,7,5,22
191227072,5,4,3,3,8,23
191227073,5,6,6,0,3,20
191227074,9,7,3,4,4,27
191227075,4,5,6,1,2,18
191227076,6,2,2,2,1,13
191227077,3,9,1,2,0,15
191227078,9,7,8,5,1,30
191227079,7,6,1,6,5,25
191227080,9,2,8,9,8,36
191227081,3,1,1,0,7,12
191227082,8,5,9,6,9,37
191227083,1,6,4,6,7,24
191227084,4,7,1,1,7,20
191227085,2,4,6,7,7,26
191227086,6,4,7,8,6,31
191227087,7,6,7,4,8,32
191227088,9,9,1,2,9,30
191227089,5,3,2,4,3,17
191227090,4,2,0,5,8,19
191227091,5,2,6,1,6,20
191227092,4,5,2,5,4,20
191227093,7,8,3,0,1,19
191227094,7,1,0,3,1,12
191227095,7,5,2,7,9,30
191227096,2,1,9,2,5,19
191227097,2,1,4,6,8,21
191227098,0,3,6,2,7,18
191227099,0,3,0,6,4,13
191227100,7,2,6,6,3,24
191227101,0,0,8,1,9,18
191227102,0,5,9,8,6,28
191227103,0,9,9,7,4,29
191227104,5,3,7,8,2,25
191227105,0,5,9,5,9,28
191227106,8,6,9,9,3,35
191227107,3,0,4,0,6,13
191227108,4,0,6,9,0,19
191227109,6,8,3,9,7,33
191227110,8,7,2,0,5,22
191227111,4,5,4,6,0,19
191227112,2,1,1,2,3,9
191227113,4,0,1,9,5,19
191227114,6,9,8,6,8,37
191227115,9,4,8,7,7,35
191227116,7,1,3,8,2,21
191227117,6,0,9,3,4,22
191227118,8,0,4,0,8,20
191227119,3,6,8,3,0,20
191227120,6,0,7,7,2,22
191227121,1,7,5,6,3,22
191227122,5,2,3,8,0,18
191227123,7,8,8,9,6,38
191227124,4,7,5,4,6,26
191227125,7,5,0,5,1,18
191227126,0,4,6,0,0,10
191227127,8,4,6,9,7,34
191227128,6,8,2,2,4,22
191227129,9,4,8,7,9,37
191227130,9,2,6,6,6,29
191227131,6,4,4,5,1,20
191227132,3,4,0,4,8,19
191227133,8,4,1,6,9,28
191227134,1,1,9,5,4,20
191227135,7,0,5,8,5,25
191227136,2,3,1,5,3,14
191227137,7,9,5,2,1,24
191227138,5,8,6,2,2,23
191227139,5,9,9,4,3,30
191227140,0,7,4,0,1,12
191227141,1,3,1,1,5,11
191227142,7,2,8,7,2,26
191227143,2,5,2,3,6,18
191227144,4,8,9,5,1,27
191227145,1,8,2,3,1,15
191227146,5,8,2,3,8,26
191227147,5,0,9,6,8,28
191227148,0,7,7,0,5,19
191227149,2,2,2,2,1,9
191227150,5,9,2,2,3,21
191227151,1,2,7,9,2,21
191227152,0,6,6,4,6,22
191227153,9,7,1,0,2,19
191227154,7,6,9,4,8,34
191227155,5,5,6,3,9,28
191227156,5,0,4,2,5,16
191227157,3,7,5,7,7,29
191227158,0,9,9,5,7,30
191227159,9,0,9,0,7,25
191227160,0,6,1,1,5,13
191227161,5,5,2,8,2,22
191227162,5,7,1,4,7,24
191227163,4,8,8,6,6,32
191227164,8,9,4,5,3,29
191227165,8,5,4,2,3,22
191227166,4,2,8,7,6,27
191227167,3,7,7,0,7,24
191227168,3,3,3,2,5,16
191227169,3,4,9,9,0,25
191227170,3,9,4,4,6,26
191227171,7,1,9,8,8,33
191227172,4,9,9,4,9,35
191227173,4,7,0,8,7,26
191227174,1,9,8,3,1,22
191227175,1,1,3,2,2,9
191227176,4,3,7,9,9,32
191227177,7,0,7,7,0,21
191227178,7,4,9,3,5,28
191227179,6,7,9,4,1,27
191227180,6,2,9,7,0,24
191227181,1,7,9,8,5,30
191227182,0,0,3,3,8,14
191227183,6,6,8,5,7,32
191227184,5,0,1,2,8,16
191227185,8,7,9,8,5,37
191227186,9,9,1,7,1,27
191227187,0,9,6,7,6,28
191227188,6,2,3,5,6,22
191227189,9,4,7,4,2,26
191227190,5,5,0,1,0,11
191227191,0,5,9,2,3,19
191227192,0,6,4,7,1,18
191227193,1,1,8,4,0,14
191227194,8,4,8,5,6,31
191227195,8,1,2,6,7,24
191227196,8,4,3,7,9,31
191227197,8,0,9,7,5,29
191227198,0,3,5,0,3,11
191227199,1,1,6,1,6,15
191227200,8,6,2,8,3,27
191227201,7,3,6,3,9,28
191227202,7,0,0,2,9,18
191227203,8,7,4,2,5,26
191227204,8,3,5,1,1,18
191227205,7,1,9,4,8,29
191227206,4,5,1,7,8,25
191227207,8,0,8,0,2,18
191227208,9,7,1,8,2,27
191227209,2,3,1,1,9,16
191227210,5,2,2,5,4,18
191227211,7,8,0,9,1,25
191227212,0,7,3,9,7,26
191227213,6,0,8,2,0,16
191227214,9,8,7,2,6,32
191227215,0,6,0,7,4,17
191227216,8,6,1,9,8,32
191227217,9,6,4,9,0,28
191227218,9,0,8,1,5,23
191227219,5,8,8,7,3,31
191227220,0,1,6,7,6,20
191227221,2,1,1,5,0,9
191227222,8,0,9,7,4,28
191227223,6,3,1,6,3,19
191227224,5,3,8,3,0,19
191227225,3,1,4,4,0,12
191227226,2,8,5,8,5,28
191227227,7,8,3,5,9,32
191227228,6,3,8,3,6,26
191227229,2,3,1,0,5,11
191227230,9,3,9,9,4,34
191227231,6,1,4,1,8,20
191227232,8,3,1,9,9,30
191227233,3,6,5,6,3,23
191227234,9,8,2,3,9,31
191227235,0,8,2,6,3,19
191227236,4,2,7,2,2,17
191227237,1,8,0,7,6,22
191227238,5,9,4,5,7,30
191227239,2,4,4,4,0,14
191227240,9,7,3,5,3,27
191227241,1,8,0,4,1,14
191227242,2,9,3,3,5,22
191227243,7,2,2,3,8,22
191227244,8,4,4,9,7,32
191227245,4,5,3,6,4,22
191227246,8,2,1,9,3,23
191227247,9,2,4,1,8,24
191227248,3,1,3,0,3,10
191227249,5,8,7,0,4,24
191227250,4,1,7,3,4,19
191227251,9,5,7,3,9,33
191227252,7,6,7,6,6,32
191227253,8,2,5,2,5,22
191227254,1,3,1,3,3,11
191227255,5,5,0,7,2,19
191227256,3,0,8,3,5,19
191227257,3,5,7,6,1,22
191227258,2,5,3,4,9,23
191227259,2,3,9,9,7,30
191227260,1,9,0,1,0,11
191227261,8,7,3,3,1,22
191227262,2,3,0,3,0,8
191227263,7,1,5,8,8,29
191227264,5,5,9,6,1,26
191227265,7,2,5,0,8,22
191227266,3,5,8,1,6,23
191227267,6,1,7,7,6,27
191227268,3,3,9,9,6,30
191227269,1,3,8,5,5,22
191227270,3,2,7,1,3,16
191227271,4,2,2,0,6,14
191227272,2,0,4,0,9,15
191227273,6,7,7,4,1,25
191227274,0,7,1,0,0,8
191227275,9,3,2,6,4,24
191227276,3,5,5,4,3,20
191227277,8,6,9,2,8,33
191227278,0,8,6,4,2,20
191227279,1,4,2,9,0,16
191227280,0,5,7,5,7,24
191227281,9,9,5,7,0,30
191227282,5,2,9,2,3,21
191227283,2,7,9,6,9,33
191227284,6,7,5,0,5,23
191227285,2,0,4,3,8,17
191227286,3,4,0,8,9,24
191227287,5,2,4,2,2,15
191227288,5,5,2,3,6,21
191227289,4,0,1,5,8,18
191227290,9,9,1,7,6,32
191227291,8,5,5,9,9,36
191227292,8,0,6,4,7,25
191227293,9,3,7,1,2,22
191227294,3,6,1,2,9,21
191227295,9,4,9,7,9,38
191227296,0,5,6,2,4,17
191227297,7,4,4,4,2,21
191227298,2,3,0,7,3,15
191227299,6,2,8,4,2,22
191227300,3,0,7,7,9,26
191227301,6,4,9,0,9,28
191227302,6,0,9,1,3,19
191227303,8,9,9,1,1,28
191227304,7,9,3,2,0,21
191227305,9,3,6,1,5,24
191227306,5,8,7,7,9,36
191227307,2,6,8,4,3,23
191227308,3,9,0,6,6,24
191227309,2,2,9,6,9,28
191227310,1,0,3,7,6,17
191227311,8,7,3,7,0,25
191227312,4,2,5,2,5,18
191227313,3,2,3,4,4,16
191227314,0,8,5,5,7,25
191227315,6,7,9,8,0,30
191227316,0,0,7,0,5,12
191227317,8,8,6,1,1,24
191227318,3,8,7,0,1,19
191227319,5,7,3,6,0,21
191227320,6,2,8,2,2,20
191227321,4,4,7,2,5,22
191227322,7,2,0,0,2,11
191227323,8,4,7,8,7,34
191227324,2,0,1,2,1,6
191227325,9,2,5,2,5,23
191227326,3,8,8,2,5,26
191227327,4,5,9,1,4,23
191227328,9,0,0,2,6,17
191227329,4,9,8,0,1,22
191227330,2,8,4,4,3,21
191227331,0,0,3,1,7,11
191227332,1,9,9,6,8,33
191227333,7,7,5,7,8,34
191227334,7,1,3,2,5,18
191227335,6,4,5,6,9,30
191227336,5,9,4,0,2,20
191227337,0,9,1,8,5,23
191227338,2,0,6,5,8,21
191227339,4,5,0,9,0,18
191227340,5,8,4,6,3,26
191227341,0,2,0,2,8,12
191227342,0,4,3,2,2,11
191227343,6,1,9,6,4,26
191227344,4,6,4,5,1,20
191227345,7,4,7,8,2,28
191227346,7,7,5,1,1,21
191227347,7,5,5,6,6,29
191227348,0,4,9,8,5,26
191227349,6,5,9,5,0,25
191227350,8,4,5,2,7,26
191227351,8,4,5,2,1,20
191227352,6,8,0,4,5,23
191227353,0,5,6,5,9,25
191227354,3,2,7,7,3,22
191227355,0,0,2,1,4,7
191227356,1,9,7,7,5,29
191227357,3,0,3,2,0,8
191227358,5,5,1,0,0,11
191227359,2,5,4,7,9,27
191227360,9,2,6,6,0,23
191227361,3,8,4,9,6,30
191227362,1,4,0,6,4,15
191227363,5,7,1,4,1,18
191227364,5,1,0,5,0,11
191227365,0,9,7,3,3,22
191227366,3,9,1,8,0,21
191227367,6,3,7,0,3,19
191227368,3,1,8,4,6,22
191227369,5,8,9,2,6,30
191227370,6,8,0,0,5,19
191227371,5,5,9,9,7,35
191227372,7,7,5,2,3,24
191227373,6,9,6,2,1,24
191227374,6,7,1,3,9,26
191227375,4,0,7,4,5,20
191227376,6,8,3,6,8,31
191227377,2,9,9,3,9,32
191227378,1,0,8,1,8,18
191227379,7,1,7,9,8,32
191227380,7,7,1,1,9,25
191227381,5,3,4,8,6,26
191227382,3,7,6,1,2,19
191227383,7,2,3,9,3,24
191227384,6,8,9,9,5,37
191227385,0,1,6,9,6,22
191227386,0,5,3,8,9,25
191227387,2,2,7,3,3,17
191227388,9,7,0,9,5,30
191227389,6,3,3,6,1,19
191227390,6,7,7,4,2,26
191227391,5,6,4,4,4,23
191227392,3,2,3,3,5,16
191227393,9,4,8,5,9,35
191227394,8,2,6,7,2,25
191227395,7,9,2,2,1,21
191227396,7,3,7,4,9,30
191227397,7,0,9,8,5,29
191227398,9,6,7,6,4,32
191227399,4,9,1,0,6,20
191227400,6,9,9,3,6,33
191227401,2,9,9,0,9,29
191227402,6,7,8,4,6,31
191227403,9,2,1,5,2,19
191227404,5,6,8,3,1,23
191227405,9,9,4,2,8,32
191227406,2,9,9,2,4,26
191227407,6,1,8,2,8,25
191227408,5,6,2,0,2,15
191227409,1,9,2,0,9,21
191227410,6,5,9,4,4,28
191227411,5,9,3,1,6,24
191227412,4,6,7,9,6,32
191227413,8,1,6,8,6,29
191227414,4,4,4,7,0,19
191227415,2,8,6,3,5,24
191227416,1,3,6,2,9,21
191227417,0,5,9,5,4,23
191227418,3,5,4,8,3,23
191227419,1,1,4,6,2,14
191227420,3,1,6,5,6,21
191227421,2,2,3,3,1,11
191227422,9,3,1,0,5,18
191227423,5,3,2,1,9,20
191227424,6,9,2,6,5,28
191227425,1,8,4,1,5,19
191227426,7,2,8,5,9,31
191227427,7,1,9,5,0,22
191227428,1,8,7,1,1,18
191227429,5,0,5,3,0,13
191227430,5,9,6,2,2,24
191227431,7,5,8,1,2,23
191227432,0,4,0,4,8,16
191227433,0,4,3,9,7,23
191227434,8,2,6,7,1,24
191227435,7,5,2,8,8,30
191227436,9,5,5,0,1,20
191227437,2,3,7,4,2,18
191227438,2,9,3,8,5,27
191227439,0,3,7,0,7,17
191227440,6,2,4,5,6,23
191227441,1,9,5,9,8,32
191227442,1,9,5,3,3,21
191227443,1,2,2,7,7,19
191227444,1,3,7,9,8,28
191227445,6,8,2,9,5,30
191227446,1,5,3,9,0,18
191227447,9,8,0,6,8,31
191227448,7,3,1,4,1,16
191227449,1,4,1,8,8,22
191227450,3,3,2,3,7,18
191227451,7,0,0,5,3,15
191227452,5,2,7,5,0,19
191227453,7,1,6,6,8,28
191227454,9,6,2,5,4,26
191227455,3,1,0,4,4,12
191227456,4,6,2,6,6,24
191227457,3,6,2,8,9,28
191227458,2,0,1,6,9,18
191227459,9,1,1,0,8,19
191227460,5,4,3,2,1,15
191227461,0,7,9,0,1,17
191227462,4,9,4,9,5,31
191227463,2,2,9,5,9,27
191227464,9,9,1,1,3,23
191227465,7,8,1,4,4,24
191227466,2,9,3,7,9,30
191227467,7,1,0,2,3,13
191227468,1,8,5,6,4,24
191227469,9,2,1,6,8,26
191227470,6,0,5,6,3,20
191227471,8,8,4,9,4,33
191227472,6,3,3,9,8,29
191227473,4,3,2,2,4,15
191227474,5,7,7,5,7,31
191227475,1,6,3,6,7,23
191227476,8,7,9,5,8,37
191227477,9,8,7,3,7,34
191227478,4,3,0,3,5,15
191227479,9,4,4,4,6,27
191227480,2,8,5,5,0,20
191227481,1,5,9,8,3,26
191227482,6,9,7,3,0,25
191227483,4,5,5,8,1,23
191227484,9,5,2,8,7,31
191227485,2,2,1,9,1,15
191227486,6,9,9,6,1,31
191227487,1,3,3,2,6,15
191227488,5,7,5,9,6,32
191227489,4,2,8,7,3,24
191227490,9,2,6,3,9,29
191227491,1,7,3,4,2,17
191227492,9,0,8,2,7,26
191227493,8,0,0,9,4,21
191227494,5,5,6,8,9,33
191227495,4,6,8,7,8,33
191227496,7,1,7,8,0,23
191227497,2,7,6,3,3,21
191227498,0,4,0,4,2,10
191227499,4,5,6,6,5,26
191227500,6,0,7,8,6,27
191227501,9,4,1,1,5,20
191227502,2,1,9,6,5,23
191227503,6,9,1,9,7,32
191227504,9,7,1,7,4,28
191227505,4,0,2,9,9,24
191227506,1,9,9,4,5,28
191227507,8,7,6,8,3,32
191227508,2,3,1,2,2,10
191227509,0,2,3,9,3,17
191227510,8,2,1,4,5,20
191227511,3,5,0,1,5,14
191227512,1,6,2,9,9,27
191227513,4,4,5,4,3,20
191227514,5,0,3,4,5,17
191227515,4,8,6,0,3,21
191227516,8,2,1,3,1,15
191227517,6,3,7,9,0,25
191227518,1,9,7,3,8,28
191227519,5,6,6,0,2,19
191227520,8,6,9,9,0,32
191227521,2,6,8,6,4,26
191227522,1,3,2,7,8,21
191227523,3,6,7,0,8,24
191227524,3,7,8,9,0,27
191227525,6,1,1,0,1,9
191227526,0,5,2,8,8,23
191227527,2,9,5,2,3,21
191227528,0,5,5,3,0,13
191227529,8,4,7,2,3,24
191227530,4,3,2,6,3,18
191227531,4,9,8,0,3,24
191227532,4,3,3,3,2,15
191227533,1,4,8,3,6,22
191227534,4,0,8,5,8,25
191227535,9,1,0,0,4,14
191227536,8,1,3,9,6,27
191227537,8,5,5,3,3,24
191227538,9,5,2,9,1,26
191227539,5,8,9,2,0,24
191227540,0,6,0,1,7,14
191227541,2,3,4,1,2,12
191227542,9,0,0,5,0,14
191227543,9,8,1,8,0,26
191227544,0,9,0,2,6,17
191227545,5,6,9,0,6,26
191227546,9,0,8,8,3,28
191227547,8,7,7,5,3,30
191227548,2,5,7,3,4,21
191227549,3,2,4,4,3,16
191227550,9,9,2,6,1,27
191227551,0,4,1,1,4,10
191227552,8,6,1,2,1,18
191227553,7,9,2,8,8,34
191227554,8,9,4,1,3,25
191227555,0,7,7,4,8,26
191227556,6,1,7,0,6,20
191227557,7,3,5,0,9,24
191227558,7,4,3,4,8,26
191227559,2,5,7,0,7,21
191227560,1,2,9,0,0,12
191227561,1,6,6,0,1,14
191227562,0,9,1,3,2,15
191227563,6,2,4,2,5,19
191227564,3,0,0,8,5,16
191227565,6,9,8,9,8,40
191227566,1,2,7,0,3,13
191227567,5,4,4,7,4,24
191227568,8,9,8,8,9,42
191227569,8,2,8,1,2,21
191227570,5,0,3,2,7,17
191227571,4,4,0,7,1,16
191227572,0,6,8,0,8,22
191227573,0,7,7,6,3,23
191227574,3,3,1,9,7,23
191227575,0,2,5,8,2,17
191227576,2,9,3,6,7,27
191227577,8,6,2,6,6,28
191227578,5,7,8,3,4,27
191227579,7,6,0,0,2,15
191227580,9,6,3,6,8,32
191227581,8,5,1,7,0,21
191227582,0,5,0,1,8,14
191227583,8,6,0,2,5,21
191227584,3,5,2,4,7,21
191227585,1,0,6,9,1,17
191227586,4,5,1,5,4,19
191227587,8,1,6,1,7,23
191227588,1,0,2,3,3,9
191227589,3,3,1,9,1,17
191227590,1,1,3,5,9,19
191227591,9,7,6,8,7,37
191227592,1,9,8,0,5,23
191227593,4,8,1,9,7,29
191227594,0,0,5,4,1,10
191227595,4,6,9,1,5,25
191227596,0,5,4,2,8,19
191227597,1,1,9,1,5,17
191227598,8,8,8,2,3,29
191227599,4,3,3,9,6,25
191227600,6,7,0,9,7,29
191227601,5,8,9,7,3,32
191227602,0,4,9,1,8,22
191227603,2,5,2,5,9,23
191227604,4,6,6,7,8,31
191227605,0,3,5,8,5,21
191227606,8,2,1,1,5,17
191227607,4,2,4,1,3,14
191227608,8,4,8,9,1,30
191227609,3,5,6,6,1,21
191227610,3,3,4,8,0,18
191227611,5,2,0,2,0,9
191227612,8,3,0,8,1,20
191227613,0,9,7,1,1,18
191227614,5,8,0,1,8,22
191227615,6,1,5,2,7,21
191227616,2,0,6,1,4,13
191227617,4,5,1,0,6,16
191227618,9,9,8,6,1,33
191227619,0,4,4,5,5,18
191227620,3,5,9,3,5,25
191227621,3,3,7,7,7,27
191227622,2,0,1,4,7,14
191227623,5,4,3,7,4,23
191227624,4,6,2,9,3,24
191227625,3,2,5,3,3,16
191227626,0,5,8,4,5,22
191227627,3,6,7,1,3,20
191227628,2,3,4,0,2,11
191227629,2,2,9,6,8,27
191227630,2,9,6,6,1,24
191227631,6,3,3,9,3,24
191227632,2,5,8,3,0,18
191227633,3,5,2,4,0,14
191227634,7,4,6,4,5,26
191227635,6,7,4,5,8,30
191227636,6,1,3,4,7,21
191227637,0,6,2,0,4,12
191227638,8,6,6,0,5,25
191227639,2,7,7,7,3,26
191227640,8,6,8,1,2,25
191227641,9,6,6,5,0,26
191227642,4,6,1,0,9,20
191227643,4,8,1,2,1,16
191227644,9,2,8,6,9,34
191227645,6,1,8,9,5,29
191227646,7,2,5,4,2,20
191227647,6,9,9,3,3,30
191227648,0,8,9,7,0,24
191227649,3,0,6,6,1,16
191227650,5,9,6,6,9,35
191227651,8,3,4,1,6,22
191227652,2,2,9,2,8,23
191227653,3,4,8,7,1,23
191227654,2,2,0,8,6,18
191227655,9,1,8,2,0,20
191227656,1,9,4,5,5,24
191227657,4,9,0,5,9,27
191227658,2,9,2,8,5,26
191227659,6,7,3,8,7,31
191227660,3,8,9,5,9,34
191227661,1,5,4,9,6,25
191227662,6,1,3,3,2,15
191227663,5,9,9,1,8,32
191227664,8,9,6,4,1,28
191227665,3,2,9,5,5,24
191227666,9,4,6,8,0,27
191227667,3,0,8,4,1,16
191227668,3,5,5,7,9,29
191227669,2,5,1,2,0,10
191227670,4,6,9,6,6,31
191227671,6,6,3,4,9,28
191227672,3,7,4,4,4,22
191227673,3,3,8,1,1,16
191227674,8,0,1,2,3,14
191227675,4,3,4,9,9,29
191227676,6,2,7,6,0,21
191227677,3,5,5,9,9,31
191227678,6,4,2,8,2,22
191227679,4,5,5,9,4,27
191227680,4,0,4,2,2,12
191227681,1,0,9,6,9,25
191227682,7,6,3,4,0,20
191227683,9,3,2,4,7,25
191227684,6,1,4,0,4,15
191227685,8,7,2,3,0,20
191227686,4,8,0,8,6,26
191227687,1,4,3,9,4,21
191227688,7,2,9,2,5,25
191227689,4,7,2,5,5,23
191227690,5,5,8,7,0,25
191227691,4,5,9,5,7,30
191227692,4,7,3,3,1,18
191227693,9,0,7,5,3,24
191227694,9,6,8,2,0,25
191227695,4,4,2,2,3,15
191227696,5,6,6,3,9,29
191227697,7,0,1,9,1,18
191227698,7,3,7,2,0,19
191227699,5,6,9,2,7,29
191227700,7,4,4,8,3,26
191227701,1,9,9,0,3,22
191227702,1,7,1,6,3,18
191227703,2,1,9,3,0,15
191227704,1,8,1,4,5,19
191227705,0,8,5,1,5,19
191227706,0,1,8,5,1,15
191227707,5,5,8,2,1,21
191227708,4,7,1,1,6,19
191227709,5,6,2,7,6,26
191227710,5,8,9,4,9,35
191227711,8,6,5,4,9,32
191227712,0,0,0,0,6,6
191227713,6,0,8,6,8,28
191227714,8,5,3,1,9,26
191227715,2,5,1,9,1,18
191227716,5,2,3,1,2,13
191227717,0,3,6,3,1,13
191227718,8,3,9,5,8,33
191227719,6,8,6,6,9,35
191227720,8,4,8,9,3,32
191227721,2,8,8,7,9,34
191227722,1,1,6,1,4,13
191227723,6,9,5,8,4,32
191227724,0,8,1,2,4,15
191227725,3,2,2,7,7,21
191227726,5,3,0,4,8,20
191227727,9,0,2,4,4,19
191227728,6,2,1,2,7,18
191227729,7,5,1,9,1,23
191227730,9,0,5,0,0,14
191227731,2,7,5,8,8,30
191227732,5,7,0,3,8,23
191227733,3,7,5,6,2,23
191227734,2,0,8,1,6,17
191227735,6,5,3,7,4,25
191227736,6,7,1,9,1,24
191227737,1,0,7,2,1,11
191227738,3,4,2,6,1,16
191227739,8,7,9,4,0,28
191227740,2,2,8,6,7,25
191227741,3,1,8,2,2,16
191227742,7,0,0,5,8,20
191227743,9,9,4,8,0,30
191227744,2,3,9,4,1,19
191227745,3,1,3,9,2,18
191227746,6,9,2,0,7,24
191227747,2,4,6,1,7,20
191227748,8,0,0,2,3,13
191227749,8,2,7,7,6,30
191227750,8,4,6,9,3,30
191227751,3,5,7,7,6,28
191227752,7,3,9,9,3,31
191227753,8,8,6,8,4,34
191227754,8,1,4,9,2,24
191227755,1,3,0,8,4,16
191227756,1,8,4,6,6,25
191227757,7,8,3,9,1,28
191227758,3,9,1,4,3,20
191227759,6,7,4,0,8,25
191227760,4,3,5,3,7,22
191227761,4,1,2,7,7,21
191227762,5,8,1,4,0,18
191227763,1,9,4,2,6,22
191227764,7,8,9,2,0,26
191227765,3,2,9,4,5,23
191227766,3,1,2,4,5,15
191227767,8,9,6,5,9,37
191227768,9,3,1,3,0,16
191227769,8,9,1,9,5,32
191227770,1,5,3,7,4,20
191227771,8,3,9,8,2,30
191227772,1,3,3,6,8,21
191227773,0,4,7,6,8,25
191227774,7,6,2,2,7,24
191227775,5,4,4,6,5,24
191227776,2,3,2,9,2,18
191227777,2,4,9,0,1,16
191227778,3,4,9,6,5,27
191227779,0,7,2,0,4,13
191227780,5,7,2,5,9,28
191227781,0,5,6,8,7,26
191227782,0,3,0,3,0,6
191227783,0,7,8,4,3,22
191227784,1,2,2,3,3,11
191227785,4,1,7,5,1,18
191227786,3,9,0,1,8,21
191227787,3,8,4,9,4,28
191227788,6,2,2,8,7,25
191227789,5,0,6,7,5,23
191227790,2,0,2,6,8,18
191227791,2,9,9,2,2,24
191227792,2,6,5,5,2,20
191227793,8,9,4,0,1,22
191227794,5,8,7,1,2,23
191227795,4,8,6,5,6,29
191227796,2,5,8,1,2,18
191227797,5,3,1,4,2,15
191227798,0,6,3,7,1,17
191227799,7,8,4,9,0,28
191227800,2,2,9,4,5,22
191227801,4,8,6,7,9,34
191227802,0,0,6,1,2,9
191227803,7,6,5,1,7,26
191227804,5,7,5,6,6,29
191227805,8,1,6,8,7,30
191227806,3,4,7,9,9,32
191227807,6,5,1,7,4,23
191227808,1,3,5,8,6,23
191227809,7,4,7,3,3,24
191227810,7,9,0,2,4,22
191227811,5,9,5,2,1,22
191227812,2,8,3,9,8,30
191227813,6,0,9,7,3,25
191227814,8,8,6,3,3,28
191227815,6,9,5,6,4,30
191227816,4,3,5,0,4,16
191227817,1,4,6,8,2,21
191227818,4,1,4,6,5,20
191227819,1,4,4,3,9,21
191227820,5,7,0,1,8,21
191227821,3,6,8,9,3,29
191227822,5,1,7,3,3,19
191227823,6,3,0,4,9,22
191227824,3,6,0,9,8,26
191227825,9,9,1,6,5,30
191227826,9,8,1,9,5,32
191227827,8,5,7,5,2,27
191227828,5,6,5,5,2,23
191227829,9,8,9,9,7,42
191227830,0,1,8,4,7,20
191227831,1,8,4,5,9,27
191227832,7,7,5,5,8,32
191227833,2,4,4,8,7,25
191227834,5,6,7,4,4,26
191227835,1,9,0,6,4,20
191227836,2,3,8,0,5,18
191227837,8,9,4,1,1,23
191227838,8,5,0,3,2,18
191227839,6,8,7,7,2,30
191227840,8,0,6,9,1,24
191227841,0,3,1,8,9,21
191227842,1,8,6,4,0,19
191227843,6,0,8,0,5,19
191227844,6,3,9,7,2,27
191227845,4,1,5,7,7,24
191227846,3,6,8,1,5,23
191227847,7,0,9,5,0,21
191227848,5,6,9,9,5,34
191227849,8,0,4,9,3,24
191227850,0,2,0,0,1,3
191227851,1,0,0,8,7,16
191227852,2,3,8,4,1,18
191227853,0,2,2,7,1,12
191227854,6,0,2,6,8,22
191227855,3,9,9,8,9,38
191227856,8,6,6,8,3,31
191227857,3,7,5,1,0,16
191227858,5,2,4,5,6,22
191227859,9,2,3,3,0,17
191227860,0,7,0,4,6,17
191227861,3,7,2,8,1,21
191227862,6,4,5,1,5,21
191227863,7,3,3,5,1,19
191227864,9,6,3,7,6,31
191227865,1,2,7,4,6,20
191227866,8,7,5,4,8,32
191227867,5,1,2,8,2,18
191227868,6,7,1,4,2,20
191227869,2,5,5,0,0,12
191227870,8,6,1,2,5,22
191227871,5,5,4,9,9,32
191227872,1,6,9,9,5,30
191227873,5,4,7,4,4,24
191227874,5,1,4,7,3,20
191227875,5,2,4,6,1,18
191227876,7,2,7,9,2,27
191227877,4,7,0,1,1,13
191227878,9,7,1,8,0,25
191227879,1,0,9,2,1,13
191227880,9,1,9,4,9,32
191227881,7,3,8,2,2,22
191227882,9,9,8,0,4,30
191227883,0,5,7,2,1,15
191227884,5,3,6,4,8,26
191227885,4,1,8,2,1,16
191227886,8,7,8,1,3,27
191227887,5,4,1,2,9,21
191227888,3,7,5,6,1,22
191227889,9,8,7,6,4,34
191227890,3,6,2,6,8,25
191227891,6,3,2,6,0,17
191227892,5,9,9,3,7,33
191227893,8,4,4,0,2,18
191227894,9,7,3,4,3,26
191227895,0,7,6,8,1,22
191227896,2,3,0,7,9,21
191227897,8,3,3,0,9,23
191227898,1,2,7,7,6,23
191227899,7,3,7,4,7,28
191227900,5,0,9,0,0,14
191227901,1,8,7,1,8,25
191227902,7,9,8,9,0,33
191227903,6,5,1,1,4,17
191227904,6,2,2,0,1,11
191227905,4,5,2,8,5,24
191227906,0,6,1,2,5,14
191227907,1,7,4,0,2,14
191227908,0,7,3,4,6,20
191227909,8,4,5,9,2,28
191227910,1,8,4,0,7,20
191227911,7,2,9,6,4,28
191227912,1,8,1,9,1,20
191227913,3,3,1,5,0,12
191227914,6,8,9,5,0,28
191227915,9,7,7,4,1,28
191227916,4,3,8,6,0,21
191227917,7,4,9,5,9,34
191227918,6,2,2,5,9,24
191227919,3,2,1,6,5,17
191227920,5,0,3,8,7,23
191227921,7,7,9,5,2,30
191227922,3,7,4,6,0,20
191227923,1,9,8,0,2,20
191227924,4,6,5,5,2,22
191227925,6,9,6,2,5,28
191227926,1,1,9,1,8,20
191227927,3,8,8,6,0,25
191227928,2,9,6,6,2,25
191227929,7,2,1,8,4,22
191227930,3,8,6,7,6,30
191227931,2,9,0,3,8,22
191227932,9,2,4,5,2,22
191227933,1,4,0,6,3,14
191227934,8,9,6,4,0,27
191227935,7,2,9,9,5,32
191227936,7,9,3,5,4,28
191227937,4,1,1,5,1,12
191227938,6,0,3,8,5,22
191227939,8,4,0,1,1,14
191227940,7,1,3,5,4,20
191227941,8,6,9,0,3,26
191227942,9,4,1,4,1,19
191227943,9,1,0,9,0,19
191227944,5,6,8,9,8,36
191227945,3,3,9,3,7,25
191227946,5,1,8,1,6,21
191227947,6,8,6,4,6,30
191227948,5,2,7,9,3,26
191227949,7,8,9,2,2,28
191227950,4,1,5,3,6,19
191227951,0,1,1,5,2,9
191227952,2,9,9,1,9,30
191227953,7,7,7,0,1,22
191227954,6,9,2,4,1,22
191227955,3,0,6,9,3,21
191227956,1,2,3,1,3,10
191227957,6,7,6,9,4,32
191227958,1,3,7,0,6,17
191227959,8,4,7,4,7,30
191227960,2,1,7,6,4,20
191227961,8,1,1,5,4,19
191227962,6,4,3,1,3,17
191227963,8,4,3,4,1,20
191227964,6,1,6,9,8,30
191227965,2,0,7,2,7,18
191227966,1,5,0,6,4,16
191227967,6,8,7,2,6,29
191227968,2,6,9,6,8,31
191227969,4,0,7,5,0,16
191227970,4,8,4,4,2,22
191227971,2,8,5,1,4,20
191227972,8,1,5,8,3,25
191227973,4,9,0,0,9,22
191227974,7,4,8,8,3,30
191227975,1,7,6,2,1,17
191227976,1,7,9,0,9,26
191227977,0,8,1,6,3,18
191227978,6,6,8,5,4,29
191227979,9,2,3,4,7,25
191227980,3,8,9,8,6,34
191227981,1,4,4,3,1,13
191227982,6,3,9,4,1,23
191227983,1,5,2,0,3,11
191227984,4,8,4,3,4,23
191227985,5,2,1,3,9,20
191227986,5,6,0,8,4,23
191227987,8,3,0,3,2,16
191227988,9,7,4,5,8,33
191227989,1,4,5,2,0,12
191227990,6,0,9,1,5,21
191227991,8,9,4,4,3,28
191227992,0,1,2,1,6,10
191227993,9,3,3,6,3,24
191227994,6,2,7,0,9,24
191227995,9,4,1,8,2,24
191227996,4,8,4,3,2,21
191227997,2,7,2,9,5,25
191227998,6,0,1,4,5,16
191227999,8,3,2,5,0,18
1912271000,1,9,5,0,5,20
1912271001,7,0,3,3,6,19
1912271002,5,7,0,4,4,20
1912271003,1,7,2,9,7,26
1912271004,8,4,9,1,8,30
1912271005,3,2,9,5,4,23
1912271006,6,1,4,5,5,21
1912271007,9,2,6,8,9,34
1912271008,9,7,5,5,3,29
1912271009,4,5,8,6,8,31
1912271010,6,7,1,8,2,24
1912271011,0,4,3,5,5,17
1912271012,9,8,9,6,1,33
1912271013,4,2,9,4,3,22
1912271014,0,6,0,1,2,9
1912271015,6,8,1,6,0,21
1912271016,7,9,9,9,5,39
1912271017,9,2,2,1,5,19
1912271018,2,6,1,8,0,17
1912271019,3,8,7,4,4,26
1912271020,4,4,4,2,8,22
1912271021,3,0,9,6,0,18
1912271022,8,9,9,7,3,36
1912271023,5,8,3,2,9,27
1912271024,3,8,8,1,1,21
1912271025,9,0,7,0,8,24
1912271026,1,0,7,0,7,15
1912271027,8,4,2,6,7,27
1912271028,6,4,0,9,2,21
1912271029,2,3,5,2,8,20
1912271030,4,3,8,8,8,31
1912271031,9,1,7,5,2,24
1912271032,5,9,9,6,5,34
1912271033,0,3,8,0,4,15
1912271034,6,5,2,5,0,18
1912271035,0,4,9,7,6,26
1912271036,1,3,0,3,5,12
1912271037,8,8,2,3,4,25
1912271038,8,8,4,7,2,29
1912271039,4,1,1,6,2,14
1912271040,3,1,1,5,2,12
1912271041,6,4,2,1,0,13
1912271042,0,7,6,7,8,28
1912271043,5,5,5,5,6,26
1912271044,1,7,2,7,1,18
1912271045,3,1,2,6,4,16
1912271046,2,7,8,2,2,21
1912271047,3,7,8,4,8,30
1912271048,4,3,5,2,2,16
1912271049,9,1,7,0,0,17
1912271050,1,2,5,5,5,18
1912271051,5,1,3,0,7,16
1912271052,2,9,1,3,1,16
1912271053,7,9,1,1,7,25
1912271054,5,3,3,9,1,21
1912271055,8,0,7,0,8,23
1912271056,7,9,7,9,7,39
1912271057,8,6,5,9,0,28
1912271058,8,5,8,5,7,33
1912271059,3,6,9,6,0,24
1912271060,5,7,0,2,2,16
1912271061,8,8,5,4,2,27
1912271062,5,5,2,4,4,20
1912271063,6,5,4,9,7,31
1912271064,9,9,5,3,1,27
1912271065,3,7,8,1,1,20
1912271066,8,6,7,1,8,30
1912271067,9,9,9,1,9,37
1912271068,1,0,2,1,1,5
1912271069,6,0,4,4,7,21
1912271070,4,9,2,4,9,28
1912271071,4,1,2,5,0,12
1912271072,5,6,9,0,8,28
1912271073,7,6,8,9,9,39
1912271074,0,2,1,9,7,19
1912271075,2,6,2,6,2,18
1912271076,5,5,6,6,1,23
1912271077,2,0,1,3,2,8
1912271078,6,9,4,1,5,25
1912271079,6,4,5,2,3,20
1912271080,2,5,5,9,7,28
1912271081,3,3,3,7,5,21
1912271082,6,8,1,6,3,24
1912271083,9,2,9,8,5,33
1912271084,0,1,0,2,1,4
1912271085,4,8,0,1,0,13
1912271086,5,2,7,6,6,26
1912271087,2,2,7,5,5,21
1912271088,3,7,0,9,6,25
1912271089,9,6,0,5,2,22
1912271090,3,7,5,0,0,15
1912271091,1,0,1,4,0,6
1912271092,8,6,7,4,1,26
1912271093,9,7,2,6,4,28
1912271094,7,4,8,0,6,25
1912271095,1,2,3,0,7,13
1912271096,7,9,0,8,1,25
1912271097,7,0,9,4,2,22
1912271098,5,0,7,7,9,28
1912271099,3,6,7,3,4,23
1912271100,2,7,0,1,3,13
1912271101,2,2,1,0,3,8
1912271102,5,2,4,9,2,22
1912271103,8,0,4,6,3,21
1912271104,5,2,0,3,8,18
1912271105,4,7,4,1,3,19
191228001,0,8,6,6,4,24
191228002,1,9,2,5,5,22
191228003,4,3,3,0,6,16
191228004,9,8,7,6,1,31
191228005,6,7,8,5,1,27
191228006,8,5,6,0,7,26
191228007,7,3,4,3,9,26
191228008,0,4,2,2,3,11
191228009,6,7,5,7,9,34
191228010,4,7,1,4,9,25
191228011,3,6,2,0,2,13
191228012,5,1,3,6,2,17
191228013,5,9,1,7,9,31
191228014,0,5,2,5,3,15
191228015,7,9,5,0,0,21
191228016,6,8,0,6,8,28
191228017,1,2,4,4,3,14
191228018,6,4,9,4,4,27
191228019,3,1,5,0,4,13
191228020,3,0,0,7,7,17
191228021,2,5,6,8,0,21
191228022,9,7,5,4,8,33
191228023,7,4,0,0,2,13
191228024,2,5,9,7,7,30
191228025,9,6,6,6,5,32
191228026,1,7,1,9,4,22
191228027,8,7,8,1,9,33
191228028,8,1,4,9,4,26
191228029,9,8,2,6,1,26
191228030,4,4,5,2,8,23
191228031,0,1,3,4,1,9
191228032,7,0,7,4,3,21
191228033,5,4,1,5,0,15
191228034,6,8,6,5,6,31
191228035,0,3,2,9,7,21
191228036,6,4,4,4,2,20
191228037,2,7,7,4,8,28
191228038,6,3,8,3,9,29
191228039,1,5,8,1,7,22
191228040,6,5,4,7,7,29
191228041,6,3,8,1,5,23
191228042,8,3,4,4,3,22
191228043,3,2,7,3,8,23
191228044,5,4,3,9,7,28
191228045,1,2,2,6,0,11
191228046,1,4,2,0,6,13
191228047,9,9,8,2,8,36
191228048,6,9,4,1,2,22
191228049,6,2,4,1,2,15
191228050,6,9,9,8,0,32
191228051,7,1,2,1,1,12
191228052,7,2,9,7,2,27
191228053,1,4,7,6,8,26
191228054,8,6,4,8,8,34
191228055,8,1,8,9,4,30
191228056,1,4,1,3,1,10
191228057,3,3,6,4,2,18
191228058,3,4,9,3,8,27
191228059,8,5,9,5,9,36
191228060,0,6,5,0,3,14
191228061,5,3,7,9,7,31
191228062,1,8,9,3,4,25
191228063,4,7,7,8,8,34
191228064,3,8,3,1,8,23
191228065,4,8,0,4,0,16
191228066,1,5,3,7,8,24
191228067,7,5,4,4,4,24
191228068,1,8,6,7,0,22
191228069,8,3,9,3,7,30
191228070,8,0,8,1,9,26
191228071,1,2,9,2,8,22
191228072,5,3,6,9,6,29
191228073,7,4,6,3,3,23
191228074,1,6,3,2,1,13
191228075,6,4,0,0,7,17
191228076,2,7,1,6,5,21
191228077,5,7,2,5,4,23
191228078,7,7,2,3,9,28
191228079,6,2,0,6,4,18
191228080,6,9,2,3,8,28
191228081,1,7,9,0,4,21
191228082,8,2,2,8,2,22
191228083,6,4,6,7,1,24
191228084,9,1,1,4,7,22
191228085,8,8,0,5,9,30
191228086,3,1,8,3,8,23
191228087,1,7,2,1,6,17
191228088,8,4,8,2,7,29
191228089,2,7,0,5,1,15
191228090,3,6,8,6,6,29
191228091,6,6,6,7,0,25
191228092,5,8,5,5,7,30
191228093,8,1,8,9,3,29
191228094,1,0,2,0,5,8
191228095,9,5,4,1,4,23
191228096,7,7,2,0,0,16
191228097,9,5,2,5,1,22
191228098,6,2,5,4,6,23
191228099,5,1,4,7,7,24
191228100,7,5,7,1,4,24
191228101,1,3,4,6,7,21
191228102,7,1,5,2,3,18
191228103,6,9,1,4,0,20
191228104,4,3,7,4,6,24
191228105,9,7,0,2,6,24
191228106,5,6,2,3,1,17
191228107,9,2,5,5,3,24
191228108,0,4,5,3,4,16
191228109,7,1,4,7,8,27
191228110,7,1,5,9,0,22
191228111,9,4,0,8,0,21
191228112,3,5,4,3,8,23
191228113,2,9,2,7,7,27
191228114,4,3,1,1,2,11
191228115,2,3,1,9,6,21
191228116,4,3,7,5,4,23
191228117,3,2,5,2,4,16
191228118,8,9,9,9,6,41
191228119,6,2,7,7,8,30
191228120,8,9,7,7,8,39
191228121,8,9,3,1,0,21
191228122,9,8,9,4,5,35
191228123,3,0,6,1,7,17
191228124,7,6,9,5,0,27
191228125,1,5,5,8,8,27
191228126,9,5,3,7,8,32
191228127,3,2,7,0,7,19
191228128,1,8,2,1,3,15
191228129,6,2,9,9,6,32
191228130,6,3,8,2,9,28
191228131,8,0,7,7,3,25
191228132,6,3,2,6,3,20
191228133,9,5,8,2,8,32
191228134,1,6,9,6,4,26
191228135,8,6,9,7,0,30
191228136,0,2,5,5,8,20
191228137,8,7,2,5,3,25
191228138,5,7,4,0,3,19
191228139,3,8,5,2,4,22
191228140,6,4,0,5,2,17
191228141,2,0,7,3,0,12
191228142,4,6,9,0,0,19
191228143,8,5,9,4,7,33
191228144,0,8,9,1,0,18
191228145,2,3,6,1,7,19
191228146,5,2,4,0,0,11
191228147,3,8,0,4,0,15
191228148,6,3,7,0,1,17
191228149,5,3,6,9,3,26
191228150,7,7,8,0,9,31
191228151,5,1,4,9,1,20
191228152,4,0,4,3,0,11
191228153,8,0,7,0,1,16
191228154,9,8,0,3,6,26
191228155,6,1,0,6,4,17
191228156,3,9,0,1,2,15
191228157,7,7,3,3,7,27
191228158,8,8,7,5,5,33
191228159,3,1,2,1,7,14
191228160,2,9,0,0,9,20
191228161,8,5,7,5,8,33
191228162,1,9,2,2,8,22
191228163,3,4,9,1,7,24
191228164,4,2,9,0,8,23
191228165,2,9,0,7,7,25
191228166,2,5,8,9,1,25
191228167,4,9,1,3,3,20
191228168,9,2,7,9,7,34
191228169,8,9,0,5,1,23
191228170,7,7,4,8,6,32
191228171,2,4,6,8,3,23
191228172,5,6,4,6,9,30
191228173,5,1,4,1,2,13
191228174,2,2,9,7,1,21
191228175,6,9,4,6,8,33
191228176,9,9,2,7,0,27
191228177,2,2,5,9,4,22
191228178,8,7,7,5,5,32
191228179,3,8,7,0,5,23
191228180,4,0,4,5,9,22
191228181,1,0,0,8,5,14
191228182,4,5,8,8,0,25
191228183,9,4,5,9,4,31
191228184,8,4,3,6,2,23
191228185,6,6,4,2,1,19
191228186,9,3,6,6,1,25
191228187,6,0,1,8,6,21
191228188,9,1,9,4,4,27
191228189,2,7,0,3,2,14
191228190,4,1,0,9,9,23
191228191,6,3,8,4,7,28
191228192,5,6,9,1,4,25
191228193,1,1,8,0,1,11
191228194,2,8,7,2,6,25
191228195,7,6,5,7,0,25
191228196,1,7,9,8,1,26
191228197,2,3,3,9,0,17
191228198,3,2,8,2,2,17
191228199,7,5,1,9,5,27
191228200,2,4,3,2,2,13
191228201,0,7,4,6,3,20
191228202,9,6,8,2,5,30
191228203,6,8,5,1,7,27
191228204,4,9,7,1,2,23
191228205,5,9,7,9,8,38
191228206,5,9,1,6,9,30
191228207,5,5,6,9,4,29
191228208,9,0,9,6,3,27
191228209,1,2,4,1,3,11
191228210,1,7,1,5,6,20
191228211,1,2,1,6,6,16
191228212,4,1,9,9,8,31
191228213,5,4,9,1,1,20
191228214,8,2,9,2,8,29
191228215,3,3,6,7,8,27
191228216,7,1,7,8,9,32
191228217,3,0,1,5,3,12
191228218,1,2,7,9,6,25
191228219,0,1,6,4,1,12
191228220,4,0,2,9,8,23
191228221,0,5,9,5,3,22
191228222,4,1,3,7,7,22
191228223,5,5,2,4,2,18
191228224,8,7,1,6,8,30
191228225,8,6,3,0,8,25
191228226,2,0,2,9,9,22
191228227,0,8,1,6,4,19
191228228,4,2,9,6,9,30
191228229,5,9,1,4,7,26
191228230,3,0,7,8,9,27
191228231,6,9,1,4,8,28
191228232,0,5,0,4,4,13
191228233,2,7,2,3,9,23
191228234,4,5,2,3,0,14
191228235,6,8,0,3,1,18
191228236,0,4,3,3,4,14
191228237,6,3,4,7,6,26
191228238,2,7,6,1,9,25
191228239,7,0,6,9,8,30
191228240,6,6,9,8,4,33
191228241,9,6,3,1,8,27
191228242,4,2,7,6,5,24
191228243,4,3,2,2,0,11
191228244,1,4,6,2,0,13
191228245,5,6,9,0,1,21
191228246,6,7,4,1,2,20
191228247,0,0,1,0,2,3
191228248,0,1,3,1,8,13
191228249,3,0,7,2,3,15
191228250,7,4,4,8,2,25
191228251,7,0,1,5,2,15
191228252,7,9,8,4,3,31
191228253,2,1,2,1,4,10
191228254,1,9,9,0,1,20
191228255,2,6,9,2,0,19
191228256,0,6,1,1,7,15
191228257,1,0,1,9,9,20
191228258,4,6,0,7,6,23
191228259,1,8,4,7,1,21
191228260,3,1,1,2,8,15
191228261,6,7,4,4,9,30
191228262,1,2,7,8,7,25
191228263,1,6,4,0,3,14
191228264,0,7,1,5,4,17
191228265,0,7,9,6,0,22
191228266,7,6,5,5,9,32
191228267,9,5,3,6,5,28
191228268,0,3,7,4,3,17
191228269,6,4,2,6,1,19
191228270,9,6,5,5,7,32
191228271,9,0,2,9,7,27
191228272,0,0,8,0,4,12
191228273,0,3,1,7,2,13
191228274,7,8,6,9,6,36
191228275,3,7,2,0,8,20
191228276,9,7,0,4,5,25
191228277,4,3,9,3,7,26
191228278,4,5,3,0,7,19
191228279,8,9,4,6,9,36
191228280,1,2,9,8,0,20
191228281,7,2,6,7,7,29
191228282,4,0,7,3,6,20
191228283,1,1,7,7,3,19
191228284,0,3,3,0,0,6
191228285,5,7,9,5,6,32
191228286,3,8,2,3,0,16
191228287,0,3,2,9,5,19
191228288,3,4,2,2,2,13
191228289,0,5,7,4,1,17
191228290,1,2,0,9,3,15
191228291,6,9,8,1,2,26
191228292,2,2,8,0,3,15
191228293,8,1,8,1,4,22
191228294,5,3,4,1,9,22
191228295,3,2,7,8,8,28
191228296,9,2,2,0,0,13
191228297,9,7,3,7,7,33
191228298,4,2,9,6,6,27
191228299,4,7,6,1,8,26
191228300,7,9,7,7,8,38
191228301,5,9,9,6,1,30
191228302,6,5,3,7,2,23
191228303,4,5,5,2,6,22
191228304,5,7,1,4,6,23
191228305,8,3,5,6,2,24
191228306,8,7,1,1,3,20
191228307,6,3,6,4,6,25
191228308,6,6,8,5,8,33
191228309,8,0,0,9,6,23
191228310,0,6,8,5,8,27
191228311,7,7,0,0,2,16
191228312,8,5,9,5,0,27
191228313,2,6,5,8,3,24
191228314,2,1,6,2,1,12
191228315,7,7,7,0,0,21
191228316,9,7,9,4,7,36
191228317,5,9,6,0,0,20
191228318,6,2,6,8,0,22
191228319,9,8,2,6,5,30
191228320,0,9,5,8,8,30
191228321,0,4,5,4,2,15
191228322,2,8,1,4,7,22
191228323,8,8,6,2,3,27
191228324,2,0,3,5,0,10
191228325,7,9,9,0,9,34
191228326,2,0,0,1,5,8
191228327,6,3,9,1,1,20
191228328,7,5,9,6,9,36
191228329,1,4,2,8,8,23
191228330,5,3,0,7,8,23
191228331,7,1,8,4,7,27
191228332,6,4,2,6,3,21
191228333,6,7,9,8,4,34
191228334,2,8,2,1,7,20
191228335,4,9,0,7,6,26
191228336,1,1,8,5,8,23
191228337,3,4,6,7,7,27
191228338,0,0,9,5,8,22
191228339,5,3,8,1,5,22
191228340,6,3,5,9,1,24
191228341,7,3,8,9,4,31
191228342,2,5,8,7,4,26
191228343,3,3,5,2,0,13
191228344,9,9,3,4,6,31
191228345,0,7,2,0,2,11
191228346,9,4,4,7,2,26
191228347,1,6,6,9,6,28
191228348,0,0,5,5,3,13
191228349,2,3,0,7,6,18
191228350,6,0,7,6,9,28
191228351,9,7,6,2,1,25
191228352,4,5,0,8,6,23
191228353,5,2,3,4,8,22
191228354,5,1,9,0,5,20
191228355,4,8,1,3,4,20
191228356,1,0,4,6,7,18
191228357,8,4,2,5,4,23
191228358,9,9,1,1,4,24
191228359,5,9,3,5,2,24
191228360,1,8,2,4,8,23
191228361,6,8,1,7,5,27
191228362,6,7,1,4,6,24
191228363,2,3,8,0,9,22
191228364,9,2,5,2,2,20
191228365,6,6,1,8,3,24
191228366,5,6,1,0,0,12
191228367,1,9,5,5,4,24
191228368,2,6,2,0,0,10
191228369,4,1,3,6,3,17
191228370,0,3,7,4,5,19
191228371,9,4,1,5,5,24
191228372,3,5,5,6,0,19
191228373,5,5,7,8,1,26
191228374,9,4,8,7,2,30
191228375,0,0,5,7,3,15
191228376,5,5,4,0,9,23
191228377,4,2,3,6,4,19
191228378,2,0,0,4,4,10
191228379,1,4,7,8,8,28
191228380,8,9,3,0,5,25
191228381,6,8,8,9,5,36
191228382,7,8,4,5,1,25
191228383,4,0,0,3,1,8
191228384,4,0,9,0,2,15
191228385,6,4,5,1,3,19
191228386,0,8,8,5,9,30
191228387,1,2,4,0,5,12
191228388,9,0,1,6,0,16
191228389,8,4,6,8,3,29
191228390,2,6,2,2,0,12
191228391,6,0,5,6,7,24
191228392,2,0,4,6,9,21
191228393,0,6,7,9,8,30
191228394,4,4,9,1,4,22
191228395,3,6,0,2,8,19
191228396,3,5,2,7,1,18
191228397,0,8,9,0,7,24
191228398,7,9,2,2,8,28
191228399,2,5,3,5,0,15
191228400,0,2,9,8,7,26
191228401,1,3,5,6,9,24
191228402,2,8,7,7,9,33
191228403,3,1,1,3,3,11
191228404,5,9,2,0,8,24
191228405,5,7,1,9,3,25
191228406,1,3,6,2,8,20
191228407,2,4,2,3,4,15
191228408,0,5,3,4,1,13
191228409,8,8,8,5,7,36
191228410,0,5,2,7,3,17
191228411,9,2,3,4,4,22
191228412,0,9,7,2,3,21
191228413,9,1,7,6,4,27
191228414,7,6,9,9,2,33
191228415,4,7,9,5,0,25
191228416,9,9,1,3,4,26
191228417,8,6,4,9,4,31
191228418,5,2,0,3,2,12
191228419,0,2,6,6,3,17
191228420,6,6,5,9,1,27
191228421,4,8,7,1,1,21
191228422,2,0,3,1,3,9
191228423,7,3,2,3,0,15
191228424,8,6,8,0,9,31
191228425,7,3,1,0,9,20
191228426,0,6,6,2,6,20
191228427,2,2,2,6,5,17
191228428,8,2,3,1,7,21
191228429,8,7,8,5,8,36
191228430,7,8,2,5,0,22
191228431,2,3,2,2,3,12
191228432,3,2,8,3,1,17
191228433,8,7,9,7,1,32
191228434,5,4,2,2,7,20
191228435,4,6,7,2,3,22
191228436,4,0,0,0,1,5
191228437,8,6,0,4,0,18
191228438,4,7,3,7,5,26
191228439,5,5,4,6,5,25
191228440,0,7,9,1,5,22
191228441,5,2,7,7,6,27
191228442,5,4,0,4,6,19
191228443,3,7,7,9,8,34
191228444,1,0,5,1,1,8
191228445,7,9,3,2,3,24
191228446,7,6,3,3,7,26
191228447,6,4,7,9,1,27
191228448,0,6,5,1,3,15
191228449,5,7,4,7,4,27
191228450,6,0,9,8,9,32
191228451,8,7,5,6,3,29
191228452,9,5,9,3,3,29
191228453,1,6,2,8,7,24
191228454,3,7,7,8,7,32
191228455,2,8,3,8,9,30
191228456,0,0,9,2,5,16
191228457,2,1,6,1,9,19
191228458,0,1,4,7,8,20
191228459,5,1,5,5,7,23
191228460,5,7,0,5,3,20