date,first,second,third,fourth,fiveth,sum
191127002,3,3,2,8,0,16
191127003,2,8,1,0,9,20
191127004,6,7,8,7,9,37
191127005,1,8,4,6,5,24
191127006,1,1,5,4,5,16
191127007,4,5,9,2,6,26
191127008,2,9,1,3,4,19
191127009,9,9,1,2,1,22
191127010,8,9,3,8,9,37
191127011,7,4,3,4,6,24
191127012,7,3,5,9,5,29
191127013,6,4,2,7,2,21
191127014,1,7,8,9,4,29
191127015,8,1,8,4,3,24
191127016,0,6,7,0,3,16
191127017,1,9,4,5,5,24
191127018,1,9,2,3,9,24
191127019,2,9,6,5,7,29
191127020,8,9,8,5,8,38
191127021,2,9,2,8,1,22
191127022,4,2,9,3,0,18
191127023,3,7,0,9,4,23
191127024,3,1,5,5,7,21
191127025,0,2,8,8,2,20
191127026,6,9,0,7,7,29
191127027,0,2,5,6,5,18
191127028,1,9,9,1,7,27
191127029,1,7,6,6,6,26
191127030,3,7,9,5,2,26
191127031,7,4,5,3,2,21
191127032,8,6,9,4,7,34
191127033,0,3,4,1,1,9
191127034,0,7,7,2,3,19
191127035,8,1,8,1,9,27
191127036,5,6,0,3,1,15
191127037,6,7,8,8,0,29
191127038,2,1,8,4,9,24
191127039,0,4,4,3,2,13
191127040,1,0,2,4,7,14
191127041,7,5,8,8,5,33
191127042,3,6,5,3,9,26
191127043,9,6,0,6,5,26
191127044,6,3,2,2,1,14
191127045,1,5,7,7,3,23
191127046,7,0,9,4,1,21
191127047,3,4,2,2,2,13
191127048,5,9,6,3,9,32
191127049,8,7,3,1,7,26
191127050,4,2,9,8,1,24
191127051,6,4,6,0,1,17
191127052,9,4,7,4,5,29
191127053,8,7,1,7,8,31
191127054,6,8,5,0,6,25
191127055,7,7,1,0,7,22
191127056,9,8,4,1,6,28
191127057,7,2,1,0,5,15
191127058,8,1,1,8,3,21
191127059,6,5,3,4,1,19
191127060,7,7,2,5,9,30
191127061,4,2,0,0,5,11
191127062,5,7,9,0,5,26
191127063,7,0,6,9,7,29
191127064,3,2,6,4,3,18
191127065,7,0,7,2,8,24
191127066,3,7,5,4,2,21
191127067,3,3,3,7,7,23
191127068,0,9,0,6,3,18
191127069,9,7,6,2,1,25
191127070,0,9,3,6,5,23
191127071,3,5,8,7,0,23
191127072,9,8,1,4,0,22
191127073,8,8,7,9,6,38
191127074,0,5,6,5,9,25
191127075,9,1,6,1,1,18
191127076,1,4,5,6,0,16
191127077,1,3,6,4,3,17
191127078,6,5,8,0,0,19
191127079,0,2,5,5,3,15
191127080,8,1,2,6,6,23
191127081,0,2,3,8,1,14
191127082,5,4,6,5,8,28
191127083,9,2,2,3,6,22
191127084,4,6,4,6,8,28
191127085,5,6,9,2,3,25
191127086,7,8,9,0,3,27
191127087,4,4,9,3,8,28
191127088,6,4,8,5,6,29
191127089,0,7,5,6,7,25
191127090,1,0,0,3,5,9
191127091,0,1,9,4,5,19
191127092,2,3,7,9,8,29
191127093,1,7,7,0,4,19
191127094,6,8,6,4,2,26
191127095,1,6,5,2,7,21
191127096,4,9,5,7,2,27
191127097,1,9,2,4,6,22
191127098,1,9,9,0,3,22
191127099,1,5,7,0,0,13
191127100,5,3,9,1,3,21
191127101,6,0,1,0,0,7
191127102,2,9,3,0,8,22
191127103,2,7,7,2,1,19
191127104,0,6,4,1,0,11
191127105,1,1,1,1,2,6
191127106,0,8,7,1,2,18
191127107,5,9,3,7,3,27
191127108,5,1,9,9,8,32
191127109,2,8,5,1,1,17
191127110,4,2,4,9,1,20
191127111,8,5,8,2,4,27
191127112,4,0,6,1,8,19
191127113,1,0,9,0,9,19
191127114,3,5,3,6,0,17
191127115,8,3,7,3,9,30
191127116,3,8,5,4,3,23
191127117,9,0,1,3,0,13
191127118,7,6,1,7,7,28
191127119,4,5,4,9,1,23
191127120,3,7,5,4,4,23
191127121,1,5,1,5,9,21
191127122,2,5,9,1,5,22
191127123,6,5,6,9,7,33
191127124,6,4,5,1,7,23
191127125,0,1,1,1,2,5
191127126,8,9,0,5,8,30
191127127,8,3,1,2,1,15
191127128,2,6,3,4,0,15
191127129,4,0,7,8,1,20
191127130,3,2,1,1,3,10
191127131,2,5,5,2,2,16
191127132,1,1,6,8,9,25
191127133,3,0,9,8,8,28
191127134,8,7,7,0,3,25
191127135,3,1,6,7,7,24
191127136,1,4,8,1,3,17
191127137,5,1,5,7,1,19
191127138,5,9,0,7,8,29
191127139,9,4,2,6,4,25
191127140,1,8,8,4,3,24
191127141,1,5,2,7,8,23
191127142,6,2,7,7,3,25
191127143,5,5,7,4,9,30
191127144,5,1,0,4,7,17
191127145,9,7,0,2,9,27
191127146,2,7,3,6,7,25
191127147,8,4,3,6,1,22
191127148,9,6,7,3,8,33
191127149,8,0,5,0,2,15
191127150,8,9,3,0,8,28
191127151,2,0,1,7,4,14
191127152,0,7,4,1,8,20
191127153,2,5,1,0,5,13
191127154,3,4,0,6,7,20
191127155,1,8,1,4,9,23
191127156,9,2,9,8,3,31
191127157,1,1,4,4,4,14
191127158,9,5,7,3,4,28
191127159,1,3,3,0,5,12
191127160,3,0,6,2,7,18
191127161,3,1,4,3,8,19
191127162,3,1,3,8,5,20
191127163,9,2,1,8,2,22
191127164,0,6,8,6,6,26
191127165,2,0,8,5,4,19
191127166,3,8,2,3,1,17
191127167,3,9,1,9,8,30
191127168,1,9,4,6,9,29
191127169,7,0,9,1,0,17
191127170,7,7,6,3,0,23
191127171,7,5,7,7,9,35
191127172,4,3,4,0,0,11
191127173,7,0,1,6,5,19
191127174,2,2,4,0,6,14
191127175,6,0,6,3,0,15
191127176,4,8,2,0,9,23
191127177,6,7,3,3,8,27
191127178,0,8,9,9,2,28
191127179,5,5,0,3,9,22
191127180,7,5,6,9,2,29
191127181,9,1,0,4,0,14
191127182,1,2,5,4,1,13
191127183,4,6,7,7,3,27
191127184,8,0,3,6,0,17
191127185,4,3,0,8,4,19
191127186,6,3,8,7,6,30
191127187,4,8,7,1,5,25
191127188,7,9,9,4,1,30
191127189,3,7,7,6,9,32
191127190,7,2,2,5,3,19
191127191,8,8,9,4,1,30
191127192,1,1,7,4,2,15
191127193,3,0,0,4,9,16
191127194,2,5,9,5,5,26
191127195,9,5,1,4,0,19
191127196,1,2,5,4,2,14
191127197,9,4,5,7,6,31
191127198,5,8,3,4,1,21
191127199,0,9,3,0,4,16
191127200,9,0,0,1,8,18
191127201,2,8,9,9,1,29
191127202,7,2,1,1,6,17
191127203,6,0,5,2,8,21
191127204,8,6,3,4,3,24
191127205,1,3,9,0,5,18
191127206,0,2,7,0,5,14
191127207,2,8,6,6,1,23
191127208,6,0,3,3,0,12
191127209,3,6,6,2,2,19
191127210,5,3,9,5,2,24
191127211,2,6,2,2,0,12
191127212,2,3,1,8,8,22
191127213,9,2,1,7,8,27
191127214,6,6,0,9,3,24
191127215,2,0,4,0,7,13
191127216,7,7,8,7,5,34
191127217,3,8,6,5,5,27
191127218,2,0,9,9,8,28
191127219,2,6,3,7,1,19
191127220,2,6,5,7,2,22
191127221,6,1,9,1,2,19
191127222,2,4,1,1,4,12
191127223,4,6,6,8,2,26
191127224,7,1,3,4,5,20
191127225,3,1,4,2,5,15
191127226,8,3,9,5,7,32
191127227,9,8,7,2,9,35
191127228,6,3,3,7,0,19
191127229,7,7,2,9,0,25
191127230,0,3,5,0,1,9
191127231,0,9,4,0,6,19
191127232,8,5,7,7,5,32
191127233,3,8,4,4,7,26
191127234,0,4,5,9,7,25
191127235,4,3,8,7,1,23
191127236,4,0,8,5,6,23
191127237,7,9,0,3,9,28
191127238,9,3,1,1,4,18
191127239,3,4,2,0,3,12
191127240,5,9,5,6,5,30
191127241,5,8,1,5,1,20
191127242,0,6,6,4,3,19
191127243,7,5,3,7,1,23
191127244,0,0,4,2,3,9
191127245,8,1,1,5,3,18
191127246,6,9,7,5,7,34
191127247,1,9,1,7,8,26
191127248,3,2,3,4,5,17
191127249,0,7,8,5,2,22
191127250,2,0,9,4,7,22
191127251,3,1,4,3,7,18
191127252,0,8,3,4,2,17
191127253,1,2,2,0,9,14
191127254,1,0,1,3,9,14
191127255,3,7,6,0,5,21
191127256,6,7,7,4,0,24
191127257,7,5,2,4,7,25
191127258,3,5,5,9,9,31
191127259,2,5,9,8,4,28
191127260,6,7,5,6,1,25
191127261,1,8,4,9,1,23
191127262,3,5,9,5,6,28
191127263,4,8,9,1,0,22
191127264,6,8,2,8,6,30
191127265,8,4,5,0,7,24
191127266,9,6,8,7,2,32
191127267,9,8,7,8,1,33
191127268,3,9,3,0,5,20
191127269,9,8,4,8,5,34
191127270,0,3,5,6,9,23
191127271,7,1,9,1,9,27
191127272,7,9,7,3,5,31
191127273,1,2,0,8,9,20
191127274,6,3,1,1,4,15
191127275,9,9,6,4,3,31
191127276,4,0,3,4,1,12
191127277,5,4,7,4,6,26
191127278,5,7,4,7,1,24
191127279,1,2,4,3,4,14
191127280,5,5,2,1,8,21
191127281,9,0,6,7,7,29
191127282,4,2,6,4,5,21
191127283,2,3,0,7,5,17
191127284,5,3,7,9,8,32
191127285,2,2,5,4,8,21
191127286,5,6,8,4,4,27
191127287,9,3,3,3,5,23
191127288,2,5,4,0,7,18
191127289,1,6,5,3,7,22
191127290,2,9,9,8,8,36
191127291,4,3,9,0,1,17
191127292,5,4,6,2,8,25
191127293,2,3,4,9,8,26
191127294,9,1,3,1,9,23
191127295,0,9,2,7,7,25
191127296,1,8,2,7,3,21
191127297,1,2,8,4,1,16
191127298,2,5,0,0,2,9
191127299,0,2,1,8,8,19
191127300,4,0,7,9,9,29
191127301,4,3,6,7,5,25
191127302,6,6,6,5,5,28
191127303,8,6,2,4,9,29
191127304,1,7,2,8,0,18
191127305,9,1,6,8,8,32
191127306,4,7,9,8,2,30
191127307,5,3,3,0,5,16
191127308,8,5,8,2,9,32
191127309,6,7,2,6,2,23
191127310,2,0,8,8,3,21
191127311,3,0,5,3,7,18
191127312,3,6,6,7,3,25
191127313,6,8,0,6,1,21
191127314,0,8,0,1,8,17
191127315,9,3,9,4,6,31
191127316,9,7,6,9,8,39
191127317,2,2,6,8,0,18
191127318,7,0,3,4,3,17
191127319,1,6,6,1,9,23
191127320,7,4,9,4,3,27
191127321,6,3,5,3,6,23
191127322,8,5,0,0,4,17
191127323,4,4,8,8,8,32
191127324,7,4,4,8,3,26
191127325,0,2,1,1,8,12
191127326,2,1,0,2,7,12
191127327,0,7,3,1,0,11
191127328,5,3,8,6,1,23
191127329,7,0,1,2,6,16
191127330,8,9,5,0,9,31
191127331,2,9,2,3,6,22
191127332,0,7,8,3,4,22
191127333,6,3,1,3,2,15
191127334,9,8,2,9,3,31
191127335,1,2,1,6,5,15
191127336,5,6,6,8,4,29
191127337,1,5,0,9,1,16
191127338,0,7,4,6,0,17
191127339,5,0,4,7,3,19
191127340,7,8,3,5,8,31
191127341,0,9,1,4,3,17
191127342,5,0,4,4,0,13
191127343,5,1,6,2,4,18
191127344,3,5,7,9,8,32
191127345,6,4,9,3,9,31
191127346,1,8,8,6,5,28
191127347,1,9,2,5,1,18
191127348,9,6,5,8,0,28
191127349,4,8,4,4,2,22
191127350,5,5,1,8,2,21
191127351,4,0,6,7,5,22
191127352,6,3,1,5,4,19
191127353,1,0,5,8,9,23
191127354,1,9,2,3,6,21
191127355,9,4,1,3,8,25
191127356,2,6,4,1,5,18
191127357,1,9,4,4,8,26
191127358,9,6,4,8,9,36
191127359,6,9,3,5,8,31
191127360,5,9,6,4,0,24
191127361,0,7,9,5,0,21
191127362,6,2,2,6,3,19
191127363,9,2,2,8,0,21
191127364,9,4,5,4,0,22
191127365,9,4,2,6,8,29
191127366,0,6,8,8,7,29
191127367,9,1,6,6,5,27
191127368,0,2,2,0,5,9
191127369,2,9,1,3,6,21
191127370,2,7,9,9,1,28
191127371,0,4,6,2,5,17
191127372,7,2,6,1,5,21
191127373,6,6,7,0,0,19
191127374,1,2,2,5,6,16
191127375,6,6,6,8,1,27
191127376,1,3,5,8,5,22
191127377,4,0,9,6,5,24
191127378,8,5,1,6,9,29
191127379,1,8,3,9,9,30
191127380,2,7,5,2,3,19
191127381,4,7,0,7,0,18
191127382,7,1,0,3,6,17
191127383,1,9,6,8,7,31
191127384,9,1,1,5,3,19
191127385,2,6,4,0,5,17
191127386,9,3,9,9,9,39
191127387,5,8,4,7,3,27
191127388,3,4,9,0,4,20
191127389,7,2,4,2,5,20
191127390,6,4,0,7,3,20
191127391,5,8,8,3,1,25
191127392,8,5,3,0,4,20
191127393,7,0,2,0,1,10
191127394,1,5,2,5,7,20
191127395,5,0,6,9,0,20
191127396,4,0,4,8,1,17
191127397,5,1,3,4,0,13
191127398,5,9,5,7,0,26
191127399,7,8,4,6,7,32
191127400,6,7,1,3,2,19
191127401,2,1,6,8,8,25
191127402,7,0,1,1,9,18
191127403,3,3,8,5,4,23
191127404,7,9,5,1,5,27
191127405,4,5,7,1,6,23
191127406,2,4,2,7,8,23
191127407,8,2,5,3,4,22
191127408,6,2,9,9,4,30
191127409,9,8,1,4,3,25
191127410,6,9,2,8,0,25
191127411,7,6,3,0,2,18
191127412,3,4,1,7,5,20
191127413,9,2,6,7,1,25
191127414,1,1,9,3,5,19
191127415,3,4,7,6,7,27
191127416,6,4,3,1,6,20
191127417,2,2,8,1,0,13
191127418,0,1,9,9,8,27
191127419,1,4,6,6,7,24
191127420,4,9,4,1,4,22
191127421,4,7,9,7,9,36
191127422,8,6,2,6,9,31
191127423,5,8,2,6,4,25
191127424,1,9,3,2,4,19
191127425,6,9,3,6,8,32
191127426,9,4,4,9,4,30
191127427,4,1,8,9,6,28
191127428,2,0,1,0,2,5
191127429,4,9,9,4,4,30
191127430,3,4,7,8,4,26
191127431,2,3,9,3,4,21
191127432,9,3,6,7,1,26
191127433,8,3,4,7,6,28
191127434,7,3,8,2,0,20
191127435,2,0,9,6,7,24
191127436,6,4,4,6,9,29
191127437,9,9,8,0,4,30
191127438,5,2,8,5,6,26
191127439,3,3,4,0,3,13
191127440,4,6,4,2,4,20
191127441,5,1,1,2,9,18
191127442,0,5,5,4,6,20
191127443,5,5,3,8,0,21
191127444,9,1,2,7,0,19
191127445,1,9,6,5,4,25
191127446,9,7,2,8,5,31
191127447,8,9,6,3,8,34
191127448,2,3,7,5,0,17
191127449,8,3,9,3,9,32
191127450,1,3,7,8,3,22
191127451,1,5,3,2,0,11
191127452,2,2,0,4,9,17
191127453,0,7,2,4,5,18
191127454,6,0,2,5,0,13
191127455,7,6,0,6,8,27
191127456,1,0,8,4,3,16
191127457,8,3,4,4,2,21
191127458,1,4,1,3,1,10
191127459,6,5,8,6,2,27
191127460,5,9,1,2,7,24
191127461,5,2,9,1,9,26
191127462,8,3,1,3,8,23
191127463,7,4,6,8,5,30
191127464,6,5,4,6,8,29
191127465,7,2,5,5,8,27
191127466,3,3,4,4,4,18
191127467,5,0,3,7,4,19
191127468,2,1,1,0,9,13
191127469,8,0,1,0,5,14
191127470,8,2,5,9,8,32
191127471,5,2,6,1,1,15
191127472,0,0,8,9,9,26
191127473,0,2,8,2,4,16
191127474,1,1,1,7,1,11
191127475,1,7,7,8,5,28
191127476,2,3,8,3,0,16
191127477,5,8,1,2,1,17
191127478,0,4,2,2,4,12
191127479,4,6,6,6,4,26
191127480,0,1,7,2,5,15
191127481,7,6,9,9,3,34
191127482,7,1,2,2,8,20
191127483,1,5,1,5,5,17
191127484,8,3,8,3,5,27
191127485,4,7,8,0,7,26
191127486,9,8,7,0,9,33
191127487,0,0,1,9,3,13
191127488,8,5,4,3,1,21
191127489,6,8,8,0,8,30
191127490,0,4,9,3,2,18
191127491,4,7,5,9,5,30
191127492,0,8,0,8,5,21
191127493,9,4,5,0,0,18
191127494,3,7,2,5,4,21
191127495,6,6,2,4,4,22
191127496,5,5,3,2,7,22
191127497,9,0,8,7,4,28
191127498,6,5,5,5,5,26
191127499,0,0,2,8,9,19
191127500,6,7,6,8,1,28
191127501,0,9,4,6,0,19
191127502,4,5,2,5,9,25
191127503,2,5,3,9,3,22
191127504,4,2,9,7,9,31
191127505,1,8,0,9,6,24
191127506,0,7,9,3,8,27
191127507,1,3,0,5,4,13
191127508,9,9,9,5,0,32
191127509,3,4,5,7,8,27
191127510,1,9,5,1,2,18
191127511,8,0,9,0,7,24
191127512,9,6,6,9,5,35
191127513,3,5,7,5,4,24
191127514,3,6,9,5,7,30
191127515,1,6,8,9,7,31
191127516,0,1,6,8,3,18
191127517,0,5,6,4,0,15
191127518,9,9,3,6,2,29
191127519,8,7,3,4,3,25
191127520,4,2,0,6,8,20
191127521,2,2,2,5,9,20
191127522,6,9,9,3,4,31
191127523,9,3,9,2,1,24
191127524,7,7,0,9,2,25
191127525,2,8,4,2,5,21
191127526,9,5,7,4,7,32
191127527,5,2,2,4,3,16
191127528,6,7,3,6,0,22
191127529,3,8,4,5,8,28
191127530,8,7,0,1,4,20
191127531,3,2,3,0,3,11
191127532,4,5,6,0,0,15
191127533,3,9,7,5,7,31
191127534,4,6,8,5,7,30
191127535,6,6,6,3,8,29
191127536,5,3,3,4,8,23
191127537,9,1,4,1,3,18
191127538,9,2,3,8,1,23
191127539,4,5,4,1,8,22
191127540,4,1,0,1,3,9
191127541,1,3,8,3,0,15
191127542,3,9,6,6,2,26
191127543,6,2,8,0,2,18
191127544,4,0,2,7,5,18
191127545,8,8,5,3,7,31
191127546,6,3,1,0,1,11
191127547,6,3,9,4,0,22
191127548,4,4,9,2,8,27
191127549,4,2,5,0,1,12
191127550,0,4,3,9,7,23
191127551,1,0,2,6,1,10
191127552,0,1,8,4,9,22
191127553,8,9,9,0,3,29
191127554,9,4,1,1,9,24
191127555,1,5,0,2,7,15
191127556,0,0,2,6,8,16
191127557,5,1,2,2,4,14
191127558,6,9,5,3,8,31
191127559,5,2,9,7,7,30
191127560,0,1,1,9,8,19
191127561,5,3,9,5,6,28
191127562,0,9,0,5,0,14
191127563,9,5,7,6,3,30
191127564,8,3,6,4,4,25
191127565,2,7,0,5,5,19
191127566,8,7,7,8,2,32
191127567,2,8,3,9,3,25
191127568,7,6,3,8,7,31
191127569,5,8,9,8,1,31
191127570,1,0,3,3,7,14
191127571,1,9,1,9,2,22
191127572,3,6,9,0,1,19
191127573,6,9,3,8,8,34
191127574,1,2,2,2,8,15
191127575,6,9,8,7,6,36
191127576,9,5,5,7,7,33
191127577,9,5,2,9,0,25
191127578,7,0,0,8,2,17
191127579,4,4,9,7,7,31
191127580,1,9,3,0,4,17
191127581,2,9,9,6,3,29
191127582,9,4,5,9,1,28
191127583,7,6,1,6,1,21
191127584,5,5,8,5,4,27
191127585,3,6,2,9,3,23
191127586,1,8,4,7,5,25
191127587,5,6,0,9,3,23
191127588,4,4,2,4,7,21
191127589,2,0,5,0,1,8
191127590,3,5,1,4,4,17
191127591,0,8,6,0,8,22
191127592,9,8,6,6,0,29
191127593,7,1,4,3,7,22
191127594,0,2,1,7,9,19
191127595,0,5,3,2,5,15
191127596,5,7,5,7,5,29
191127597,2,1,8,1,0,12
191127598,2,4,1,5,4,16
191127599,3,5,7,8,7,30
191127600,5,3,7,9,6,30
191127601,4,8,4,2,5,23
191127602,6,1,1,6,5,19
191127603,9,3,6,3,8,29
191127604,9,5,1,5,4,24
191127605,5,6,9,5,6,31
191127606,3,2,8,0,0,13
191127607,8,2,1,0,9,20
191127608,9,3,1,6,2,21
191127609,8,8,8,9,1,34
191127610,0,9,3,4,9,25
191127611,5,9,2,2,9,27
191127612,5,3,9,5,4,26
191127613,8,3,2,9,9,31
191127614,2,4,1,2,6,15
191127615,4,5,5,2,9,25
191127616,2,9,1,3,1,16
191127617,3,5,0,2,5,15
191127618,4,7,0,0,6,17
191127619,5,5,3,2,8,23
191127620,7,0,8,4,5,24
191127621,0,6,5,6,0,17
191127622,4,6,8,4,1,23
191127623,5,6,9,3,6,29
191127624,4,7,3,0,1,15
191127625,3,3,3,0,5,14
191127626,5,9,4,5,4,27
191127627,8,8,3,2,9,30
191127628,1,8,8,8,8,33
191127629,6,1,3,7,4,21
191127630,1,0,3,9,9,22
191127631,0,0,3,3,4,10
191127632,4,4,0,4,7,19
191127633,3,5,0,3,1,12
191127634,2,4,9,1,4,20
191127635,6,1,2,5,3,17
191127636,7,7,2,6,9,31
191127637,6,0,6,8,2,22
191127638,9,7,8,2,7,33
191127639,9,3,7,9,9,37
191127640,5,7,8,7,9,36
191127641,4,1,5,7,0,17
191127642,7,9,8,8,4,36
191127643,6,4,0,9,7,26
191127644,0,9,2,7,3,21
191127645,2,3,5,6,3,19
191127646,8,1,3,5,6,23
191127647,3,5,9,2,4,23
191127648,9,3,5,9,1,27
191127649,3,6,2,0,7,18
191127650,4,2,4,1,6,17
191127651,6,0,9,7,0,22
191127652,9,8,1,9,3,30
191127653,0,0,5,8,2,15
191127654,5,6,9,3,5,28
191127655,1,9,0,6,8,24
191127656,7,3,5,5,3,23
191127657,9,2,9,2,1,23
191127658,5,5,8,2,4,24
191127659,3,6,6,1,4,20
191127660,6,3,9,2,4,24
191127661,5,6,2,0,3,16
191127662,6,5,9,5,0,25
191127663,0,4,6,3,7,20
191127664,6,3,0,2,5,16
191127665,0,9,2,2,2,15
191127666,0,3,3,2,4,12
191127667,7,8,1,9,1,26
191127668,5,0,8,6,2,21
191127669,6,5,4,0,5,20
191127670,1,1,8,1,1,12
191127671,7,3,8,3,4,25
191127672,4,5,7,2,1,19
191127673,7,5,2,6,6,26
191127674,5,9,7,7,3,31
191127675,2,6,6,6,8,28
191127676,8,8,7,9,1,33
191127677,9,3,0,0,7,19
191127678,4,4,7,5,9,29
191127679,9,2,4,5,6,26
191127680,8,5,2,7,4,26
191127681,6,0,6,4,6,22
191127682,4,9,9,8,9,39
191127683,1,0,1,4,3,9
191127684,8,8,6,4,9,35
191127685,4,8,7,6,5,30
191127686,1,8,6,3,5,23
191127687,0,2,2,2,7,13
191127688,3,5,1,7,0,16
191127689,1,2,0,3,9,15
191127690,6,0,4,6,6,22
191127691,6,5,1,5,1,18
191127692,0,0,1,2,4,7
191127693,3,0,5,3,0,11
191127694,1,3,2,5,9,20
191127695,0,3,5,9,4,21
191127696,5,3,4,8,6,26
191127697,6,1,9,9,8,33
191127698,9,6,2,6,1,24
191127699,1,8,5,2,0,16
191127700,0,1,8,1,0,10
191127701,7,4,9,4,9,33
191127702,1,2,1,8,8,20
191127703,7,8,7,9,3,34
191127704,9,3,6,8,9,35
191127705,3,9,9,8,9,38
191127706,5,8,4,8,9,34
191127707,0,1,0,2,1,4
191127708,1,9,3,2,3,18
191127709,6,7,1,7,7,28
191127710,4,1,6,4,2,17
191127711,7,7,9,8,7,38
191127712,2,2,1,0,5,10
191127713,3,3,5,1,4,16
191127714,9,9,4,0,5,27
191127715,9,2,6,5,6,28
191127716,4,2,4,3,0,13
191127717,0,2,2,8,2,14
191127718,0,8,7,8,5,28
191127719,5,1,4,5,3,18
191127720,3,0,5,4,1,13
191127721,2,6,3,2,4,17
191127722,9,1,5,0,9,24
191127723,9,5,5,2,5,26
191127724,2,0,6,4,0,12
191127725,6,4,3,7,2,22
191127726,5,7,2,8,4,26
191127727,4,7,9,5,9,34
191127728,7,5,0,0,8,20
191127729,5,0,4,2,1,12
191127730,5,3,7,7,1,23
191127731,4,0,5,3,2,14
191127732,0,1,8,2,2,13
191127733,6,9,3,6,3,27
191127734,3,6,8,3,7,27
191127735,0,3,7,0,1,11
191127736,7,1,7,4,4,23
191127737,4,0,8,2,0,14
191127738,8,5,9,3,0,25
191127739,5,4,2,0,5,16
191127740,8,3,2,0,2,15
191127741,3,3,2,2,1,11
191127742,8,6,0,2,6,22
191127743,6,2,8,1,0,17
191127744,5,9,3,4,7,28
191127745,4,2,0,5,0,11
191127746,9,1,8,2,0,20
191127747,0,6,0,9,9,24
191127748,7,9,4,2,1,23
191127749,2,1,6,7,6,22
191127750,4,0,9,8,6,27
191127751,3,3,9,2,2,19
191127752,7,0,1,1,7,16
191127753,7,7,5,4,4,27
191127754,3,8,4,3,6,24
191127755,6,8,3,4,4,25
191127756,0,5,2,2,2,11
191127757,2,7,3,6,6,24
191127758,9,9,9,0,2,29
191127759,0,8,7,5,1,21
191127760,2,3,7,3,0,15
191127761,2,8,7,9,9,35
191127762,2,7,6,2,0,17
191127763,4,9,5,6,4,28
191127764,0,5,0,0,4,9
191127765,7,5,3,5,7,27
191127766,3,6,0,0,3,12
191127767,3,2,7,1,8,21
191127768,5,0,2,1,1,9
191127769,5,1,3,6,3,18
191127770,4,7,6,7,7,31
191127771,5,3,3,1,2,14
191127772,2,2,0,7,4,15
191127773,8,3,3,1,0,15
191127774,4,1,7,9,8,29
191127775,4,5,0,4,3,16
191127776,3,6,3,1,0,13
191127777,1,5,9,8,8,31
191127778,6,1,5,3,2,17
191127779,4,8,9,3,0,24
191127780,3,1,1,2,3,10
191127781,2,4,5,1,2,14
191127782,5,7,2,4,6,24
191127783,9,4,9,4,2,28
191127784,1,5,8,2,4,20
191127785,0,3,7,7,6,23
191127786,2,0,5,5,1,13
191127787,0,3,4,5,5,17
191127788,7,5,6,2,1,21
191127789,2,7,6,4,5,24
191127790,7,1,8,1,3,20
191127791,7,2,0,2,3,14
191127792,8,0,2,5,2,17
191127793,2,7,1,5,6,21
191127794,2,9,3,7,2,23
191127795,9,0,8,8,2,27
191127796,5,1,9,4,3,22
191127797,0,5,2,9,8,24
191127798,0,9,5,5,9,28
191127799,1,1,7,3,5,17
191127800,9,2,6,4,2,23
191127801,8,4,5,7,7,31
191127802,9,7,7,1,6,30
191127803,0,1,4,2,6,13
191127804,1,7,0,2,5,15
191127805,6,4,8,3,0,21
191127806,4,7,3,4,9,27
191127807,3,8,5,6,9,31
191127808,6,1,0,0,5,12
191127809,1,3,4,8,2,18
191127810,6,4,4,4,0,18
191127811,5,3,0,5,4,17
191127812,0,5,5,8,4,22
191127813,5,5,2,0,4,16
191127814,1,4,2,4,8,19
191127815,3,9,0,0,8,20
191127816,6,6,2,2,1,17
191127817,1,4,7,0,7,19
191127818,2,8,3,7,1,21
191127819,3,0,1,1,7,12
191127820,5,6,5,2,7,25
191127821,1,2,7,7,9,26
191127822,7,9,0,1,7,24
191127823,5,9,4,8,1,27
191127824,0,7,3,6,3,19
191127825,8,5,2,9,6,30
191127826,1,2,5,5,1,14
191127827,4,3,8,4,2,21
191127828,7,6,1,6,3,23
191127829,7,6,7,5,1,26
191127830,3,9,3,7,9,31
191127831,9,7,7,4,7,34
191127832,1,5,8,5,8,27
191127833,2,3,4,7,2,18
191127834,9,2,2,6,3,22
191127835,5,1,7,3,1,17
191127836,2,9,8,0,3,22
191127837,6,8,1,0,3,18
191127838,1,7,3,8,9,28
191127839,8,2,0,4,4,18
191127840,8,0,1,0,7,16
191127841,4,3,9,6,9,31
191127842,8,8,5,6,4,31
191127843,2,6,3,1,2,14
191127844,6,3,7,9,1,26
191127845,0,3,6,5,6,20
191127846,5,6,0,7,4,22
191127847,9,7,7,3,3,29
191127848,5,8,1,0,2,16
191127849,7,7,1,0,8,23
191127850,5,4,4,9,9,31
191127851,3,0,7,8,3,21
191127852,9,4,9,3,0,25
191127853,9,1,5,7,1,23
191127854,3,7,7,1,5,23
191127855,3,0,3,0,5,11
191127856,7,0,8,5,9,29
191127857,3,0,5,2,6,16
191127858,3,6,0,8,7,24
191127859,5,1,7,6,0,19
191127860,7,3,6,6,2,24
191127861,9,3,4,7,8,31
191127862,5,1,4,0,3,13
191127863,8,2,7,4,3,24
191127864,9,1,2,0,8,20
191127865,2,6,8,8,9,33
191127866,2,3,4,6,7,22
191127867,9,2,2,8,7,28
191127868,5,6,0,6,4,21
191127869,7,6,9,0,9,31
191127870,2,3,9,0,2,16
191127871,4,1,7,0,7,19
191127872,8,4,4,2,8,26
191127873,3,1,5,3,0,12
191127874,7,5,0,6,3,21
191127875,3,7,7,4,2,23
191127876,4,9,9,5,7,34
191127877,2,0,6,1,7,16
191127878,0,4,7,8,0,19
191127879,0,4,1,2,7,14
191127880,3,4,6,8,2,23
191127881,5,8,0,0,1,14
191127882,0,6,7,3,6,22
191127883,4,3,0,9,3,19
191127884,1,7,9,6,6,29
191127885,0,7,4,6,4,21
191127886,6,8,0,3,2,19
191127887,8,2,1,4,5,20
191127888,7,9,4,6,9,35
191127889,6,9,5,0,4,24
191127890,4,2,9,8,5,28
191127891,3,5,2,2,5,17
191127892,1,0,5,3,2,11
191127893,3,0,1,9,3,16
191127894,2,6,6,9,8,31
191127895,7,8,1,0,9,25
191127896,5,9,9,5,4,32
191127897,8,7,4,1,4,24
191127898,5,8,1,8,7,29
191127899,5,0,1,2,4,12
191127900,8,4,8,6,0,26
191127901,1,3,2,3,6,15
191127902,8,5,4,0,3,20
191127903,6,0,1,9,3,19
191127904,1,6,3,9,5,24
191127905,7,3,7,1,5,23
191127906,2,1,6,3,1,13
191127907,2,1,7,3,3,16
191127908,0,5,5,3,5,18
191127909,7,5,9,6,0,27
191127910,8,8,4,0,4,24
191127911,7,7,3,2,1,20
191127912,2,5,5,5,3,20
191127913,4,5,4,8,5,26
191127914,5,5,0,4,5,19
191127915,7,6,1,3,8,25
191127916,8,7,2,8,3,28
191127917,1,6,1,0,4,12
191127918,1,0,2,1,4,8
191127919,8,0,0,6,2,16
191127920,2,6,3,6,7,24
191127921,9,6,8,5,9,37
191127922,9,7,9,1,4,30
191127923,8,3,5,5,3,24
191127924,0,5,5,2,2,14
191127925,0,6,0,5,0,11
191127926,0,1,0,8,6,15
191127927,9,8,0,1,7,25
191127928,5,6,4,5,7,27
191127929,5,8,9,7,1,30
191127930,0,8,7,8,8,31
191127931,6,7,9,8,2,32
191127932,7,2,6,0,0,15
191127933,9,9,3,1,4,26
191127934,5,2,2,0,3,12
191127935,6,4,6,7,7,30
191127936,4,6,5,3,3,21
191127937,8,5,3,7,7,30
191127938,9,4,7,2,7,29
191127939,8,2,5,3,1,19
191127940,0,4,2,1,0,7
191127941,5,8,5,9,9,36
191127942,5,6,0,5,6,22
191127943,7,8,0,0,8,23
191127944,5,1,7,1,8,22
191127945,6,0,0,6,2,14
191127946,2,2,7,8,6,25
191127947,4,3,2,5,1,15
191127948,0,3,6,8,7,24
191127949,1,4,9,0,5,19
191127950,1,3,2,3,8,17
191127951,1,0,1,8,8,18
191127952,9,6,1,6,8,30
191127953,0,5,8,8,0,21
191127954,6,1,4,6,3,20
191127955,6,9,0,6,3,24
191127956,0,2,4,8,3,17
191127957,9,0,1,6,1,17
191127958,0,5,3,8,5,21
191127959,2,1,1,4,5,13
191127960,2,0,1,7,1,11
191127961,1,0,9,3,2,15
191127962,4,4,7,1,6,22
191127963,7,1,5,1,6,20
191127964,1,7,3,2,8,21
191127965,7,6,0,5,7,25
191127966,3,0,6,0,2,11
191127967,9,2,3,7,7,28
191127968,0,0,1,7,8,16
191127969,9,0,1,8,7,25
191127970,8,7,6,8,9,38
191127971,4,5,8,4,2,23
191127972,1,4,9,4,1,19
191127973,4,2,0,5,3,14
191127974,2,5,5,5,9,26
191127975,2,5,7,6,2,22
191127976,5,8,9,3,3,28
191127977,8,4,2,5,1,20
191127978,3,3,6,8,3,23
191127979,0,6,7,1,6,20
191127980,1,3,0,5,0,9
191127981,6,9,3,2,4,24
191127982,2,4,5,0,8,19
191127983,5,2,9,9,0,25
191127984,9,7,3,1,8,28
191127985,5,9,8,9,2,33
191127986,7,8,9,2,8,34
191127987,0,9,5,0,0,14
191127988,2,8,7,9,4,30
191127989,5,9,5,5,1,25
191127990,2,3,7,6,7,25
191127991,1,4,3,3,9,20
191127992,7,0,3,4,6,20
191127993,8,5,8,4,1,26
191127994,1,2,6,4,6,19
191127995,9,4,0,6,8,27
191127996,6,5,0,4,2,17
191127997,9,7,8,1,9,34
191127998,8,5,3,6,4,26
191127999,0,1,2,6,9,18
1911271000,7,6,9,5,6,33
1911271001,3,1,9,3,4,20
1911271002,2,2,5,1,7,17
1911271003,3,1,3,6,3,16
1911271004,8,1,2,9,4,24
1911271005,7,3,2,5,6,23
1911271006,0,3,9,3,2,17
1911271007,5,6,5,0,6,22
1911271008,2,0,3,9,4,18
1911271009,0,3,4,7,4,18
1911271010,4,7,7,5,1,24
1911271011,5,2,0,4,9,20
1911271012,1,5,6,5,2,19
1911271013,5,9,1,5,0,20
1911271014,2,3,5,9,3,22
1911271015,4,5,8,1,3,21
1911271016,5,1,8,7,8,29
1911271017,1,1,7,9,0,18
1911271018,9,5,1,5,8,28
1911271019,0,2,0,3,2,7
1911271020,4,7,6,4,5,26
1911271021,2,7,6,5,6,26
1911271022,1,8,2,9,9,29
1911271023,8,9,5,1,7,30
1911271024,0,0,9,6,7,22
1911271025,6,8,5,2,7,28
1911271026,0,9,0,2,0,11
1911271027,3,1,9,6,6,25
1911271028,1,4,0,2,5,12
1911271029,7,9,5,2,1,24
1911271030,3,8,7,6,9,33
1911271031,8,8,5,4,5,30
1911271032,0,2,3,2,6,13
1911271033,6,9,8,9,0,32
1911271034,8,4,3,2,7,24
1911271035,9,9,3,3,6,30
1911271036,7,2,7,7,6,29
1911271037,3,8,2,4,2,19
1911271038,4,9,1,6,6,26
1911271039,4,6,0,1,3,14
1911271040,1,3,7,3,8,22
1911271041,2,3,6,9,1,21
1911271042,5,8,3,5,4,25
1911271043,0,0,8,5,2,15
1911271044,6,0,0,3,3,12
1911271045,7,1,1,2,3,14
1911271046,3,1,6,1,9,20
1911271047,2,0,2,2,9,15
1911271048,4,0,0,5,0,9
1911271049,0,8,6,0,2,16
1911271050,7,7,8,5,6,33
1911271051,9,0,9,6,8,32
1911271052,9,4,0,4,0,17
1911271053,9,8,5,7,5,34
1911271054,6,3,6,8,7,30
1911271055,4,9,6,6,7,32
1911271056,8,0,1,4,9,22
1911271057,2,8,5,1,7,23
1911271058,2,3,1,9,5,20
1911271059,6,6,6,6,1,25
1911271060,0,3,6,8,4,21
1911271061,4,2,6,4,8,24
1911271062,6,6,3,1,6,22
1911271063,1,8,0,8,6,23
1911271064,6,7,2,8,1,24
1911271065,0,5,6,4,1,16
1911271066,2,1,7,3,6,19
1911271067,2,1,4,6,1,14
1911271068,1,7,1,5,4,18
1911271069,3,3,7,0,3,16
1911271070,8,8,5,5,4,30
1911271071,6,4,7,3,7,27
1911271072,5,5,0,9,8,27
1911271073,4,9,9,9,7,38
1911271074,9,0,8,4,0,21
1911271075,0,9,5,9,0,23
1911271076,4,6,6,5,9,30
1911271077,7,3,5,8,2,25
1911271078,3,1,8,8,0,20
1911271079,6,7,6,7,0,26
1911271080,2,5,3,9,0,19
1911271081,2,4,0,6,1,13
1911271082,5,3,2,0,7,17
1911271083,9,1,2,7,7,26
1911271084,9,2,0,3,0,14
1911271085,9,3,4,9,8,33
1911271086,3,6,0,2,9,20
1911271087,8,3,9,6,1,27
1911271088,3,9,3,5,7,27
1911271089,2,7,1,8,4,22
1911271090,0,8,7,5,7,27
1911271091,7,6,9,4,3,29
1911271092,4,2,0,1,2,9
1911271093,4,1,6,5,6,22
1911271094,1,7,1,3,5,17
1911271095,3,8,0,4,7,22
1911271096,9,7,1,8,4,29
1911271097,4,3,3,0,3,13
1911271098,4,8,4,8,2,26
1911271099,5,1,7,9,4,26
1911271100,1,7,2,3,3,16
1911271101,9,6,6,9,1,31
1911271102,3,5,6,9,1,24
1911271103,1,3,2,6,4,16
1911271104,6,9,4,4,0,23
1911271105,9,6,2,6,0,23
191128001,5,2,2,3,2,14
191128002,6,6,0,8,3,23
191128003,6,3,5,4,2,20
191128004,2,9,8,1,7,27
191128005,1,8,5,5,5,24
191128006,4,6,0,9,8,27
191128007,1,8,4,2,3,18
191128008,3,0,4,8,8,23
191128009,9,5,2,9,4,29
191128010,5,1,7,8,6,27
191128011,2,2,3,4,5,16
191128012,8,9,0,5,2,24
191128013,2,7,1,4,3,17
191128014,1,3,4,8,4,20
191128015,1,3,7,3,6,20
191128016,8,3,7,5,2,25
191128017,0,9,6,2,2,19
191128018,3,4,9,7,0,23
191128019,7,0,4,6,7,24
191128020,6,8,6,0,7,27
191128021,1,7,6,4,0,18
191128022,7,7,9,5,5,33
191128023,9,7,5,1,0,22
191128024,0,3,6,3,5,17
191128025,7,8,4,7,4,30
191128026,2,2,7,5,8,24
191128027,6,5,9,4,3,27
191128028,3,0,8,6,0,17
191128029,9,3,4,1,1,18
191128030,8,9,8,6,8,39
191128031,0,7,2,3,7,19
191128032,5,3,4,3,1,16
191128033,9,0,2,0,5,16
191128034,2,3,4,8,8,25
191128035,1,1,3,7,3,15
191128036,7,0,0,8,3,18
191128037,9,2,4,3,7,25
191128038,4,1,5,1,5,16
191128039,4,4,2,4,3,17
191128040,3,2,5,5,8,23
191128041,4,0,2,3,6,15
191128042,8,9,5,1,1,24
191128043,0,4,8,9,1,22
191128044,5,1,0,4,6,16
191128045,2,1,4,1,1,9
191128046,9,4,3,0,7,23
191128047,8,6,2,4,4,24
191128048,1,0,1,2,8,12
191128049,9,6,4,7,3,29
191128050,2,5,0,4,7,18
191128051,4,8,9,8,2,31
191128052,6,1,3,5,3,18
191128053,9,2,2,7,9,29
191128054,9,8,2,7,7,33
191128055,1,6,0,9,2,18
191128056,9,8,4,9,4,34
191128057,9,3,7,4,7,30
191128058,6,5,7,9,6,33
191128059,0,5,1,6,8,20
191128060,3,7,2,8,4,24
191128061,0,5,4,2,5,16
191128062,4,9,4,6,3,26
191128063,9,9,5,8,6,37
191128064,1,6,5,0,8,20
191128065,6,7,2,3,7,25
191128066,7,9,2,8,7,33
191128067,4,1,9,8,5,27
191128068,1,5,4,5,1,16
191128069,9,9,8,0,2,28
191128070,1,6,8,6,1,22
191128071,1,2,7,0,4,14
191128072,1,0,4,3,2,10
191128073,1,6,2,6,8,23
191128074,7,4,5,1,6,23
191128075,0,5,4,9,2,20
191128076,0,5,0,6,9,20
191128077,1,1,9,8,0,19
191128078,8,8,9,4,0,29
191128079,0,0,7,5,0,12
191128080,1,8,6,4,2,21
191128081,4,0,2,9,3,18
191128082,6,0,3,5,8,22
191128083,4,6,2,1,0,13
191128084,2,3,7,6,0,18
191128085,5,0,6,3,3,17
191128086,5,0,1,3,5,14
191128087,2,6,6,4,2,20
191128088,4,9,6,5,3,27
191128089,1,5,3,0,7,16
191128090,9,0,1,6,8,24
191128091,1,3,9,0,6,19
191128092,6,8,3,4,1,22
191128093,5,3,3,8,9,28
191128094,2,5,6,0,0,13
191128095,4,0,5,2,5,16
191128096,1,7,6,4,1,19
191128097,8,8,4,5,8,33
191128098,2,6,2,5,5,20
191128099,4,6,7,0,2,19
191128100,0,4,3,1,0,8
191128101,7,3,6,7,3,26
191128102,9,9,3,0,0,21
191128103,8,3,1,7,5,24
191128104,8,8,4,2,9,31
191128105,4,4,3,1,4,16
191128106,9,6,5,3,2,25
191128107,5,3,6,0,1,15
191128108,9,0,0,9,2,20
191128109,7,7,5,7,0,26
191128110,8,3,9,4,6,30
191128111,3,5,1,2,3,14
191128112,4,2,4,3,3,16
191128113,4,6,4,0,6,20
191128114,4,7,9,1,2,23
191128115,8,7,5,4,5,29
191128116,1,4,7,2,0,14
191128117,0,9,8,9,6,32
191128118,6,9,4,4,4,27
191128119,1,7,6,8,8,30
191128120,2,9,2,2,4,19
191128121,4,3,7,4,4,22
191128122,6,4,9,2,3,24
191128123,8,8,0,5,4,25
191128124,4,4,9,5,8,30
191128125,9,1,6,4,7,27
191128126,6,0,7,4,1,18
191128127,1,9,8,5,0,23
191128128,7,0,5,2,1,15
191128129,7,5,1,5,4,22
191128130,4,5,4,3,1,17
191128131,9,4,5,2,1,21
191128132,0,8,1,0,5,14
191128133,8,6,2,0,8,24
191128134,2,7,5,8,8,30
191128135,7,1,5,4,8,25
191128136,9,3,1,8,9,30
191128137,1,6,8,9,0,24
191128138,5,5,5,9,8,32
191128139,5,5,9,8,1,28
191128140,5,2,4,2,3,16
191128141,7,9,9,7,4,36
191128142,6,9,8,1,0,24
191128143,3,1,7,9,4,24
191128144,8,1,9,2,8,28
191128145,3,0,8,6,5,22
191128146,9,6,4,6,6,31
191128147,8,5,3,2,3,21
191128148,1,3,5,0,9,18
191128149,6,3,3,7,6,25
191128150,6,3,1,2,1,13
191128151,9,6,3,8,9,35
191128152,0,8,0,0,7,15
191128153,7,0,2,1,8,18
191128154,7,4,8,7,6,32
191128155,6,0,0,3,1,10
191128156,4,2,0,3,4,13
191128157,2,4,3,5,4,18
191128158,9,5,2,6,3,25
191128159,2,7,3,7,7,26
191128160,5,6,0,8,3,22
191128161,0,4,7,8,5,24
191128162,3,5,8,6,5,27
191128163,6,4,2,2,5,19
191128164,8,1,5,4,4,22
191128165,3,6,8,6,8,31
191128166,8,8,5,1,6,28
191128167,2,5,7,2,1,17
191128168,4,3,3,8,1,19
191128169,1,7,0,5,8,21
191128170,4,7,7,3,0,21
191128171,1,6,6,4,5,22
191128172,4,8,4,5,9,30
191128173,7,8,1,4,3,23
191128174,1,3,5,1,6,16
191128175,7,5,5,3,2,22
191128176,3,8,0,6,6,23
191128177,7,8,7,4,4,30
191128178,0,7,0,0,4,11
191128179,8,3,8,6,2,27
191128180,9,1,0,9,5,24
191128181,5,5,3,5,2,20
191128182,5,5,8,1,6,25
191128183,4,5,1,9,7,26
191128184,3,4,6,7,0,20
191128185,7,2,1,8,8,26
191128186,2,8,6,8,0,24
191128187,2,5,9,2,2,20
191128188,3,9,0,6,9,27
191128189,8,5,1,9,6,29
191128190,2,6,1,6,8,23
191128191,4,5,3,8,9,29
191128192,3,7,1,5,2,18
191128193,5,9,8,5,8,35
191128194,2,7,1,7,0,17
191128195,9,7,2,9,0,27
191128196,8,0,0,4,0,12
191128197,8,7,8,9,8,40
191128198,2,1,5,2,1,11
191128199,8,7,5,5,4,29
191128200,3,1,3,5,6,18
191128201,5,9,9,8,0,31
191128202,1,6,0,0,9,16
191128203,0,2,7,8,8,25
191128204,2,1,5,1,0,9
191128205,3,8,5,8,9,33
191128206,7,8,0,5,8,28
191128207,8,1,4,5,6,24
191128208,2,4,2,8,1,17
191128209,5,7,4,5,0,21
191128210,2,8,4,9,2,25
191128211,5,3,6,2,4,20
191128212,4,1,3,9,8,25
191128213,3,5,1,5,3,17
191128214,3,2,9,4,2,20
191128215,9,6,6,1,7,29
191128216,5,2,0,7,8,22
191128217,2,4,1,8,1,16
191128218,9,7,4,0,7,27
191128219,8,6,1,1,7,23
191128220,4,1,8,0,4,17
191128221,1,8,3,8,3,23
191128222,9,2,3,1,7,22
191128223,3,6,2,1,2,14
191128224,1,7,3,9,2,22
191128225,7,6,6,6,8,33
191128226,5,8,2,8,6,29
191128227,0,7,3,7,7,24
191128228,7,4,5,0,5,21
191128229,5,1,0,2,0,8
191128230,7,7,4,3,0,21
191128231,6,4,4,3,0,17
191128232,1,4,7,5,6,23
191128233,7,9,5,9,7,37
191128234,6,7,1,2,1,17
191128235,8,6,5,9,2,30
191128236,3,8,4,0,4,19
191128237,6,8,7,7,2,30
191128238,1,8,3,5,4,21
191128239,7,7,5,7,9,35
191128240,4,9,3,8,8,32
191128241,9,6,6,1,1,23
191128242,7,8,5,5,1,26
191128243,2,4,3,8,1,18
191128244,2,1,2,3,2,10
191128245,5,4,7,1,3,20
191128246,6,3,3,2,7,21
191128247,2,5,7,1,0,15
191128248,4,6,4,4,5,23
191128249,8,5,6,9,2,30
191128250,1,2,1,4,0,8
191128251,7,0,6,6,8,27
191128252,1,6,5,5,3,20
191128253,6,7,0,6,2,21
191128254,3,8,8,9,5,33
191128255,6,3,5,1,1,16
191128256,0,5,3,4,0,12
191128257,2,0,9,3,8,22
191128258,5,5,4,8,5,27
191128259,2,1,1,2,7,13
191128260,9,3,6,2,2,22
191128261,7,3,6,6,3,25
191128262,3,6,7,8,1,25
191128263,2,9,3,2,7,23
191128264,9,4,3,9,3,28
191128265,0,6,0,1,2,9
191128266,7,0,1,2,5,15
191128267,7,7,8,2,0,24
191128268,4,4,5,0,9,22
191128269,2,2,9,1,6,20
191128270,6,5,4,2,1,18
191128271,6,1,9,6,3,25
191128272,4,4,9,9,3,29
191128273,6,5,3,1,8,23
191128274,3,7,1,9,1,21
191128275,6,3,6,4,5,24
191128276,4,6,6,4,2,22
191128277,9,7,9,6,0,31
191128278,4,3,4,9,7,27
191128279,6,1,9,3,7,26
191128280,8,2,9,5,8,32
191128281,9,4,0,2,1,16
191128282,7,6,4,1,6,24
191128283,7,2,2,5,0,16
191128284,7,8,3,5,0,23
191128285,3,5,5,3,0,16
191128286,9,1,9,3,4,26
191128287,4,5,9,3,0,21
191128288,4,1,0,3,7,15
191128289,2,3,2,7,5,19
191128290,6,3,5,0,5,19
191128291,2,5,3,8,4,22
191128292,7,5,7,3,8,30
191128293,7,1,3,3,3,17
191128294,3,5,5,2,3,18
191128295,0,6,1,1,3,11
191128296,1,4,9,4,0,18
191128297,1,3,1,1,4,10
191128298,5,2,0,9,9,25
191128299,3,1,3,5,5,17
191128300,4,4,7,6,6,27
191128301,9,0,9,7,5,30
191128302,4,8,4,9,2,27
191128303,7,5,0,8,0,20
191128304,0,4,1,7,9,21
191128305,4,1,6,0,7,18
191128306,8,5,2,9,8,32
191128307,7,2,7,3,5,24
191128308,2,4,9,4,9,28
191128309,2,9,7,3,3,24
191128310,9,6,9,9,9,42
191128311,3,6,4,1,5,19
191128312,5,3,7,2,5,22
191128313,3,3,3,0,7,16
191128314,3,9,4,2,2,20
191128315,1,4,4,0,1,10
191128316,8,8,0,2,7,25
191128317,2,1,6,4,0,13
191128318,3,8,4,0,1,16
191128319,5,2,4,3,0,14
191128320,7,6,2,2,8,25
191128321,6,1,3,9,7,26
191128322,8,8,2,1,0,19
191128323,3,5,8,2,9,27
191128324,5,9,9,4,1,28
191128325,2,1,3,3,3,12
191128326,7,7,0,4,5,23
191128327,0,3,4,0,9,16
191128328,5,9,4,5,6,29
191128329,0,0,7,1,1,9
191128330,4,1,5,7,9,26
191128331,5,4,3,2,3,17
191128332,2,1,7,2,3,15
191128333,4,2,0,5,2,13
191128334,6,7,9,7,4,33
191128335,0,4,1,9,2,16
191128336,5,6,0,6,9,26
191128337,8,1,8,2,1,20
191128338,4,9,2,4,8,27
191128339,7,8,6,8,0,29
191128340,5,2,7,1,3,18
191128341,3,5,1,8,6,23
191128342,0,8,1,0,8,17
191128343,9,3,0,8,2,22
191128344,8,4,7,2,2,23
191128345,6,8,3,8,7,32
191128346,9,3,6,8,3,29
191128347,5,3,9,2,1,20
191128348,1,4,8,7,9,29
191128349,8,7,7,0,0,22
191128350,1,3,9,1,1,15
191128351,9,9,5,1,1,25
191128352,9,8,4,2,6,29
191128353,1,0,2,8,6,17
191128354,6,5,6,9,5,31
191128355,5,5,9,7,8,34
191128356,9,9,9,9,3,39
191128357,3,7,8,0,8,26
191128358,8,2,7,6,3,26
191128359,0,7,4,8,2,21
191128360,3,6,7,0,9,25
191128361,7,3,4,1,5,20
191128362,0,0,5,0,6,11
191128363,0,2,8,4,7,21
191128364,4,5,2,5,3,19
191128365,1,8,2,7,8,26
191128366,2,7,6,2,7,24
191128367,6,4,2,9,1,22
191128368,8,4,9,1,3,25
191128369,4,0,6,1,2,13
191128370,2,8,0,4,2,16
191128371,8,6,0,6,2,22
191128372,2,4,1,0,7,14
191128373,4,2,0,9,8,23
191128374,7,9,1,1,3,21
191128375,2,8,8,2,8,28
191128376,6,8,7,7,6,34
191128377,1,0,8,0,7,16
191128378,6,5,0,9,8,28
191128379,6,3,4,7,9,29
191128380,9,0,2,9,3,23
191128381,6,6,0,9,7,28
191128382,1,3,6,2,6,18
191128383,8,7,1,6,5,27
191128384,7,0,0,4,7,18
191128385,5,0,9,9,4,27
191128386,4,3,2,3,0,12
191128387,5,9,6,2,9,31
191128388,0,8,8,3,9,28
191128389,6,3,9,1,8,27
191128390,8,1,0,4,8,21
191128391,9,2,0,8,3,22
191128392,5,3,8,3,6,25
191128393,5,0,2,0,4,11
191128394,6,6,4,8,5,29
191128395,4,5,8,1,8,26
191128396,3,0,3,5,4,15
191128397,0,8,8,1,6,23
191128398,5,3,1,8,8,25
191128399,1,4,3,7,7,22
191128400,6,7,2,4,5,24
191128401,1,4,9,4,8,26
191128402,3,1,6,7,8,25
191128403,4,3,7,0,2,16
191128404,8,6,9,1,0,24
191128405,2,5,2,8,9,26
191128406,7,4,1,3,0,15
191128407,2,5,6,3,0,16
191128408,7,8,8,2,6,31
191128409,0,2,9,6,1,18
191128410,8,4,6,2,9,29
191128411,8,5,4,6,4,27
191128412,4,1,2,8,4,19
191128413,9,8,6,5,0,28
191128414,9,4,7,4,0,24
191128415,6,7,4,7,9,33
191128416,7,9,4,5,3,28
191128417,2,9,7,3,5,26
191128418,2,8,0,4,3,17
191128419,9,1,1,4,5,20
191128420,1,1,2,2,2,8
191128421,2,4,7,2,5,20
191128422,2,7,4,3,1,17
191128423,0,9,3,7,0,19
191128424,7,1,8,4,0,20
191128425,5,3,8,1,5,22
191128426,0,0,9,1,4,14
191128427,0,1,1,9,5,16
191128428,1,3,4,3,6,17
191128429,5,3,1,0,4,13
191128430,4,8,5,2,6,25
191128431,6,6,8,2,8,30
191128432,1,5,9,3,2,20
191128433,1,2,2,3,2,10
191128434,8,5,5,4,8,30
191128435,0,3,6,5,8,22
191128436,5,6,6,7,0,24
191128437,7,1,3,2,8,21
191128438,5,6,8,9,6,34
191128439,2,6,5,2,3,18
191128440,2,3,8,8,8,29
191128441,5,8,8,7,1,29
191128442,4,2,9,4,0,19
191128443,3,1,3,4,9,20
191128444,0,7,3,3,9,22
191128445,9,9,6,9,8,41
191128446,6,3,1,0,7,17
191128447,4,6,4,8,2,24
191128448,6,1,8,7,5,27
191128449,3,4,9,5,1,22
191128450,3,6,7,4,4,24
191128451,6,7,3,0,6,22
191128452,5,8,3,5,3,24
191128453,3,4,0,7,9,23
191128454,2,5,5,4,7,23
191128455,2,8,9,8,3,30
191128456,1,6,6,2,2,17
191128457,5,0,2,4,9,20
191128458,7,3,8,4,3,25
191128459,8,7,2,2,7,26
191128460,0,7,4,3,1,15
191128461,4,1,0,7,7,19
191128462,3,8,7,2,5,25
191128463,9,8,0,8,7,32
191128464,9,9,4,5,7,34
191128465,2,4,8,9,0,23
191128466,7,8,9,8,7,39
191128467,1,4,4,8,7,24
191128468,9,3,0,7,2,21
191128469,0,9,6,1,8,24
191128470,9,8,9,4,8,38
191128471,1,0,0,6,0,7
191128472,1,2,7,3,8,21
191128473,2,5,7,8,9,31
191128474,5,2,7,6,1,21
191128475,6,5,9,0,1,21
191128476,7,6,3,5,9,30
191128477,2,3,4,0,8,17
191128478,0,1,6,9,7,23
191128479,8,6,8,8,9,39
191128480,5,0,2,8,1,16
191128481,9,3,1,5,6,24
191128482,1,6,5,4,3,19
191128483,8,1,1,9,8,27
191128484,3,0,7,0,6,16
191128485,8,6,0,1,8,23
191128486,9,9,8,8,3,37
191128487,2,0,8,1,4,15
191128488,5,9,9,6,4,33
191128489,2,5,4,6,9,26
191128490,5,0,5,5,3,18
191128491,7,1,9,2,2,21
191128492,3,2,9,1,9,24
191128493,3,4,5,1,7,20
191128494,1,2,7,8,8,26
191128495,9,0,9,8,9,35
191128496,8,7,8,9,1,33
191128497,5,5,2,7,9,28
191128498,8,1,7,3,7,26
191128499,7,2,5,9,7,30
191128500,4,0,1,0,4,9
191128501,5,8,0,7,1,21
191128502,0,7,2,8,4,21
191128503,5,2,0,1,5,13
191128504,2,5,3,0,5,15
191128505,2,9,6,6,7,30
191128506,6,5,3,6,8,28
191128507,3,8,7,7,2,27
191128508,1,1,8,0,4,14
191128509,4,7,1,4,0,16
191128510,5,0,5,8,4,22
191128511,0,5,3,0,1,9
191128512,2,9,2,0,2,15
191128513,9,0,4,6,3,22
191128514,1,6,9,3,0,19
191128515,4,0,4,1,8,17
191128516,2,5,1,0,0,8
191128517,5,7,3,0,2,17
191128518,9,4,6,1,8,28
191128519,8,6,0,8,6,28
191128520,2,7,2,7,7,25
191128521,7,8,2,0,3,20
191128522,5,1,2,1,8,17
191128523,5,0,0,0,9,14
191128524,2,0,2,5,4,13
191128525,7,0,9,5,7,28
191128526,9,8,8,2,9,36
191128527,2,0,9,2,6,19
191128528,3,5,6,7,7,28
191128529,6,4,7,8,8,33
191128530,1,1,2,0,9,13
191128531,0,2,9,2,8,21
191128532,7,8,6,7,6,34
191128533,2,0,4,0,4,10
191128534,0,8,6,6,1,21
191128535,2,9,1,1,5,18
191128536,1,1,1,3,7,13
191128537,8,4,8,2,5,27
191128538,5,8,7,2,1,23
191128539,8,3,0,9,5,25
191128540,3,4,6,2,2,17
191128541,8,4,0,8,0,20
191128542,1,0,6,9,2,18
191128543,7,0,8,9,4,28
191128544,9,8,2,2,8,29
191128545,7,3,5,7,9,31
191128546,4,7,9,1,5,26
191128547,8,4,7,0,5,24
191128548,3,8,8,3,4,26
191128549,8,6,4,4,2,24
191128550,3,6,3,8,0,20
191128551,1,3,6,9,9,28
191128552,4,5,8,0,4,21
191128553,8,5,1,0,0,14
191128554,3,1,7,0,6,17
191128555,5,4,2,9,7,27
191128556,4,8,9,1,9,31
191128557,2,2,1,6,3,14
191128558,3,3,2,8,8,24
191128559,9,0,0,1,2,12
191128560,4,1,8,4,4,21
191128561,1,9,6,2,2,20
191128562,3,2,3,4,8,20
191128563,2,8,8,8,7,33
191128564,2,7,8,7,3,27
191128565,8,4,9,8,9,38
191128566,2,5,8,5,0,20
191128567,9,7,7,6,0,29
191128568,2,2,6,9,7,26
191128569,4,0,3,3,6,16
191128570,1,9,2,0,7,19
191128571,4,3,2,5,3,17
191128572,2,6,6,8,8,30
191128573,6,9,8,4,1,28
191128574,4,8,3,3,6,24
191128575,7,8,9,9,3,36
191128576,4,2,9,9,2,26
191128577,0,6,5,5,9,25
191128578,4,6,3,3,3,19
191128579,8,9,0,5,4,26
191128580,4,5,7,2,4,22
191128581,1,4,8,2,9,24
191128582,5,7,6,2,6,26
191128583,1,9,1,8,4,23
191128584,1,3,9,4,2,19
191128585,2,5,8,7,6,28
191128586,8,1,9,8,8,34
191128587,9,4,1,3,1,18
191128588,0,2,2,0,6,10
191128589,6,0,5,7,3,21
191128590,8,1,3,4,7,23
191128591,1,1,0,1,2,5
191128592,5,3,2,6,5,21
191128593,7,0,3,6,3,19
191128594,3,3,3,9,5,23
191128595,8,8,4,0,7,27
191128596,7,5,9,5,8,34
191128597,5,2,7,1,7,22
191128598,5,7,3,1,4,20
191128599,5,6,6,7,2,26
191128600,1,1,3,2,4,11
191128601,8,1,0,0,3,12
191128602,0,0,1,5,9,15
191128603,0,1,2,7,8,18
191128604,2,9,6,9,5,31
191128605,4,2,2,0,8,16
191128606,3,9,3,6,4,25
191128607,4,5,0,2,6,17
191128608,0,3,9,5,9,26
191128609,3,0,5,7,6,21
191128610,1,4,9,9,4,27
191128611,1,7,4,1,0,13
191128612,3,0,4,0,1,8
191128613,4,8,9,9,4,34
191128614,0,8,6,4,2,20
191128615,2,2,6,5,2,17
191128616,1,5,4,3,2,15
191128617,0,7,2,3,5,17
191128618,1,4,8,0,2,15
191128619,1,9,8,2,8,28
191128620,8,2,1,6,2,19
191128621,4,2,8,6,1,21
191128622,8,0,6,3,8,25
191128623,2,1,2,4,0,9
191128624,7,1,8,8,1,25
191128625,0,4,9,9,5,27
191128626,1,3,1,6,8,19
191128627,4,5,9,1,8,27
191128628,7,8,8,6,9,38
191128629,0,6,8,9,3,26
191128630,4,4,4,0,6,18
191128631,3,4,9,8,9,33
191128632,8,5,9,7,5,34
191128633,0,2,9,1,1,13
191128634,6,6,8,4,1,25
191128635,5,5,8,2,7,27
191128636,7,4,3,4,4,22
191128637,6,2,1,3,6,18
191128638,3,3,6,7,0,19
191128639,0,9,8,8,3,28
191128640,0,3,3,6,3,15
191128641,8,9,0,7,6,30
191128642,9,0,9,1,6,25
191128643,7,9,1,6,0,23
191128644,6,2,1,4,0,13
191128645,4,0,8,2,9,23
191128646,0,0,8,0,3,11
191128647,1,7,8,3,4,23
191128648,8,0,3,0,1,12
191128649,7,7,6,1,0,21
191128650,0,1,7,5,6,19
191128651,7,1,8,5,6,27
191128652,3,2,5,7,9,26
191128653,9,7,7,3,2,28
191128654,2,7,4,1,1,15
191128655,2,2,8,4,6,22
191128656,5,7,7,2,0,21
191128657,3,2,8,1,5,19
191128658,4,5,5,2,6,22
191128659,7,1,0,1,2,11
191128660,2,5,6,7,8,28
191128661,6,3,9,6,7,31
191128662,1,8,9,8,2,28
191128663,7,6,9,0,1,23
191128664,7,8,3,6,3,27
191128665,7,9,0,9,0,25
191128666,7,7,9,9,2,34
191128667,8,4,4,7,6,29
191128668,7,0,2,7,3,19
191128669,9,8,0,6,8,31
191128670,3,2,3,1,3,12
191128671,7,7,0,5,6,25
191128672,5,1,7,8,1,22
191128673,2,9,5,8,0,24
191128674,0,5,6,8,8,27
191128675,7,5,3,2,5,22
191128676,5,0,7,3,2,17
191128677,1,9,5,3,2,20
191128678,1,7,2,5,7,22
191128679,9,2,0,6,4,21
191128680,5,0,0,8,0,13
191128681,4,6,1,4,9,24
191128682,3,4,4,2,6,19
191128683,9,7,9,9,7,41
191128684,5,5,4,7,8,29
191128685,4,9,0,6,6,25
191128686,0,3,1,6,1,11
191128687,1,9,3,6,1,20
191128688,3,2,5,4,8,22
191128689,8,9,9,3,1,30
191128690,9,2,7,4,4,26
191128691,1,9,1,4,1,16
191128692,6,2,1,2,6,17
191128693,1,5,5,9,6,26
191128694,2,2,6,5,9,24
191128695,8,3,2,3,8,24
191128696,6,6,3,5,2,22
191128697,6,6,9,1,3,25
191128698,7,0,9,5,2,23
191128699,9,8,0,6,9,32
191128700,1,5,1,4,8,19
191128701,2,0,0,2,9,13
191128702,5,3,5,0,3,16
191128703,5,9,1,2,9,26
191128704,5,4,1,1,7,18
191128705,3,8,6,5,1,23
191128706,0,8,1,3,8,20
191128707,2,5,8,8,9,32
191128708,0,8,2,1,0,11
191128709,7,4,9,8,6,34
191128710,6,7,0,2,2,17
191128711,2,6,1,0,7,16
191128712,3,1,2,9,2,17
191128713,0,6,1,7,8,22
191128714,1,8,6,2,5,22
191128715,4,8,1,6,1,20
191128716,3,7,0,0,5,15
191128717,6,8,7,0,8,29
191128718,4,0,9,0,1,14
191128719,1,8,4,7,9,29
191128720,3,9,0,4,0,16
191128721,2,4,5,6,1,18
191128722,0,1,0,6,0,7
191128723,1,3,2,5,2,13
191128724,9,0,8,1,2,20
191128725,1,1,3,6,8,19
191128726,2,3,6,6,3,20
191128727,4,9,8,7,3,31
191128728,2,7,3,3,7,22
191128729,0,1,0,4,4,9
191128730,9,5,4,5,7,30
191128731,8,5,8,1,4,26
191128732,9,4,1,4,6,24
191128733,3,4,5,5,7,24
191128734,6,7,9,8,8,38
191128735,2,0,0,6,1,9
191128736,9,6,4,9,6,34
191128737,6,6,1,7,2,22
191128738,5,9,3,6,0,23
191128739,3,0,8,6,1,18
191128740,7,0,3,5,8,23
191128741,1,3,6,0,1,11
191128742,3,5,2,3,7,20
191128743,3,6,7,9,4,29
191128744,3,3,2,5,1,14
191128745,4,5,0,5,4,18
191128746,9,7,0,6,7,29
191128747,4,3,0,9,8,24
191128748,4,8,2,4,1,19
191128749,2,9,9,1,6,27
191128750,8,0,7,1,4,20
191128751,6,6,6,9,0,27
191128752,4,2,9,3,9,27
191128753,7,8,5,7,9,36
191128754,9,7,6,5,9,36
191128755,0,3,9,0,6,18
191128756,1,8,2,1,4,16
191128757,8,4,8,0,8,28
191128758,3,0,8,3,6,20
191128759,0,1,5,6,6,18
191128760,9,0,2,9,1,21
191128761,2,4,2,4,8,20
191128762,9,7,6,0,7,29
191128763,1,4,8,0,0,13
191128764,6,7,3,2,5,23
191128765,0,2,0,7,5,14
191128766,3,1,0,1,6,11
191128767,1,3,4,9,9,26
191128768,1,6,3,3,7,20
191128769,0,2,0,4,6,12
191128770,5,6,5,1,1,18
191128771,3,9,0,5,7,24
191128772,6,5,3,0,6,20
191128773,3,9,8,1,4,25
191128774,4,7,7,8,7,33
191128775,0,1,4,5,8,18
191128776,8,2,1,7,1,19
191128777,0,3,9,7,0,19
191128778,7,5,0,6,4,22
191128779,0,9,0,7,6,22
191128780,7,5,3,7,4,26
191128781,4,2,5,3,3,17
191128782,0,1,1,3,6,11
191128783,0,0,3,9,7,19
191128784,7,2,2,8,4,23
191128785,4,7,9,5,7,32
191128786,7,8,5,9,5,34
191128787,2,0,1,2,6,11
191128788,7,7,1,6,8,29
191128789,4,6,0,8,9,27
191128790,9,1,9,3,1,23
191128791,7,6,0,6,3,22
191128792,2,3,5,9,2,21
191128793,3,8,9,1,7,28
191128794,4,4,7,3,6,24
191128795,8,9,7,7,5,36
191128796,0,5,7,9,9,30
191128797,8,8,0,7,8,31
191128798,9,1,2,3,3,18
191128799,8,5,4,0,1,18
191128800,4,2,4,8,2,20
191128801,2,2,5,7,0,16
191128802,2,0,8,2,5,17
191128803,8,9,4,9,7,37
191128804,9,7,9,4,6,35
191128805,7,4,0,0,4,15
191128806,2,6,0,9,2,19
191128807,9,6,5,1,3,24
191128808,1,5,7,6,0,19
191128809,0,5,0,4,8,17
191128810,6,8,3,8,6,31
191128811,5,0,2,2,4,13
191128812,5,6,1,4,9,25
191128813,3,5,2,8,5,23
191128814,7,4,0,0,8,19
191128815,3,1,6,7,1,18
191128816,8,4,9,5,2,28
191128817,7,9,9,1,8,34
191128818,1,6,3,1,5,16
191128819,4,7,0,4,7,22
191128820,2,4,8,5,5,24
191128821,8,9,5,4,1,27
191128822,0,7,7,2,0,16
191128823,7,1,2,0,1,11
191128824,6,9,3,7,4,29
191128825,9,0,8,9,4,30
191128826,4,2,5,0,4,15
191128827,6,1,3,4,7,21
191128828,5,4,1,4,9,23
191128829,3,6,1,7,4,21
191128830,9,9,7,3,1,29
191128831,5,9,6,9,6,35
191128832,9,9,0,5,7,30
191128833,2,5,5,6,8,26
191128834,7,2,9,1,0,19
191128835,2,1,6,3,4,16
191128836,7,2,0,8,0,17
191128837,0,9,5,5,2,21
191128838,1,8,7,5,4,25
191128839,9,7,4,5,5,30
191128840,2,9,9,3,4,27
191128841,3,1,4,5,9,22
191128842,4,3,9,4,8,28
191128843,4,4,8,8,9,33
191128844,5,0,2,6,9,22
191128845,1,0,3,7,3,14
191128846,2,3,5,4,6,20
191128847,9,8,6,3,9,35
191128848,0,7,6,8,1,22
191128849,7,7,2,3,1,20
191128850,2,6,6,4,0,18
191128851,5,0,0,7,7,19
191128852,1,2,6,8,2,19
191128853,1,3,2,4,5,15
191128854,6,4,8,5,8,31
191128855,2,9,2,0,8,21
191128856,1,8,8,9,0,26
191128857,1,9,7,7,1,25
191128858,2,3,9,5,2,21
191128859,4,1,5,0,1,11
191128860,6,4,6,2,9,27
191128861,2,4,0,8,9,23
191128862,1,6,8,4,6,25
191128863,9,7,2,0,2,20
191128864,0,0,8,3,3,14
191128865,3,0,0,7,4,14
191128866,3,3,6,4,0,16
191128867,2,9,5,9,2,27
191128868,4,6,5,4,5,24
191128869,4,3,6,7,3,23
191128870,6,9,9,7,7,38
191128871,6,9,6,3,9,33
191128872,8,9,6,7,1,31
191128873,7,2,6,3,6,24
191128874,5,1,2,3,9,20
191128875,0,2,6,0,8,16
191128876,7,4,8,2,4,25
191128877,4,2,1,1,9,17
191128878,1,9,3,7,3,23
191128879,0,4,3,6,8,21
191128880,0,1,2,1,9,13
191128881,2,6,3,9,6,26
191128882,0,5,3,8,8,24
191128883,4,4,0,9,3,20
191128884,5,8,5,7,1,26
191128885,0,1,7,6,5,19
191128886,1,0,9,6,4,20
191128887,5,1,9,9,6,30
191128888,6,8,7,2,4,27
191128889,3,5,1,1,5,15
191128890,0,5,8,6,1,20
191128891,6,2,3,8,5,24
191128892,7,3,9,5,5,29
191128893,5,0,6,4,8,23
191128894,7,3,6,1,1,18
191128895,2,0,4,4,7,17
191128896,2,6,0,6,4,18
191128897,1,5,0,4,3,13
191128898,3,5,5,4,9,26
191128899,8,3,6,5,5,27
191128900,7,2,6,4,2,21
191128901,3,9,2,7,7,28
191128902,9,3,2,7,8,29
191128903,9,5,8,0,4,26
191128904,8,5,9,4,3,29
191128905,8,1,2,8,9,28
191128906,5,3,7,4,0,19
191128907,4,3,3,4,2,16
191128908,3,4,2,2,8,19
191128909,2,6,0,0,1,9
191128910,7,3,5,1,8,24
191128911,6,1,8,6,4,25
191128912,2,1,6,4,1,14
191128913,4,4,3,9,1,21
191128914,5,2,6,7,5,25
191128915,4,9,6,0,9,28
191128916,5,8,9,0,9,31
191128917,6,9,8,3,1,27
191128918,0,1,1,6,7,15
191128919,9,7,6,8,7,37
191128920,0,1,8,7,2,18
191128921,2,0,4,0,2,8
191128922,5,6,6,1,7,25
191128923,0,2,8,3,3,16
191128924,7,2,8,7,6,30
191128925,2,2,4,2,0,10
191128926,4,1,8,1,0,14
191128927,3,4,6,8,8,29
191128928,7,9,5,8,1,30
191128929,0,7,2,5,2,16
191128930,1,0,3,0,3,7
191128931,3,7,5,6,2,23
191128932,0,4,8,9,5,26
191128933,5,9,9,5,1,29
191128934,2,3,1,0,7,13
191128935,2,9,2,9,6,28
191128936,4,7,0,0,1,12
191128937,2,1,7,1,8,19
191128938,1,4,7,5,9,26
191128939,7,7,3,1,1,19
191128940,6,5,7,2,0,20
191128941,7,5,5,2,3,22
191128942,4,4,9,9,8,34
191128943,0,4,7,5,8,24
191128944,5,2,5,7,0,19
191128945,5,2,8,4,6,25
191128946,3,7,5,0,0,15
191128947,4,1,4,1,7,17
191128948,5,0,0,5,1,11
191128949,8,7,5,3,4,27
191128950,3,5,1,0,1,10
191128951,6,0,2,3,4,15
191128952,7,6,3,3,5,24
191128953,4,4,9,8,6,31
191128954,8,5,3,0,6,22
191128955,0,0,1,0,2,3
191128956,5,2,3,4,2,16
191128957,1,9,7,5,2,24
191128958,2,6,5,8,6,27
191128959,4,4,4,9,9,30
191128960,8,2,5,7,1,23
191128961,7,1,5,0,5,18
191128962,3,9,7,5,0,24
191128963,3,9,9,9,7,37
191128964,7,5,9,4,9,34
191128965,9,5,0,7,7,28
191128966,1,2,9,4,3,19
191128967,6,5,5,7,7,30
191128968,3,7,0,0,4,14
191128969,5,5,4,8,7,29
191128970,4,0,6,3,3,16
191128971,1,2,3,0,3,9
191128972,4,6,2,5,7,24
191128973,1,6,8,3,6,24
191128974,1,3,0,2,2,8
191128975,4,6,2,5,5,22
191128976,7,0,3,1,0,11
191128977,1,2,3,8,9,23
191128978,5,6,7,2,7,27
191128979,5,6,3,2,8,24
191128980,9,3,3,4,7,26
191128981,0,1,0,3,0,4
191128982,4,2,0,8,4,18
191128983,1,4,1,1,3,10
191128984,8,0,2,1,8,19
191128985,2,0,0,4,4,10
191128986,1,7,1,2,4,15
191128987,4,0,9,1,9,23
191128988,6,9,8,6,3,32
191128989,6,8,1,4,5,24
191128990,7,8,9,9,4,37
191128991,3,3,4,1,2,13
191128992,1,6,1,8,9,25
191128993,2,9,1,8,1,21
191128994,1,0,7,3,7,18
191128995,3,7,4,2,1,17
191128996,4,4,1,3,6,18
191128997,0,2,7,8,9,26
191128998,8,0,9,8,9,34
191128999,2,2,4,4,1,13
1911281000,7,8,2,1,1,19
1911281001,7,6,7,1,4,25
1911281002,1,0,1,8,1,11
1911281003,0,7,0,3,9,19
1911281004,5,8,8,8,9,38
1911281005,7,4,7,1,6,25
1911281006,9,6,6,3,7,31
1911281007,0,8,2,8,4,22
1911281008,9,4,7,5,3,28
1911281009,8,9,4,5,3,29
1911281010,0,4,1,1,8,14
1911281011,9,5,0,9,6,29
1911281012,6,9,6,8,4,33
1911281013,7,6,8,4,3,28
1911281014,2,4,6,1,8,21
1911281015,0,9,8,2,1,20
1911281016,0,6,9,9,3,27
1911281017,3,8,8,2,3,24
1911281018,7,8,7,0,7,29
1911281019,7,6,9,5,5,32
1911281020,6,8,8,1,8,31
1911281021,8,0,9,3,7,27
1911281022,9,8,6,0,1,24
1911281023,2,6,0,1,3,12
1911281024,2,7,4,3,7,23
1911281025,2,7,6,4,6,25
1911281026,0,2,2,2,9,15
1911281027,8,3,3,1,5,20
1911281028,3,1,8,2,4,18
1911281029,8,6,1,8,6,29
1911281030,4,0,0,0,3,7
1911281031,4,9,8,4,2,27
1911281032,1,1,8,1,9,20
1911281033,4,8,7,5,9,33
1911281034,2,1,9,5,0,17
1911281035,2,9,0,0,6,17
1911281036,1,2,4,5,3,15
1911281037,1,9,7,0,7,24
1911281038,7,5,2,0,4,18
1911281039,6,0,8,1,2,17
1911281040,6,7,3,1,8,25
1911281041,4,0,9,8,0,21
1911281042,9,8,7,5,1,30
1911281043,8,8,7,4,1,28
1911281044,8,9,6,4,9,36
1911281045,3,8,7,9,7,34
1911281046,8,5,7,2,0,22
1911281047,2,6,6,7,9,30
1911281048,0,8,2,5,2,17
1911281049,8,5,2,8,9,32
1911281050,8,0,4,3,0,15
1911281051,8,1,8,6,8,31
1911281052,2,7,3,9,1,22
1911281053,3,7,2,9,9,30
1911281054,6,1,7,8,0,22
1911281055,9,6,5,6,0,26
1911281056,3,1,5,7,6,22
1911281057,3,2,1,7,6,19
1911281058,0,7,8,6,9,30
1911281059,8,7,5,6,2,28
1911281060,9,3,5,5,9,31
1911281061,7,4,4,0,4,19
1911281062,4,9,5,0,7,25
1911281063,5,2,0,9,0,16
1911281064,7,5,8,4,1,25
1911281065,4,4,9,7,1,25
1911281066,2,5,4,3,2,16
1911281067,4,6,3,6,8,27
1911281068,5,5,6,3,6,25
1911281069,4,1,1,5,1,12
1911281070,4,2,4,0,6,16
1911281071,3,4,3,9,3,22
1911281072,8,3,5,0,6,22
1911281073,9,7,1,8,3,28
1911281074,0,0,7,9,8,24
1911281075,1,2,2,7,8,20
1911281076,2,4,8,8,2,24
1911281077,6,5,6,5,4,26
1911281078,6,3,4,4,2,19
1911281079,3,0,5,1,4,13
1911281080,2,2,9,8,0,21
1911281081,4,7,3,8,3,25
1911281082,6,9,3,5,7,30
1911281083,8,4,1,3,6,22
1911281084,2,4,6,2,8,22
1911281085,7,2,6,7,4,26
1911281086,1,0,4,2,7,14
1911281087,6,6,8,9,8,37
1911281088,1,7,5,9,9,31
1911281089,8,3,4,9,7,31
1911281090,9,9,2,0,3,23
1911281091,5,4,5,4,8,26
1911281092,9,3,0,5,2,19
1911281093,3,3,5,8,2,21
1911281094,8,3,3,6,2,22
1911281095,2,3,5,0,9,19
1911281096,5,9,6,3,0,23
1911281097,6,1,8,4,5,24
1911281098,6,0,2,5,1,14
1911281099,0,6,5,6,4,21
1911281100,1,7,6,5,8,27
1911281101,8,4,0,5,6,23
1911281102,3,8,9,9,6,35
1911281103,8,2,3,9,9,31
1911281104,5,5,1,6,0,17
1911281105,0,4,8,8,1,21
191129001,0,3,5,3,8,19
191129002,0,1,8,0,4,13
191129003,6,9,4,9,7,35
191129004,2,3,3,0,9,17
191129005,7,6,4,5,9,31
191129006,1,1,2,5,5,14
191129007,8,4,0,1,6,19
191129008,1,8,5,8,6,28
191129009,9,2,8,5,5,29
191129010,0,9,6,0,2,17
191129011,8,0,3,4,9,24
191129012,2,7,1,5,9,24
191129013,6,6,3,3,7,25
191129014,5,9,5,1,5,25
191129015,3,4,4,9,8,28
191129016,5,7,8,6,4,30
191129017,0,2,6,8,7,23
191129018,2,5,6,4,0,17
191129019,5,8,0,4,7,24
191129020,2,3,9,5,3,22
191129021,2,0,4,6,6,18
191129022,7,0,2,0,5,14
191129023,4,8,3,2,3,20
191129024,1,0,9,0,1,11
191129025,7,5,5,7,5,29
191129026,0,8,3,4,0,15
191129027,1,5,7,9,7,29
191129028,7,1,0,6,6,20
191129029,2,2,2,6,1,13
191129030,5,8,9,5,0,27
191129031,9,9,1,7,1,27
191129032,9,9,9,8,0,35
191129033,7,3,3,7,9,29
191129034,5,5,2,9,7,28
191129035,0,9,9,5,8,31
191129036,2,7,3,4,0,16
191129037,4,8,3,6,4,25
191129038,3,8,7,9,3,30
191129039,7,9,9,6,4,35
191129040,2,9,8,5,5,29
191129041,7,8,1,6,4,26
191129042,6,6,7,2,3,24
191129043,3,8,0,9,6,26
191129044,8,3,3,6,4,24
191129045,2,7,3,6,4,22
191129046,4,1,5,9,8,27
191129047,1,0,7,9,4,21
191129048,6,6,0,5,1,18
191129049,5,9,7,1,8,30
191129050,5,1,7,0,6,19
191129051,8,1,0,1,4,14
191129052,7,8,3,1,0,19
191129053,6,6,2,5,5,24
191129054,8,5,7,0,8,28
191129055,5,3,4,3,0,15
191129056,9,9,6,9,2,35
191129057,6,0,5,2,4,17
191129058,1,5,9,4,7,26
191129059,5,6,2,4,4,21
191129060,1,6,2,0,7,16
191129061,2,5,0,5,1,13
191129062,7,8,5,9,4,33
191129063,2,2,5,8,8,25
191129064,5,1,9,0,3,18
191129065,0,7,6,0,4,17
191129066,1,0,5,7,0,13
191129067,1,3,2,9,8,23
191129068,3,0,1,1,5,10
191129069,4,1,6,0,8,19
191129070,3,0,8,7,4,22
191129071,0,6,1,1,7,15
191129072,0,5,7,3,5,20
191129073,8,4,2,1,1,16
191129074,4,9,2,2,5,22
191129075,3,5,8,8,3,27
191129076,7,6,9,7,6,35
191129077,4,4,9,6,2,25
191129078,3,6,5,4,0,18
191129079,3,8,6,6,1,24
191129080,1,2,5,5,5,18
191129081,8,6,4,3,7,28
191129082,6,0,6,7,2,21
191129083,2,1,0,2,5,10
191129084,3,4,8,5,4,24
191129085,4,8,7,4,2,25
191129086,4,7,4,8,1,24
191129087,7,3,5,2,1,18
191129088,3,2,7,0,2,14
191129089,6,5,6,1,2,20
191129090,3,3,7,8,2,23
191129091,0,2,0,4,5,11
191129092,8,0,5,7,7,27
191129093,2,7,5,9,0,23
191129094,6,6,8,6,0,26
191129095,9,5,0,7,1,22
191129096,4,2,1,5,0,12
191129097,9,5,5,2,3,24
191129098,4,1,7,1,5,18
191129099,6,4,9,6,3,28
191129100,3,5,3,3,6,20
191129101,6,4,7,8,7,32
191129102,6,9,0,0,2,17
191129103,6,8,6,1,4,25
191129104,8,1,3,4,6,22
191129105,5,6,3,7,8,29
191129106,6,4,2,4,1,17
191129107,3,9,6,3,4,25
191129108,6,8,1,7,0,22
191129109,8,7,9,1,1,26
191129110,3,4,8,8,4,27
191129111,7,0,5,7,3,22
191129112,5,0,4,8,2,19
191129113,3,8,4,6,0,21
191129114,2,0,8,2,1,13
191129115,3,9,7,6,3,28
191129116,4,3,3,8,4,22
191129117,8,6,5,0,5,24
191129118,5,6,6,0,8,25
191129119,4,5,8,0,9,26
191129120,8,3,9,9,9,38
191129121,7,1,3,2,7,20
191129122,0,8,5,2,2,17
191129123,3,4,6,0,5,18
191129124,4,1,8,9,4,26
191129125,1,2,0,7,8,18
191129126,3,6,9,5,5,28
191129127,4,4,2,7,4,21
191129128,2,4,8,6,3,23
191129129,5,8,4,3,7,27
191129130,5,1,3,1,8,18
191129131,6,7,9,3,4,29
191129132,0,2,6,1,3,12
191129133,8,8,5,2,4,27
191129134,0,1,3,8,1,13
191129135,1,1,6,2,3,13
191129136,9,1,9,8,8,35
191129137,5,7,3,8,0,23
191129138,8,1,1,2,6,18
191129139,4,1,4,7,6,22
191129140,1,4,0,7,9,21
191129141,6,5,5,6,3,25
191129142,6,9,3,6,6,30
191129143,6,0,2,9,1,18
191129144,5,8,1,2,5,21
191129145,1,6,5,2,2,16
191129146,5,6,0,6,1,18
191129147,2,6,6,3,1,18
191129148,4,0,4,2,5,15
191129149,0,5,4,4,1,14
191129150,3,9,0,4,6,22
191129151,0,5,4,3,0,12
191129152,4,1,1,1,8,15
191129153,7,2,5,8,8,30
191129154,2,6,6,9,0,23
191129155,8,7,8,3,4,30
191129156,9,9,3,9,3,33
191129157,2,0,3,3,3,11
191129158,4,2,6,9,6,27
191129159,4,2,3,0,5,14
191129160,8,6,5,8,2,29
191129161,5,2,6,1,6,20
191129162,6,9,1,6,6,28
191129163,2,8,4,3,9,26
191129164,8,1,5,0,4,18
191129165,7,6,7,1,5,26
191129166,0,2,4,3,2,11
191129167,2,3,8,0,5,18
191129168,3,5,1,7,1,17
191129169,6,3,9,5,6,29
191129170,5,1,4,0,4,14
191129171,4,9,4,2,6,25
191129172,6,5,1,9,6,27
191129173,9,2,5,6,2,24
191129174,7,9,6,4,3,29
191129175,2,3,6,2,9,22
191129176,5,6,8,4,2,25
191129177,7,4,8,0,6,25
191129178,2,8,9,0,0,19
191129179,1,3,4,6,6,20
191129180,1,0,9,1,0,11
191129181,6,1,8,6,8,29
191129182,8,1,2,8,8,27
191129183,2,5,6,5,2,20
191129184,5,3,8,2,1,19
191129185,3,2,5,3,5,18
191129186,7,8,3,4,1,23
191129187,9,7,1,7,2,26
191129188,6,6,8,8,3,31
191129189,2,0,1,9,4,16
191129190,6,4,8,6,6,30
191129191,1,2,2,1,1,7
191129192,9,5,6,5,5,30
191129193,9,1,4,6,9,29
191129194,2,6,2,2,8,20
191129195,1,6,0,3,3,13
191129196,4,6,1,9,1,21
191129197,8,9,5,5,1,28
191129198,8,8,8,2,2,28
191129199,0,8,2,5,8,23
191129200,0,3,3,0,3,9
191129201,5,3,3,8,4,23
191129202,2,3,8,8,5,26
191129203,7,8,6,7,9,37
191129204,7,6,0,3,1,17
191129205,6,1,9,3,4,23
191129206,5,2,9,8,8,32
191129207,1,6,1,9,8,25
191129208,7,6,1,5,6,25
191129209,8,6,7,2,2,25
191129210,0,1,6,6,1,14
191129211,4,5,2,8,7,26
191129212,6,0,8,8,2,24
191129213,2,7,2,6,5,22
191129214,7,6,4,2,7,26
191129215,7,3,9,2,4,25
191129216,6,4,9,9,2,30
191129217,5,9,8,5,2,29
191129218,9,0,8,4,7,28
191129219,5,1,0,3,9,18
191129220,7,9,6,2,5,29
191129221,3,7,8,0,1,19
191129222,5,0,8,2,9,24
191129223,0,7,8,0,3,18
191129224,7,8,9,1,3,28
191129225,6,6,7,4,1,24
191129226,8,3,2,2,9,24
191129227,3,4,9,4,2,22
191129228,9,1,8,2,8,28
191129229,1,2,7,4,0,14
191129230,3,5,2,8,8,26
191129231,2,6,6,2,4,20
191129232,9,9,8,4,8,38
191129233,8,2,5,3,9,27
191129234,8,4,9,6,2,29
191129235,2,4,5,7,5,23
191129236,4,5,8,9,8,34
191129237,8,5,9,5,1,28
191129238,5,3,7,8,8,31
191129239,0,3,1,4,0,8
191129240,4,6,4,7,6,27
191129241,0,2,1,8,2,13
191129242,5,4,5,8,3,25
191129243,3,0,9,1,5,18
191129244,4,1,1,8,9,23
191129245,2,5,9,5,1,22
191129246,8,2,6,0,7,23
191129247,2,1,3,8,3,17
191129248,2,2,1,2,2,9
191129249,6,3,2,5,5,21
191129250,0,2,9,6,0,17
191129251,5,1,5,1,1,13
191129252,0,8,8,2,2,20
191129253,4,3,1,2,8,18
191129254,9,8,3,6,2,28
191129255,5,0,6,7,8,26
191129256,8,6,1,0,9,24
191129257,9,0,0,6,1,16
191129258,3,3,9,7,7,29
191129259,1,3,3,1,6,14
191129260,5,9,9,1,9,33
191129261,6,4,5,7,9,31
191129262,8,7,4,0,8,27
191129263,2,3,5,1,4,15
191129264,5,9,2,1,0,17
191129265,9,7,1,2,6,25
191129266,0,8,7,7,3,25
191129267,8,7,6,6,6,33
191129268,2,0,0,6,4,12
191129269,3,0,3,6,6,18
191129270,7,5,7,7,2,28
191129271,8,1,3,1,0,13
191129272,7,7,6,8,3,31
191129273,1,8,5,5,1,20
191129274,1,4,4,3,6,18
191129275,3,2,1,1,0,7
191129276,2,4,7,2,0,15
191129277,7,1,9,7,2,26
191129278,7,0,7,9,5,28
191129279,4,8,8,2,7,29
191129280,3,2,7,4,4,20
191129281,1,6,7,8,1,23
191129282,5,7,9,0,7,28
191129283,2,0,5,5,8,20
191129284,0,4,8,8,2,22
191129285,3,9,5,3,6,26
191129286,7,4,9,8,0,28
191129287,3,9,8,7,1,28
191129288,2,5,7,2,4,20
191129289,1,7,0,1,3,12
191129290,9,9,7,8,3,36
191129291,3,1,5,2,9,20
191129292,9,6,4,5,9,33
191129293,2,1,0,9,9,21
191129294,7,7,4,9,0,27
191129295,1,4,4,4,9,22
191129296,9,7,2,1,9,28
191129297,7,1,8,6,4,26
191129298,8,3,3,9,5,28
191129299,9,7,3,2,1,22
191129300,4,1,1,1,2,9
191129301,9,4,3,1,9,26
191129302,7,9,9,7,8,40
191129303,9,3,8,7,6,33
191129304,9,8,0,9,4,30
191129305,1,9,2,2,2,16
191129306,1,3,5,5,5,19
191129307,4,5,1,5,8,23
191129308,4,0,6,6,9,25
191129309,6,7,4,3,2,22
191129310,6,8,2,7,7,30
191129311,0,2,6,4,4,16
191129312,6,5,6,5,1,23
191129313,9,7,9,7,8,40
191129314,4,1,6,3,1,15
191129315,5,5,2,7,6,25
191129316,1,4,5,5,4,19
191129317,3,5,3,8,7,26
191129318,4,7,3,0,0,14
191129319,9,5,2,1,0,17
191129320,6,8,6,7,8,35
191129321,2,7,0,0,7,16
191129322,7,8,4,6,6,31
191129323,7,6,4,6,4,27
191129324,7,8,2,8,8,33
191129325,8,3,6,3,6,26
191129326,2,4,1,3,8,18
191129327,4,8,6,1,3,22
191129328,5,6,2,7,3,23
191129329,0,8,0,9,2,19
191129330,0,1,1,9,1,12
191129331,4,4,1,0,6,15
191129332,5,6,8,9,5,33
191129333,5,8,6,7,9,35
191129334,1,2,9,6,8,26
191129335,7,1,5,4,5,22
191129336,9,6,4,4,4,27
191129337,9,1,3,8,1,22
191129338,0,1,5,3,0,9
191129339,1,7,1,3,9,21
191129340,7,4,6,9,7,33
191129341,9,6,2,4,0,21
191129342,2,1,7,6,0,16
191129343,1,8,8,1,5,23
191129344,8,7,3,9,6,33
191129345,2,0,6,3,5,16
191129346,3,5,5,3,7,23
191129347,1,2,2,7,6,18
191129348,1,0,5,4,1,11
191129349,8,1,9,3,7,28
191129350,5,1,6,1,8,21
191129351,7,0,4,8,7,26
191129352,5,4,7,6,0,22
191129353,9,9,1,6,1,26
191129354,6,4,4,6,4,24
191129355,7,6,9,4,9,35
191129356,7,4,7,8,0,26
191129357,6,6,4,4,3,23
191129358,8,5,2,6,6,27
191129359,9,8,0,1,0,18
191129360,9,6,3,1,9,28
191129361,8,4,1,6,0,19
191129362,1,8,3,4,9,25
191129363,0,1,7,6,4,18
191129364,5,2,0,4,0,11
191129365,6,2,8,3,8,27
191129366,6,5,4,1,5,21
191129367,6,1,5,2,2,16
191129368,0,5,7,6,7,25
191129369,0,7,9,4,5,25
191129370,5,7,9,8,7,36
191129371,8,0,0,9,7,24
191129372,0,4,2,3,3,12
191129373,8,1,0,7,9,25
191129374,0,2,3,6,9,20
191129375,3,9,2,0,2,16
191129376,5,9,0,2,8,24
191129377,7,9,5,7,8,36
191129378,6,8,5,6,7,32
191129379,1,6,5,2,7,21
191129380,9,3,8,2,3,25
191129381,1,0,9,0,5,15
191129382,1,8,2,4,4,19
191129383,5,7,4,8,6,30
191129384,7,2,3,5,8,25
191129385,8,0,3,9,0,20
191129386,6,9,8,7,1,31
191129387,5,0,6,4,0,15
191129388,2,7,3,1,5,18
191129389,7,3,6,9,3,28
191129390,1,4,0,5,7,17
191129391,7,5,8,6,6,32
191129392,2,6,3,9,8,28
191129393,6,6,1,2,3,18
191129394,6,4,6,7,6,29
191129395,9,4,9,1,5,28
191129396,4,5,6,1,6,22
191129397,8,5,8,9,6,36
191129398,8,1,9,6,7,31
191129399,3,4,0,1,4,12
191129400,5,1,7,9,6,28
191129401,3,0,2,9,8,22
191129402,6,1,1,7,4,19
191129403,1,6,8,6,9,30
191129404,0,4,9,3,8,24
191129405,7,4,1,0,1,13
191129406,4,8,8,7,2,29
191129407,6,4,8,0,0,18
191129408,2,1,4,0,7,14
191129409,0,4,8,4,3,19
191129410,7,2,0,2,9,20
191129411,9,9,9,9,9,45
191129412,6,6,7,6,3,28
191129413,9,7,1,6,5,28
191129414,9,2,8,4,9,32
191129415,4,8,2,9,5,28
191129416,6,8,9,7,8,38
191129417,4,4,0,8,3,19
191129418,9,0,4,2,4,19
191129419,4,1,2,9,1,17
191129420,5,8,2,6,7,28
191129421,8,3,1,0,3,15
191129422,2,6,4,6,9,27
191129423,2,7,5,3,1,18
191129424,3,2,2,9,0,16
191129425,7,4,6,3,5,25
191129426,7,5,5,1,8,26
191129427,0,8,3,2,6,19
191129428,3,4,5,5,0,17
191129429,6,1,9,6,6,28
191129430,9,1,7,2,1,20
191129431,7,1,2,8,6,24
191129432,1,7,5,7,4,24
191129433,3,0,2,1,6,12
191129434,5,9,5,5,8,32
191129435,8,2,3,1,7,21
191129436,3,1,9,3,2,18
191129437,1,8,3,1,2,15
191129438,6,2,2,5,3,18
191129439,3,4,6,2,6,21
191129440,2,6,2,6,5,21
191129441,0,2,2,7,2,13
191129442,3,9,6,9,4,31
191129443,4,9,1,1,5,20
191129444,1,2,1,6,1,11
191129445,8,8,2,6,2,26
191129446,2,9,7,6,3,27
191129447,9,4,3,9,2,27
191129448,3,2,4,8,3,20
191129449,2,0,2,0,1,5
191129450,3,6,0,2,1,12
191129451,8,5,7,5,8,33
191129452,3,0,9,1,6,19
191129453,5,6,3,4,6,24
191129454,2,5,5,7,3,22
191129455,5,9,0,8,4,26
191129456,6,5,8,3,3,25
191129457,5,8,9,8,8,38
191129458,2,7,7,5,0,21
191129459,8,4,0,7,0,19
191129460,1,0,7,3,5,16
191129461,3,4,1,8,4,20
191129462,7,5,4,1,4,21
191129463,4,7,5,5,6,27
191129464,9,0,6,7,4,26
191129465,7,3,5,0,1,16
191129466,9,7,9,3,5,33
191129467,2,7,2,2,7,20
191129468,5,2,2,6,8,23
191129469,1,3,0,5,7,16
191129470,4,8,2,2,9,25
191129471,7,0,6,0,1,14
191129472,7,9,8,0,8,32
191129473,7,8,6,5,9,35
191129474,8,8,4,6,4,30
191129475,8,5,9,0,1,23
191129476,4,0,7,8,6,25
191129477,5,1,6,1,7,20
191129478,8,1,1,0,4,14
191129479,8,1,0,3,3,15
191129480,2,8,4,6,1,21
191129481,9,4,0,5,8,26
191129482,2,7,0,8,0,17
191129483,0,3,7,2,8,20
191129484,8,0,0,5,5,18
191129485,0,5,8,4,4,21
191129486,3,3,6,5,1,18
191129487,0,5,3,6,9,23
191129488,4,2,3,6,6,21
191129489,1,8,5,5,4,23
191129490,3,3,7,1,2,16
191129491,6,1,6,0,7,20
191129492,8,8,8,1,4,29
191129493,1,7,5,2,3,18
191129494,8,0,6,5,3,22
191129495,8,0,4,1,3,16
191129496,7,7,9,7,6,36
191129497,8,9,7,6,3,33
191129498,4,8,6,6,3,27
191129499,7,9,6,7,5,34
191129500,3,9,7,5,9,33
191129501,9,4,3,9,5,30
191129502,2,6,4,2,3,17
191129503,5,9,9,4,4,31
191129504,3,1,8,6,2,20
191129505,6,5,1,2,3,17
191129506,1,5,8,9,8,31
191129507,8,3,9,1,3,24
191129508,7,3,1,4,5,20
191129509,3,7,0,2,3,15
191129510,6,9,3,8,3,29
191129511,0,8,7,1,4,20
191129512,7,3,9,8,6,33
191129513,4,2,3,3,7,19
191129514,2,2,8,1,7,20
191129515,8,9,2,5,8,32
191129516,7,8,5,0,8,28
191129517,5,4,9,9,9,36
191129518,5,8,4,1,9,27
191129519,5,8,1,9,7,30
191129520,4,4,1,3,3,15
191129521,7,5,5,0,2,19
191129522,5,0,3,5,4,17
191129523,6,8,1,4,9,28
191129524,8,4,0,2,0,14
191129525,0,0,5,3,4,12
191129526,8,2,1,4,9,24
191129527,2,8,9,5,9,33
191129528,5,8,0,9,9,31
191129529,1,2,6,9,5,23
191129530,2,6,4,7,1,20
191129531,6,9,2,9,8,34
191129532,7,6,2,6,1,22
191129533,1,3,8,7,6,25
191129534,2,5,0,4,4,15
191129535,0,2,6,3,4,15
191129536,7,4,0,2,6,19
191129537,3,9,4,9,8,33
191129538,2,6,2,9,6,25
191129539,5,9,2,3,4,23
191129540,2,8,1,1,9,21
191129541,1,2,4,7,3,17
191129542,2,6,6,1,1,16
191129543,4,3,1,7,6,21
191129544,0,0,9,2,7,18
191129545,3,2,5,8,9,27
191129546,2,3,4,8,6,23
191129547,9,0,3,7,1,20
191129548,9,2,0,4,7,22
191129549,1,2,6,9,2,20
191129550,0,7,1,0,9,17
191129551,5,7,9,0,3,24
191129552,3,6,3,4,9,25
191129553,5,0,0,7,2,14
191129554,7,1,6,4,3,21
191129555,4,9,7,6,0,26
191129556,1,5,4,6,6,22
191129557,7,8,9,9,7,40
191129558,9,8,5,9,5,36
191129559,1,3,2,5,1,12
191129560,7,4,0,6,2,19
191129561,9,7,6,8,6,36
191129562,2,0,8,0,6,16
191129563,8,7,9,9,3,36
191129564,3,6,8,9,0,26
191129565,8,0,1,3,7,19
191129566,8,9,0,5,5,27
191129567,0,1,2,6,3,12
191129568,4,4,4,7,6,25
191129569,4,2,8,9,8,31
191129570,8,5,7,2,9,31
191129571,7,9,7,4,9,36
191129572,7,4,8,1,8,28
191129573,5,1,2,8,7,23
191129574,4,7,8,1,5,25
191129575,5,2,0,2,7,16
191129576,8,6,7,8,0,29
191129577,1,6,1,5,8,21
191129578,4,0,0,1,4,9
191129579,9,1,1,3,0,14
191129580,2,7,7,1,9,26
191129581,1,9,0,3,7,20
191129582,0,7,6,3,0,16
191129583,5,3,5,7,5,25
191129584,4,0,9,1,1,15
191129585,5,9,0,5,8,27
191129586,2,7,5,3,3,20
191129587,7,9,6,5,9,36
191129588,1,7,9,4,1,22
191129589,7,2,2,2,3,16
191129590,1,2,5,1,9,18
191129591,9,0,2,8,0,19
191129592,2,6,5,2,2,17
191129593,6,1,3,6,2,18
191129594,6,3,2,9,6,26
191129595,4,1,6,2,6,19
191129596,4,5,9,5,1,24
191129597,5,7,1,1,5,19
191129598,8,5,4,4,5,26
191129599,7,5,3,4,3,22
191129600,5,6,9,2,7,29
191129601,3,8,7,1,9,28
191129602,8,2,3,4,6,23
191129603,0,0,6,9,4,19
191129604,3,9,5,3,4,24
191129605,6,4,2,3,9,24
191129606,7,5,0,1,6,19
191129607,2,0,3,0,4,9
191129608,8,3,9,2,7,29
191129609,6,4,9,6,2,27
191129610,4,0,0,4,2,10
191129611,2,5,6,4,5,22
191129612,2,0,7,4,1,14
191129613,9,8,6,1,3,27
191129614,1,2,5,2,1,11
191129615,8,5,5,5,9,32
191129616,0,7,0,9,9,25
191129617,5,4,7,0,2,18
191129618,9,5,1,1,2,18
191129619,3,3,3,8,1,18
191129620,4,2,6,3,5,20
191129621,9,8,5,8,2,32
191129622,6,0,9,1,5,21
191129623,9,1,3,5,9,27
191129624,9,1,2,8,6,26
191129625,9,8,6,3,6,32
191129626,0,6,1,5,4,16
191129627,2,0,5,4,7,18
191129628,6,2,3,2,0,13
191129629,8,1,2,5,9,25
191129630,2,5,9,4,1,21
191129631,6,7,3,7,4,27
191129632,3,3,8,8,0,22
191129633,8,7,6,5,2,28
191129634,2,9,6,9,1,27
191129635,9,8,7,0,6,30
191129636,6,6,8,7,4,31
191129637,7,8,5,4,1,25
191129638,4,2,2,7,4,19
191129639,4,7,1,3,1,16
191129640,4,5,4,5,2,20
191129641,9,2,0,5,9,25
191129642,0,3,5,6,3,17
191129643,3,9,8,8,5,33
191129644,7,3,7,2,5,24
191129645,4,2,9,8,6,29
191129646,0,4,2,9,2,17
191129647,9,8,1,0,8,26
191129648,0,1,0,3,2,6
191129649,7,5,2,8,2,24
191129650,1,9,8,7,4,29
191129651,9,0,0,9,6,24
191129652,2,9,0,4,9,24
191129653,3,1,9,7,1,21
191129654,4,6,7,0,1,18
191129655,2,7,6,8,9,32
191129656,7,0,2,6,1,16
191129657,7,2,4,0,8,21
191129658,3,1,7,1,9,21
191129659,2,3,3,4,9,21
191129660,8,3,7,5,7,30
191129661,5,5,1,5,5,21
191129662,3,1,3,3,7,17
191129663,6,3,2,2,0,13
191129664,7,1,9,1,0,18
191129665,9,1,1,2,1,14
191129666,2,4,2,5,3,16
191129667,3,0,2,1,0,6
191129668,1,9,2,5,8,25
191129669,4,4,0,4,9,21
191129670,3,1,4,4,4,16
191129671,8,8,4,8,9,37
191129672,2,5,0,2,5,14
191129673,3,9,1,1,7,21
191129674,3,5,3,1,9,21
191129675,4,1,1,9,5,20
191129676,3,6,7,1,5,22
191129677,3,9,5,5,5,27
191129678,3,0,4,8,7,22
191129679,5,7,1,6,6,25
191129680,8,6,9,6,9,38
191129681,9,5,2,0,5,21
191129682,1,5,2,3,2,13
191129683,5,5,0,4,0,14
191129684,8,3,6,5,2,24
191129685,3,4,6,1,4,18
191129686,6,3,2,3,9,23
191129687,1,6,9,8,4,28
191129688,4,4,0,4,6,18
191129689,2,1,2,9,9,23
191129690,5,6,2,5,2,20
191129691,9,2,5,5,9,30
191129692,5,1,5,5,1,17
191129693,9,0,9,1,7,26
191129694,3,2,0,7,6,18
191129695,4,4,6,3,9,26
191129696,6,6,4,5,2,23
191129697,8,2,4,8,5,27
191129698,3,6,5,4,2,20
191129699,6,5,3,5,5,24
191129700,2,8,3,4,9,26
191129701,5,6,2,8,3,24
191129702,3,8,3,7,0,21
191129703,6,4,8,8,2,28
191129704,1,1,6,3,2,13
191129705,0,7,3,5,7,22
191129706,7,2,5,1,6,21
191129707,2,5,6,6,2,21
191129708,4,2,8,4,9,27
191129709,4,2,7,6,4,23
191129710,5,6,4,8,1,24
191129711,8,4,8,5,1,26
191129712,2,3,9,5,0,19
191129713,1,7,8,5,7,28
191129714,5,5,2,5,2,19
191129715,3,1,8,1,4,17
191129716,7,2,4,3,5,21
191129717,3,5,9,4,3,24
191129718,6,3,0,0,6,15
191129719,3,5,7,2,8,25
191129720,8,1,5,9,4,27
191129721,6,4,3,3,1,17
191129722,7,7,1,9,1,25
191129723,6,1,0,0,9,16
191129724,7,0,6,3,6,22
191129725,5,1,5,6,8,25
191129726,9,0,8,6,1,24
191129727,8,3,0,1,3,15
191129728,4,8,6,9,0,27
191129729,8,5,6,5,8,32
191129730,2,4,5,3,7,21
191129731,6,3,4,7,3,23
191129732,4,1,9,1,3,18
191129733,6,9,3,6,2,26
191129734,7,4,6,0,9,26
191129735,4,5,4,0,2,15
191129736,2,8,0,9,9,28
191129737,7,7,6,2,7,29
191129738,7,7,3,4,1,22
191129739,4,4,5,8,5,26
191129740,8,7,4,7,7,33
191129741,3,6,4,9,8,30
191129742,6,2,2,5,1,16
191129743,1,2,1,5,0,9
191129744,7,0,7,6,9,29
191129745,2,8,6,4,4,24
191129746,0,9,6,6,8,29
191129747,1,0,3,9,3,16
191129748,6,9,9,7,0,31
191129749,1,3,3,9,6,22
191129750,5,1,1,6,6,19
191129751,9,0,5,6,8,28
191129752,0,4,7,6,0,17
191129753,5,5,0,6,8,24
191129754,1,3,0,7,8,19
191129755,1,1,0,8,8,18
191129756,2,8,9,2,7,28
191129757,8,8,8,7,0,31
191129758,7,9,2,8,9,35
191129759,6,5,0,1,7,19
191129760,7,6,1,7,3,24
191129761,3,0,6,0,9,18
191129762,9,4,8,4,0,25
191129763,8,8,9,0,9,34
191129764,2,2,4,2,1,11
191129765,7,6,2,1,9,25
191129766,7,5,2,7,3,24
191129767,6,2,5,3,5,21
191129768,5,0,8,9,6,28
191129769,2,3,4,7,3,19
191129770,2,9,9,2,1,23
191129771,5,4,3,9,9,30
191129772,5,4,1,8,1,19
191129773,2,5,3,3,3,16
191129774,3,8,2,3,1,17
191129775,3,2,6,5,0,16
191129776,3,5,1,9,6,24
191129777,2,1,9,0,9,21
191129778,6,7,8,1,4,26
191129779,6,3,1,8,2,20
191129780,0,6,8,3,4,21
191129781,2,1,4,4,0,11
191129782,9,4,7,6,3,29
191129783,1,8,9,9,3,30
191129784,7,9,7,0,8,31
191129785,9,6,5,1,1,22
191129786,6,8,7,4,2,27
191129787,5,4,0,6,0,15
191129788,5,6,7,7,6,31
191129789,6,1,2,4,1,14
191129790,3,7,8,6,1,25
191129791,1,8,0,0,9,18
191129792,4,0,1,8,1,14
191129793,9,0,3,4,4,20
191129794,0,5,2,3,3,13
191129795,7,0,9,1,2,19
191129796,8,2,0,4,5,19
191129797,1,9,2,9,1,22
191129798,8,1,5,9,2,25
191129799,4,3,0,8,1,16
191129800,7,9,8,5,8,37
191129801,1,7,2,0,2,12
191129802,8,7,8,9,4,36
191129803,2,5,0,6,4,17
191129804,0,2,8,4,5,19
191129805,7,3,0,4,6,20
191129806,8,5,0,0,4,17
191129807,5,3,5,9,2,24
191129808,2,3,7,2,6,20
191129809,3,0,0,5,3,11
191129810,6,3,9,3,2,23
191129811,8,7,5,7,5,32
191129812,4,6,2,4,3,19
191129813,6,3,1,8,7,25
191129814,8,7,0,5,9,29
191129815,5,8,0,2,4,19
191129816,2,4,5,5,6,22
191129817,4,1,9,1,2,17
191129818,9,3,7,5,1,25
191129819,1,1,0,6,7,15
191129820,8,4,1,7,4,24
191129821,3,1,1,8,3,16
191129822,7,7,7,2,5,28
191129823,2,5,0,9,8,24
191129824,0,7,1,5,6,19
191129825,5,8,9,8,1,31
191129826,0,8,2,7,7,24
191129827,5,3,8,1,3,20
191129828,1,8,3,1,0,13
191129829,7,0,7,1,3,18
191129830,7,5,5,5,5,27
191129831,1,7,6,9,8,31
191129832,8,6,6,5,8,33
191129833,9,4,6,4,1,24
191129834,1,3,7,0,7,18
191129835,1,6,4,5,3,19
191129836,7,2,3,9,3,24
191129837,4,5,3,6,9,27
191129838,0,1,9,5,7,22
191129839,8,5,0,8,2,23
191129840,1,7,5,4,0,17
191129841,5,9,4,3,5,26
191129842,7,7,0,1,3,18
191129843,0,5,2,1,7,15
191129844,8,5,6,7,0,26
191129845,5,7,5,5,9,31
191129846,2,3,7,3,0,15
191129847,0,0,3,7,7,17
191129848,1,7,4,1,3,16
191129849,3,9,2,2,6,22
191129850,7,1,8,5,3,24
191129851,0,0,5,6,8,19
191129852,5,0,7,6,9,27
191129853,8,5,5,5,8,31
191129854,4,7,7,6,8,32
191129855,8,9,4,5,6,32
191129856,5,7,4,0,8,24
191129857,1,3,8,0,2,14
191129858,7,1,9,8,4,29
191129859,4,3,5,5,2,19
191129860,2,4,9,8,8,31
191129861,6,5,5,1,4,21
191129862,8,2,1,6,7,24
191129863,0,7,0,3,5,15
191129864,3,6,8,1,5,23
191129865,6,0,7,0,8,21
191129866,0,1,6,2,2,11
191129867,8,4,7,0,3,22
191129868,4,0,6,0,2,12
191129869,9,4,0,9,5,27
191129870,6,5,4,7,0,22
191129871,4,6,4,9,2,25
191129872,9,5,4,5,2,25
191129873,1,0,8,1,2,12
191129874,3,9,4,4,4,24
191129875,3,2,5,3,1,14
191129876,0,4,2,5,0,11
191129877,5,2,8,5,2,22
191129878,2,7,2,5,5,21
191129879,8,0,0,1,2,11
191129880,5,9,0,3,8,25
191129881,5,1,4,5,5,20
191129882,5,6,3,2,3,19
191129883,1,2,8,2,2,15
191129884,5,9,7,3,1,25
191129885,8,9,4,5,4,30
191129886,1,5,2,7,0,15
191129887,0,6,7,3,3,19
191129888,5,2,8,1,7,23
191129889,9,4,5,2,5,25
191129890,6,1,9,1,4,21
191129891,3,1,7,1,5,17
191129892,0,1,3,0,4,8
191129893,4,4,7,8,3,26
191129894,6,2,0,0,1,9
191129895,9,0,8,6,5,28
191129896,5,1,1,7,7,21
191129897,0,6,4,2,3,15
191129898,0,3,4,8,5,20
191129899,1,4,0,5,3,13
191129900,4,9,3,1,5,22
191129901,6,9,0,3,8,26
191129902,8,2,4,6,5,25
191129903,4,1,9,2,7,23
191129904,2,9,2,5,7,25
191129905,2,4,6,1,7,20
191129906,2,4,3,0,9,18
191129907,8,0,3,8,1,20
191129908,3,4,0,1,1,9
191129909,4,9,2,0,5,20
191129910,6,2,0,5,8,21
191129911,7,6,6,1,9,29
191129912,0,1,0,3,7,11
191129913,0,5,3,5,1,14
191129914,4,1,4,8,8,25
191129915,9,7,2,9,3,30
191129916,8,9,9,9,2,37
191129917,6,9,6,4,6,31
191129918,5,9,6,3,9,32
191129919,2,7,9,8,7,33
191129920,1,6,6,1,7,21
191129921,7,0,7,1,5,20
191129922,6,2,9,5,5,27
191129923,3,2,4,2,3,14
191129924,8,5,8,4,2,27
191129925,4,0,4,7,4,19
191129926,2,4,8,8,8,30
191129927,9,4,3,9,6,31
191129928,7,9,1,2,8,27
191129929,6,4,1,6,3,20
191129930,7,6,9,9,9,40
191129931,2,0,3,8,6,19
191129932,2,7,2,3,8,22
191129933,2,5,5,8,3,23
191129934,0,7,7,4,6,24
191129935,1,4,2,7,2,16
191129936,7,6,3,8,5,29
191129937,9,2,8,5,4,28
191129938,6,7,3,4,6,26
191129939,9,5,7,4,5,30
191129940,5,1,2,0,2,10
191129941,4,0,2,8,1,15
191129942,0,1,5,9,2,17
191129943,2,2,5,6,1,16
191129944,9,3,7,3,8,30
191129945,7,7,3,7,2,26
191129946,7,0,8,7,1,23
191129947,0,8,9,9,1,27
191129948,2,5,1,7,9,24
191129949,9,3,7,6,5,30
191129950,9,6,2,5,1,23
191129951,4,7,4,9,7,31
191129952,4,7,9,8,0,28
191129953,0,1,7,7,2,17
191129954,0,3,5,5,0,13
191129955,9,6,9,8,2,34
191129956,8,8,1,3,1,21
191129957,7,5,8,9,0,29
191129958,2,1,8,9,8,28
191129959,3,2,5,3,7,20
191129960,3,7,8,8,0,26
191129961,1,5,1,7,0,14
191129962,9,2,8,6,1,26
191129963,2,2,7,2,7,20
191129964,5,8,7,6,9,35
191129965,9,0,9,3,5,26
191129966,7,5,7,1,4,24
191129967,6,4,4,5,5,24
191129968,6,8,1,2,1,18
191129969,8,8,2,3,2,23
191129970,1,6,3,4,1,15
191129971,3,0,2,5,8,18
191129972,0,3,4,0,8,15
191129973,4,3,3,2,6,18
191129974,6,0,6,9,1,22
191129975,3,9,8,9,4,33
191129976,1,1,9,4,1,16
191129977,6,6,8,2,6,28
191129978,1,6,3,5,0,15
191129979,4,7,1,4,8,24
191129980,4,5,8,3,5,25
191129981,1,9,1,5,5,21
191129982,5,3,6,9,2,25
191129983,7,6,9,4,8,34
191129984,2,1,8,5,7,23
191129985,6,9,8,0,2,25
191129986,9,6,0,9,8,32
191129987,5,5,9,6,8,33
191129988,4,0,8,5,9,26
191129989,7,1,0,8,0,16
191129990,8,8,3,0,2,21
191129991,5,1,0,6,1,13
191129992,5,7,1,8,6,27
191129993,7,4,8,8,8,35
191129994,7,4,5,1,7,24
191129995,4,2,1,5,8,20
191129996,0,7,0,1,8,16
191129997,2,9,0,8,1,20
191129998,7,8,5,8,4,32
191129999,4,8,3,8,5,28
1911291000,6,9,2,5,3,25
1911291001,6,4,8,9,4,31
1911291002,2,3,4,8,9,26
1911291003,6,0,5,8,3,22
1911291004,1,8,7,4,9,29
1911291005,6,2,8,4,4,24
1911291006,2,7,5,1,4,19
1911291007,3,3,1,0,3,10
1911291008,4,1,7,4,7,23
1911291009,1,8,0,1,7,17
1911291010,5,7,5,8,5,30
1911291011,3,9,4,5,3,24
1911291012,2,4,9,1,8,24
1911291013,5,3,2,3,4,17
1911291014,4,8,0,2,7,21
1911291015,3,3,8,9,2,25
1911291016,4,2,3,7,0,16
1911291017,0,9,6,4,4,23
1911291018,8,5,2,7,9,31
1911291019,5,5,5,1,4,20
1911291020,4,7,6,8,0,25
1911291021,0,5,1,4,1,11
1911291022,3,9,8,7,5,32
1911291023,2,6,9,6,7,30
1911291024,2,5,6,2,6,21
1911291025,0,3,4,2,3,12
1911291026,2,4,9,9,2,26
1911291027,2,7,3,9,7,28
1911291028,4,1,7,2,5,19
1911291029,2,8,3,9,3,25
1911291030,9,9,8,7,2,35
1911291031,6,3,9,1,3,22
1911291032,0,9,5,9,6,29
1911291033,3,4,1,9,6,23
1911291034,9,6,4,2,8,29
1911291035,0,7,3,4,6,20
1911291036,1,0,4,2,4,11
1911291037,7,7,8,7,0,29
1911291038,1,2,4,0,0,7
1911291039,7,4,1,1,2,15
1911291040,4,9,1,4,4,22
1911291041,0,8,2,5,1,16
1911291042,5,8,4,9,9,35
1911291043,2,0,5,0,2,9
1911291044,5,7,5,6,2,25
1911291045,3,6,7,8,3,27
1911291046,9,8,5,4,7,33
1911291047,1,9,9,1,1,21
1911291048,3,5,1,8,5,22
1911291049,3,1,1,8,6,19
1911291050,7,5,1,4,4,21
1911291051,5,7,4,5,6,27
1911291052,0,0,3,1,0,4
1911291053,2,3,9,2,2,18
1911291054,4,5,1,2,0,12
1911291055,0,5,2,0,6,13
1911291056,8,3,1,7,9,28
1911291057,4,2,5,3,5,19
1911291058,8,3,4,7,7,29
1911291059,5,8,8,4,5,30
1911291060,7,1,3,6,7,24
1911291061,1,9,7,1,7,25
1911291062,2,3,2,2,5,14
1911291063,1,5,4,7,1,18
1911291064,4,1,6,2,9,22
1911291065,5,4,2,0,9,20
1911291066,5,0,9,4,5,23
1911291067,0,7,1,5,7,20
1911291068,0,3,8,2,9,22
1911291069,4,8,7,7,7,33
1911291070,9,6,1,8,3,27
1911291071,8,9,2,6,1,26
1911291072,5,9,8,5,3,30
1911291073,7,5,5,8,2,27
1911291074,1,6,9,5,4,25
1911291075,1,2,4,5,4,16
1911291076,3,8,8,3,7,29
1911291077,9,4,0,7,4,24
1911291078,1,2,7,0,3,13
1911291079,1,4,0,1,5,11
1911291080,6,0,5,4,3,18
1911291081,3,5,7,9,4,28
1911291082,5,5,7,2,7,26
1911291083,3,7,6,7,3,26
1911291084,0,7,1,1,7,16
1911291085,0,6,0,9,3,18
1911291086,8,3,1,8,9,29
1911291087,1,2,5,8,2,18
1911291088,5,6,4,6,7,28
1911291089,0,5,3,2,5,15
1911291090,8,2,1,1,0,12
1911291091,0,8,3,8,3,22
1911291092,9,0,8,8,7,32
1911291093,6,4,1,6,7,24
1911291094,9,7,7,1,3,27
1911291095,9,5,8,5,1,28
1911291096,9,3,8,4,9,33
1911291097,7,5,3,4,7,26
1911291098,2,0,2,6,1,11
1911291099,9,2,9,4,4,28
1911291100,3,9,1,7,1,21
1911291101,8,5,5,3,9,30
1911291102,8,7,3,1,3,22
1911291103,1,3,4,5,7,20
1911291104,1,3,1,5,3,13
1911291105,2,0,2,8,0,12
191130001,0,4,5,8,9,26
191130002,0,5,5,4,9,23
191130003,5,7,6,6,8,32
191130004,4,9,1,8,4,26
191130005,8,3,5,0,8,24
191130006,3,8,2,3,3,19
191130007,4,3,8,7,7,29
191130008,8,5,2,3,9,27
191130009,0,5,1,3,5,14
191130010,1,8,5,9,9,32
191130011,3,3,7,8,3,24
191130012,9,2,6,7,7,31
191130013,0,2,9,1,3,15
191130014,0,3,3,4,2,12
191130015,5,7,7,8,2,29
191130016,6,5,0,3,6,20
191130017,4,5,7,8,5,29
191130018,4,6,6,7,0,23
191130019,6,1,3,9,5,24
191130020,4,8,1,6,4,23
191130021,7,8,7,3,0,25
191130022,1,0,1,8,5,15
191130023,6,3,8,4,9,30
191130024,2,2,2,4,6,16
191130025,3,3,8,4,7,25
191130026,6,7,8,9,5,35
191130027,0,2,4,2,9,17
191130028,3,0,8,9,8,28
191130029,8,5,3,7,7,30
191130030,8,4,6,3,2,23
191130031,8,4,0,9,1,22
191130032,6,5,6,8,3,28
191130033,5,4,4,1,4,18
191130034,6,2,9,7,8,32
191130035,6,1,6,2,3,18
191130036,7,9,9,7,0,32
191130037,9,5,3,5,5,27
191130038,6,2,9,6,7,30
191130039,8,2,4,7,8,29
191130040,8,9,4,6,6,33
191130041,9,4,5,8,5,31
191130042,6,4,4,8,2,24
191130043,8,9,8,2,1,28
191130044,5,4,6,6,9,30
191130045,5,4,2,8,5,24
191130046,7,7,9,8,8,39
191130047,0,4,6,9,4,23
191130048,9,8,8,7,3,35
191130049,3,2,2,2,6,15
191130050,2,3,3,2,4,14
191130051,9,5,3,8,4,29
191130052,9,1,4,8,9,31
191130053,8,9,0,9,4,30
191130054,2,0,9,1,8,20
191130055,8,6,1,1,1,17
191130056,6,7,6,7,2,28
191130057,0,7,3,3,2,15
191130058,6,4,6,7,4,27
191130059,8,2,1,5,1,17
191130060,4,7,7,9,6,33
191130061,0,8,8,0,9,25
191130062,6,9,2,5,4,26
191130063,0,5,9,9,5,28
191130064,2,7,5,0,5,19
191130065,0,9,4,0,4,17
191130066,0,7,7,9,8,31
191130067,6,5,0,7,8,26
191130068,0,7,1,3,1,12
191130069,5,5,4,8,0,22
191130070,4,1,9,3,5,22
191130071,5,8,7,0,9,29
191130072,5,9,6,2,2,24
191130073,5,7,7,4,1,24
191130074,6,6,2,1,2,17
191130075,0,1,7,0,8,16
191130076,5,4,8,8,4,29
191130077,6,3,6,8,2,25
191130078,6,1,5,1,9,22
191130079,5,9,9,6,3,32
191130080,8,6,4,1,4,23
191130081,0,0,1,2,2,5
191130082,9,7,5,9,5,35
191130083,1,3,5,3,2,14
191130084,9,6,7,1,7,30
191130085,9,0,3,4,8,24
191130086,6,2,2,4,6,20
191130087,6,1,1,6,0,14
191130088,0,8,5,4,8,25
191130089,1,3,7,6,8,25
191130090,3,1,8,9,7,28
191130091,7,4,1,1,3,16
191130092,8,4,7,1,2,22
191130093,1,8,5,2,1,17
191130094,5,3,2,4,2,16
191130095,1,6,2,7,7,23
191130096,5,3,0,3,6,17
191130097,4,3,2,4,6,19
191130098,1,4,2,6,2,15
191130099,4,9,7,7,9,36
191130100,9,0,6,1,1,17
191130101,2,2,1,5,0,10
191130102,7,7,4,7,2,27
191130103,8,0,6,7,1,22
191130104,2,3,2,6,1,14
191130105,1,7,0,3,6,17
191130106,9,4,0,9,1,23
191130107,2,8,2,0,7,19
191130108,3,0,2,6,1,12
191130109,5,3,2,8,2,20
191130110,4,2,4,0,3,13
191130111,3,8,2,6,8,27
191130112,7,1,4,7,9,28
191130113,4,4,3,8,7,26
191130114,6,6,3,4,0,19
191130115,9,8,9,4,2,32
191130116,9,7,7,4,7,34
191130117,9,8,3,7,5,32
191130118,9,1,5,0,1,16
191130119,4,0,2,9,7,22
191130120,7,9,2,8,8,34
191130121,0,3,8,8,2,21
191130122,9,1,5,9,1,25
191130123,3,4,2,8,7,24
191130124,5,2,9,6,1,23
191130125,8,8,7,0,3,26
191130126,2,9,6,4,8,29
191130127,5,3,0,5,9,22
191130128,3,4,2,6,4,19
191130129,8,7,3,2,1,21
191130130,1,7,4,9,6,27
191130131,4,8,5,5,9,31
191130132,0,8,4,6,5,23
191130133,0,7,2,4,9,22
191130134,2,2,1,8,3,16
191130135,8,2,4,7,0,21
191130136,8,1,4,6,4,23
191130137,8,2,4,5,1,20
191130138,7,6,2,5,5,25
191130139,8,9,3,1,2,23
191130140,3,9,2,6,5,25
191130141,6,7,9,9,3,34
191130142,3,1,8,0,2,14
191130143,9,8,6,1,4,28
191130144,8,8,1,9,0,26
191130145,4,3,7,0,6,20
191130146,4,0,8,9,1,22
191130147,1,6,8,7,3,25
191130148,6,9,4,4,3,26
191130149,8,3,7,5,3,26
191130150,9,2,1,1,3,16
191130151,7,0,5,0,0,12
191130152,5,4,6,5,1,21
191130153,0,2,4,3,6,15
191130154,5,3,0,6,7,21
191130155,8,0,5,2,9,24
191130156,5,7,6,5,3,26
191130157,0,5,1,7,4,17
191130158,7,2,6,4,8,27
191130159,8,0,2,0,3,13
191130160,7,4,0,9,9,29
191130161,7,2,0,5,7,21
191130162,0,6,2,8,5,21
191130163,8,0,0,0,5,13
191130164,2,9,7,9,4,31
191130165,0,3,0,6,3,12
191130166,8,6,7,5,4,30
191130167,8,7,8,2,9,34
191130168,9,1,7,1,4,22
191130169,3,4,0,4,3,14
191130170,7,2,7,1,6,23
191130171,8,2,1,3,3,17
191130172,5,6,8,5,6,30
191130173,7,3,9,8,1,28
191130174,1,5,3,6,4,19
191130175,3,3,2,4,3,15
191130176,8,8,8,8,6,38
191130177,8,2,9,9,7,35
191130178,0,2,7,8,7,24
191130179,1,5,0,9,6,21
191130180,3,9,7,4,0,23
191130181,1,8,6,8,5,28
191130182,4,7,3,5,5,24
191130183,5,6,0,2,2,15
191130184,8,3,6,5,0,22
191130185,2,7,3,0,8,20
191130186,2,3,6,7,8,26
191130187,4,0,1,4,9,18
191130188,4,1,1,6,5,17
191130189,8,6,2,6,8,30
191130190,8,4,3,6,6,27
191130191,9,7,6,9,0,31
191130192,6,0,5,0,9,20
191130193,3,0,4,7,9,23
191130194,0,6,6,9,8,29
191130195,1,9,6,3,9,28
191130196,7,3,5,1,7,23
191130197,3,4,5,0,0,12
191130198,0,4,8,6,3,21
191130199,3,6,9,1,0,19
191130200,0,7,4,7,8,26
191130201,4,2,0,4,4,14
191130202,2,6,5,4,2,19
191130203,1,9,4,5,6,25
191130204,1,5,9,7,5,27
191130205,0,8,3,2,9,22
191130206,6,5,4,0,4,19
191130207,5,9,6,6,9,35
191130208,0,8,7,4,0,19
191130209,6,1,5,2,5,19
191130210,2,1,7,3,1,14
191130211,7,2,4,7,9,29
191130212,3,9,3,7,2,24
191130213,9,9,6,7,1,32
191130214,3,7,9,2,5,26
191130215,6,5,8,1,4,24
191130216,8,8,8,4,8,36
191130217,6,6,9,2,3,26
191130218,5,3,2,7,7,24
191130219,5,0,8,5,7,25
191130220,9,5,6,2,8,30
191130221,1,3,8,4,3,19
191130222,9,5,4,1,0,19
191130223,5,1,0,2,4,12
191130224,1,0,1,9,8,19
191130225,9,8,0,4,7,28
191130226,5,8,2,8,1,24
191130227,5,6,3,6,3,23
191130228,5,6,1,9,2,23
191130229,2,1,8,6,4,21
191130230,5,8,5,5,9,32
191130231,7,0,0,2,3,12
191130232,9,2,5,0,1,17
191130233,9,3,2,9,9,32
191130234,2,0,5,9,6,22
191130235,2,2,8,7,1,20
191130236,5,6,3,7,4,25
191130237,4,5,7,5,5,26
191130238,5,2,6,7,0,20
191130239,1,8,6,4,2,21
191130240,5,1,2,7,8,23
191130241,3,7,9,1,8,28
191130242,5,6,7,3,0,21
191130243,0,2,0,6,2,10
191130244,0,3,3,7,5,18
191130245,5,9,5,0,3,22
191130246,3,1,0,5,7,16
191130247,6,7,0,4,0,17
191130248,0,4,8,6,1,19
191130249,0,7,5,8,0,20
191130250,9,3,8,7,2,29
191130251,2,2,7,4,4,19
191130252,3,0,2,4,6,15
191130253,0,9,7,7,6,29
191130254,5,1,6,0,7,19
191130255,7,9,7,7,5,35
191130256,0,8,4,2,5,19
191130257,6,5,5,5,5,26
191130258,2,2,4,9,5,22
191130259,4,4,8,5,4,25
191130260,0,8,7,4,6,25
191130261,2,7,8,5,9,31
191130262,5,1,1,6,5,18
191130263,6,6,5,0,4,21
191130264,3,1,6,3,5,18
191130265,7,7,2,4,5,25
191130266,3,6,7,5,7,28
191130267,3,9,9,1,9,31
191130268,9,1,1,5,5,21
191130269,4,9,6,3,0,22
191130270,1,3,3,8,2,17
191130271,0,9,1,6,1,17
191130272,0,6,2,5,1,14
191130273,1,8,6,7,5,27
191130274,8,4,7,5,2,26
191130275,8,9,4,0,2,23
191130276,6,1,6,7,5,25
191130277,8,8,9,4,9,38
191130278,8,0,2,2,7,19
191130279,7,1,2,4,3,17
191130280,9,4,9,7,4,33
191130281,0,8,8,0,0,16
191130282,7,4,2,4,8,25
191130283,4,6,0,7,3,20
191130284,3,1,3,0,0,7
191130285,9,5,3,2,5,24
191130286,2,5,9,1,3,20
191130287,8,3,7,5,8,31
191130288,6,3,1,1,0,11
191130289,2,5,6,9,7,29
191130290,2,3,7,2,5,19
191130291,3,9,0,5,5,22
191130292,8,4,9,9,8,38
191130293,5,0,6,3,0,14
191130294,4,9,6,1,7,27
191130295,6,1,1,9,0,17
191130296,1,7,4,5,0,17
191130297,2,0,0,9,9,20
191130298,0,0,5,5,8,18
191130299,1,6,4,7,7,25
191130300,9,1,7,3,2,22
191130301,7,0,6,9,0,22
191130302,0,5,9,2,2,18
191130303,7,4,4,0,5,20
191130304,9,9,4,8,9,39
191130305,1,8,5,5,2,21
191130306,1,8,8,1,7,25
191130307,2,3,3,0,0,8
191130308,1,2,7,9,4,23
191130309,8,7,8,1,0,24
191130310,4,8,3,2,9,26
191130311,9,8,1,9,1,28
191130312,6,2,5,5,6,24
191130313,6,1,6,3,2,18
191130314,2,2,4,0,0,8
191130315,0,2,8,9,3,22
191130316,6,4,1,5,4,20
191130317,5,4,6,0,8,23
191130318,7,4,0,3,4,18
191130319,4,7,7,4,4,26
191130320,8,0,4,5,4,21
191130321,8,3,2,3,4,20
191130322,6,6,4,0,3,19
191130323,8,3,4,8,3,26
191130324,1,8,8,5,5,27
191130325,5,6,0,3,9,23
191130326,3,7,2,5,2,19
191130327,8,9,2,7,9,35
191130328,5,1,4,7,7,24
191130329,8,2,0,0,0,10
191130330,4,4,9,0,1,18
191130331,9,0,4,1,0,14
191130332,7,1,6,4,6,24
191130333,9,0,5,6,6,26
191130334,9,3,3,7,5,27
191130335,5,5,8,3,8,29
191130336,0,2,0,7,1,10
191130337,1,5,5,0,4,15
191130338,6,1,6,8,7,28
191130339,5,6,4,2,8,25
191130340,4,4,5,2,2,17
191130341,2,4,7,4,8,25
191130342,1,0,6,4,6,17
191130343,7,4,5,6,4,26
191130344,2,4,7,2,8,23
191130345,6,1,7,7,1,22
191130346,8,0,4,1,6,19
191130347,2,8,0,2,5,17
191130348,1,6,4,8,4,23
191130349,9,6,1,3,2,21
191130350,9,6,9,0,4,28
191130351,2,2,0,7,8,19
191130352,6,7,9,6,7,35
191130353,5,0,4,9,9,27
191130354,0,4,4,5,4,17
191130355,0,2,2,8,7,19
191130356,0,9,4,8,9,30
191130357,6,9,1,8,2,26
191130358,3,0,2,8,0,13
191130359,3,1,2,1,7,14
191130360,5,5,0,1,0,11
191130361,7,9,7,3,3,29
191130362,3,3,8,1,8,23
191130363,5,4,4,8,1,22
191130364,1,9,9,1,0,20
191130365,6,9,9,2,0,26
191130366,8,4,8,2,1,23
191130367,9,6,8,2,4,29
191130368,5,7,7,6,2,27
191130369,6,3,3,3,7,22
191130370,6,6,1,1,2,16
191130371,7,1,4,8,1,21
191130372,8,2,6,6,9,31
191130373,9,4,6,4,2,25
191130374,0,0,6,7,1,14
191130375,1,7,6,1,9,24
191130376,9,1,5,4,2,21
191130377,4,5,1,2,4,16
191130378,5,6,3,2,5,21
191130379,7,6,7,4,4,28
191130380,0,3,3,3,1,10
191130381,6,7,2,9,9,33
191130382,8,3,0,0,5,16
191130383,5,1,4,9,2,21
191130384,3,4,9,5,3,24
191130385,5,8,2,6,1,22
191130386,1,5,3,6,6,21
191130387,1,3,8,0,0,12
191130388,9,8,6,5,5,33
191130389,5,9,6,0,4,24
191130390,2,3,4,4,1,14
191130391,8,5,7,9,9,38
191130392,6,5,3,3,7,24
191130393,0,0,0,0,2,2
191130394,6,3,8,8,9,34
191130395,6,5,6,5,0,22
191130396,5,3,2,7,4,21
191130397,0,5,8,6,7,26
191130398,5,9,1,3,8,26
191130399,4,9,2,2,9,26
191130400,6,1,9,9,3,28
191130401,1,5,9,7,1,23
191130402,6,1,3,5,2,17
191130403,5,7,0,0,0,12
191130404,9,3,3,2,0,17
191130405,6,7,4,1,4,22
191130406,2,5,1,1,9,18
191130407,6,3,1,6,4,20
191130408,5,4,7,8,7,31
191130409,0,8,0,7,6,21
191130410,8,4,7,9,5,33
191130411,5,0,8,8,4,25
191130412,0,0,3,0,2,5
191130413,7,9,1,0,3,20
191130414,4,7,3,7,9,30
191130415,2,6,9,2,2,21
191130416,4,9,8,9,7,37
191130417,9,0,5,9,1,24
191130418,7,2,3,5,7,24
191130419,0,8,1,8,6,23
191130420,3,8,0,4,7,22
191130421,1,8,4,0,0,13
191130422,5,4,5,5,4,23
191130423,1,3,0,9,8,21
191130424,3,9,7,1,5,25
191130425,3,0,2,3,4,12
191130426,7,3,7,9,4,30
191130427,8,3,2,3,1,17
191130428,8,5,3,5,5,26
191130429,2,9,3,0,4,18
191130430,9,9,2,0,1,21
191130431,4,9,6,8,1,28
191130432,3,3,6,0,1,13
191130433,9,8,8,0,1,26
191130434,5,8,4,0,3,20
191130435,1,6,6,7,7,27
191130436,6,1,7,0,5,19
191130437,8,7,8,4,8,35
191130438,0,8,7,2,3,20
191130439,6,1,9,0,1,17
191130440,6,0,2,3,3,14
191130441,3,1,4,8,2,18
191130442,9,1,7,2,4,23
191130443,8,4,8,6,8,34
191130444,0,9,4,5,0,18
191130445,1,1,6,0,8,16
191130446,6,6,9,5,3,29
191130447,8,2,2,9,9,30
191130448,3,4,9,3,8,27
191130449,2,5,0,0,3,10
191130450,8,6,0,9,9,32
191130451,2,7,4,7,8,28
191130452,5,1,4,4,6,20
191130453,6,9,5,9,3,32
191130454,7,6,3,7,7,30
191130455,4,2,5,1,2,14
191130456,0,8,4,0,8,20
191130457,6,0,3,4,1,14
191130458,9,6,6,7,5,33
191130459,7,7,3,9,3,29
191130460,4,0,6,4,1,15
191130461,9,6,3,5,4,27
191130462,5,9,0,4,9,27
191130463,5,8,7,5,5,30
191130464,8,1,7,0,3,19
191130465,1,3,3,1,3,11
191130466,0,2,2,0,3,7
191130467,2,7,3,0,1,13
191130468,9,2,6,6,1,24
191130469,5,7,0,4,4,20
191130470,7,6,5,3,8,29
191130471,7,1,1,2,2,13
191130472,3,9,9,9,5,35
191130473,1,3,0,1,5,10
191130474,2,6,8,6,4,26
191130475,9,2,8,0,5,24
191130476,4,2,6,3,4,19
191130477,3,5,9,3,8,28
191130478,5,0,0,1,6,12
191130479,5,6,3,8,0,22
191130480,6,0,9,5,8,28
191130481,7,4,6,5,3,25
191130482,1,6,6,9,3,25
191130483,8,7,8,9,9,41
191130484,5,1,8,7,3,24
191130485,5,2,6,1,4,18
191130486,6,8,1,6,8,29
191130487,5,1,0,3,5,14
191130488,8,3,5,2,9,27
191130489,9,6,0,5,8,28
191130490,3,5,5,0,7,20
191130491,4,9,1,8,1,23
191130492,5,9,6,8,0,28
191130493,6,0,5,2,5,18
191130494,0,5,5,1,6,17
191130495,1,9,9,7,3,29
191130496,4,3,9,1,1,18
191130497,5,5,7,9,4,30
191130498,5,7,5,0,7,24
191130499,4,2,3,1,8,18
191130500,8,6,6,4,8,32
191130501,6,0,4,1,0,11
191130502,1,1,4,9,0,15
191130503,3,3,4,3,3,16
191130504,0,2,4,2,6,14
191130505,0,5,7,5,9,26
191130506,7,2,2,8,1,20
191130507,1,0,0,1,0,2
191130508,2,5,8,1,5,21
191130509,5,5,5,0,4,19
191130510,6,4,5,2,6,23
191130511,5,7,5,1,6,24
191130512,9,2,3,3,0,17
191130513,5,5,2,5,5,22
191130514,8,0,6,0,6,20
191130515,4,4,0,4,2,14
191130516,6,9,2,2,1,20
191130517,2,7,4,3,4,20
191130518,0,1,7,1,0,9
191130519,0,1,5,6,3,15
191130520,7,9,4,1,6,27
191130521,4,1,6,6,5,22
191130522,6,9,5,2,2,24
191130523,2,5,3,4,8,22
191130524,1,1,4,8,3,17
191130525,1,4,6,1,7,19
191130526,9,4,2,9,6,30
191130527,6,5,7,4,6,28
191130528,7,3,3,5,6,24
191130529,7,9,5,4,2,27
191130530,1,2,4,3,4,14
191130531,2,4,4,1,9,20
191130532,6,8,6,9,1,30
191130533,7,0,8,4,4,23
191130534,4,3,8,9,6,30
191130535,4,3,8,9,5,29
191130536,4,5,7,8,2,26
191130537,7,4,7,1,3,22
191130538,8,3,3,2,6,22
191130539,8,4,0,0,3,15
191130540,0,4,6,2,8,20
191130541,7,4,0,8,0,19
191130542,5,6,9,1,4,25
191130543,4,4,5,8,4,25
191130544,3,4,6,1,9,23
191130545,2,3,3,2,2,12
191130546,8,3,9,1,7,28
191130547,2,8,6,9,7,32
191130548,9,6,2,4,2,23
191130549,8,8,7,5,5,33
191130550,4,8,5,3,1,21
191130551,0,9,5,2,0,16
191130552,0,1,1,4,7,13
191130553,4,1,1,6,8,20
191130554,3,1,5,4,1,14
191130555,7,0,3,0,3,13
191130556,7,0,1,7,6,21
191130557,3,0,2,6,7,18
191130558,0,8,5,6,4,23
191130559,7,0,4,3,8,22
191130560,6,1,1,9,7,24
191130561,3,3,6,1,5,18
191130562,7,2,0,7,0,16
191130563,3,3,9,9,3,27
191130564,0,7,8,8,0,23
191130565,3,4,8,2,0,17
191130566,4,3,3,9,7,26
191130567,2,1,4,6,9,22
191130568,3,2,1,8,4,18
191130569,4,3,2,3,3,15
191130570,2,3,4,8,5,22
191130571,4,5,8,3,0,20
191130572,2,8,8,6,3,27
191130573,9,2,4,0,8,23
191130574,8,9,5,3,2,27
191130575,3,8,9,6,8,34
191130576,9,7,9,8,1,34
191130577,9,0,6,8,5,28
191130578,4,4,1,1,7,17
191130579,8,8,3,8,0,27
191130580,8,7,7,2,7,31
191130581,2,6,4,1,5,18
191130582,8,3,2,6,2,21
191130583,1,9,5,8,5,28
191130584,3,3,6,3,7,22
191130585,7,7,0,7,7,28
191130586,9,8,0,4,9,30
191130587,8,4,9,9,1,31
191130588,5,9,7,4,2,27
191130589,8,8,7,0,5,28
191130590,1,4,9,8,6,28
191130591,6,7,8,4,4,29
191130592,4,2,0,0,6,12
191130593,3,0,5,4,4,16
191130594,0,1,6,4,3,14
191130595,7,4,2,9,8,30
191130596,7,4,9,4,6,30
191130597,1,6,4,1,4,16
191130598,6,1,4,2,7,20
191130599,2,9,5,7,7,30
191130600,1,4,8,7,2,22
191130601,3,9,1,4,8,25
191130602,5,9,7,0,3,24
191130603,6,9,0,7,6,28
191130604,0,9,7,1,4,21
191130605,5,7,2,4,2,20
191130606,6,7,9,8,1,31
191130607,9,8,6,2,4,29
191130608,3,8,6,9,5,31
191130609,6,7,1,6,8,28
191130610,5,8,8,6,0,27
191130611,6,1,9,6,7,29
191130612,1,6,3,1,4,15
191130613,8,4,8,8,9,37
191130614,7,8,2,0,6,23
191130615,3,7,8,6,6,30
191130616,3,6,5,6,1,21
191130617,3,5,5,1,3,17
191130618,6,6,2,0,9,23
191130619,4,3,5,3,3,18
191130620,1,7,3,8,7,26
191130621,6,5,3,7,3,24
191130622,0,8,1,1,3,13
191130623,3,3,6,1,2,15
191130624,4,8,9,5,8,34
191130625,8,9,2,3,6,28
191130626,7,2,0,5,3,17
191130627,9,9,7,0,1,26
191130628,5,0,4,3,0,12
191130629,0,2,0,7,6,15
191130630,5,9,8,0,5,27
191130631,3,2,1,9,7,22
191130632,6,8,0,3,2,19
191130633,5,8,9,3,0,25
191130634,6,9,3,0,7,25
191130635,4,9,2,8,7,30
191130636,1,7,4,2,3,17
191130637,1,7,9,9,9,35
191130638,2,5,0,2,6,15
191130639,7,1,1,6,4,19
191130640,2,7,8,0,9,26
191130641,4,1,8,1,1,15
191130642,5,3,1,8,7,24
191130643,0,8,0,3,0,11
191130644,7,8,9,7,1,32
191130645,2,4,2,2,8,18
191130646,1,7,7,5,1,21
191130647,1,9,8,1,0,19
191130648,3,7,0,6,1,17
191130649,8,9,7,5,3,32
191130650,9,0,0,7,4,20
191130651,3,3,3,9,2,20
191130652,8,7,4,6,2,27
191130653,1,7,8,9,8,33
191130654,6,4,0,9,2,21
191130655,5,6,6,7,3,27
191130656,5,5,9,6,6,31
191130657,9,0,2,2,2,15
191130658,2,6,0,8,3,19
191130659,2,7,2,4,4,19
191130660,7,5,1,0,0,13
191130661,7,8,0,8,5,28
191130662,3,9,6,9,1,28
191130663,1,4,2,7,1,15
191130664,8,1,8,2,0,19
191130665,8,1,8,3,0,20
191130666,7,4,1,2,1,15
191130667,8,9,3,2,0,22
191130668,6,6,5,6,5,28
191130669,7,7,6,9,6,35
191130670,4,6,1,0,5,16
191130671,5,2,2,9,6,24
191130672,0,6,1,1,6,14
191130673,1,0,7,6,5,19
191130674,6,5,6,6,9,32
191130675,3,9,2,1,9,24
191130676,5,1,9,7,0,22
191130677,6,7,5,9,7,34
191130678,1,1,5,6,7,20
191130679,8,6,5,4,3,26
191130680,9,5,5,7,9,35
191130681,8,4,0,3,9,24
191130682,7,4,4,0,9,24
191130683,1,3,1,2,4,11
191130684,0,0,4,3,6,13
191130685,3,3,2,4,8,20
191130686,9,0,8,8,0,25
191130687,6,2,9,0,6,23
191130688,9,9,9,6,0,33
191130689,2,5,0,5,3,15
191130690,1,3,8,9,7,28
191130691,6,4,5,1,0,16
191130692,3,6,9,8,9,35
191130693,2,7,0,3,2,14
191130694,7,7,7,5,5,31
191130695,5,5,9,1,7,27
191130696,7,7,1,8,3,26
191130697,5,4,1,7,1,18
191130698,5,5,2,2,2,16
191130699,1,1,2,8,4,16
191130700,5,0,2,4,0,11
191130701,9,8,9,2,4,32
191130702,7,0,5,0,9,21
191130703,8,2,5,0,9,24
191130704,4,7,9,1,5,26
191130705,9,0,9,6,9,33
191130706,8,8,0,2,5,23
191130707,8,3,2,1,6,20
191130708,1,0,2,8,3,14
191130709,3,0,2,8,1,14
191130710,1,8,8,3,0,20
191130711,3,7,4,2,5,21
191130712,4,8,4,5,7,28
191130713,0,9,7,7,9,32
191130714,4,9,2,9,1,25
191130715,1,6,8,7,1,23
191130716,8,1,6,6,1,22
191130717,7,3,0,8,7,25
191130718,9,1,1,4,4,19
191130719,0,1,9,3,6,19
191130720,3,0,7,9,7,26
191130721,1,9,3,3,3,19
191130722,4,3,0,2,2,11
191130723,0,8,3,1,0,12
191130724,6,9,5,1,2,23
191130725,4,3,4,8,1,20
191130726,2,6,3,7,6,24
191130727,1,9,5,8,2,25
191130728,3,8,2,1,8,22
191130729,6,6,5,8,4,29
191130730,0,4,7,2,9,22
191130731,6,4,5,1,8,24
191130732,7,2,9,7,7,32
191130733,5,9,8,5,5,32
191130734,4,8,7,6,0,25
191130735,2,9,5,6,9,31
191130736,4,8,7,0,6,25
191130737,6,2,1,1,1,11
191130738,4,6,7,3,0,20
191130739,5,4,5,9,3,26
191130740,8,6,6,8,4,32
191130741,7,2,9,6,6,30
191130742,8,1,7,6,2,24
191130743,9,1,5,6,6,27
191130744,5,9,6,4,0,24
191130745,7,5,0,2,6,20
191130746,0,5,7,5,6,23
191130747,0,0,2,4,9,15
191130748,9,6,1,8,1,25
191130749,3,7,6,8,5,29
191130750,1,1,5,1,9,17
191130751,5,7,6,7,1,26
191130752,2,3,9,9,8,31
191130753,3,3,6,8,9,29
191130754,3,7,4,0,9,23
191130755,5,1,3,2,5,16
191130756,6,5,7,6,8,32
191130757,8,7,1,5,4,25
191130758,2,2,4,9,7,24
191130759,6,3,7,1,5,22
191130760,5,0,8,3,6,22
191130761,4,6,4,2,8,24
191130762,2,6,6,6,5,25
191130763,1,0,2,7,3,13
191130764,1,9,7,0,2,19
191130765,3,5,8,3,5,24
191130766,4,6,0,4,9,23
191130767,9,9,4,3,8,33
191130768,3,4,1,1,8,17
191130769,8,2,8,7,4,29
191130770,2,9,4,5,6,26
191130771,2,3,0,4,4,13
191130772,5,2,9,6,9,31
191130773,1,7,1,2,3,14
191130774,6,4,5,0,4,19
191130775,5,0,2,6,0,13
191130776,6,8,7,8,9,38
191130777,9,3,6,5,6,29
191130778,8,5,4,7,6,30
191130779,3,4,2,8,9,26
191130780,1,3,0,7,6,17
191130781,5,0,9,7,6,27
191130782,7,6,4,0,1,18
191130783,7,6,1,2,8,24
191130784,4,0,4,9,3,20
191130785,4,1,9,1,6,21
191130786,0,6,0,5,6,17
191130787,9,0,8,7,7,31
191130788,8,8,1,6,2,25
191130789,4,5,4,9,8,30
191130790,6,3,8,0,2,19
191130791,5,7,8,4,3,27
191130792,9,2,0,2,9,22
191130793,8,0,8,0,8,24
191130794,2,4,9,3,5,23
191130795,2,5,6,6,4,23
191130796,8,6,9,4,2,29
191130797,1,2,9,9,3,24
191130798,7,8,7,5,2,29
191130799,8,1,9,8,2,28
191130800,5,0,6,7,7,25
191130801,3,2,6,5,3,19
191130802,4,2,3,7,9,25
191130803,4,6,0,8,9,27
191130804,1,6,6,2,1,16
191130805,1,8,6,5,6,26
191130806,4,9,5,9,4,31
191130807,1,8,0,5,6,20
191130808,1,4,8,5,0,18
191130809,3,9,2,3,7,24
191130810,8,9,9,0,1,27
191130811,0,1,3,0,2,6
191130812,8,6,5,1,8,28
191130813,8,6,5,9,1,29
191130814,8,0,7,4,4,23
191130815,3,2,6,4,5,20
191130816,2,8,3,9,1,23
191130817,1,2,3,9,9,24
191130818,9,4,6,0,1,20
191130819,1,0,4,3,6,14
191130820,0,8,8,7,0,23
191130821,3,4,9,5,5,26
191130822,4,3,7,0,3,17
191130823,2,3,7,9,4,25
191130824,8,6,2,5,2,23
191130825,6,1,9,1,9,26
191130826,5,9,3,6,9,32
191130827,0,1,5,9,5,20
191130828,6,3,3,1,0,13
191130829,4,8,8,0,2,22
191130830,1,9,9,5,5,29
191130831,8,8,4,2,5,27
191130832,4,3,4,1,2,14
191130833,6,2,0,4,8,20
191130834,6,1,0,2,0,9
191130835,5,6,0,2,0,13
191130836,2,7,5,9,2,25
191130837,1,5,8,3,2,19
191130838,5,7,9,0,0,21
191130839,5,3,4,9,0,21
191130840,8,2,9,2,5,26
191130841,9,7,2,8,0,26
191130842,6,1,4,0,6,17
191130843,0,3,5,9,1,18
191130844,5,5,8,8,3,29
191130845,6,2,9,2,3,22
191130846,8,6,9,7,7,37
191130847,7,7,1,5,2,22
191130848,5,2,4,6,3,20
191130849,5,8,6,4,4,27
191130850,8,9,2,0,5,24
191130851,2,8,8,8,5,31
191130852,1,3,3,0,5,12
191130853,6,7,5,7,6,31
191130854,2,1,4,6,5,18
191130855,9,4,5,7,6,31
191130856,4,5,3,7,3,22
191130857,1,6,3,6,1,17
191130858,0,5,8,5,4,22
191130859,6,9,7,0,9,31
191130860,5,1,9,7,6,28
191130861,3,1,3,3,8,18
191130862,3,3,1,5,6,18
191130863,3,0,9,5,8,25
191130864,8,9,8,5,4,34
191130865,4,8,8,5,8,33
191130866,5,3,9,4,5,26
191130867,1,1,8,2,2,14
191130868,2,6,7,3,4,22
191130869,1,9,5,9,4,28
191130870,1,6,3,1,0,11
191130871,2,8,9,3,6,28
191130872,2,7,5,6,1,21
191130873,9,2,2,5,9,27
191130874,9,4,1,9,0,23
191130875,1,8,1,6,9,25
191130876,3,9,9,5,9,35
191130877,7,5,1,5,4,22
191130878,7,2,4,3,8,24
191130879,8,6,5,0,0,19
191130880,2,5,8,1,3,19
191130881,1,4,1,6,9,21
191130882,0,9,5,8,4,26
191130883,4,7,6,3,5,25
191130884,5,5,2,2,9,23
191130885,2,9,1,6,6,24
191130886,8,1,5,4,2,20
191130887,3,8,6,4,8,29
191130888,5,5,0,8,8,26
191130889,5,0,4,6,7,22
191130890,0,4,4,9,3,20
191130891,2,1,3,8,5,19
191130892,4,1,8,7,6,26
191130893,1,7,1,3,1,13
191130894,7,2,2,0,7,18
191130895,9,2,0,8,0,19
191130896,2,4,1,8,4,19
191130897,1,7,1,5,5,19
191130898,9,6,7,7,7,36
191130899,9,8,3,3,9,32
191130900,6,3,4,7,0,20
191130901,2,6,5,4,4,21
191130902,5,2,6,1,7,21
191130903,4,4,0,7,6,21
191130904,3,1,7,2,9,22
191130905,9,1,1,8,6,25
191130906,0,4,1,5,7,17
191130907,4,9,7,7,2,29
191130908,4,8,6,9,1,28
191130909,9,3,0,2,1,15
191130910,9,2,2,5,0,18
191130911,7,3,7,1,3,21
191130912,7,2,7,3,4,23
191130913,5,2,0,6,4,17
191130914,1,7,3,9,4,24
191130915,5,9,0,3,5,22
191130916,5,1,8,9,1,24
191130917,5,3,0,6,9,23
191130918,9,0,5,7,1,22
191130919,3,6,4,6,6,25
191130920,5,4,6,3,0,18
191130921,7,0,1,8,1,17
191130922,9,1,1,9,7,27
191130923,0,8,4,0,5,17
191130924,8,7,8,6,6,35
191130925,0,0,5,9,2,16
191130926,5,5,9,7,8,34
191130927,5,0,5,4,2,16
191130928,8,9,0,6,0,23
191130929,3,7,2,5,7,24
191130930,8,5,7,4,9,33
191130931,9,3,4,9,4,29
191130932,8,3,0,5,9,25
191130933,5,1,7,0,5,18
191130934,5,9,4,9,4,31
191130935,8,9,1,7,8,33
191130936,0,9,5,3,1,18
191130937,5,5,1,9,9,29
191130938,0,8,6,8,5,27
191130939,4,9,6,9,4,32
191130940,3,2,4,6,0,15
191130941,4,9,0,8,7,28
191130942,0,7,0,7,5,19
191130943,1,5,5,4,3,18
191130944,5,7,7,2,1,22
191130945,5,3,2,6,5,21
191130946,5,2,8,7,5,27
191130947,5,7,8,8,9,37
191130948,6,6,6,1,6,25
191130949,8,9,5,0,1,23
191130950,5,2,7,2,8,24
191130951,3,6,9,7,2,27
191130952,9,5,1,2,4,21
191130953,6,9,9,0,9,33
191130954,2,8,0,2,3,15
191130955,1,9,4,2,9,25
191130956,7,8,2,8,5,30
191130957,1,1,4,3,1,10
191130958,5,7,0,6,9,27
191130959,0,0,7,2,3,12
191130960,6,1,9,3,6,25
191130961,8,3,7,2,1,21
191130962,2,2,0,8,3,15
191130963,7,2,0,0,6,15
191130964,4,9,4,2,5,24
191130965,5,6,2,8,9,30
191130966,1,5,9,6,9,30
191130967,7,3,0,5,6,21
191130968,7,1,3,8,0,19
191130969,9,8,6,4,2,29
191130970,8,2,1,5,4,20
191130971,0,6,6,1,7,20
191130972,4,7,0,1,5,17
191130973,3,1,2,1,1,8
191130974,5,6,4,2,7,24
191130975,8,6,7,9,3,33
191130976,0,8,9,9,9,35
191130977,5,9,6,0,8,28
191130978,2,1,1,6,6,16
191130979,6,8,3,4,0,21
191130980,3,7,9,3,1,23
191130981,9,5,3,6,4,27
191130982,4,9,1,5,7,26
191130983,8,0,6,2,2,18
191130984,5,4,0,4,4,17
191130985,3,5,1,0,5,14
191130986,6,4,4,1,4,19
191130987,2,6,2,9,8,27
191130988,7,1,2,0,4,14
191130989,7,5,1,1,0,14
191130990,8,3,7,2,0,20
191130991,6,4,0,2,6,18
191130992,7,2,9,7,2,27
191130993,9,1,0,1,0,11
191130994,9,8,4,2,8,31
191130995,7,1,9,2,9,28
191130996,0,9,6,0,1,16
191130997,4,0,2,3,4,13
191130998,0,5,6,0,3,14
191130999,6,7,1,9,8,31
1911301000,7,2,3,4,5,21
1911301001,7,7,5,6,4,29
1911301002,3,2,4,5,4,18
1911301003,7,5,6,0,5,23
1911301004,2,6,0,2,4,14
1911301005,3,3,1,9,4,20
1911301006,6,6,9,8,9,38
1911301007,9,7,7,9,7,39
1911301008,8,0,0,8,9,25
1911301009,1,0,3,2,4,10
1911301010,7,4,3,1,0,15
1911301011,0,4,9,4,7,24
1911301012,2,3,2,8,2,17
1911301013,3,7,7,6,3,26
1911301014,2,8,0,8,5,23
1911301015,0,9,5,6,0,20
1911301016,5,8,9,9,5,36
1911301017,0,1,4,3,9,17
1911301018,0,2,6,0,1,9
1911301019,6,5,7,6,0,24
1911301020,2,6,3,2,0,13
1911301021,3,3,5,9,2,22
1911301022,7,9,6,9,9,40
1911301023,8,4,7,6,0,25
1911301024,5,2,8,4,6,25
1911301025,1,9,3,9,9,31
1911301026,7,4,3,7,9,30
1911301027,4,8,6,0,0,18
1911301028,3,8,4,8,3,26
1911301029,9,2,6,0,3,20
1911301030,3,8,3,3,5,22
1911301031,9,7,1,9,4,30
1911301032,3,5,3,6,3,20
1911301033,9,0,3,9,0,21
1911301034,3,0,1,6,1,11
1911301035,8,1,3,2,3,17
1911301036,0,5,2,5,1,13
1911301037,4,6,8,4,2,24
1911301038,8,7,3,7,0,25
1911301039,2,0,6,5,5,18
1911301040,2,1,1,0,6,10
1911301041,7,5,3,2,9,26
1911301042,7,7,9,3,0,26
1911301043,3,6,1,7,6,23
1911301044,4,2,6,6,4,22
1911301045,7,3,5,9,8,32
1911301046,2,7,9,2,9,29
1911301047,3,1,7,0,2,13
1911301048,5,9,9,9,7,39
1911301049,3,6,9,2,6,26
1911301050,1,1,4,4,3,13
1911301051,6,6,7,9,1,29
1911301052,9,9,2,9,1,30
1911301053,5,2,8,5,8,28
1911301054,3,6,4,4,5,22
1911301055,0,9,8,1,4,22
1911301056,8,4,0,4,2,18
1911301057,1,3,1,5,1,11
1911301058,6,3,6,5,2,22
1911301059,9,0,0,7,8,24
1911301060,5,0,5,6,9,25
1911301061,8,2,1,5,8,24
1911301062,1,1,1,5,5,13
1911301063,8,4,2,1,0,15
1911301064,8,5,2,5,3,23
1911301065,9,7,2,9,5,32
1911301066,3,2,1,0,9,15
1911301067,7,4,3,8,4,26
1911301068,7,4,9,7,4,31
1911301069,9,5,1,7,9,31
1911301070,0,4,3,9,0,16
1911301071,4,8,1,7,6,26
1911301072,0,1,6,5,3,15
1911301073,3,8,4,0,2,17
1911301074,4,3,4,1,8,20
1911301075,7,1,9,2,0,19
1911301076,4,9,5,7,9,34
1911301077,6,0,0,8,4,18
1911301078,9,7,6,8,8,38
1911301079,5,2,7,5,2,21
1911301080,8,4,0,9,4,25
1911301081,1,9,5,0,9,24
1911301082,1,6,6,0,0,13
1911301083,7,1,3,3,2,16
1911301084,3,3,7,5,0,18
1911301085,2,4,5,7,6,24
1911301086,0,6,4,8,1,19
1911301087,1,5,7,6,2,21
1911301088,0,1,4,9,1,15
1911301089,5,6,5,4,8,28
1911301090,8,2,4,6,3,23
1911301091,4,2,2,3,0,11
1911301092,9,7,1,1,0,18
1911301093,3,1,7,0,3,14
1911301094,8,7,0,8,5,28
1911301095,3,1,3,6,2,15
1911301096,0,8,7,3,4,22
1911301097,0,6,6,3,6,21
1911301098,9,8,7,6,6,36
1911301099,4,0,0,0,8,12
1911301100,0,6,9,1,7,23
1911301101,6,4,6,4,9,29
1911301102,4,2,4,0,8,18
1911301103,0,8,5,5,1,19
1911301104,0,7,1,3,3,14
1911301105,4,2,8,6,7,27
191201001,4,7,9,1,2,23
191201002,6,5,1,8,3,23
191201003,0,9,3,4,2,18
191201004,5,0,6,0,6,17
191201005,7,9,6,2,0,24
191201006,6,1,8,2,1,18
191201007,0,6,4,4,7,21
191201008,8,0,6,7,2,23
191201009,3,6,6,3,8,26
191201010,3,5,0,0,1,9
191201011,5,3,6,5,0,19
191201012,2,2,4,0,5,13
191201013,3,5,4,4,1,17
191201014,8,1,6,3,8,26
191201015,6,3,9,9,7,34
191201016,2,3,9,2,7,23
191201017,0,7,4,0,6,17
191201018,7,3,8,1,5,24
191201019,7,9,3,4,7,30
191201020,1,2,5,2,2,12
191201021,1,4,4,2,9,20
191201022,2,2,4,1,1,10
191201023,6,2,9,4,8,29
191201024,2,1,3,2,9,17
191201025,9,2,9,1,4,25
191201026,6,0,0,9,0,15
191201027,1,1,7,3,1,13
191201028,8,1,4,2,3,18
191201029,8,2,0,2,0,12
191201030,2,2,1,8,4,17
191201031,9,2,7,8,7,33
191201032,7,8,5,8,9,37
191201033,0,0,3,2,6,11
191201034,3,9,7,4,4,27
191201035,5,0,7,6,8,26
191201036,2,9,7,3,0,21
191201037,0,2,4,4,4,14
191201038,0,8,1,5,6,20
191201039,8,0,3,3,3,17
191201040,4,2,2,7,0,15
191201041,4,0,2,5,8,19
191201042,9,4,0,7,7,27
191201043,5,1,7,1,4,18
191201044,9,2,4,2,6,23
191201045,2,6,2,8,6,24
191201046,8,7,9,9,7,40
191201047,3,1,9,8,9,30
191201048,1,2,5,0,6,14
191201049,8,3,5,5,5,26
191201050,3,3,3,9,4,22
191201051,4,2,1,0,8,15
191201052,6,2,4,4,6,22
191201053,7,8,1,9,6,31
191201054,4,7,5,0,9,25
191201055,9,8,3,1,9,30
191201056,9,9,9,5,3,35
191201057,3,4,5,8,5,25
191201058,0,4,2,2,4,12
191201059,1,8,5,1,2,17
191201060,7,4,4,6,3,24
191201061,4,3,5,6,3,21
191201062,6,2,3,4,9,24
191201063,7,6,9,2,0,24
191201064,3,5,0,0,4,12
191201065,4,9,4,3,4,24
191201066,6,9,0,4,5,24
191201067,2,5,6,7,3,23
191201068,8,1,5,8,5,27
191201069,1,6,0,6,8,21
191201070,5,8,2,8,9,32
191201071,9,6,2,1,2,20
191201072,9,2,4,9,5,29
191201073,7,1,1,8,8,25
191201074,3,2,5,4,4,18
191201075,1,1,5,0,8,15
191201076,6,3,0,1,5,15
191201077,1,6,4,6,2,19
191201078,7,8,3,8,8,34
191201079,5,7,2,9,9,32
191201080,5,5,0,7,1,18
191201081,9,7,3,6,2,27
191201082,5,0,0,1,0,6
191201083,7,7,5,8,7,34
191201084,0,8,1,7,6,22
191201085,6,0,6,2,0,14
191201086,3,8,3,4,6,24
191201087,0,9,3,0,0,12
191201088,0,8,2,2,1,13
191201089,4,3,2,4,8,21
191201090,1,7,4,8,1,21
191201091,2,5,7,0,1,15
191201092,3,2,2,8,9,24
191201093,2,0,4,0,0,6
191201094,4,4,9,4,6,27
191201095,5,0,1,2,9,17
191201096,2,6,0,1,7,16
191201097,5,0,2,5,6,18
191201098,9,3,2,5,6,25
191201099,1,7,2,4,4,18
191201100,8,9,0,0,5,22
191201101,4,6,1,8,7,26
191201102,8,6,2,5,7,28
191201103,3,4,5,5,7,24
191201104,8,6,7,3,8,32
191201105,8,1,6,3,5,23
191201106,5,1,2,2,0,10
191201107,4,0,1,5,9,19
191201108,3,4,3,3,0,13
191201109,3,4,3,1,2,13
191201110,3,7,6,6,9,31
191201111,0,6,1,4,1,12
191201112,6,9,6,5,0,26
191201113,4,5,8,9,4,30
191201114,6,8,5,3,8,30
191201115,6,1,3,5,9,24
191201116,0,0,0,0,4,4
191201117,4,1,2,5,3,15
191201118,3,3,4,0,2,12
191201119,7,4,2,4,2,19
191201120,9,9,8,5,6,37
191201121,9,6,0,2,0,17
191201122,2,5,2,0,5,14
191201123,0,3,3,7,3,16
191201124,9,4,8,4,8,33
191201125,7,7,2,4,0,20
191201126,0,8,7,9,2,26
191201127,1,7,9,5,3,25
191201128,8,3,2,2,0,15
191201129,0,9,2,4,3,18
191201130,1,9,6,7,6,29
191201131,9,0,2,0,6,17
191201132,4,1,1,0,5,11
191201133,3,1,6,4,1,15
191201134,2,1,9,9,5,26
191201135,2,7,2,1,4,16
191201136,8,3,5,3,5,24
191201137,6,9,3,2,9,29
191201138,6,1,9,7,9,32
191201139,0,8,9,3,6,26
191201140,3,4,9,9,0,25
191201141,2,0,0,1,4,7
191201142,1,4,4,9,6,24
191201143,3,7,5,4,4,23
191201144,8,3,9,6,0,26
191201145,2,2,1,3,4,12
191201146,2,1,3,1,4,11
191201147,1,0,3,0,6,10
191201148,1,8,6,1,1,17
191201149,2,3,2,4,8,19
191201150,3,0,4,7,2,16
191201151,8,4,9,1,7,29
191201152,8,4,0,4,3,19
191201153,7,2,6,9,2,26
191201154,8,5,6,4,7,30
191201155,4,2,3,5,5,19
191201156,9,4,0,4,0,17
191201157,8,8,8,9,7,40
191201158,9,9,8,2,7,35
191201159,7,4,8,8,0,27
191201160,5,4,8,6,9,32
191201161,7,2,3,5,5,22
191201162,5,8,8,3,2,26
191201163,5,4,7,4,8,28
191201164,1,4,2,6,8,21
191201165,9,7,4,2,2,24
191201166,4,2,3,9,5,23
191201167,8,1,6,4,9,28
191201168,7,1,2,9,5,24
191201169,2,9,2,2,3,18
191201170,6,9,4,2,7,28
191201171,7,7,3,9,0,26
191201172,6,8,5,3,7,29
191201173,1,8,3,5,2,19
191201174,1,1,2,6,3,13
191201175,6,4,7,6,0,23
191201176,0,8,4,1,4,17
191201177,5,0,5,5,1,16
191201178,5,2,5,6,2,20
191201179,0,4,5,4,9,22
191201180,1,5,9,8,6,29
191201181,4,9,5,4,6,28
191201182,0,2,2,9,8,21
191201183,7,5,5,6,0,23
191201184,7,1,1,9,6,24
191201185,9,5,4,4,7,29
191201186,2,6,8,8,0,24
191201187,9,8,6,1,2,26
191201188,5,7,7,0,3,22
191201189,6,0,4,4,0,14
191201190,6,4,7,0,4,21
191201191,9,4,1,2,0,16
191201192,2,1,0,7,6,16
191201193,8,3,7,3,6,27
191201194,4,5,0,3,3,15
191201195,7,0,7,6,4,24
191201196,4,2,4,3,2,15
191201197,9,1,6,9,9,34
191201198,2,6,2,7,5,22
191201199,8,5,6,0,4,23
191201200,6,6,8,7,6,33
191201201,1,4,9,5,7,26
191201202,4,8,8,1,0,21
191201203,4,6,1,9,2,22
191201204,6,4,1,5,2,18
191201205,9,9,3,8,0,29
191201206,9,2,4,1,9,25
191201207,0,1,2,3,3,9
191201208,3,3,2,7,4,19
191201209,8,8,9,3,1,29
191201210,7,1,7,1,1,17
191201211,3,7,8,6,7,31
191201212,3,8,6,3,6,26
191201213,4,3,9,7,9,32
191201214,4,9,0,3,7,23
191201215,4,8,3,7,5,27
191201216,9,9,0,0,8,26
191201217,2,7,7,8,9,33
191201218,8,1,4,6,7,26
191201219,4,8,6,5,0,23
191201220,5,6,6,8,7,32
191201221,1,7,2,4,3,17
191201222,6,0,1,4,0,11
191201223,9,3,1,0,7,20
191201224,3,6,5,6,9,29
191201225,9,9,7,4,2,31
191201226,0,6,5,9,7,27
191201227,8,9,0,8,3,28
191201228,2,9,4,2,6,23
191201229,0,1,8,0,3,12
191201230,3,1,1,2,1,8
191201231,3,5,8,8,1,25
191201232,8,9,3,5,2,27
191201233,5,6,7,9,7,34
191201234,4,0,1,3,8,16
191201235,0,3,4,8,0,15
191201236,0,3,9,6,1,19
191201237,0,9,5,6,4,24
191201238,5,5,7,0,0,17
191201239,5,0,1,6,6,18
191201240,7,4,7,6,2,26
191201241,6,2,2,1,8,19
191201242,8,8,3,4,3,26
191201243,1,6,4,1,2,14
191201244,6,5,3,1,8,23
191201245,6,4,9,8,2,29
191201246,0,0,2,0,6,8
191201247,7,9,9,9,7,41
191201248,8,5,0,1,3,17
191201249,4,1,8,4,8,25
191201250,4,1,3,4,4,16
191201251,5,7,1,7,0,20
191201252,2,5,7,0,4,18
191201253,0,1,2,9,1,13
191201254,1,8,7,5,1,22
191201255,0,8,4,2,6,20
191201256,6,6,6,2,2,22
191201257,5,9,1,5,5,25
191201258,9,8,7,8,8,40
191201259,0,9,1,3,5,18
191201260,5,2,0,0,2,9
191201261,0,5,5,7,8,25
191201262,6,3,1,7,8,25
191201263,6,3,4,3,6,22
191201264,9,1,3,0,6,19
191201265,0,9,4,5,2,20
191201266,2,2,3,2,3,12
191201267,0,1,4,1,9,15
191201268,1,5,5,5,5,21
191201269,3,0,3,3,0,9
191201270,8,8,4,2,3,25
191201271,1,1,5,3,3,13
191201272,3,8,6,6,6,29
191201273,2,1,3,9,4,19
191201274,7,0,0,4,9,20
191201275,4,1,6,6,7,24
191201276,5,4,4,2,2,17
191201277,2,8,5,6,5,26
191201278,3,9,0,9,0,21
191201279,9,8,0,4,1,22
191201280,5,1,7,0,8,21
191201281,2,6,9,5,2,24
191201282,6,5,0,7,3,21
191201283,8,8,6,2,9,33
191201284,3,7,1,7,0,18
191201285,1,6,7,7,6,27
191201286,3,9,7,2,2,23
191201287,9,6,1,0,0,16
191201288,3,9,7,7,7,33
191201289,9,4,4,5,5,27
191201290,5,0,6,2,5,18
191201291,4,4,7,2,0,17
191201292,4,4,2,4,9,23
191201293,8,2,5,3,1,19
191201294,1,0,3,3,4,11
191201295,6,9,5,7,4,31
191201296,6,9,8,2,2,27
191201297,6,9,2,7,0,24
191201298,4,7,9,8,7,35
191201299,3,9,6,1,6,25
191201300,8,9,0,4,2,23
191201301,4,4,5,4,5,22
191201302,1,7,6,6,2,22
191201303,8,8,5,7,3,31
191201304,4,4,7,4,8,27
191201305,6,1,0,6,1,14
191201306,7,6,5,9,3,30
191201307,5,8,6,4,3,26
191201308,1,1,9,8,7,26
191201309,3,5,5,8,9,30
191201310,1,1,2,3,1,8
191201311,8,0,1,9,3,21
191201312,7,2,2,9,7,27
191201313,0,0,0,5,0,5
191201314,8,6,0,2,6,22
191201315,4,9,8,3,1,25
191201316,7,1,8,1,3,20
191201317,6,4,9,1,9,29
191201318,5,0,0,4,2,11
191201319,2,6,2,5,9,24
191201320,8,3,7,5,9,32
191201321,4,8,8,9,5,34
191201322,2,5,0,2,1,10
191201323,2,0,8,1,9,20
191201324,1,6,7,8,7,29
191201325,7,7,7,7,5,33
191201326,3,3,1,3,3,13
191201327,1,6,5,0,9,21
191201328,5,2,3,0,7,17
191201329,0,3,6,1,8,18
191201330,4,6,1,0,1,12
191201331,7,4,8,2,6,27
191201332,4,5,8,9,1,27
191201333,1,0,9,0,8,18
191201334,3,6,0,0,4,13
191201335,5,8,5,8,7,33
191201336,4,4,4,0,0,12
191201337,2,7,2,0,9,20
191201338,0,8,2,8,4,22
191201339,6,8,8,1,8,31
191201340,9,4,5,9,9,36
191201341,9,7,6,4,1,27
191201342,4,6,1,0,6,17
191201343,9,2,5,0,8,24
191201344,2,0,6,3,1,12
191201345,1,7,1,9,5,23
191201346,1,7,6,4,6,24
191201347,0,9,6,2,1,18
191201348,6,4,3,3,5,21
191201349,4,1,4,7,9,25
191201350,7,7,3,9,8,34
191201351,6,9,3,3,9,30
191201352,7,5,1,0,9,22
191201353,9,5,9,4,7,34
191201354,0,6,2,2,7,17
191201355,7,3,6,0,2,18
191201356,2,7,7,2,8,26
191201357,2,7,8,1,3,21
191201358,8,8,2,6,9,33
191201359,3,7,1,3,4,18
191201360,0,9,7,4,8,28
191201361,7,2,6,8,9,32
191201362,7,9,1,1,4,22
191201363,1,8,1,9,3,22
191201364,5,1,6,5,0,17
191201365,5,6,1,4,7,23
191201366,5,0,4,5,9,23
191201367,1,5,1,2,8,17
191201368,5,3,9,3,6,26
191201369,4,9,5,0,7,25
191201370,8,6,5,7,2,28
191201371,4,0,4,1,9,18
191201372,5,8,9,4,0,26
191201373,0,5,5,4,6,20
191201374,9,6,3,7,6,31
191201375,1,9,5,3,8,26
191201376,5,4,8,9,3,29
191201377,1,1,2,8,3,15
191201378,3,4,5,8,1,21
191201379,4,0,0,9,4,17
191201380,2,5,0,2,9,18
191201381,5,4,4,7,0,20
191201382,4,4,5,5,4,22
191201383,5,7,9,6,6,33
191201384,0,3,5,4,4,16
191201385,9,3,6,0,3,21
191201386,1,9,2,9,7,28
191201387,6,8,7,0,3,24
191201388,8,3,0,0,1,12
191201389,4,5,1,1,5,16
191201390,3,1,0,0,6,10
191201391,4,5,4,0,9,22
191201392,4,9,1,1,6,21
191201393,7,2,5,7,9,30
191201394,5,0,2,1,5,13
191201395,5,7,2,9,2,25
191201396,1,9,1,1,4,16
191201397,3,2,5,8,2,20
191201398,6,3,5,1,1,16
191201399,4,0,4,8,4,20
191201400,1,0,0,5,2,8
191201401,3,4,9,4,0,20
191201402,4,6,9,5,3,27
191201403,7,4,6,2,3,22
191201404,1,6,5,3,0,15
191201405,3,9,5,4,2,23
191201406,9,2,9,5,1,26
191201407,4,0,9,0,8,21
191201408,6,7,3,0,6,22
191201409,1,9,7,7,1,25
191201410,2,9,6,1,0,18
191201411,1,6,5,0,3,15
191201412,3,9,5,9,8,34
191201413,3,1,5,6,4,19
191201414,3,4,1,2,7,17
191201415,5,0,3,1,7,16
191201416,5,8,0,4,3,20
191201417,6,2,2,7,4,21
191201418,1,5,7,3,9,25
191201419,8,7,0,4,9,28
191201420,9,6,1,6,2,24
191201421,9,4,5,3,5,26
191201422,7,0,4,8,0,19
191201423,4,4,0,2,3,13
191201424,2,6,6,3,1,18
191201425,0,7,3,0,6,16
191201426,1,8,7,9,4,29
191201427,4,5,2,4,5,20
191201428,2,7,7,5,1,22
191201429,9,1,4,3,9,26
191201430,3,3,8,2,3,19
191201431,1,2,9,5,7,24
191201432,9,8,1,0,5,23
191201433,9,5,2,9,9,34
191201434,3,7,6,4,7,27
191201435,7,5,0,1,5,18
191201436,3,4,3,5,2,17
191201437,5,8,9,1,9,32
191201438,4,1,2,0,5,12
191201439,9,5,7,9,9,39
191201440,8,3,2,2,4,19
191201441,5,3,3,0,9,20
191201442,7,4,2,1,9,23
191201443,6,0,5,4,7,22
191201444,6,5,7,7,6,31
191201445,2,4,1,2,9,18
191201446,9,1,6,1,9,26
191201447,8,8,3,2,5,26
191201448,0,0,9,5,9,23
191201449,3,8,2,2,8,23
191201450,2,2,9,4,1,18
191201451,4,9,2,6,6,27
191201452,0,9,2,1,1,13
191201453,1,4,4,7,3,19
191201454,4,5,8,1,9,27
191201455,5,3,1,1,8,18
191201456,9,8,3,8,0,28
191201457,6,6,0,2,3,17
191201458,4,0,9,4,2,19
191201459,3,4,6,3,2,18
191201460,7,5,7,2,2,23
191201461,4,8,0,1,8,21
191201462,0,8,9,6,8,31
191201463,5,2,4,3,9,23
191201464,6,2,2,4,4,18
191201465,4,9,2,9,2,26
191201466,8,0,1,5,9,23
191201467,7,1,9,3,4,24
191201468,6,6,3,9,7,31
191201469,8,1,7,6,8,30
191201470,7,2,9,0,7,25
191201471,2,4,7,3,3,19
191201472,8,7,0,7,1,23
191201473,5,6,4,0,4,19
191201474,0,4,1,4,9,18
191201475,1,5,2,4,1,13
191201476,2,2,0,5,6,15
191201477,6,0,8,3,1,18
191201478,7,1,1,7,9,25
191201479,1,8,6,8,3,26
191201480,2,3,3,0,6,14
191201481,8,3,4,0,1,16
191201482,8,9,4,4,9,34
191201483,5,0,2,8,8,23
191201484,5,3,5,9,8,30
191201485,7,4,5,0,1,17
191201486,1,1,8,6,6,22
191201487,3,8,9,8,6,34
191201488,9,5,0,8,7,29
191201489,8,6,3,9,5,31
191201490,4,3,2,1,1,11
191201491,6,4,5,3,5,23
191201492,9,2,5,7,4,27
191201493,9,4,0,2,7,22
191201494,4,6,6,6,6,28
191201495,3,0,5,9,1,18
191201496,7,6,9,8,4,34
191201497,1,5,9,9,0,24
191201498,7,9,2,8,3,29
191201499,2,3,6,2,1,14
191201500,1,6,6,6,3,22
191201501,2,3,1,8,5,19
191201502,6,6,2,5,7,26
191201503,3,5,5,5,0,18
191201504,5,4,5,1,5,20
191201505,6,2,8,4,3,23
191201506,4,9,5,1,1,20
191201507,7,5,0,7,8,27
191201508,6,5,1,0,8,20
191201509,5,7,7,5,6,30
191201510,0,3,2,0,7,12
191201511,0,6,6,3,2,17
191201512,8,8,8,6,2,32
191201513,2,9,7,4,1,23
191201514,3,7,4,3,7,24
191201515,7,9,7,2,5,30
191201516,1,4,0,2,7,14
191201517,2,2,7,6,7,24
191201518,5,3,7,3,2,20
191201519,5,2,3,9,4,23
191201520,6,2,0,4,7,19
191201521,3,7,9,3,8,30
191201522,3,9,3,6,7,28
191201523,5,5,2,3,8,23
191201524,7,8,4,9,3,31
191201525,9,1,4,5,4,23
191201526,6,9,7,9,3,34
191201527,0,9,0,4,0,13
191201528,4,3,1,6,8,22
191201529,6,1,4,5,5,21
191201530,1,2,1,3,5,12
191201531,0,8,7,8,0,23
191201532,8,1,0,9,4,22
191201533,8,6,6,7,5,32
191201534,2,0,3,8,1,14
191201535,0,8,7,3,8,26
191201536,3,0,3,9,2,17
191201537,4,4,4,7,0,19
191201538,6,3,7,4,8,28
191201539,7,2,8,5,1,23
191201540,4,3,5,5,1,18
191201541,7,5,4,4,0,20
191201542,7,3,6,2,8,26
191201543,1,4,6,3,6,20
191201544,1,1,1,0,9,12
191201545,3,8,0,7,0,18
191201546,1,1,3,0,2,7
191201547,1,7,3,0,1,12
191201548,5,9,9,9,2,34
191201549,8,5,8,1,9,31
191201550,8,3,2,7,8,28
191201551,1,2,2,0,4,9
191201552,5,0,8,4,9,26
191201553,3,0,8,2,5,18
191201554,6,4,2,3,1,16
191201555,1,0,0,1,8,10
191201556,4,6,1,8,9,28
191201557,2,4,2,2,4,14
191201558,9,5,9,5,3,31
191201559,6,7,4,8,3,28
191201560,9,9,6,1,9,34
191201561,4,9,9,3,0,25
191201562,9,6,0,1,5,21
191201563,8,5,5,8,7,33
191201564,6,3,6,0,0,15
191201565,5,2,5,3,5,20
191201566,8,6,3,8,7,32
191201567,5,4,9,6,6,30
191201568,1,8,5,6,8,28
191201569,3,2,2,4,6,17
191201570,4,1,8,0,1,14
191201571,6,9,4,2,2,23
191201572,3,8,3,9,3,26
191201573,1,9,5,1,3,19
191201574,7,1,1,8,6,23
191201575,3,0,7,4,6,20
191201576,6,2,0,9,9,26
191201577,6,2,8,9,2,27
191201578,7,1,9,0,6,23
191201579,6,8,6,0,3,23
191201580,0,2,5,3,8,18
191201581,7,6,0,7,5,25
191201582,6,6,8,3,4,27
191201583,1,1,7,1,3,13
191201584,9,1,5,8,3,26
191201585,3,5,9,1,1,19
191201586,5,9,6,0,2,22
191201587,1,0,2,8,1,12
191201588,0,1,6,3,8,18
191201589,4,5,8,2,6,25
191201590,0,5,4,7,6,22
191201591,8,2,7,1,8,26
191201592,3,7,3,4,8,25
191201593,9,4,8,3,0,24
191201594,6,3,8,5,3,25
191201595,2,2,9,6,7,26
191201596,7,7,4,5,4,27
191201597,5,9,5,2,3,24
191201598,4,4,6,8,6,28
191201599,6,6,9,0,1,22
191201600,7,1,1,9,3,21
191201601,2,9,8,9,4,32
191201602,0,7,1,8,3,19
191201603,5,5,1,7,1,19
191201604,1,9,5,2,1,18
191201605,5,1,9,0,0,15
191201606,4,7,1,5,0,17
191201607,6,1,4,2,4,17
191201608,4,1,5,1,1,12
191201609,4,8,8,1,8,29
191201610,3,0,7,7,1,18
191201611,5,8,5,2,5,25
191201612,3,9,1,0,3,16
191201613,0,9,9,1,9,28
191201614,5,9,7,2,5,28
191201615,4,5,8,4,0,21
191201616,0,2,4,1,8,15
191201617,2,0,6,4,5,17
191201618,5,6,1,2,5,19
191201619,5,5,4,3,7,24
191201620,5,5,7,5,2,24
191201621,5,8,6,8,3,30
191201622,3,0,1,3,6,13
191201623,5,6,8,9,3,31
191201624,0,5,0,9,1,15
191201625,1,6,8,7,4,26
191201626,3,6,8,8,9,34
191201627,0,9,2,6,1,18
191201628,2,6,1,5,9,23
191201629,1,6,5,8,0,20
191201630,4,4,8,0,3,19
191201631,9,9,9,3,4,34
191201632,8,3,8,5,3,27
191201633,8,1,3,8,1,21
191201634,2,7,7,8,5,29
191201635,6,5,3,4,4,22
191201636,4,3,4,8,4,23
191201637,6,7,6,8,4,31
191201638,9,1,4,4,5,23
191201639,7,3,9,1,7,27
191201640,6,5,1,4,0,16
191201641,1,3,8,8,2,22
191201642,4,4,0,9,4,21
191201643,2,3,1,0,9,15
191201644,4,2,4,1,6,17
191201645,9,9,1,7,1,27
191201646,0,8,9,4,8,29
191201647,6,1,0,4,1,12
191201648,2,4,2,1,6,15
191201649,5,2,9,2,8,26
191201650,5,4,6,7,3,25
191201651,4,6,5,3,2,20
191201652,6,6,6,1,3,22
191201653,2,9,3,4,4,22
191201654,1,8,8,8,8,33
191201655,5,2,6,8,3,24
191201656,3,3,1,3,6,16
191201657,0,8,3,6,8,25
191201658,7,4,3,0,4,18
191201659,6,0,0,6,0,12
191201660,7,4,1,8,5,25
191201661,4,1,0,0,6,11
191201662,1,8,3,3,3,18
191201663,3,5,9,5,2,24
191201664,1,1,8,7,6,23
191201665,7,0,3,8,7,25
191201666,7,8,0,8,2,25
191201667,3,9,7,1,2,22
191201668,7,3,9,1,1,21
191201669,3,8,6,9,7,33
191201670,2,6,0,1,4,13
191201671,9,7,8,5,2,31
191201672,1,3,5,9,6,24
191201673,7,5,6,1,8,27
191201674,6,4,0,0,3,13
191201675,5,4,0,6,8,23
191201676,8,7,9,1,3,28
191201677,2,4,0,0,2,8
191201678,0,4,2,4,9,19
191201679,7,9,3,1,5,25
191201680,0,6,0,2,3,11
191201681,4,7,6,1,8,26
191201682,7,9,0,3,2,21
191201683,7,9,2,6,9,33
191201684,8,9,5,6,3,31
191201685,4,0,5,1,8,18
191201686,4,9,5,5,3,26
191201687,4,6,4,1,6,21
191201688,3,1,7,0,4,15
191201689,3,0,0,9,9,21
191201690,6,7,7,4,5,29
191201691,6,2,7,2,4,21
191201692,7,3,6,1,4,21
191201693,5,6,5,0,1,17
191201694,1,7,4,2,1,15
191201695,3,6,1,3,0,13
191201696,0,1,3,5,7,16
191201697,1,2,3,2,3,11
191201698,3,9,1,1,6,20
191201699,0,5,8,5,7,25
191201700,5,2,9,2,7,25
191201701,5,8,4,4,2,23
191201702,9,3,7,7,7,33
191201703,7,0,4,2,6,19
191201704,6,0,4,3,0,13
191201705,4,2,7,1,6,20
191201706,3,0,9,2,0,14
191201707,9,1,3,3,5,21
191201708,9,2,6,7,9,33
191201709,1,3,5,5,8,22
191201710,8,1,5,7,5,26
191201711,6,7,6,5,8,32
191201712,4,8,2,5,9,28
191201713,2,5,3,2,0,12
191201714,5,3,3,1,4,16
191201715,4,4,5,1,9,23
191201716,6,2,1,9,9,27
191201717,6,7,4,5,8,30
191201718,0,4,4,1,7,16
191201719,8,3,8,0,7,26
191201720,4,6,1,5,7,23
191201721,0,5,9,1,0,15
191201722,9,8,6,0,5,28
191201723,3,1,4,0,4,12
191201724,6,8,8,1,5,28
191201725,3,4,4,4,3,18
191201726,0,3,3,8,2,16
191201727,3,6,6,2,4,21
191201728,4,7,9,8,8,36
191201729,8,3,8,4,5,28
191201730,4,2,7,0,0,13
191201731,3,7,8,6,4,28
191201732,0,6,1,4,7,18
191201733,1,4,9,7,3,24
191201734,4,8,4,3,1,20
191201735,0,1,1,2,4,8
191201736,8,1,3,0,7,19
191201737,9,6,1,0,6,22
191201738,6,2,2,1,9,20
191201739,0,8,7,1,4,20
191201740,0,8,0,5,3,16
191201741,5,8,1,2,0,16
191201742,1,8,4,1,8,22
191201743,3,6,1,7,5,22
191201744,3,8,0,8,1,20
191201745,5,4,4,2,1,16
191201746,3,5,5,1,6,20
191201747,5,5,8,3,5,26
191201748,9,3,9,8,3,32
191201749,8,4,8,7,9,36
191201750,3,0,1,8,2,14
191201751,1,5,2,8,0,16
191201752,3,1,6,2,8,20
191201753,4,5,6,1,8,24
191201754,3,2,3,5,6,19
191201755,4,0,8,7,5,24
191201756,1,4,2,9,2,18
191201757,4,2,9,3,4,22
191201758,0,1,7,6,9,23
191201759,8,6,7,1,9,31
191201760,0,8,6,6,1,21
191201761,8,3,3,6,2,22
191201762,4,1,5,7,5,22
191201763,6,8,7,0,7,28
191201764,1,4,7,3,7,22
191201765,0,0,6,6,1,13
191201766,6,5,3,8,9,31
191201767,6,8,6,8,9,37
191201768,2,0,8,0,6,16
191201769,9,9,0,3,2,23
191201770,2,3,1,2,8,16
191201771,1,6,1,4,5,17
191201772,7,4,8,0,9,28
191201773,3,4,6,4,5,22
191201774,3,2,0,3,1,9
191201775,5,8,6,7,2,28
191201776,8,6,6,7,7,34
191201777,8,3,5,0,4,20
191201778,6,8,8,5,3,30
191201779,4,9,1,7,5,26
191201780,3,6,5,9,8,31
191201781,1,2,6,2,0,11
191201782,0,0,4,8,6,18
191201783,8,9,7,0,7,31
191201784,6,1,7,9,3,26
191201785,5,6,4,7,9,31
191201786,4,5,6,5,5,25
191201787,6,3,5,8,2,24
191201788,2,2,5,4,9,22
191201789,7,6,8,3,7,31
191201790,9,9,7,9,2,36
191201791,0,5,4,6,6,21
191201792,3,4,7,7,3,24
191201793,7,2,9,6,9,33
191201794,0,0,7,7,8,22
191201795,4,1,3,4,8,20
191201796,6,1,3,1,6,17
191201797,9,3,0,4,4,20
191201798,4,5,5,1,4,19
191201799,8,4,3,4,7,26
191201800,0,2,1,8,8,19
191201801,2,2,5,3,7,19
191201802,1,7,5,9,2,24
191201803,9,1,2,8,1,21
191201804,0,0,5,1,1,7
191201805,6,3,3,9,5,26
191201806,5,1,6,2,3,17
191201807,1,6,7,6,8,28
191201808,5,3,7,0,7,22
191201809,9,7,0,8,5,29
191201810,9,2,1,2,3,17
191201811,7,4,3,9,0,23
191201812,7,7,0,0,6,20
191201813,5,5,8,9,4,31
191201814,0,0,4,9,1,14
191201815,8,9,6,8,1,32
191201816,3,2,7,8,5,25
191201817,5,5,9,5,5,29
191201818,7,4,2,2,4,19
191201819,5,3,1,9,0,18
191201820,4,0,5,8,3,20
191201821,9,6,9,7,3,34
191201822,4,1,2,9,2,18
191201823,2,8,5,9,2,26
191201824,5,6,8,4,7,30
191201825,0,4,4,8,5,21
191201826,5,2,6,9,7,29
191201827,4,5,7,2,9,27
191201828,3,5,0,2,8,18
191201829,2,9,0,4,3,18
191201830,0,3,3,7,8,21
191201831,6,9,4,1,9,29
191201832,8,7,1,7,5,28
191201833,5,2,3,6,6,22
191201834,7,5,2,6,7,27
191201835,4,5,2,2,3,16
191201836,6,5,5,5,4,25
191201837,6,3,5,2,4,20
191201838,8,3,5,2,1,19
191201839,0,6,5,4,9,24
191201840,0,6,4,5,5,20
191201841,9,3,9,0,9,30
191201842,1,9,4,1,7,22
191201843,4,9,2,5,2,22
191201844,1,2,4,7,7,21
191201845,1,6,2,2,9,20
191201846,7,8,8,2,1,26
191201847,3,1,8,2,9,23
191201848,0,5,4,4,0,13
191201849,5,2,2,1,0,10
191201850,9,8,6,3,3,29
191201851,1,0,7,6,7,21
191201852,1,8,3,1,7,20
191201853,5,3,7,5,9,29
191201854,4,7,0,9,4,24
191201855,9,5,3,4,1,22
191201856,6,9,8,2,6,31
191201857,7,9,3,5,5,29
191201858,8,8,1,3,5,25
191201859,0,6,1,4,2,13
191201860,2,8,1,4,4,19
191201861,4,8,8,1,7,28
191201862,3,3,6,1,3,16
191201863,4,8,8,7,2,29
191201864,4,2,0,0,4,10
191201865,7,2,1,2,5,17
191201866,5,5,4,2,1,17
191201867,1,5,4,1,9,20
191201868,9,1,1,3,9,23
191201869,6,0,8,5,3,22
191201870,8,8,6,5,5,32
191201871,8,1,7,6,5,27
191201872,3,9,1,3,2,18
191201873,5,0,4,0,2,11
191201874,3,8,1,2,0,14
191201875,5,6,7,2,4,24
191201876,2,1,4,5,2,14
191201877,1,2,2,5,7,17
191201878,1,7,9,0,3,20
191201879,2,5,1,3,4,15
191201880,8,1,0,6,7,22
191201881,2,6,2,0,2,12
191201882,0,1,2,8,7,18
191201883,2,9,6,9,8,34
191201884,9,3,6,1,9,28
191201885,8,4,6,4,7,29
191201886,0,0,2,9,0,11
191201887,4,3,8,2,7,24
191201888,9,0,3,0,1,13
191201889,3,6,0,0,7,16
191201890,1,2,6,2,8,19
191201891,1,6,2,1,4,14
191201892,3,7,4,8,5,27
191201893,9,7,9,4,7,36
191201894,5,6,0,4,6,21
191201895,2,9,5,5,6,27
191201896,4,7,9,6,9,35
191201897,0,5,4,2,7,18
191201898,8,0,0,7,3,18
191201899,0,8,5,1,1,15
191201900,3,8,4,5,0,20
191201901,7,7,6,8,3,31
191201902,8,6,3,9,0,26
191201903,6,0,1,0,9,16
191201904,0,8,8,7,6,29
191201905,8,8,4,5,8,33
191201906,7,7,1,0,8,23
191201907,7,2,2,8,2,21
191201908,3,5,4,4,9,25
191201909,4,9,9,0,9,31
191201910,3,4,8,4,6,25
191201911,7,5,4,5,8,29
191201912,1,0,5,8,4,18
191201913,7,3,2,2,8,22
191201914,6,7,7,8,3,31
191201915,3,1,9,4,8,25
191201916,6,1,0,5,8,20
191201917,7,6,1,5,6,25
191201918,1,9,5,7,0,22
191201919,5,9,4,2,0,20
191201920,7,1,4,9,6,27
191201921,6,6,3,5,7,27
191201922,0,8,5,0,3,16
191201923,0,1,0,5,7,13
191201924,9,2,1,5,2,19
191201925,9,3,5,8,8,33
191201926,1,1,5,3,6,16
191201927,5,6,9,3,4,27
191201928,7,5,8,5,7,32
191201929,6,0,9,5,0,20
191201930,9,0,8,1,5,23
191201931,9,8,2,8,7,34
191201932,6,7,9,9,9,40
191201933,9,4,5,0,2,20
191201934,3,7,0,1,9,20
191201935,4,5,1,3,8,21
191201936,7,4,2,7,9,29
191201937,0,3,1,0,5,9
191201938,1,9,1,1,2,14
191201939,7,7,2,7,6,29
191201940,3,8,6,3,2,22
191201941,7,0,2,2,8,19
191201942,6,9,4,8,7,34
191201943,6,2,2,8,6,24
191201944,6,5,4,5,5,25
191201945,6,1,5,8,9,29
191201946,9,7,8,0,6,30
191201947,8,0,5,8,3,24
191201948,4,7,6,0,3,20
191201949,0,3,7,5,6,21
191201950,2,1,5,6,8,22
191201951,4,3,7,7,2,23
191201952,9,9,4,6,0,28
191201953,6,8,8,0,9,31
191201954,7,2,8,3,3,23
191201955,3,8,3,7,1,22
191201956,9,3,6,7,6,31
191201957,9,7,5,0,6,27
191201958,9,4,6,2,8,29
191201959,7,9,2,5,8,31
191201960,9,2,1,8,3,23
191201961,9,5,8,8,2,32
191201962,2,7,3,7,9,28
191201963,9,5,5,2,3,24
191201964,9,1,6,4,1,21
191201965,1,9,2,2,1,15
191201966,5,8,3,8,7,31
191201967,0,5,3,3,7,18
191201968,3,4,3,5,6,21
191201969,4,5,4,0,0,13
191201970,8,2,6,5,6,27
191201971,2,0,0,5,8,15
191201972,9,9,0,9,6,33
191201973,3,0,7,8,9,27
191201974,8,5,4,6,6,29
191201975,9,7,3,1,4,24
191201976,0,4,6,5,4,19
191201977,4,4,8,2,7,25
191201978,3,0,0,3,1,7
191201979,1,6,4,8,9,28
191201980,7,4,5,6,5,27
191201981,6,2,6,0,1,15
191201982,1,4,1,9,9,24
191201983,2,1,3,6,1,13
191201984,8,6,0,3,7,24
191201985,0,5,5,3,8,21
191201986,2,9,8,6,4,29
191201987,1,6,8,5,3,23
191201988,1,0,4,9,9,23
191201989,6,0,9,2,9,26
191201990,0,3,9,9,9,30
191201991,8,8,8,3,5,32
191201992,7,0,5,1,8,21
191201993,9,7,7,9,4,36
191201994,9,4,6,7,9,35
191201995,6,8,3,6,6,29
191201996,2,8,7,3,3,23
191201997,0,3,1,8,3,15
191201998,4,4,8,2,8,26
191201999,2,7,9,3,4,25
1912011000,0,9,2,2,8,21
1912011001,1,9,1,1,1,13
1912011002,0,0,4,4,0,8
1912011003,6,4,6,9,4,29
1912011004,5,4,6,7,1,23
1912011005,9,2,8,5,1,25
1912011006,9,1,0,4,9,23
1912011007,9,2,4,4,8,27
1912011008,1,5,8,2,4,20
1912011009,6,1,5,7,7,26
1912011010,8,8,5,5,1,27
1912011011,5,1,9,7,8,30
1912011012,3,6,4,5,8,26
1912011013,1,2,8,1,0,12
1912011014,5,9,2,3,3,22
1912011015,0,9,6,4,6,25
1912011016,8,1,5,6,9,29
1912011017,2,1,0,9,4,16
1912011018,3,6,6,2,7,24
1912011019,9,1,0,8,7,25
1912011020,3,3,5,4,3,18
1912011021,3,9,5,4,1,22
1912011022,9,4,1,5,9,28
1912011023,7,4,9,7,3,30
1912011024,7,9,3,2,2,23
1912011025,5,1,4,2,3,15
1912011026,9,9,5,5,7,35
1912011027,4,4,4,2,1,15
1912011028,8,4,0,6,6,24
1912011029,2,4,1,6,7,20
1912011030,1,2,7,8,3,21
1912011031,7,6,5,2,9,29
1912011032,9,7,3,4,2,25
1912011033,5,0,0,1,4,10
1912011034,6,7,6,2,8,29
1912011035,0,5,7,6,7,25
1912011036,6,7,7,6,1,27
1912011037,3,3,3,6,9,24
1912011038,6,4,7,1,4,22
1912011039,2,9,4,1,0,16
1912011040,2,1,0,2,5,10
1912011041,6,9,3,1,4,23
1912011042,5,0,2,7,5,19
1912011043,2,9,6,9,6,32
1912011044,6,0,7,1,9,23
1912011045,6,7,6,7,5,31
1912011046,3,1,0,1,6,11
1912011047,2,6,2,3,0,13
1912011048,0,0,6,8,4,18
1912011049,8,4,0,5,1,18
1912011050,7,3,6,4,6,26
1912011051,9,6,5,2,8,30
1912011052,2,5,2,2,1,12
1912011053,4,8,4,8,0,24
1912011054,5,7,2,5,1,20
1912011055,3,6,6,6,0,21
1912011056,7,1,9,4,6,27
1912011057,1,3,6,7,3,20
1912011058,4,5,6,1,6,22
1912011059,2,0,8,6,5,21
1912011060,8,6,8,7,5,34
1912011061,7,0,8,6,5,26
1912011062,3,3,5,6,1,18
1912011063,6,5,1,9,1,22
1912011064,5,2,9,7,7,30
1912011065,1,5,7,3,5,21
1912011066,1,7,0,9,5,22
1912011067,8,9,8,4,0,29
1912011068,0,0,6,0,2,8
1912011069,2,0,4,0,9,15
1912011070,9,9,3,0,2,23
1912011071,1,4,4,9,3,21
1912011072,5,3,6,4,0,18
1912011073,4,7,0,1,4,16
1912011074,8,6,6,9,8,37
1912011075,4,2,2,5,6,19
1912011076,2,7,0,4,7,20
1912011077,5,1,1,2,1,10
1912011078,1,3,4,8,7,23
1912011079,8,9,4,0,8,29
1912011080,5,8,5,4,1,23
1912011081,4,4,7,5,5,25
1912011082,3,0,5,3,8,19
1912011083,7,7,1,3,8,26
1912011084,8,2,4,0,9,23
1912011085,0,6,8,2,8,24
1912011086,5,7,8,5,2,27
1912011087,1,7,6,6,1,21
1912011088,5,2,0,1,0,8
1912011089,0,5,7,2,3,17
1912011090,4,5,4,9,7,29
1912011091,9,0,5,5,2,21
1912011092,6,0,0,2,7,15
1912011093,2,0,3,4,3,12
1912011094,8,0,5,5,9,27
1912011095,2,0,8,0,0,10
1912011096,6,4,2,1,6,19
1912011097,4,6,3,7,6,26
1912011098,9,2,1,6,0,18
1912011099,1,0,4,6,6,17
1912011100,6,3,5,7,7,28
1912011101,7,4,9,5,4,29
1912011102,4,1,1,1,1,8
1912011103,1,8,1,2,5,17
1912011104,7,0,6,2,7,22
1912011105,3,0,8,2,4,17
191202001,8,1,5,5,1,20
191202002,1,9,3,2,7,22
191202003,0,3,6,8,3,20
191202004,1,6,1,3,0,11
191202005,0,6,6,9,7,28
191202006,7,5,4,4,3,23
191202007,7,6,9,4,3,29
191202008,0,3,1,9,4,17
191202009,9,5,0,0,1,15
191202010,2,9,6,7,3,27
191202011,3,7,4,2,9,25
191202012,4,6,8,5,0,23
191202013,1,5,2,3,2,13
191202014,9,2,3,6,1,21
191202015,7,0,5,6,5,23
191202016,0,7,8,2,3,20
191202017,4,0,8,2,3,17
191202018,4,7,8,7,7,33
191202019,6,7,4,8,6,31
191202020,5,6,8,9,1,29
191202021,8,2,0,3,2,15
191202022,7,9,5,8,7,36
191202023,5,5,1,3,6,20
191202024,1,5,8,9,5,28
191202025,0,9,2,6,0,17
191202026,7,4,6,5,2,24
191202027,1,6,6,7,4,24
191202028,9,7,2,0,0,18
191202029,1,1,7,3,6,18
191202030,8,9,9,1,2,29
191202031,9,6,9,1,3,28
191202032,4,6,2,0,9,21
191202033,8,2,9,6,7,32
191202034,7,4,6,9,3,29
191202035,8,6,6,0,9,29
191202036,8,3,5,3,2,21
191202037,7,6,1,1,4,19
191202038,0,8,3,9,9,29
191202039,4,7,0,5,6,22
191202040,2,3,5,5,8,23
191202041,5,3,2,2,5,17
191202042,5,1,0,4,2,12
191202043,8,5,5,0,6,24
191202044,3,3,9,5,6,26
191202045,9,4,6,7,3,29
191202046,4,0,2,5,3,14
191202047,5,1,8,6,2,22
191202048,2,7,8,8,1,26
191202049,5,1,3,1,4,14
191202050,0,3,1,8,4,16
191202051,9,7,0,2,4,22
191202052,8,2,1,5,3,19
191202053,1,1,0,3,0,5
191202054,5,3,0,7,8,23
191202055,0,0,8,9,7,24
191202056,1,1,3,9,0,14
191202057,6,0,4,4,6,20
191202058,5,3,6,4,3,21
191202059,1,5,2,4,5,17
191202060,8,5,1,6,9,29
191202061,3,8,5,3,9,28
191202062,7,6,1,1,7,22
191202063,5,4,6,2,2,19
191202064,6,9,5,4,6,30
191202065,1,4,6,6,4,21
191202066,5,9,3,9,5,31
191202067,9,9,8,6,5,37
191202068,3,6,6,8,1,24
191202069,5,4,0,8,4,21
191202070,2,9,6,2,5,24
191202071,5,4,3,8,7,27
191202072,1,3,3,9,3,19
191202073,0,3,3,4,4,14
191202074,7,1,3,2,5,18
191202075,0,4,7,2,8,21
191202076,3,4,5,0,4,16
191202077,1,3,3,9,8,24
191202078,8,7,5,7,9,36
191202079,4,5,3,4,2,18
191202080,0,6,0,0,8,14
191202081,1,0,4,6,0,11
191202082,5,6,6,4,7,28
191202083,8,6,4,0,5,23
191202084,3,3,4,6,8,24
191202085,7,2,0,1,9,19
191202086,6,7,6,6,0,25
191202087,0,2,2,5,1,10
191202088,9,3,1,7,6,26
191202089,4,4,6,5,6,25
191202090,2,0,8,3,2,15
191202091,5,4,6,3,2,20
191202092,0,3,1,9,2,15
191202093,3,9,1,8,8,29
191202094,3,5,8,2,1,19
191202095,6,6,7,0,2,21
191202096,2,7,5,1,4,19
191202097,0,1,3,8,2,14
191202098,5,4,2,4,5,20
191202099,1,6,3,4,7,21
191202100,4,2,2,1,4,13
191202101,4,5,2,8,2,21
191202102,5,2,7,8,7,29
191202103,8,2,7,2,0,19
191202104,2,2,5,4,4,17
191202105,5,8,5,9,7,34
191202106,6,6,4,3,6,25
191202107,1,9,2,5,2,19
191202108,5,3,8,3,4,23
191202109,4,7,0,9,0,20
191202110,0,1,0,1,5,7
191202111,7,6,2,6,8,29
191202112,3,5,0,6,1,15
191202113,3,7,3,8,1,22
191202114,1,7,5,6,5,24
191202115,7,1,4,7,2,21
191202116,6,8,6,9,0,29
191202117,0,0,0,2,2,4
191202118,2,0,5,7,5,19
191202119,0,9,1,7,5,22
191202120,8,8,1,8,7,32
191202121,4,3,0,7,0,14
191202122,2,5,1,1,3,12
191202123,8,0,6,1,8,23
191202124,6,8,0,6,5,25
191202125,2,4,4,5,0,15
191202126,3,8,6,6,8,31
191202127,5,2,0,4,9,20
191202128,7,2,9,5,4,27
191202129,1,2,9,1,9,22
191202130,4,0,8,3,4,19
191202131,8,4,5,3,8,28
191202132,6,1,0,2,3,12
191202133,8,6,1,2,6,23
191202134,4,0,0,2,0,6
191202135,3,0,1,6,7,17
191202136,9,0,1,9,2,21
191202137,2,9,3,7,6,27
191202138,4,0,3,9,5,21
191202139,6,3,0,0,5,14
191202140,6,4,6,5,9,30
191202141,6,8,5,5,1,25
191202142,0,8,1,2,8,19
191202143,0,6,7,3,7,23
191202144,7,0,8,0,7,22
191202145,2,6,6,4,5,23
191202146,4,2,7,5,6,24
191202147,7,9,4,2,5,27
191202148,1,9,8,3,7,28
191202149,6,2,5,1,3,17
191202150,3,2,5,6,8,24
191202151,4,6,7,8,4,29
191202152,2,9,3,7,8,29
191202153,1,8,2,9,2,22
191202154,6,7,8,5,6,32
191202155,0,9,9,2,0,20
191202156,7,3,7,1,2,20
191202157,0,2,3,2,7,14
191202158,9,1,5,0,2,17
191202159,3,8,9,4,2,26
191202160,5,9,5,0,0,19
191202161,7,6,6,0,5,24
191202162,3,4,2,8,1,18
191202163,1,1,3,1,6,12
191202164,2,3,7,4,0,16
191202165,7,3,9,6,8,33
191202166,6,4,5,7,6,28
191202167,8,4,8,3,5,28
191202168,4,8,5,6,2,25
191202169,0,7,5,7,2,21
191202170,5,2,6,8,6,27
191202171,8,8,7,1,3,27
191202172,7,8,8,8,8,39
191202173,0,3,0,5,2,10
191202174,8,7,7,3,8,33
191202175,4,5,8,8,4,29
191202176,3,8,4,3,4,22
191202177,4,6,3,3,1,17
191202178,2,7,2,7,5,23
191202179,0,9,2,6,4,21
191202180,1,5,1,0,5,12
191202181,6,8,5,9,8,36
191202182,0,2,1,9,7,19
191202183,2,2,9,4,0,17
191202184,4,1,9,0,8,22
191202185,9,3,3,2,8,25
191202186,0,1,8,6,1,16
191202187,9,4,4,7,9,33
191202188,8,7,8,5,9,37
191202189,7,3,4,7,8,29
191202190,3,6,0,2,5,16
191202191,0,0,1,3,6,10
191202192,0,5,6,0,1,12
191202193,1,9,3,7,8,28
191202194,1,6,0,7,0,14
191202195,9,3,3,8,6,29
191202196,8,3,1,3,2,17
191202197,1,5,1,9,4,20
191202198,6,9,8,9,7,39
191202199,6,4,4,3,3,20
191202200,9,1,1,0,5,16
191202201,1,0,6,6,3,16
191202202,0,4,8,9,5,26
191202203,1,2,5,4,6,18
191202204,4,6,1,3,6,20
191202205,9,3,1,9,9,31
191202206,6,1,7,0,3,17
191202207,9,0,0,7,9,25
191202208,1,2,7,1,5,16
191202209,1,3,0,8,8,20
191202210,5,2,7,2,0,16
191202211,4,9,4,6,4,27
191202212,3,0,0,9,0,12
191202213,7,6,0,3,1,17
191202214,4,2,4,2,9,21
191202215,7,6,4,5,6,28
191202216,3,0,6,4,4,17
191202217,8,7,5,5,3,28
191202218,9,3,4,0,2,18
191202219,4,9,2,8,6,29
191202220,7,1,9,9,7,33
191202221,5,5,9,4,0,23
191202222,4,4,5,6,0,19
191202223,5,8,1,6,0,20
191202224,0,0,0,4,3,7
191202225,5,8,8,2,9,32
191202226,3,7,7,8,2,27
191202227,9,4,6,0,0,19
191202228,6,3,9,8,2,28
191202229,5,0,7,9,1,22
191202230,5,3,0,9,3,20
191202231,8,8,2,8,3,29
191202232,5,0,1,5,9,20
191202233,1,4,6,9,0,20
191202234,0,8,4,7,9,28
191202235,3,8,1,6,3,21
191202236,7,7,5,7,1,27
191202237,9,5,5,5,5,29
191202238,7,1,3,5,6,22
191202239,7,2,4,8,7,28
191202240,3,0,9,4,5,21
191202241,3,1,7,4,0,15
191202242,4,2,3,7,4,20
191202243,1,5,9,5,2,22
191202244,7,9,7,6,9,38
191202245,9,1,0,8,8,26
191202246,7,3,1,0,4,15
191202247,7,3,8,6,1,25
191202248,3,7,2,3,9,24
191202249,5,9,3,4,0,21
191202250,8,2,4,0,8,22
191202251,8,8,8,9,0,33
191202252,4,3,6,6,5,24
191202253,3,5,3,4,2,17
191202254,0,8,9,8,8,33
191202255,8,1,6,7,3,25
191202256,9,5,7,6,0,27
191202257,6,8,4,9,1,28
191202258,1,2,3,1,1,8
191202259,6,9,3,9,6,33
191202260,3,3,5,9,0,20
191202261,4,3,5,5,6,23
191202262,1,0,6,7,9,23
191202263,4,1,1,7,8,21
191202264,3,4,5,2,9,23
191202265,0,9,8,2,0,19
191202266,3,5,2,1,3,14
191202267,6,2,2,1,2,13
191202268,6,9,1,0,2,18
191202269,2,1,9,1,3,16
191202270,7,3,1,1,8,20
191202271,9,8,5,1,7,30
191202272,2,7,4,8,9,30
191202273,9,0,7,2,0,18
191202274,2,9,7,5,3,26
191202275,1,6,6,7,0,20
191202276,6,2,5,0,9,22
191202277,9,0,3,1,2,15
191202278,3,6,3,2,9,23
191202279,5,5,4,9,2,25
191202280,0,0,2,5,1,8
191202281,6,9,7,8,5,35
191202282,4,8,6,5,3,26
191202283,1,6,2,0,7,16
191202284,0,2,1,5,9,17
191202285,3,4,8,3,7,25
191202286,0,0,7,9,1,17
191202287,9,3,0,5,1,18
191202288,2,8,7,7,1,25
191202289,3,3,7,8,8,29
191202290,1,6,0,6,2,15
191202291,9,0,7,5,7,28
191202292,0,0,5,7,0,12
191202293,7,3,9,2,3,24
191202294,9,8,0,8,7,32
191202295,1,7,8,2,6,24
191202296,5,7,7,0,1,20
191202297,8,3,0,6,4,21
191202298,6,2,1,1,8,18
191202299,0,1,1,9,2,13
191202300,2,2,2,5,6,17
191202301,5,1,6,9,5,26
191202302,7,0,9,6,1,23
191202303,0,0,1,4,1,6
191202304,3,8,2,1,2,16
191202305,8,8,4,4,7,31
191202306,1,3,8,7,2,21
191202307,5,0,9,3,9,26
191202308,6,2,6,2,6,22
191202309,7,5,7,2,6,27
191202310,5,1,3,3,3,15
191202311,0,1,2,5,0,8
191202312,2,9,9,6,5,31
191202313,5,7,3,5,5,25
191202314,9,5,6,6,4,30
191202315,5,6,1,6,9,27
191202316,2,2,1,2,0,7
191202317,7,8,7,1,3,26
191202318,8,2,9,3,7,29
191202319,1,3,0,7,7,18
191202320,6,6,9,1,1,23
191202321,0,7,5,4,3,19
191202322,1,8,0,0,4,13
191202323,1,8,9,4,2,24
191202324,4,5,9,3,2,23
191202325,2,3,3,9,8,25
191202326,8,8,9,9,1,35
191202327,2,8,0,3,1,14
191202328,5,7,4,1,8,25
191202329,0,6,1,5,4,16
191202330,9,7,7,3,5,31
191202331,6,8,0,3,5,22
191202332,1,5,3,1,6,16
191202333,3,6,8,3,0,20
191202334,5,8,0,8,1,22
191202335,3,8,1,1,6,19
191202336,4,5,9,8,7,33
191202337,7,9,8,6,1,31
191202338,2,8,7,5,0,22
191202339,0,6,3,5,0,14
191202340,8,1,3,1,9,22
191202341,8,2,5,6,6,27
191202342,3,1,7,1,4,16
191202343,3,3,8,5,2,21
191202344,2,9,6,3,3,23
191202345,8,4,2,4,3,21
191202346,5,2,9,6,2,24
191202347,1,0,9,8,0,18
191202348,1,1,0,4,7,13
191202349,6,5,0,6,2,19
191202350,1,7,0,3,9,20
191202351,8,1,8,6,0,23
191202352,5,8,0,7,1,21
191202353,9,0,9,1,0,19
191202354,7,0,7,0,1,15
191202355,4,8,1,0,2,15
191202356,2,6,3,5,8,24
191202357,4,2,1,2,5,14
191202358,1,9,4,9,6,29
191202359,4,3,0,5,9,21
191202360,8,9,2,0,6,25
191202361,3,1,6,3,2,15
191202362,2,2,2,5,2,13
191202363,8,3,2,9,4,26
191202364,3,2,0,7,7,19
191202365,0,4,3,8,0,15
191202366,8,0,9,7,1,25
191202367,8,7,4,7,5,31
191202368,9,2,5,6,9,31
191202369,9,7,3,3,7,29
191202370,5,0,1,3,9,18
191202371,8,8,0,4,6,26
191202372,5,2,5,6,4,22
191202373,7,0,3,5,1,16
191202374,5,2,2,5,2,16
191202375,2,9,9,7,8,35
191202376,4,0,8,1,0,13
191202377,1,6,8,8,5,28
191202378,8,7,3,6,1,25
191202379,3,0,0,0,6,9
191202380,1,2,1,7,8,19
191202381,6,0,7,2,4,19
191202382,6,4,8,8,1,27
191202383,6,6,4,0,4,20
191202384,0,0,1,7,5,13
191202385,9,3,7,4,1,24
191202386,3,4,8,7,3,25
191202387,8,0,3,8,0,19
191202388,6,8,4,4,0,22
191202389,6,6,5,4,8,29
191202390,9,0,5,5,9,28
191202391,4,7,3,3,0,17
191202392,6,9,1,7,7,30
191202393,3,2,1,1,9,16
191202394,0,0,8,3,6,17
191202395,5,8,7,6,8,34
191202396,7,3,1,0,3,14
191202397,6,2,8,6,1,23
191202398,6,9,6,2,2,25
191202399,4,0,1,6,2,13
191202400,0,2,5,6,1,14
191202401,4,4,2,7,1,18
191202402,9,7,0,6,7,29
191202403,5,9,4,6,4,28
191202404,5,4,4,0,7,20
191202405,1,4,2,3,7,17
191202406,1,2,3,5,5,16
191202407,9,6,1,2,5,23
191202408,3,9,7,5,1,25
191202409,2,1,4,7,2,16
191202410,7,1,0,8,1,17
191202411,1,9,4,3,9,26
191202412,4,6,1,8,8,27
191202413,5,5,0,6,3,19
191202414,2,1,2,7,5,17
191202415,6,5,1,1,8,21
191202416,0,8,4,8,3,23
191202417,1,0,9,1,3,14
191202418,4,7,5,6,2,24
191202419,4,4,6,8,4,26
191202420,9,1,5,5,3,23
191202421,4,1,8,8,9,30
191202422,8,6,9,9,6,38
191202423,2,0,0,9,9,20
191202424,9,5,3,1,9,27
191202425,4,4,0,0,1,9
191202426,5,1,0,5,5,16
191202427,2,6,8,0,1,17
191202428,1,0,5,5,7,18
191202429,4,2,2,7,6,21
191202430,4,2,4,6,5,21
191202431,6,7,8,8,2,31
191202432,7,3,1,7,9,27
191202433,4,2,8,8,3,25
191202434,5,0,7,4,1,17
191202435,5,0,2,0,2,9
191202436,3,1,9,8,5,26
191202437,5,2,5,2,1,15
191202438,4,6,8,2,3,23
191202439,2,2,9,9,8,30
191202440,4,5,4,5,0,18
191202441,5,0,1,4,8,18
191202442,5,9,0,8,8,30
191202443,6,6,3,7,7,29
191202444,5,2,6,1,1,15
191202445,4,7,8,5,0,24
191202446,3,3,4,4,7,21
191202447,1,1,0,2,7,11
191202448,8,4,3,6,4,25
191202449,7,2,5,7,0,21
191202450,1,9,5,4,1,20
191202451,2,5,0,0,1,8
191202452,2,5,8,0,0,15
191202453,0,8,8,5,2,23
191202454,1,1,7,3,8,20
191202455,1,1,9,9,4,24
191202456,8,8,2,2,7,27
191202457,4,0,6,2,8,20
191202458,1,0,8,2,6,17
191202459,9,1,4,6,2,22
191202460,4,4,2,2,4,16
191202461,0,8,6,5,4,23
191202462,2,0,1,7,2,12
191202463,4,3,7,1,0,15
191202464,2,0,4,9,4,19
191202465,9,7,8,8,8,40
191202466,5,6,9,5,1,26
191202467,6,3,1,1,6,17
191202468,4,6,7,0,2,19
191202469,0,6,9,3,6,24
191202470,4,8,3,9,0,24
191202471,8,9,9,1,1,28
191202472,7,8,0,2,7,24
191202473,9,3,9,4,7,32
191202474,2,0,6,3,2,13
191202475,8,6,4,8,4,30
191202476,5,7,1,4,0,17
191202477,3,8,6,5,4,26
191202478,1,0,0,3,7,11
191202479,3,9,0,8,2,22
191202480,0,2,5,8,7,22
191202481,6,2,2,6,3,19
191202482,0,1,6,2,4,13
191202483,4,6,6,5,0,21
191202484,3,6,2,4,3,18
191202485,4,7,8,6,6,31
191202486,6,6,0,0,4,16
191202487,2,2,9,4,8,25
191202488,5,4,4,9,7,29
191202489,5,2,9,0,5,21
191202490,8,0,7,9,8,32
191202491,1,8,3,8,6,26
191202492,6,9,3,5,6,29
191202493,2,0,7,1,6,16
191202494,5,2,6,2,8,23
191202495,2,4,8,0,7,21
191202496,9,9,1,7,6,32
191202497,9,3,1,7,3,23
191202498,1,9,3,0,6,19
191202499,1,3,7,0,1,12
191202500,8,8,8,8,6,38
191202501,4,5,0,2,1,12
191202502,4,2,7,8,6,27
191202503,9,1,1,3,2,16
191202504,2,5,2,8,7,24
191202505,8,0,3,3,4,18
191202506,0,2,0,7,4,13
191202507,6,0,4,2,9,21
191202508,6,9,8,7,0,30
191202509,2,9,1,1,7,20
191202510,4,1,4,8,2,19
191202511,0,9,6,9,5,29
191202512,5,8,5,5,1,24
191202513,7,7,0,9,1,24
191202514,2,0,2,6,2,12
191202515,2,6,2,1,9,20
191202516,1,3,0,0,1,5
191202517,8,2,5,3,7,25
191202518,1,6,5,6,2,20
191202519,9,9,7,3,4,32
191202520,7,2,7,6,0,22
191202521,6,7,6,1,2,22
191202522,1,8,3,7,3,22
191202523,4,9,6,0,3,22
191202524,2,1,7,6,4,20
191202525,6,3,4,0,2,15
191202526,4,4,6,9,4,27
191202527,9,2,1,3,4,19
191202528,3,3,7,6,3,22
191202529,9,9,0,7,0,25
191202530,1,2,9,4,6,22
191202531,1,1,6,4,8,20
191202532,4,6,1,0,2,13
191202533,9,7,0,8,2,26
191202534,0,8,4,1,6,19
191202535,7,9,2,4,3,25
191202536,7,8,7,0,9,31
191202537,3,8,5,7,6,29
191202538,4,2,2,1,2,11
191202539,3,9,0,3,5,20
191202540,0,8,5,5,3,21
191202541,1,9,8,9,1,28
191202542,4,3,3,0,6,16
191202543,5,5,9,7,1,27
191202544,6,3,6,7,1,23
191202545,8,1,3,0,3,15
191202546,4,6,3,4,4,21
191202547,8,2,9,1,8,28
191202548,3,8,9,1,3,24
191202549,1,4,4,2,7,18
191202550,8,2,9,3,0,22
191202551,7,1,3,9,3,23
191202552,1,7,0,5,4,17
191202553,8,1,6,1,9,25
191202554,1,8,8,4,0,21
191202555,4,3,1,8,0,16
191202556,3,6,3,6,5,23
191202557,3,1,6,1,2,13
191202558,8,8,3,4,6,29
191202559,0,1,5,1,1,8
191202560,9,3,8,0,2,22
191202561,1,8,5,5,2,21
191202562,5,8,1,7,2,23
191202563,4,3,3,5,1,16
191202564,0,7,6,9,1,23
191202565,4,1,9,9,4,27
191202566,1,6,7,0,6,20
191202567,0,4,3,9,1,17
191202568,3,2,8,9,0,22
191202569,5,9,0,9,9,32
191202570,7,1,6,6,6,26
191202571,5,2,3,3,0,13
191202572,9,9,1,2,9,30
191202573,5,1,8,5,5,24
191202574,8,1,1,0,4,14
191202575,3,1,9,2,6,21
191202576,4,2,3,8,8,25
191202577,7,8,7,3,6,31
191202578,8,6,6,1,0,21
191202579,0,3,0,4,9,16
191202580,4,6,2,3,5,20
191202581,7,5,9,3,0,24
191202582,1,5,2,6,2,16
191202583,2,5,0,1,2,10
191202584,0,6,0,5,7,18
191202585,9,2,9,7,6,33
191202586,8,0,4,0,2,14
191202587,5,6,2,6,0,19
191202588,3,4,6,2,3,18
191202589,8,2,6,4,7,27
191202590,7,8,3,0,3,21
191202591,9,6,2,3,5,25
191202592,4,1,4,4,9,22
191202593,6,8,3,5,3,25
191202594,1,7,7,6,4,25
191202595,9,3,9,8,9,38
191202596,4,6,2,0,2,14
191202597,6,6,2,7,2,23
191202598,4,5,6,0,4,19
191202599,8,6,6,4,9,33
191202600,5,8,6,2,5,26
191202601,1,8,5,3,4,21
191202602,2,7,9,5,6,29
191202603,0,2,0,8,4,14
191202604,9,3,7,9,3,31
191202605,7,7,1,3,5,23
191202606,0,1,2,4,2,9
191202607,9,1,2,0,6,18
191202608,7,7,0,8,1,23
191202609,8,0,5,2,4,19
191202610,8,9,5,1,6,29
191202611,2,6,9,6,3,26
191202612,6,3,9,6,3,27
191202613,7,9,2,3,7,28
191202614,8,0,2,5,7,22
191202615,3,9,4,4,9,29
191202616,3,2,5,3,1,14
191202617,8,7,2,3,6,26
191202618,7,0,5,2,5,19
191202619,5,2,9,6,1,23
191202620,0,7,5,1,9,22
191202621,7,0,5,2,0,14
191202622,4,9,3,9,7,32
191202623,0,3,4,6,5,18
191202624,7,6,2,1,6,22
191202625,1,5,6,9,0,21
191202626,8,5,4,9,9,35
191202627,0,1,2,8,0,11
191202628,6,0,2,8,1,17
191202629,2,3,4,8,7,24
191202630,6,0,7,4,2,19
191202631,5,3,3,6,2,19
191202632,3,3,0,4,9,19
191202633,3,1,2,6,9,21
191202634,2,0,4,6,1,13
191202635,8,5,7,8,6,34
191202636,9,2,3,5,9,28
191202637,4,8,3,8,3,26
191202638,1,6,6,1,3,17
191202639,1,3,7,9,4,24
191202640,6,9,4,6,9,34
191202641,5,2,6,4,8,25
191202642,5,4,4,7,8,28
191202643,8,0,1,5,5,19
191202644,8,1,7,7,3,26
191202645,1,4,0,4,5,14
191202646,1,0,1,1,5,8
191202647,4,9,6,1,0,20
191202648,1,9,7,2,4,23
191202649,7,5,7,3,8,30
191202650,6,4,9,5,9,33
191202651,4,9,8,5,3,29
191202652,3,0,7,1,7,18
191202653,8,4,4,6,2,24
191202654,3,4,3,3,6,19
191202655,3,4,5,1,6,19
191202656,0,8,9,1,0,18
191202657,6,5,4,0,3,18
191202658,2,0,0,8,9,19
191202659,6,2,0,7,2,17
191202660,8,5,6,2,0,21
191202661,2,9,8,5,3,27
191202662,0,1,8,4,4,17
191202663,9,6,8,2,7,32
191202664,3,9,9,2,7,30
191202665,5,7,1,9,7,29
191202666,8,9,1,1,0,19
191202667,6,9,0,2,6,23
191202668,6,9,4,8,9,36
191202669,9,2,6,2,0,19
191202670,6,3,7,3,8,27
191202671,0,3,0,1,3,7
191202672,5,7,0,5,9,26
191202673,6,7,5,6,4,28
191202674,3,2,7,3,4,19
191202675,6,8,2,2,6,24
191202676,9,2,0,7,6,24
191202677,8,3,5,0,2,18
191202678,2,0,8,9,7,26
191202679,4,3,6,8,9,30
191202680,1,8,6,3,2,20
191202681,1,9,0,3,4,17
191202682,5,6,2,4,3,20
191202683,5,9,3,8,8,33
191202684,2,0,9,0,1,12
191202685,8,8,8,4,9,37
191202686,9,1,9,6,6,31
191202687,1,9,5,1,7,23
191202688,6,8,1,6,6,27
191202689,1,9,3,5,5,23
191202690,6,0,9,1,3,19
191202691,1,6,4,2,8,21
191202692,0,7,7,4,1,19
191202693,4,2,7,1,3,17
191202694,7,8,4,3,8,30
191202695,6,7,4,3,9,29
191202696,3,5,0,5,0,13
191202697,5,3,1,0,7,16
191202698,7,4,9,7,2,29
191202699,0,3,1,7,7,18
191202700,3,4,9,2,0,18
191202701,2,5,9,7,4,27
191202702,0,8,8,1,6,23
191202703,0,4,4,9,5,22
191202704,2,5,5,1,4,17
191202705,7,0,2,7,3,19
191202706,0,6,0,1,9,16
191202707,4,9,0,4,8,25
191202708,5,8,8,2,8,31
191202709,6,5,5,3,1,20
191202710,4,7,7,6,4,28
191202711,2,3,4,2,2,13
191202712,1,6,5,5,0,17
191202713,5,1,6,9,7,28
191202714,0,2,2,2,0,6
191202715,3,7,3,8,5,26
191202716,1,2,3,3,9,18
191202717,9,1,6,6,5,27
191202718,6,3,3,4,6,22
191202719,0,6,1,7,0,14
191202720,5,6,6,4,9,30
191202721,5,6,3,6,9,29
191202722,3,4,8,3,3,21
191202723,4,8,2,2,0,16
191202724,7,8,7,7,4,33
191202725,7,8,4,5,7,31
191202726,1,6,0,6,5,18
191202727,9,5,2,5,2,23
191202728,8,0,9,6,7,30
191202729,5,2,8,6,6,27
191202730,3,2,9,3,6,23
191202731,7,1,6,4,1,19
191202732,1,3,7,9,7,27
191202733,4,3,2,2,9,20
191202734,2,5,2,9,6,24
191202735,7,4,3,3,4,21
191202736,9,8,0,1,2,20
191202737,7,5,5,9,3,29
191202738,5,0,3,0,2,10
191202739,4,8,2,7,0,21
191202740,5,3,1,8,5,22
191202741,0,4,2,7,1,14
191202742,6,8,5,7,7,33
191202743,9,0,0,7,4,20
191202744,2,1,3,7,1,14
191202745,0,6,4,5,7,22
191202746,0,5,4,2,4,15
191202747,6,0,9,0,3,18
191202748,9,8,4,1,9,31
191202749,5,4,8,3,8,28
191202750,7,8,3,2,2,22
191202751,7,2,6,5,3,23
191202752,5,3,9,9,1,27
191202753,4,0,3,9,8,24
191202754,5,2,6,3,8,24
191202755,8,2,8,8,1,27
191202756,7,4,7,9,4,31
191202757,1,1,0,4,6,12
191202758,0,3,1,4,0,8
191202759,2,9,9,0,0,20
191202760,3,7,2,4,4,20
191202761,7,6,5,2,6,26
191202762,0,4,6,2,7,19
191202763,1,2,6,9,7,25
191202764,5,4,7,3,9,28
191202765,8,0,7,7,3,25
191202766,1,0,8,9,7,25
191202767,9,2,3,0,8,22
191202768,1,1,3,3,6,14
191202769,9,8,7,1,3,28
191202770,9,6,0,8,8,31
191202771,4,4,8,3,4,23
191202772,9,0,5,4,3,21
191202773,1,2,1,4,1,9
191202774,3,3,1,9,6,22
191202775,6,8,8,2,7,31
191202776,7,1,0,7,9,24
191202777,8,9,8,4,1,30
191202778,6,0,5,0,2,13
191202779,7,0,8,4,0,19
191202780,6,0,4,8,7,25
191202781,2,2,6,9,3,22
191202782,6,1,4,0,9,20
191202783,7,0,1,8,8,24
191202784,1,0,1,8,8,18
191202785,6,3,4,2,2,17
191202786,3,0,7,3,8,21
191202787,9,2,7,1,8,27
191202788,2,4,4,7,6,23
191202789,9,3,4,3,7,26
191202790,3,9,3,4,4,23
191202791,4,8,0,5,2,19
191202792,5,3,3,0,3,14
191202793,2,3,7,0,0,12
191202794,4,9,3,9,8,33
191202795,0,2,0,3,2,7
191202796,7,4,5,8,9,33
191202797,6,0,3,0,5,14
191202798,9,2,0,8,3,22
191202799,3,2,3,5,3,16
191202800,2,7,9,5,9,32
191202801,1,8,8,1,9,27
191202802,2,1,5,7,9,24
191202803,5,2,0,8,8,23
191202804,4,3,1,2,3,13
191202805,6,7,9,4,2,28
191202806,4,7,1,3,2,17
191202807,2,1,9,8,8,28
191202808,8,5,9,4,0,26
191202809,1,4,2,5,2,14
191202810,7,3,8,4,9,31
191202811,0,9,5,5,0,19
191202812,6,2,3,6,7,24
191202813,6,7,4,3,3,23
191202814,8,1,1,3,9,22
191202815,6,6,2,2,7,23
191202816,3,1,1,7,6,18
191202817,7,3,3,4,3,20
191202818,5,6,4,5,4,24
191202819,0,0,2,8,9,19
191202820,5,8,6,3,4,26
191202821,9,8,6,4,4,31
191202822,2,4,5,9,0,20
191202823,2,3,7,2,9,23
191202824,3,7,8,5,8,31
191202825,1,7,6,8,0,22
191202826,7,7,4,3,3,24
191202827,9,1,4,3,2,19
191202828,5,7,0,7,2,21
191202829,4,8,1,5,4,22
191202830,0,5,7,6,3,21
191202831,8,2,1,7,3,21
191202832,6,8,9,7,5,35
191202833,5,7,5,1,2,20
191202834,8,5,4,4,0,21
191202835,6,1,1,1,3,12
191202836,3,0,7,0,9,19
191202837,0,5,6,6,9,26
191202838,4,9,9,1,5,28
191202839,5,8,3,7,5,28
191202840,2,2,0,5,0,9
191202841,0,9,9,8,6,32
191202842,4,3,3,4,1,15
191202843,9,2,8,0,5,24
191202844,6,0,7,1,5,19
191202845,5,4,9,5,8,31
191202846,4,1,2,8,9,24
191202847,6,2,5,9,9,31
191202848,7,8,7,0,5,27
191202849,0,5,7,0,0,12
191202850,7,3,3,3,7,23
191202851,4,5,6,2,9,26
191202852,4,0,3,1,7,15
191202853,1,1,8,7,4,21
191202854,7,1,4,8,9,29
191202855,5,3,8,8,0,24
191202856,7,4,4,3,9,27
191202857,0,2,1,2,8,13
191202858,8,0,6,7,4,25
191202859,3,2,4,8,5,22
191202860,0,5,1,0,9,15
191202861,9,2,7,3,9,30
191202862,6,8,7,6,4,31
191202863,0,2,5,4,0,11
191202864,7,4,8,5,0,24
191202865,4,3,3,4,8,22
191202866,2,6,4,8,2,22
191202867,1,5,1,8,1,16
191202868,8,0,0,1,1,10
191202869,4,0,2,4,5,15
191202870,3,3,7,7,3,23
191202871,1,4,4,8,1,18
191202872,3,6,0,4,4,17
191202873,8,5,6,7,5,31
191202874,5,6,1,0,9,21
191202875,7,8,2,2,7,26
191202876,4,2,3,7,6,22
191202877,9,1,2,1,0,13
191202878,7,2,0,7,9,25
191202879,1,9,1,6,8,25
191202880,4,8,7,4,1,24
191202881,2,3,7,1,9,22
191202882,6,3,2,3,1,15
191202883,9,5,8,9,5,36
191202884,4,3,6,6,1,20
191202885,2,4,0,2,0,8
191202886,2,4,0,9,6,21
191202887,5,7,9,7,7,35
191202888,3,1,2,4,9,19
191202889,5,3,6,8,3,25
191202890,2,6,0,2,3,13
191202891,4,9,5,4,9,31
191202892,1,3,4,7,1,16
191202893,5,2,6,8,8,29
191202894,8,3,4,7,6,28
191202895,2,4,3,9,0,18
191202896,6,8,9,8,9,40
191202897,3,6,3,8,4,24
191202898,4,1,8,8,5,26
191202899,5,1,0,6,1,13
191202900,4,9,6,4,9,32
191202901,1,7,8,3,3,22
191202902,4,6,8,5,2,25
191202903,5,8,1,5,9,28
191202904,7,7,6,9,3,32
191202905,7,7,6,1,4,25
191202906,4,3,2,2,5,16
191202907,8,7,7,6,1,29
191202908,4,1,3,7,1,16
191202909,1,1,5,9,8,24
191202910,6,9,8,5,4,32
191202911,5,8,6,5,0,24
191202912,4,6,0,3,7,20
191202913,3,3,9,2,8,25
191202914,8,4,5,2,5,24
191202915,7,5,2,4,8,26
191202916,0,6,6,7,1,20
191202917,1,7,6,8,9,31
191202918,5,5,0,3,6,19
191202919,7,8,9,1,1,26
191202920,1,9,7,6,8,31
191202921,6,2,7,3,7,25
191202922,1,4,7,5,9,26
191202923,4,7,8,4,8,31
191202924,0,4,3,5,8,20
191202925,3,5,9,4,4,25
191202926,8,3,1,0,7,19
191202927,7,3,9,2,8,29
191202928,2,8,3,7,8,28
191202929,6,4,2,1,2,15
191202930,7,4,8,3,8,30
191202931,4,2,2,8,8,24
191202932,5,9,8,4,2,28
191202933,8,4,0,3,6,21
191202934,8,3,9,9,6,35
191202935,4,3,6,9,7,29
191202936,4,7,4,5,1,21
191202937,7,0,3,7,4,21
191202938,9,9,3,6,9,36
191202939,0,3,3,1,5,12
191202940,9,0,1,0,7,17
191202941,9,7,2,1,2,21
191202942,1,2,0,1,5,9
191202943,0,7,2,2,7,18
191202944,0,3,6,7,5,21
191202945,9,6,8,2,8,33
191202946,7,8,7,9,7,38
191202947,0,6,1,3,5,15
191202948,0,3,9,0,6,18
191202949,8,8,7,4,1,28
191202950,5,1,0,6,2,14
191202951,1,4,0,2,3,10
191202952,6,2,2,8,7,25
191202953,6,3,1,7,4,21
191202954,1,8,5,4,1,19
191202955,3,4,9,7,5,28
191202956,1,5,0,8,1,15
191202957,5,8,3,7,9,32
191202958,4,1,4,0,1,10
191202959,1,0,5,3,8,17
191202960,5,3,0,5,3,16
191202961,2,1,0,2,7,12
191202962,7,8,9,8,1,33
191202963,1,0,0,1,4,6
191202964,0,0,6,4,2,12
191202965,4,4,0,9,8,25
191202966,1,7,1,5,1,15
191202967,1,9,9,9,9,37
191202968,7,2,8,0,5,22
191202969,7,1,9,0,4,21
191202970,5,6,4,9,4,28
191202971,0,2,8,1,7,18
191202972,8,0,2,6,4,20
191202973,5,1,2,8,3,19
191202974,4,9,2,9,5,29
191202975,5,4,5,6,3,23
191202976,4,2,0,1,6,13
191202977,6,9,2,9,4,30
191202978,6,8,7,5,3,29
191202979,2,1,8,5,9,25
191202980,1,4,0,0,2,7
191202981,8,8,8,7,8,39
191202982,9,7,1,1,9,27
191202983,2,2,1,8,1,14
191202984,7,1,1,6,0,15
191202985,2,3,1,1,5,12
191202986,9,2,5,6,7,29
191202987,2,6,2,5,0,15
191202988,0,8,6,1,8,23
191202989,7,0,5,9,6,27
191202990,9,0,6,3,2,20
191202991,2,4,1,7,6,20
191202992,4,3,2,5,2,16
191202993,4,0,2,5,0,11
191202994,9,9,8,8,0,34
191202995,1,8,2,1,1,13
191202996,6,7,6,6,6,31
191202997,3,4,2,3,5,17
191202998,4,4,7,8,0,23
191202999,5,9,0,6,3,23
1912021000,5,7,5,8,0,25
1912021001,8,5,6,3,8,30
1912021002,5,5,2,2,1,15
1912021003,0,2,9,7,7,25
1912021004,9,2,9,4,8,32
1912021005,1,6,3,0,7,17
1912021006,5,9,1,8,8,31
1912021007,2,4,1,9,2,18
1912021008,2,2,0,1,4,9
1912021009,2,3,6,0,3,14
1912021010,9,3,5,3,4,24
1912021011,0,6,1,1,2,10
1912021012,9,9,2,5,9,34
1912021013,9,1,0,3,2,15
1912021014,8,8,8,4,8,36
1912021015,3,7,4,8,1,23
1912021016,9,3,4,6,1,23
1912021017,6,2,8,2,7,25
1912021018,6,8,9,4,5,32
1912021019,6,8,6,0,7,27
1912021020,1,3,6,8,8,26
1912021021,8,7,3,8,1,27
1912021022,5,3,8,2,5,23
1912021023,3,9,9,4,9,34
1912021024,2,7,2,8,3,22
1912021025,0,2,3,6,1,12
1912021026,8,5,5,6,3,27
1912021027,1,3,1,8,2,15
1912021028,6,6,6,2,0,20
1912021029,5,7,1,8,8,29
1912021030,0,5,9,7,7,28
1912021031,2,7,3,9,0,21
1912021032,0,8,3,0,7,18
1912021033,0,1,4,2,3,10
1912021034,9,6,7,9,2,33
1912021035,7,9,6,4,4,30
1912021036,0,9,6,3,4,22
1912021037,5,2,5,9,1,22
1912021038,2,8,7,8,4,29
1912021039,0,0,9,5,5,19
1912021040,5,6,7,4,8,30
1912021041,8,1,6,4,4,23
1912021042,4,4,4,7,1,20
1912021043,1,8,6,5,4,24
1912021044,7,0,3,5,5,20
1912021045,9,9,2,6,6,32
1912021046,5,4,1,7,4,21
1912021047,9,0,1,6,0,16
1912021048,6,0,3,7,8,24
1912021049,4,3,0,2,5,14
1912021050,3,1,3,7,0,14
1912021051,7,7,9,6,5,34
1912021052,9,7,9,5,7,37
1912021053,9,6,5,0,6,26
1912021054,3,8,7,0,3,21
1912021055,7,2,4,7,1,21
1912021056,3,8,1,2,5,19
1912021057,5,4,9,1,7,26
1912021058,3,8,5,5,9,30
1912021059,7,0,0,7,3,17
1912021060,4,5,1,2,6,18
1912021061,4,4,6,8,0,22
1912021062,5,7,5,5,3,25
1912021063,2,2,9,7,4,24
1912021064,9,1,0,4,0,14
1912021065,2,8,0,3,0,13
1912021066,0,1,9,1,8,19
1912021067,5,0,3,8,0,16
1912021068,6,1,7,1,2,17
1912021069,0,3,5,0,3,11
1912021070,8,9,5,7,9,38
1912021071,9,7,7,1,9,33
1912021072,2,3,1,7,6,19
1912021073,2,3,5,9,1,20
1912021074,8,7,6,4,0,25
1912021075,3,5,6,5,2,21
1912021076,2,5,8,6,2,23
1912021077,6,5,6,4,0,21
1912021078,1,6,8,6,2,23
1912021079,8,9,9,6,1,33
1912021080,2,0,6,1,1,10
1912021081,7,8,2,4,9,30
1912021082,3,1,0,7,8,19
1912021083,5,8,6,8,8,35
1912021084,8,8,1,5,8,30
1912021085,9,3,9,1,8,30
1912021086,8,3,8,8,4,31
1912021087,9,8,9,4,7,37
1912021088,8,7,8,9,8,40
1912021089,6,9,7,6,2,30
1912021090,5,7,8,4,7,31
1912021091,5,4,6,9,2,26
1912021092,2,7,5,9,9,32
1912021093,7,7,9,7,0,30
1912021094,2,3,5,1,1,12
1912021095,3,7,8,2,1,21
1912021096,2,4,4,3,6,19
1912021097,8,2,3,7,3,23
1912021098,3,7,4,1,0,15
1912021099,8,3,8,3,2,24
1912021100,6,6,4,9,2,27
1912021101,8,1,1,0,9,19
1912021102,5,9,0,8,0,22
1912021103,5,6,3,4,1,19
1912021104,0,5,4,0,5,14
1912021105,6,4,2,6,8,26
191203001,6,4,7,4,2,23
191203002,9,5,6,8,3,31
191203003,7,8,0,7,8,30
191203004,6,3,3,2,1,15
191203005,1,5,8,5,2,21
191203006,6,7,3,8,1,25
191203007,2,8,7,0,5,22
191203008,8,3,6,2,5,24
191203009,2,3,9,5,9,28
191203010,2,8,0,6,8,24
191203011,7,1,5,1,5,19
191203012,0,2,3,3,2,10
191203013,8,0,5,5,3,21
191203014,7,9,7,7,4,34
191203015,3,1,7,5,5,21
191203016,7,7,0,1,2,17
191203017,8,9,0,0,1,18
191203018,2,9,0,5,7,23
191203019,0,1,3,8,9,21
191203020,7,6,2,9,1,25
191203021,0,2,9,8,9,28
191203022,8,5,6,3,7,29
191203023,7,6,0,0,7,20
191203024,4,2,4,5,0,15
191203025,6,0,5,1,9,21
191203026,0,9,3,5,5,22
191203027,7,5,4,8,5,29
191203028,4,7,9,9,2,31
191203029,8,6,2,6,5,27
191203030,8,5,8,2,5,28
191203031,3,4,9,0,8,24
191203032,3,7,7,8,8,33
191203033,2,9,7,8,3,29
191203034,8,5,3,6,2,24
191203035,1,8,7,9,1,26
191203036,8,4,8,4,0,24
191203037,0,0,5,6,7,18
191203038,4,3,0,2,4,13
191203039,9,5,5,9,3,31
191203040,1,0,3,1,4,9
191203041,8,5,3,4,5,25
191203042,1,5,1,8,6,21
191203043,3,4,2,3,4,16
191203044,1,6,1,7,7,22
191203045,7,4,8,0,8,27
191203046,4,6,0,7,6,23
191203047,9,5,1,1,4,20
191203048,3,1,8,2,6,20
191203049,9,3,7,3,1,23
191203050,9,9,1,2,3,24
191203051,5,6,5,6,6,28
191203052,4,0,3,1,3,11
191203053,9,8,9,6,7,39
191203054,5,1,4,6,1,17
191203055,4,4,4,3,2,17
191203056,6,1,0,5,3,15
191203057,2,8,9,5,9,33
191203058,2,2,9,3,8,24
191203059,7,9,9,7,1,33
191203060,0,0,5,5,0,10
191203061,1,0,7,4,1,13
191203062,3,9,4,9,8,33
191203063,5,9,3,6,6,29
191203064,7,1,6,3,2,19
191203065,8,4,0,4,4,20
191203066,8,1,9,2,7,27
191203067,8,2,6,2,6,24
191203068,9,8,9,6,0,32
191203069,8,2,8,4,7,29
191203070,3,0,2,8,8,21
191203071,9,6,6,1,7,29
191203072,8,4,4,4,4,24
191203073,1,9,6,2,6,24
191203074,7,3,6,1,0,17
191203075,5,9,7,5,8,34
191203076,3,8,4,2,4,21
191203077,8,3,8,2,1,22
191203078,6,1,3,1,0,11
191203079,6,1,4,5,4,20
191203080,7,9,5,7,8,36
191203081,4,5,6,4,0,19
191203082,5,7,2,8,9,31
191203083,7,8,5,7,2,29
191203084,8,2,0,6,7,23
191203085,1,7,4,7,0,19
191203086,4,7,2,3,8,24
191203087,6,8,4,3,9,30
191203088,7,7,3,5,4,26
191203089,6,3,8,4,8,29
191203090,0,8,2,4,0,14
191203091,1,7,8,8,0,24
191203092,3,7,2,4,3,19
191203093,4,8,7,5,4,28
191203094,4,5,8,7,5,29
191203095,8,5,9,4,8,34
191203096,6,3,1,3,1,14
191203097,3,5,1,0,0,9
191203098,8,0,2,5,1,16
191203099,9,2,9,7,9,36
191203100,1,9,5,8,3,26
191203101,2,9,9,0,1,21
191203102,1,5,0,4,8,18
191203103,9,3,1,6,4,23
191203104,9,9,4,9,5,36
191203105,3,1,4,2,3,13
191203106,1,2,1,6,9,19
191203107,6,6,9,7,2,30
191203108,7,5,2,3,9,26
191203109,0,5,1,8,8,22
191203110,1,4,2,2,4,13
191203111,4,4,2,4,8,22
191203112,5,2,8,5,9,29
191203113,6,9,1,6,6,28
191203114,1,9,0,5,3,18
191203115,3,8,4,9,3,27
191203116,0,9,6,1,2,18
191203117,3,8,6,9,9,35
191203118,4,7,4,5,4,24
191203119,4,6,3,8,3,24
191203120,7,2,9,8,2,28
191203121,4,4,5,8,9,30
191203122,2,5,2,8,6,23
191203123,4,8,4,0,9,25
191203124,2,5,1,7,5,20
191203125,7,5,5,6,7,30
191203126,9,8,9,9,1,36
191203127,9,6,6,3,8,32
191203128,8,7,6,8,1,30
191203129,5,0,5,3,1,14
191203130,1,2,7,0,1,11
191203131,9,0,0,3,7,19
191203132,0,4,3,1,3,11
191203133,6,7,0,7,9,29
191203134,0,4,7,8,6,25
191203135,0,7,2,5,7,21
191203136,6,3,1,1,3,14
191203137,9,7,6,0,1,23
191203138,6,6,7,1,0,20
191203139,8,5,2,5,9,29
191203140,5,7,7,8,0,27
191203141,8,2,7,2,8,27
191203142,2,9,5,3,8,27
191203143,5,1,2,4,7,19
191203144,0,4,4,2,3,13
191203145,1,6,3,4,3,17
191203146,5,6,2,3,2,18
191203147,2,2,8,2,9,23
191203148,2,8,4,1,4,19
191203149,3,1,0,2,1,7
191203150,3,8,8,7,0,26
191203151,5,9,4,9,9,36
191203152,5,2,6,9,6,28
191203153,2,5,4,0,6,17
191203154,3,7,8,4,5,27
191203155,0,8,1,3,9,21
191203156,3,8,1,4,6,22
191203157,3,1,5,8,7,24
191203158,8,7,6,1,4,26
191203159,5,1,6,0,9,21
191203160,6,3,7,2,3,21
191203161,2,2,0,7,5,16
191203162,7,9,8,5,2,31
191203163,9,0,0,0,0,9
191203164,9,2,4,4,3,22
191203165,6,1,9,1,4,21
191203166,1,8,5,7,9,30
191203167,2,0,3,6,2,13
191203168,3,9,6,1,4,23
191203169,4,2,9,6,9,30
191203170,6,0,6,4,0,16
191203171,0,8,7,4,4,23
191203172,9,1,5,0,7,22
191203173,4,6,0,0,3,13
191203174,2,2,4,1,8,17
191203175,6,1,8,6,0,21
191203176,0,0,4,0,6,10
191203177,7,6,8,8,9,38
191203178,5,4,7,5,8,29
191203179,0,2,0,7,5,14
191203180,9,1,0,7,7,24
191203181,7,8,5,2,9,31
191203182,5,1,8,8,7,29
191203183,9,6,3,2,7,27
191203184,8,9,3,1,4,25
191203185,1,1,1,0,5,8
191203186,1,9,1,3,6,20
191203187,6,1,9,9,0,25
191203188,5,6,3,5,2,21
191203189,0,1,6,0,6,13
191203190,0,8,4,2,4,18
191203191,0,3,7,3,2,15
191203192,0,0,6,0,0,6
191203193,8,5,7,7,1,28
191203194,7,5,2,7,3,24
191203195,0,4,7,2,7,20
191203196,3,5,3,0,2,13
191203197,9,6,2,1,8,26
191203198,9,8,5,2,4,28
191203199,0,2,5,3,4,14
191203200,9,8,1,3,0,21
191203201,9,3,5,0,8,25
191203202,0,4,1,7,7,19
191203203,4,3,5,2,5,19
191203204,8,9,9,3,9,38
191203205,1,7,0,6,5,19
191203206,1,0,6,4,7,18
191203207,5,1,9,6,3,24
191203208,2,1,6,7,9,25
191203209,0,9,3,2,7,21
191203210,7,3,1,2,4,17
191203211,2,7,8,0,7,24
191203212,1,5,5,4,8,23
191203213,0,9,2,6,7,24
191203214,3,7,7,4,6,27
191203215,2,3,3,1,1,10
191203216,1,2,8,9,2,22
191203217,7,5,1,4,9,26
191203218,2,2,0,2,4,10
191203219,9,3,2,4,7,25
191203220,3,1,9,5,3,21
191203221,0,1,4,4,7,16
191203222,7,3,5,2,3,20
191203223,6,1,0,9,7,23
191203224,7,5,4,0,5,21
191203225,8,6,4,3,6,27
191203226,8,9,1,2,8,28
191203227,3,9,1,7,6,26
191203228,1,9,5,8,6,29
191203229,9,4,6,5,0,24
191203230,4,8,9,5,9,35
191203231,0,9,5,8,2,24
191203232,3,1,8,5,9,26
191203233,0,5,4,9,3,21
191203234,3,9,1,9,9,31
191203235,5,7,3,2,0,17
191203236,2,3,3,5,3,16
191203237,5,3,7,5,5,25
191203238,2,3,3,0,1,9
191203239,4,3,4,5,8,24
191203240,8,7,1,0,7,23
191203241,6,1,3,2,0,12
191203242,8,4,0,5,3,20
191203243,1,6,0,1,8,16
191203244,6,6,0,0,1,13
191203245,2,9,9,8,5,33
191203246,5,1,7,9,0,22
191203247,4,5,5,3,1,18
191203248,0,8,4,4,2,18
191203249,7,3,4,4,5,23
191203250,1,7,1,4,8,21
191203251,2,1,6,2,0,11
191203252,6,9,6,1,1,23
191203253,3,4,7,9,4,27
191203254,6,1,8,6,3,24
191203255,6,5,1,2,8,22
191203256,3,7,1,7,4,22
191203257,2,5,1,8,0,16
191203258,7,3,6,2,5,23
191203259,0,4,7,9,7,27
191203260,1,3,4,1,6,15
191203261,8,8,9,9,8,42
191203262,5,4,6,9,9,33
191203263,8,1,4,3,8,24
191203264,7,7,2,9,8,33
191203265,5,8,2,5,1,21
191203266,6,9,5,8,0,28
191203267,4,7,6,1,1,19
191203268,1,0,7,5,9,22
191203269,0,3,2,8,9,22
191203270,4,7,7,9,0,27
191203271,8,3,5,6,7,29
191203272,0,1,8,8,9,26
191203273,0,8,0,7,9,24
191203274,6,9,0,5,8,28
191203275,2,0,1,7,1,11
191203276,6,5,4,7,4,26
191203277,5,3,8,0,0,16
191203278,3,3,5,4,0,15
191203279,2,1,4,4,6,17
191203280,4,1,8,0,0,13
191203281,3,4,7,4,2,20
191203282,5,1,5,9,3,23
191203283,0,2,6,8,6,22
191203284,8,9,3,5,9,34
191203285,7,0,8,2,0,17
191203286,3,8,5,5,5,26
191203287,6,6,3,0,2,17
191203288,2,1,6,0,2,11
191203289,6,2,9,8,3,28
191203290,4,9,8,9,7,37
191203291,7,8,4,2,7,28
191203292,0,8,9,1,6,24
191203293,2,6,6,1,5,20
191203294,3,1,3,2,2,11
191203295,4,9,2,6,8,29
191203296,7,1,3,1,1,13
191203297,4,1,4,6,3,18
191203298,6,0,3,1,7,17
191203299,4,7,6,5,3,25
191203300,9,9,4,9,7,38
191203301,3,5,4,6,3,21
191203302,4,8,7,2,3,24
191203303,3,9,8,7,4,31
191203304,4,0,8,1,4,17
191203305,6,2,1,9,3,21
191203306,5,4,0,1,2,12
191203307,6,6,4,3,8,27
191203308,4,9,5,4,7,29
191203309,0,3,3,4,0,10
191203310,5,3,7,9,6,30
191203311,7,2,8,0,4,21
191203312,0,6,9,1,3,19
191203313,8,1,1,7,6,23
191203314,1,1,1,1,8,12
191203315,2,5,1,3,8,19
191203316,0,7,1,0,0,8
191203317,5,5,3,7,7,27
191203318,9,0,4,5,6,24
191203319,8,5,3,9,9,34
191203320,8,8,8,7,3,34
191203321,6,6,2,1,9,24
191203322,2,8,7,9,2,28
191203323,7,7,1,4,9,28
191203324,5,2,2,9,2,20
191203325,4,2,2,8,5,21
191203326,2,6,6,7,1,22
191203327,4,1,9,3,2,19
191203328,3,3,5,4,8,23
191203329,3,4,4,0,5,16
191203330,3,6,8,0,3,20
191203331,9,5,2,5,9,30
191203332,8,7,9,9,7,40
191203333,1,4,3,9,8,25
191203334,9,4,9,5,2,29
191203335,1,0,9,2,9,21
191203336,9,3,1,8,9,30
191203337,5,9,9,2,7,32
191203338,7,6,8,9,0,30
191203339,1,9,3,6,1,20
191203340,1,7,1,8,3,20
191203341,2,0,9,2,6,19
191203342,6,4,5,1,2,18
191203343,1,2,0,9,8,20
191203344,0,6,6,1,0,13
191203345,0,4,0,6,8,18
191203346,2,8,9,5,8,32
191203347,3,2,2,8,0,15
191203348,0,1,9,8,7,25
191203349,1,0,5,9,4,19
191203350,0,4,8,7,8,27
191203351,8,6,8,2,3,27
191203352,4,0,6,1,6,17
191203353,9,4,6,6,9,34
191203354,7,0,7,4,1,19
191203355,3,1,7,3,5,19
191203356,8,6,4,3,7,28
191203357,9,8,8,2,9,36
191203358,1,0,1,6,5,13
191203359,4,8,2,7,8,29
191203360,7,5,1,5,5,23
191203361,9,9,8,2,0,28
191203362,1,9,0,0,8,18
191203363,5,2,3,2,5,17
191203364,8,3,6,5,6,28
191203365,3,2,3,6,1,15
191203366,9,1,1,8,2,21
191203367,8,7,2,2,8,27
191203368,3,7,2,4,2,18
191203369,3,4,8,0,1,16
191203370,0,3,8,5,1,17
191203371,4,1,8,6,9,28
191203372,0,8,0,2,5,15
191203373,8,5,9,7,7,36
191203374,9,0,3,8,5,25
191203375,5,3,7,0,0,15
191203376,3,5,5,2,5,20
191203377,9,6,3,0,9,27
191203378,9,6,8,0,8,31
191203379,1,8,1,6,0,16
191203380,0,5,2,2,4,13
191203381,2,9,5,3,3,22
191203382,3,3,0,6,8,20
191203383,3,6,1,5,2,17
191203384,0,6,9,9,6,30
191203385,1,3,9,5,8,26
191203386,1,1,9,7,4,22
191203387,9,0,4,5,5,23
191203388,0,6,0,2,6,14
191203389,7,7,3,2,4,23
191203390,4,0,0,6,2,12
191203391,3,9,1,6,1,20
191203392,8,9,7,5,3,32
191203393,4,5,3,9,2,23
191203394,7,8,5,1,2,23
191203395,6,5,2,1,9,23
191203396,7,2,7,5,2,23
191203397,2,4,6,7,5,24
191203398,1,6,0,6,6,19
191203399,3,4,0,7,4,18
191203400,2,5,0,2,1,10
191203401,7,9,2,0,1,19
191203402,6,9,2,6,9,32
191203403,9,9,4,7,2,31
191203404,2,3,8,9,4,26
191203405,4,4,3,1,7,19
191203406,2,0,7,6,1,16
191203407,8,0,6,1,5,20
191203408,2,7,2,4,4,19
191203409,3,7,6,1,2,19
191203410,9,9,6,8,8,40
191203411,3,8,9,1,7,28
191203412,6,0,4,6,3,19
191203413,4,2,6,5,0,17
191203414,4,7,6,2,4,23
191203415,9,1,2,2,6,20
191203416,7,9,7,4,8,35
191203417,4,7,0,3,1,15
191203418,6,0,1,2,9,18
191203419,7,5,8,2,0,22
191203420,4,7,0,5,8,24
191203421,9,1,4,1,9,24
191203422,0,4,8,5,2,19
191203423,2,4,5,8,4,23
191203424,4,3,5,6,3,21
191203425,4,3,8,5,6,26
191203426,2,5,3,3,1,14
191203427,0,9,0,7,9,25
191203428,5,8,6,2,2,23
191203429,0,4,6,6,2,18
191203430,1,1,5,4,1,12
191203431,4,1,5,5,3,18
191203432,7,7,3,3,0,20
191203433,6,0,0,5,8,19
191203434,4,7,3,5,0,19
191203435,9,0,7,5,5,26
191203436,2,8,2,6,5,23
191203437,7,2,5,5,4,23
191203438,8,3,2,3,4,20
191203439,5,9,7,7,9,37
191203440,9,0,4,2,4,19
191203441,3,2,9,4,2,20
191203442,4,2,2,6,5,19
191203443,2,0,2,4,9,17
191203444,5,7,1,7,0,20
191203445,3,1,1,3,8,16
191203446,3,5,5,8,2,23
191203447,5,7,0,2,7,21
191203448,2,0,5,6,7,20
191203449,2,5,5,4,0,16
191203450,2,2,6,7,7,24
191203451,0,0,2,1,3,6
191203452,6,5,3,0,1,15
191203453,8,0,4,4,6,22
191203454,3,3,8,0,8,22
191203455,2,2,5,7,9,25
191203456,6,2,5,0,4,17
191203457,7,4,5,9,1,26
191203458,6,0,4,1,7,18
191203459,3,1,1,4,6,15
191203460,0,8,5,4,3,20
191203461,8,2,3,0,3,16
191203462,8,8,5,9,6,36
191203463,0,6,9,7,6,28
191203464,8,4,1,5,3,21
191203465,3,7,2,9,6,27
191203466,9,0,4,9,4,26
191203467,2,7,1,3,7,20
191203468,4,6,5,8,4,27
191203469,0,0,6,4,8,18
191203470,1,9,1,3,1,15
191203471,7,5,7,0,7,26
191203472,0,8,5,6,5,24
191203473,9,2,4,9,2,26
191203474,7,7,7,1,8,30
191203475,1,6,8,5,9,29
191203476,1,7,4,5,8,25
191203477,4,1,0,1,4,10
191203478,1,9,6,8,1,25
191203479,1,4,7,2,0,14
191203480,5,1,2,1,6,15
191203481,9,3,3,0,2,17
191203482,8,0,2,8,9,27
191203483,2,9,8,9,3,31
191203484,0,0,0,1,7,8
191203485,1,6,2,6,6,21
191203486,0,1,1,4,9,15
191203487,9,3,4,5,7,28
191203488,2,0,4,3,4,13
191203489,7,3,1,4,0,15
191203490,2,9,2,5,8,26
191203491,9,7,1,9,9,35
191203492,5,3,6,6,7,27
191203493,3,9,2,2,8,24
191203494,7,7,1,7,3,25
191203495,5,6,3,7,5,26
191203496,3,0,7,9,2,21
191203497,9,9,2,9,0,29
191203498,9,8,5,8,2,32
191203499,8,9,8,1,5,31
191203500,2,9,3,4,8,26
191203501,9,6,5,7,4,31
191203502,1,2,7,1,7,18
191203503,5,5,5,7,9,31
191203504,0,9,7,9,4,29
191203505,6,4,2,1,8,21
191203506,5,1,2,9,7,24
191203507,7,4,3,2,4,20
191203508,2,3,1,8,2,16
191203509,3,0,7,4,2,16
191203510,8,7,7,7,7,36
191203511,2,6,6,3,9,26
191203512,5,7,1,6,2,21
191203513,2,9,1,1,8,21
191203514,1,1,0,2,4,8
191203515,3,8,1,8,3,23
191203516,0,8,1,6,2,17
191203517,0,0,0,4,5,9
191203518,6,8,8,3,4,29
191203519,2,5,4,6,4,21
191203520,3,8,1,8,9,29
191203521,2,6,7,0,3,18
191203522,3,9,1,1,8,22
191203523,7,2,1,6,9,25
191203524,6,1,5,0,2,14
191203525,1,5,3,5,9,23
191203526,8,4,0,9,5,26
191203527,6,1,8,2,5,22
191203528,6,7,5,8,3,29
191203529,0,9,6,5,8,28
191203530,5,3,6,4,9,27
191203531,6,1,1,1,9,18
191203532,0,4,4,1,5,14
191203533,7,2,0,9,8,26
191203534,5,8,6,5,6,30
191203535,3,2,5,1,6,17
191203536,5,6,9,2,6,28
191203537,2,2,0,4,4,12
191203538,9,2,8,8,0,27
191203539,0,6,4,8,4,22
191203540,3,6,9,2,7,27
191203541,3,0,9,9,2,23
191203542,1,3,2,2,9,17
191203543,1,9,1,3,3,17
191203544,6,7,0,1,2,16
191203545,4,5,8,1,1,19
191203546,7,9,6,0,5,27
191203547,6,2,4,0,3,15
191203548,0,8,6,9,9,32
191203549,3,6,9,5,1,24
191203550,6,2,7,9,2,26
191203551,3,5,3,7,1,19
191203552,1,5,0,2,9,17
191203553,8,3,5,6,2,24
191203554,0,9,4,0,7,20
191203555,5,8,9,7,2,31
191203556,0,2,7,6,6,21
191203557,4,2,3,5,8,22
191203558,2,5,1,6,4,18
191203559,5,9,2,9,9,34
191203560,0,0,9,2,7,18
191203561,4,1,4,8,5,22
191203562,1,4,3,9,3,20
191203563,4,8,2,4,9,27
191203564,7,9,2,0,6,24
191203565,3,0,0,3,0,6
191203566,1,7,2,2,9,21
191203567,3,6,8,2,7,26
191203568,3,7,3,5,3,21
191203569,5,5,2,6,5,23
191203570,7,3,6,1,3,20
191203571,5,8,5,3,8,29
191203572,4,1,8,6,5,24
191203573,5,5,6,7,5,28
191203574,8,6,8,6,5,33
191203575,8,9,0,0,7,24
191203576,7,4,3,4,4,22
191203577,2,2,3,0,7,14
191203578,1,9,3,1,5,19
191203579,3,6,0,7,2,18
191203580,8,9,7,4,0,28
191203581,9,6,0,0,9,24
191203582,4,5,1,9,3,22
191203583,8,0,3,5,8,24
191203584,8,9,0,9,2,28
191203585,5,1,1,0,4,11
191203586,0,3,5,0,9,17
191203587,0,8,0,9,7,24
191203588,5,5,1,3,7,21
191203589,5,5,0,9,1,20
191203590,5,2,5,9,6,27
191203591,2,4,5,0,1,12
191203592,0,2,3,0,6,11
191203593,0,3,0,0,1,4
191203594,1,8,7,4,8,28
191203595,7,7,7,4,1,26
191203596,2,7,1,4,4,18
191203597,4,0,7,4,8,23
191203598,0,3,1,3,0,7
191203599,3,1,5,7,3,19
191203600,1,0,7,0,1,9
191203601,5,2,0,0,2,9
191203602,0,1,0,4,9,14
191203603,6,8,1,6,7,28
191203604,0,1,6,3,1,11
191203605,8,1,0,7,2,18
191203606,6,9,2,9,9,35
191203607,9,3,9,6,7,34
191203608,5,5,8,0,3,21
191203609,7,5,0,6,8,26
191203610,3,0,4,1,4,12
191203611,9,0,6,9,6,30
191203612,2,8,6,6,2,24
191203613,4,9,4,2,6,25
191203614,8,1,5,5,7,26
191203615,0,8,3,5,5,21
191203616,6,6,8,1,3,24
191203617,0,8,5,0,0,13
191203618,9,9,4,4,1,27
191203619,9,4,1,8,9,31
191203620,2,1,3,1,7,14
191203621,4,4,3,2,6,19
191203622,6,3,0,2,3,14
191203623,9,7,4,6,8,34
191203624,1,0,8,7,7,23
191203625,5,5,1,4,1,16
191203626,6,7,8,0,2,23
191203627,7,2,8,0,7,24
191203628,2,6,5,9,0,22
191203629,2,7,4,0,6,19
191203630,2,3,1,9,7,22
191203631,4,8,1,5,5,23
191203632,9,3,4,0,0,16
191203633,5,1,6,2,8,22
191203634,3,0,9,0,0,12
191203635,2,1,9,9,9,30
191203636,3,4,6,5,1,19
191203637,1,7,0,0,0,8
191203638,3,0,1,2,0,6
191203639,1,5,9,2,9,26
191203640,6,7,3,3,4,23
191203641,6,0,7,9,3,25
191203642,7,6,3,5,5,26
191203643,7,2,4,0,6,19
191203644,8,3,7,4,0,22
191203645,3,4,7,9,2,25
191203646,0,6,1,9,0,16
191203647,9,2,0,7,4,22
191203648,0,2,4,9,6,21
191203649,5,2,3,3,6,19
191203650,8,3,4,3,5,23
191203651,3,1,8,9,0,21
191203652,3,4,2,9,2,20
191203653,9,4,0,4,5,22
191203654,7,2,0,5,3,17
191203655,4,5,0,8,0,17
191203656,7,6,7,5,3,28
191203657,7,0,1,3,7,18
191203658,8,2,4,0,0,14
191203659,1,9,1,8,0,19
191203660,7,2,2,1,9,21
191203661,3,5,4,4,0,16
191203662,3,5,5,7,8,28
191203663,0,2,5,8,2,17
191203664,0,5,6,0,0,11
191203665,6,0,9,0,4,19
191203666,3,7,3,2,2,17
191203667,2,4,7,4,1,18
191203668,2,0,4,2,9,17
191203669,7,2,4,1,8,22
191203670,7,0,3,3,4,17
191203671,7,5,3,1,1,17
191203672,8,1,4,1,0,14
191203673,0,1,0,0,1,2
191203674,4,5,0,7,0,16
191203675,3,0,9,1,0,13
191203676,8,9,9,1,0,27
191203677,9,3,6,0,5,23
191203678,5,1,8,8,5,27
191203679,8,1,6,3,4,22
191203680,1,3,7,9,9,29
191203681,3,7,1,7,7,25
191203682,9,1,4,4,3,21
191203683,3,2,6,1,4,16
191203684,7,8,3,4,4,26
191203685,6,5,9,5,4,29
191203686,1,9,3,0,0,13
191203687,1,4,4,3,1,13
191203688,0,4,3,9,3,19
191203689,7,2,5,7,8,29
191203690,8,4,1,0,2,15
191203691,3,8,8,6,8,33
191203692,1,8,9,1,0,19
191203693,0,8,6,7,3,24
191203694,0,3,0,6,8,17
191203695,7,5,6,8,2,28
191203696,4,9,5,2,0,20
191203697,0,6,3,3,7,19
191203698,1,5,3,4,9,22
191203699,4,8,0,3,1,16
191203700,4,8,1,0,9,22
191203701,6,4,8,5,4,27
191203702,8,0,9,8,3,28
191203703,8,1,4,4,1,18
191203704,7,2,9,5,6,29
191203705,3,9,9,8,2,31
191203706,8,6,5,8,0,27
191203707,9,6,3,0,0,18
191203708,4,3,3,7,3,20
191203709,3,9,8,6,4,30
191203710,1,8,5,7,3,24
191203711,2,5,1,5,9,22
191203712,4,4,7,4,7,26
191203713,0,5,1,8,3,17
191203714,4,5,4,0,8,21
191203715,7,2,9,4,4,26
191203716,0,7,6,0,6,19
191203717,8,9,2,8,1,28
191203718,9,7,7,3,1,27
191203719,1,2,3,8,8,22
191203720,2,2,0,3,1,8
191203721,6,7,8,6,8,35
191203722,1,6,5,5,2,19
191203723,0,9,4,8,3,24
191203724,6,6,2,7,6,27
191203725,5,9,4,0,5,23
191203726,5,6,5,0,0,16
191203727,7,5,2,2,6,22
191203728,6,9,3,0,0,18
191203729,3,4,9,4,0,20
191203730,2,4,4,0,8,18
191203731,0,0,6,0,5,11
191203732,8,4,6,0,8,26
191203733,5,8,7,9,8,37
191203734,3,7,4,1,2,17
191203735,2,5,0,9,1,17
191203736,0,0,3,0,5,8
191203737,6,6,7,5,6,30
191203738,1,0,7,4,3,15
191203739,4,0,6,2,9,21
191203740,3,2,6,4,6,21
191203741,5,6,2,9,0,22
191203742,8,4,5,9,2,28
191203743,0,0,6,6,0,12
191203744,2,6,0,9,1,18
191203745,2,1,8,2,6,19
191203746,5,6,2,3,4,20
191203747,0,2,4,5,7,18
191203748,4,7,9,8,6,34
191203749,6,9,7,0,2,24
191203750,2,1,4,0,1,8
191203751,3,8,8,4,2,25
191203752,0,3,8,4,7,22
191203753,9,6,9,6,5,35
191203754,9,8,4,7,1,29
191203755,4,2,5,4,4,19
191203756,9,8,1,8,4,30
191203757,6,6,8,0,4,24
191203758,7,3,1,4,3,18
191203759,4,6,0,4,6,20
191203760,7,0,1,0,2,10
191203761,3,7,6,9,5,30
191203762,3,7,6,8,2,26
191203763,1,9,5,0,2,17
191203764,2,8,3,9,6,28
191203765,0,1,9,7,9,26
191203766,1,2,2,4,0,9
191203767,9,5,4,7,5,30
191203768,6,7,7,2,5,27
191203769,1,3,3,2,4,13
191203770,2,7,7,3,2,21
191203771,2,7,5,9,1,24
191203772,8,2,6,3,0,19
191203773,3,0,9,1,6,19
191203774,7,2,2,0,8,19
191203775,0,6,9,7,8,30
191203776,7,6,6,7,9,35
191203777,0,1,0,2,2,5
191203778,0,0,0,7,5,12
191203779,0,1,4,5,3,13
191203780,4,9,3,2,9,27
191203781,9,2,9,1,5,26
191203782,0,1,3,1,9,14
191203783,8,7,8,6,8,37
191203784,2,9,9,6,4,30
191203785,5,1,4,6,4,20
191203786,9,9,7,3,3,31
191203787,8,6,0,8,7,29
191203788,0,1,4,6,5,16
191203789,7,0,9,4,2,22
191203790,2,7,2,6,6,23
191203791,1,9,9,9,5,33
191203792,9,4,0,7,4,24
191203793,8,1,1,9,0,19
191203794,3,5,8,8,6,30
191203795,9,6,5,8,5,33
191203796,0,8,6,7,6,27
191203797,8,6,6,4,2,26
191203798,2,8,0,5,8,23
191203799,3,5,1,0,1,10
191203800,4,7,8,8,1,28
191203801,3,4,3,6,2,18
191203802,4,4,2,2,9,21
191203803,5,7,5,5,0,22
191203804,1,4,8,7,1,21
191203805,5,6,7,5,0,23
191203806,6,9,3,5,5,28
191203807,7,9,2,0,9,27
191203808,5,9,2,7,2,25
191203809,4,6,2,9,8,29
191203810,2,6,7,3,8,26
191203811,9,2,2,4,9,26
191203812,2,7,6,6,5,26
191203813,8,1,6,8,1,24
191203814,8,6,4,9,4,31
191203815,3,7,0,7,3,20
191203816,4,6,1,5,4,20
191203817,6,4,8,6,7,31
191203818,2,3,9,9,9,32
191203819,3,3,1,5,9,21
191203820,8,4,1,2,9,24
191203821,3,3,3,9,8,26
191203822,8,7,6,5,4,30
191203823,3,6,4,4,4,21
191203824,4,3,4,2,0,13
191203825,9,2,3,1,6,21
191203826,0,4,1,7,2,14
191203827,1,8,0,9,7,25
191203828,0,2,6,9,0,17
191203829,8,2,3,1,9,23
191203830,4,0,3,4,2,13
191203831,0,8,4,2,6,20
191203832,7,8,9,3,7,34
191203833,5,8,3,1,3,20
191203834,6,8,9,0,4,27
191203835,6,2,1,2,7,18
191203836,3,1,9,9,3,25
191203837,1,5,1,8,8,23
191203838,2,5,7,2,6,22
191203839,9,0,7,0,6,22
191203840,2,2,7,4,7,22
191203841,4,8,9,5,5,31
191203842,7,8,0,9,3,27
191203843,1,4,6,1,1,13
191203844,3,4,4,7,9,27
191203845,0,6,7,6,3,22
191203846,6,7,6,8,8,35
191203847,1,5,2,3,5,16
191203848,2,6,6,0,5,19
191203849,3,8,2,0,6,19
191203850,3,8,3,4,9,27
191203851,3,5,3,3,7,21
191203852,8,6,6,3,5,28
191203853,2,3,1,3,3,12
191203854,4,4,0,6,6,20
191203855,9,8,1,2,3,23
191203856,4,5,2,9,7,27
191203857,4,7,4,9,0,24
191203858,7,2,8,4,7,28
191203859,9,9,5,8,3,34
191203860,6,0,0,7,5,18
191203861,0,0,2,6,1,9
191203862,8,8,0,1,3,20
191203863,8,9,8,3,7,35
191203864,6,8,2,9,2,27
191203865,6,3,7,7,3,26
191203866,6,2,2,6,8,24
191203867,1,6,3,2,6,18
191203868,3,9,0,6,0,18
191203869,4,1,7,5,7,24
191203870,5,7,9,8,8,37
191203871,1,3,1,2,5,12
191203872,0,7,7,7,2,23
191203873,3,0,7,1,3,14
191203874,1,6,7,7,9,30
191203875,2,9,1,8,6,26
191203876,3,4,9,6,0,22
191203877,4,9,7,9,9,38
191203878,3,9,2,0,4,18
191203879,9,8,0,6,6,29
191203880,8,1,1,1,5,16
191203881,2,5,6,0,4,17
191203882,8,7,8,6,0,29
191203883,4,9,8,0,0,21
191203884,5,6,3,3,9,26
191203885,5,2,2,7,2,18
191203886,9,3,8,5,8,33
191203887,5,0,0,0,0,5
191203888,5,2,0,1,6,14
191203889,0,7,3,2,0,12
191203890,7,6,6,0,7,26
191203891,3,2,6,6,5,22
191203892,2,1,5,7,4,19
191203893,2,4,3,1,9,19
191203894,2,8,6,1,1,18
191203895,4,6,8,9,6,33
191203896,3,3,2,9,3,20
191203897,9,7,1,2,8,27
191203898,5,7,9,8,4,33
191203899,6,9,1,4,4,24
191203900,7,2,6,4,0,19
191203901,9,9,1,3,5,27
191203902,9,9,2,7,1,28
191203903,0,2,7,6,7,22
191203904,5,7,4,4,2,22
191203905,6,7,1,8,6,28
191203906,2,5,8,0,7,22
191203907,9,2,8,2,6,27
191203908,0,3,1,4,6,14
191203909,0,6,5,5,1,17
191203910,8,3,7,3,1,22
191203911,0,6,9,5,2,22
191203912,9,4,7,9,0,29
191203913,6,1,1,8,3,19
191203914,6,4,8,9,8,35
191203915,7,7,5,0,5,24
191203916,5,9,2,2,9,27
191203917,7,6,4,0,1,18
191203918,6,0,7,9,5,27
191203919,0,0,8,2,0,10
191203920,2,3,0,3,6,14
191203921,8,7,6,3,6,30
191203922,8,6,1,4,6,25
191203923,4,6,8,7,6,31
191203924,4,3,5,3,4,19
191203925,1,8,1,0,2,12
191203926,7,8,3,2,9,29
191203927,9,4,1,1,6,21
191203928,5,9,6,3,3,26
191203929,4,0,5,6,2,17
191203930,9,1,9,1,4,24
191203931,4,8,4,5,4,25
191203932,1,1,0,7,6,15
191203933,1,7,8,4,4,24
191203934,4,4,8,4,0,20
191203935,4,1,0,2,6,13
191203936,3,8,5,8,4,28
191203937,5,3,2,0,4,14
191203938,3,5,8,4,2,22
191203939,3,8,0,0,2,13
191203940,1,8,2,2,4,17
191203941,6,3,0,4,9,22
191203942,8,7,2,9,7,33
191203943,0,0,0,6,7,13
191203944,4,5,9,6,0,24
191203945,1,6,4,5,7,23
191203946,1,6,8,1,0,16
191203947,6,0,5,1,0,12
191203948,8,1,4,4,2,19
191203949,4,1,9,6,0,20
191203950,0,4,4,6,6,20
191203951,7,1,4,6,0,18
191203952,4,8,0,7,3,22
191203953,4,2,3,6,4,19
191203954,4,8,4,9,4,29
191203955,3,6,0,6,4,19
191203956,1,9,5,3,8,26
191203957,2,4,4,5,9,24
191203958,1,3,8,1,3,16
191203959,9,7,4,3,3,26
191203960,6,4,5,1,5,21
191203961,6,3,6,0,6,21
191203962,2,0,3,8,4,17
191203963,3,5,8,5,1,22
191203964,2,5,6,8,3,24
191203965,9,2,9,0,2,22
191203966,8,1,8,2,4,23
191203967,2,7,6,5,0,20
191203968,6,4,5,8,3,26
191203969,0,2,8,5,2,17
191203970,4,1,0,6,2,13
191203971,6,4,3,6,6,25
191203972,6,6,5,0,9,26
191203973,4,4,5,2,8,23
191203974,9,3,6,3,2,23
191203975,7,1,6,4,9,27
191203976,6,5,0,4,6,21
191203977,7,9,0,9,4,29
191203978,7,7,1,9,5,29
191203979,3,6,5,0,7,21
191203980,2,1,9,3,1,16
191203981,0,3,6,3,9,21
191203982,2,9,6,3,6,26
191203983,5,8,1,2,8,24
191203984,8,6,4,0,3,21
191203985,8,8,6,7,3,32
191203986,4,5,9,7,7,32
191203987,4,2,7,4,4,21
191203988,2,3,9,3,6,23
191203989,1,0,9,7,0,17
191203990,1,7,7,6,7,28
191203991,2,2,0,3,8,15
191203992,4,2,4,6,8,24
191203993,9,9,8,7,0,33
191203994,6,1,4,6,4,21
191203995,0,4,1,1,8,14
191203996,4,0,6,0,3,13
191203997,3,0,7,6,1,17
191203998,5,9,8,2,9,33
191203999,7,9,2,4,7,29
1912031000,7,3,7,4,5,26
1912031001,5,7,8,8,0,28
1912031002,7,9,4,9,5,34
1912031003,9,9,7,7,2,34
1912031004,2,9,9,2,9,31
1912031005,3,9,8,9,7,36
1912031006,5,4,8,7,2,26
1912031007,6,2,9,4,7,28
1912031008,4,9,0,8,1,22
1912031009,9,4,7,9,9,38
1912031010,5,4,8,2,9,28
1912031011,1,5,4,0,1,11
1912031012,6,6,8,3,0,23
1912031013,0,7,6,6,1,20
1912031014,7,6,5,1,9,28
1912031015,6,8,9,2,0,25
1912031016,0,7,5,4,5,21
1912031017,1,2,4,3,4,14
1912031018,0,0,0,1,5,6
1912031019,5,6,3,8,4,26
1912031020,3,3,1,0,7,14
1912031021,6,4,2,3,8,23
1912031022,5,1,3,0,5,14
1912031023,9,1,7,0,3,20
1912031024,4,3,0,4,2,13
1912031025,2,5,5,9,8,29
1912031026,9,7,6,3,2,27
1912031027,4,1,9,1,7,22
1912031028,3,1,7,7,6,24
1912031029,2,0,4,6,0,12
1912031030,6,1,3,9,8,27
1912031031,5,3,0,0,1,9
1912031032,0,7,0,5,1,13
1912031033,6,5,3,7,3,24
1912031034,7,1,4,4,7,23
1912031035,2,9,2,2,1,16
1912031036,7,9,2,1,5,24
1912031037,0,0,4,2,6,12
1912031038,8,6,0,2,4,20
1912031039,8,1,3,6,6,24
1912031040,5,4,5,2,8,24
1912031041,4,1,8,6,6,25
1912031042,9,5,2,5,7,28
1912031043,0,3,7,6,9,25
1912031044,5,7,6,6,8,32
1912031045,6,3,6,8,1,24
1912031046,4,3,2,7,8,24
1912031047,1,4,8,0,4,17
1912031048,6,3,7,2,4,22
1912031049,1,1,8,8,4,22
1912031050,0,7,0,2,0,9
1912031051,0,2,7,8,1,18
1912031052,8,7,0,4,8,27
1912031053,7,9,7,0,9,32
1912031054,9,9,5,2,6,31
1912031055,8,9,3,6,7,33
1912031056,3,3,8,3,2,19
1912031057,9,4,0,5,9,27
1912031058,3,2,0,9,2,16
1912031059,7,7,7,1,9,31
1912031060,6,7,3,7,1,24
1912031061,4,8,0,6,0,18
1912031062,6,3,7,2,8,26
1912031063,6,9,6,6,0,27
1912031064,3,1,9,7,1,21
1912031065,8,6,8,2,0,24
1912031066,0,3,0,8,6,17
1912031067,6,1,6,9,3,25
1912031068,2,3,2,2,8,17
1912031069,0,8,7,8,9,32
1912031070,6,0,0,3,4,13
1912031071,2,2,3,8,2,17
1912031072,3,0,6,1,7,17
1912031073,9,8,3,5,1,26
1912031074,0,0,8,6,7,21
1912031075,5,2,3,6,2,18
1912031076,7,2,6,7,0,22
1912031077,5,7,7,9,3,31
1912031078,8,4,3,8,7,30
1912031079,4,5,6,7,3,25
1912031080,4,3,4,4,7,22
1912031081,3,6,5,2,4,20
1912031082,2,0,5,5,7,19
1912031083,6,2,1,2,4,15
1912031084,0,1,8,2,6,17
1912031085,7,3,9,1,7,27
1912031086,9,6,8,6,6,35
1912031087,5,5,8,4,7,29
1912031088,5,5,5,6,9,30
1912031089,2,9,2,6,1,20
1912031090,5,1,0,4,3,13
1912031091,8,3,8,2,6,27
1912031092,3,1,2,8,9,23
1912031093,8,8,0,5,3,24
1912031094,4,1,9,5,0,19
1912031095,6,6,9,5,6,32
1912031096,8,8,0,3,9,28
1912031097,1,7,3,2,3,16
1912031098,0,8,3,9,6,26
1912031099,7,6,9,4,4,30
1912031100,8,0,9,0,4,21
1912031101,4,0,8,0,8,20
1912031102,7,7,5,9,0,28
1912031103,8,9,1,3,0,21
1912031104,8,8,0,5,5,26
1912031105,4,8,1,3,3,19
191204001,6,1,3,0,5,15
191204002,1,1,2,3,5,12
191204003,7,7,0,0,6,20
191204004,8,0,5,6,0,19
191204005,6,5,1,4,7,23
191204006,4,5,2,1,2,14
191204007,5,1,5,2,9,22
191204008,6,8,4,2,8,28
191204009,4,5,1,1,9,20
191204010,7,1,7,8,5,28
191204011,5,1,7,9,5,27
191204012,4,9,6,0,5,24
191204013,9,1,7,6,3,26
191204014,1,3,4,0,2,10
191204015,0,8,8,9,8,33
191204016,6,3,6,0,0,15
191204017,6,4,1,3,2,16
191204018,2,5,8,7,2,24
191204019,1,9,7,4,5,26
191204020,0,2,6,0,2,10
191204021,1,1,8,2,2,14
191204022,4,1,5,9,3,22
191204023,3,6,5,7,6,27
191204024,5,3,3,4,5,20
191204025,8,7,8,2,8,33
191204026,9,5,0,8,0,22
191204027,3,5,8,7,5,28
191204028,2,2,4,6,8,22
191204029,1,8,1,1,7,18
191204030,5,5,1,5,8,24
191204031,7,4,3,6,2,22
191204032,8,1,3,5,2,19
191204033,6,8,6,6,2,28
191204034,9,1,8,2,5,25
191204035,4,9,5,9,7,34
191204036,0,6,9,1,7,23
191204037,3,3,7,6,6,25
191204038,4,9,5,3,6,27
191204039,5,5,9,9,8,36
191204040,5,8,1,3,9,26
191204041,0,2,6,6,7,21
191204042,7,9,6,2,8,32
191204043,6,2,4,3,0,15
191204044,5,2,4,6,4,21
191204045,9,5,1,6,1,22
191204046,5,4,1,5,4,19
191204047,3,2,4,0,5,14
191204048,0,7,5,6,4,22
191204049,7,3,4,3,9,26
191204050,2,9,8,0,6,25
191204051,4,9,6,7,9,35
191204052,4,5,4,9,9,31
191204053,5,2,1,6,3,17
191204054,6,6,4,8,9,33
191204055,2,6,0,4,8,20
191204056,3,9,3,9,3,27
191204057,0,6,0,8,3,17
191204058,8,0,8,4,7,27
191204059,6,1,3,5,7,22
191204060,9,3,3,8,2,25
191204061,8,0,8,2,5,23
191204062,8,6,8,1,2,25
191204063,6,1,4,5,3,19
191204064,5,7,0,9,8,29
191204065,3,6,9,7,7,32
191204066,7,1,4,5,3,20
191204067,6,9,8,5,9,37
191204068,0,5,5,8,9,27
191204069,1,7,5,5,3,21
191204070,5,5,1,1,5,17
191204071,3,6,7,0,2,18
191204072,6,5,2,0,9,22
191204073,8,2,2,9,9,30
191204074,5,4,2,9,0,20
191204075,0,5,4,4,7,20
191204076,3,0,1,9,9,22
191204077,3,9,3,6,8,29
191204078,7,5,5,2,8,27
191204079,6,3,6,4,0,19
191204080,3,4,2,5,7,21
191204081,2,4,1,6,0,13
191204082,6,1,1,2,6,16
191204083,0,5,1,5,9,20
191204084,5,7,8,2,3,25
191204085,7,4,1,4,1,17
191204086,9,2,3,5,0,19
191204087,1,5,2,2,5,15
191204088,8,8,5,5,5,31
191204089,3,7,3,0,2,15
191204090,5,9,3,7,0,24
191204091,7,8,1,8,9,33
191204092,3,2,4,2,7,18
191204093,9,1,9,5,8,32
191204094,2,9,9,8,7,35
191204095,2,6,1,9,8,26
191204096,2,1,2,4,6,15
191204097,2,9,0,4,8,23
191204098,0,1,1,8,1,11
191204099,3,7,2,3,7,22
191204100,3,2,8,5,5,23
191204101,6,4,2,0,4,16
191204102,1,6,6,4,7,24
191204103,3,5,3,4,4,19
191204104,1,5,2,7,9,24
191204105,5,7,2,9,8,31
191204106,9,0,7,7,2,25
191204107,7,9,0,5,2,23
191204108,2,5,0,6,7,20
191204109,3,0,7,2,6,18
191204110,1,2,3,4,6,16
191204111,0,0,1,3,3,7
191204112,4,7,8,4,0,23
191204113,3,5,1,9,4,22
191204114,6,3,2,5,7,23
191204115,0,7,9,9,6,31
191204116,5,2,3,1,4,15
191204117,9,0,6,3,1,19
191204118,5,3,7,5,9,29
191204119,6,2,4,5,8,25
191204120,6,5,5,0,9,25
191204121,1,0,2,6,4,13
191204122,6,4,3,1,4,18
191204123,4,6,6,4,5,25
191204124,9,7,6,3,0,25
191204125,9,4,0,8,7,28
191204126,3,0,5,0,1,9
191204127,6,9,9,3,5,32
191204128,1,2,9,1,7,20
191204129,2,3,4,6,9,24
191204130,1,2,0,3,6,12
191204131,9,1,9,8,9,36
191204132,4,3,2,5,9,23
191204133,1,4,8,9,2,24
191204134,6,5,2,1,4,18
191204135,4,7,4,6,3,24
191204136,4,2,8,3,5,22
191204137,4,0,5,6,6,21
191204138,6,6,3,7,3,25
191204139,9,0,7,9,5,30
191204140,4,0,1,5,6,16
191204141,6,6,2,1,1,16
191204142,8,7,7,3,1,26
191204143,5,1,3,9,6,24
191204144,4,2,6,0,2,14
191204145,8,1,8,6,6,29
191204146,6,8,9,6,2,31
191204147,6,7,2,9,3,27
191204148,9,8,4,3,1,25
191204149,3,2,9,0,7,21
191204150,7,7,2,6,1,23
191204151,7,9,6,2,7,31
191204152,0,7,7,5,8,27
191204153,0,3,4,1,1,9
191204154,9,0,4,0,4,17
191204155,4,6,4,2,0,16
191204156,7,8,6,1,5,27
191204157,3,8,2,5,7,25
191204158,6,8,7,4,8,33
191204159,5,9,2,7,7,30
191204160,2,0,7,7,0,16
191204161,4,2,1,0,9,16
191204162,6,5,3,0,8,22
191204163,4,2,1,2,2,11
191204164,7,6,7,8,5,33
191204165,1,3,9,3,6,22
191204166,1,5,9,1,2,18
191204167,0,9,1,7,2,19
191204168,7,4,8,6,8,33
191204169,1,1,5,3,0,10
191204170,8,5,7,4,7,31
191204171,0,8,0,3,2,13
191204172,1,6,5,0,0,12
191204173,9,1,3,4,6,23
191204174,9,9,1,4,1,24
191204175,4,4,8,3,7,26
191204176,4,6,9,5,4,28
191204177,8,0,4,4,0,16
191204178,3,8,6,4,6,27
191204179,6,2,3,9,2,22
191204180,7,3,3,8,2,23
191204181,8,9,4,6,9,36
191204182,3,9,2,9,1,24
191204183,2,1,3,8,8,22
191204184,6,6,4,8,5,29
191204185,8,3,4,1,5,21
191204186,2,7,1,5,9,24
191204187,0,4,4,8,8,24
191204188,2,5,9,1,7,24
191204189,5,7,8,8,5,33
191204190,4,7,0,1,7,19
191204191,5,0,0,5,5,15
191204192,8,2,4,8,3,25
191204193,4,2,9,9,9,33
191204194,5,7,3,4,6,25
191204195,8,5,2,8,8,31
191204196,8,2,2,3,3,18
191204197,6,4,6,2,9,27
191204198,1,2,8,9,5,25
191204199,7,4,4,8,1,24
191204200,9,4,2,9,9,33
191204201,8,9,5,6,6,34
191204202,5,8,5,3,3,24
191204203,1,0,8,5,4,18
191204204,8,2,4,2,9,25
191204205,5,5,5,6,0,21
191204206,4,9,6,2,1,22
191204207,1,1,8,0,3,13
191204208,8,3,9,2,6,28
191204209,3,4,5,5,5,22
191204210,2,1,1,4,0,8
191204211,5,1,3,9,3,21
191204212,9,7,4,1,1,22
191204213,0,0,0,2,2,4
191204214,9,2,5,4,5,25
191204215,7,8,1,8,2,26
191204216,1,5,3,8,6,23
191204217,4,2,3,1,0,10
191204218,9,9,0,9,8,35
191204219,4,8,7,9,7,35
191204220,4,1,3,0,8,16
191204221,3,3,1,0,1,8
191204222,3,9,0,4,6,22
191204223,7,1,7,1,9,25
191204224,6,6,1,1,9,23
191204225,2,3,2,6,2,15
191204226,4,0,6,9,4,23
191204227,1,8,8,7,1,25
191204228,6,3,2,9,5,25
191204229,4,5,2,6,4,21
191204230,9,2,2,3,6,22
191204231,0,4,1,1,2,8
191204232,6,1,6,3,5,21
191204233,4,8,5,5,7,29
191204234,0,2,7,0,1,10
191204235,5,3,7,0,5,20
191204236,0,9,9,9,4,31
191204237,7,9,3,5,6,30
191204238,5,7,5,3,7,27
191204239,2,0,5,5,5,17
191204240,1,9,3,7,0,20
191204241,3,3,2,5,5,18
191204242,3,5,2,5,8,23
191204243,7,4,0,7,4,22
191204244,2,1,0,4,1,8
191204245,9,4,4,9,8,34
191204246,0,7,9,1,4,21
191204247,9,6,3,8,7,33
191204248,6,7,6,7,9,35
191204249,4,7,3,7,7,28
191204250,2,7,8,4,5,26
191204251,2,6,0,7,0,15
191204252,5,0,7,2,5,19
191204253,8,9,8,0,8,33
191204254,9,2,9,9,5,34
191204255,4,6,7,1,8,26
191204256,0,4,3,6,4,17
191204257,6,3,7,5,4,25
191204258,2,7,2,9,8,28
191204259,0,1,2,6,0,9
191204260,3,4,0,4,8,19
191204261,6,0,2,3,7,18
191204262,5,1,6,3,9,24
191204263,8,7,5,0,8,28
191204264,8,3,2,8,3,24
191204265,6,4,6,9,5,30
191204266,5,9,7,2,3,26
191204267,0,8,0,0,5,13
191204268,5,1,7,1,8,22
191204269,8,6,7,4,0,25
191204270,5,3,3,7,9,27
191204271,4,5,4,7,2,22
191204272,6,1,1,7,3,18
191204273,6,3,8,3,8,28
191204274,9,1,5,3,5,23
191204275,4,0,4,1,5,14
191204276,1,4,4,3,5,17
191204277,3,6,7,2,5,23
191204278,0,0,0,1,6,7
191204279,9,5,9,1,9,33
191204280,3,5,6,6,6,26
191204281,9,2,8,5,8,32
191204282,8,6,5,1,0,20
191204283,8,2,4,0,5,19
191204284,0,0,6,2,7,15
191204285,3,5,2,4,9,23
191204286,4,6,2,7,0,19
191204287,5,5,5,6,8,29
191204288,2,7,2,7,8,26
191204289,4,0,0,7,7,18
191204290,4,6,8,0,7,25
191204291,1,1,2,9,9,22
191204292,9,7,2,0,5,23
191204293,4,8,6,0,9,27
191204294,6,1,1,1,5,14
191204295,2,3,1,4,8,18
191204296,1,6,8,7,5,27
191204297,9,8,3,1,6,27
191204298,1,5,0,1,0,7
191204299,1,8,1,2,9,21
191204300,1,3,4,8,4,20
191204301,1,1,4,8,7,21
191204302,7,2,5,1,9,24
191204303,2,1,4,1,1,9
191204304,5,0,8,8,0,21
191204305,5,5,1,8,4,23
191204306,4,9,0,6,5,24
191204307,8,0,3,9,9,29
191204308,9,8,4,0,4,25
191204309,7,0,6,4,7,24
191204310,6,2,2,9,8,27
191204311,1,5,2,5,4,17
191204312,9,0,7,6,2,24
191204313,5,5,7,4,0,21
191204314,2,2,4,1,1,10
191204315,9,2,6,9,4,30
191204316,2,7,6,6,9,30
191204317,8,1,9,7,9,34
191204318,8,5,6,4,6,29
191204319,7,7,1,5,2,22
191204320,8,0,6,3,9,26
191204321,2,0,5,8,7,22
191204322,4,7,3,6,8,28
191204323,5,7,2,6,8,28
191204324,9,4,6,4,6,29
191204325,7,5,4,7,4,27
191204326,0,8,1,9,3,21
191204327,7,8,8,2,3,28
191204328,6,4,4,0,3,17
191204329,1,1,2,5,2,11
191204330,0,3,6,4,2,15
191204331,4,3,4,0,8,19
191204332,7,1,6,7,9,30
191204333,7,2,1,2,4,16
191204334,5,0,9,4,8,26
191204335,9,5,7,3,7,31
191204336,9,1,9,2,9,30
191204337,8,8,5,4,9,34
191204338,1,2,6,3,9,21
191204339,9,7,6,7,4,33
191204340,6,0,4,2,0,12
191204341,9,7,7,9,5,37
191204342,4,2,9,7,8,30
191204343,4,3,9,9,3,28
191204344,1,5,4,4,5,19
191204345,7,5,8,6,8,34
191204346,5,0,5,3,5,18
191204347,2,9,9,2,0,22
191204348,9,1,5,3,0,18
191204349,8,0,1,2,9,20
191204350,0,1,7,6,0,14
191204351,5,2,0,1,1,9
191204352,7,4,5,4,4,24
191204353,1,7,9,9,5,31
191204354,5,0,7,1,7,20
191204355,8,5,3,2,8,26
191204356,7,7,3,6,4,27
191204357,0,1,7,7,6,21
191204358,0,7,2,5,8,22
191204359,2,3,3,4,4,16
191204360,7,0,9,6,6,28
191204361,7,6,4,2,2,21
191204362,2,9,5,4,6,26
191204363,3,5,3,2,2,15
191204364,2,0,9,5,8,24
191204365,2,3,6,3,0,14
191204366,8,7,0,9,2,26
191204367,6,6,7,3,7,29
191204368,8,6,1,5,7,27
191204369,3,0,1,8,8,20
191204370,4,0,9,4,8,25
191204371,5,4,8,4,8,29
191204372,8,6,9,8,3,34
191204373,4,3,6,4,0,17
191204374,0,1,4,3,6,14
191204375,1,2,9,5,4,21
191204376,9,0,6,2,3,20
191204377,8,3,1,4,9,25
191204378,6,1,0,4,4,15
191204379,2,6,9,4,9,30
191204380,2,4,8,7,2,23
191204381,8,7,6,8,3,32
191204382,7,8,5,2,0,22
191204383,1,5,4,8,4,22
191204384,3,6,5,0,2,16
191204385,3,7,7,1,0,18
191204386,1,5,7,6,2,21
191204387,7,6,7,9,5,34
191204388,0,0,2,7,7,16
191204389,8,7,8,2,0,25
191204390,6,9,0,6,0,21
191204391,7,2,7,6,4,26
191204392,8,4,6,4,7,29
191204393,5,0,9,6,3,23
191204394,5,7,2,3,5,22
191204395,0,6,3,2,7,18
191204396,8,6,7,2,5,28
191204397,6,1,4,4,4,19
191204398,9,8,6,6,8,37
191204399,7,1,8,4,6,26
191204400,7,8,7,5,7,34
191204401,2,0,6,2,6,16
191204402,7,4,4,9,9,33
191204403,6,7,1,6,0,20
191204404,1,0,2,8,8,19
191204405,5,2,3,7,9,26
191204406,6,6,8,1,2,23
191204407,9,5,2,0,1,17
191204408,9,2,8,6,1,26
191204409,6,0,5,4,2,17
191204410,8,1,0,8,9,26
191204411,7,6,6,9,8,36
191204412,4,7,7,2,9,29
191204413,6,9,7,7,0,29
191204414,0,7,7,3,0,17
191204415,5,6,4,7,2,24
191204416,2,8,8,1,5,24
191204417,0,9,5,7,7,28
191204418,0,4,3,8,3,18
191204419,9,1,4,1,8,23
191204420,8,5,6,5,2,26
191204421,5,6,2,6,5,24
191204422,6,8,1,3,3,21
191204423,4,0,8,6,5,23
191204424,4,8,0,0,0,12
191204425,9,1,7,4,0,21
191204426,1,5,3,4,2,15
191204427,5,7,8,0,7,27
191204428,2,0,6,2,5,15
191204429,4,6,0,3,1,14
191204430,6,8,4,0,3,21
191204431,2,7,6,4,9,28
191204432,5,7,6,6,2,26
191204433,8,2,1,9,6,26
191204434,3,7,1,6,6,23
191204435,1,5,9,0,3,18
191204436,3,1,2,9,0,15
191204437,3,6,4,5,1,19
191204438,1,9,2,9,7,28
191204439,3,7,9,5,7,31
191204440,4,1,4,6,8,23
191204441,9,1,1,1,2,14
191204442,0,0,0,8,3,11
191204443,7,5,4,2,2,20
191204444,6,8,4,3,0,21
191204445,1,0,2,0,5,8
191204446,2,6,1,1,4,14
191204447,6,3,6,0,3,18
191204448,3,4,6,7,4,24
191204449,0,2,5,9,9,25
191204450,1,0,3,1,2,7
191204451,2,9,0,8,5,24
191204452,9,3,6,0,3,21
191204453,9,1,2,8,5,25
191204454,5,5,6,9,4,29
191204455,9,1,5,8,3,26
191204456,5,7,8,6,5,31
191204457,1,9,7,2,2,21
191204458,2,2,0,7,8,19
191204459,2,5,3,1,8,19
191204460,7,8,2,5,7,29
191204461,7,2,4,6,4,23
191204462,6,1,6,0,9,22
191204463,2,8,5,9,9,33
191204464,5,0,6,8,4,23
191204465,9,8,4,7,5,33
191204466,4,7,7,8,3,29
191204467,9,4,0,0,3,16
191204468,6,5,0,0,4,15
191204469,9,5,5,9,1,29
191204470,2,6,7,1,7,23
191204471,1,6,9,9,0,25
191204472,9,3,6,3,7,28
191204473,7,5,7,7,4,30
191204474,8,0,8,2,9,27
191204475,3,4,4,9,0,20
191204476,0,8,8,3,2,21
191204477,8,6,8,3,5,30
191204478,3,7,4,3,9,26
191204479,8,2,7,5,2,24
191204480,3,7,2,1,0,13
191204481,0,1,2,1,7,11
191204482,3,1,7,3,0,14
191204483,1,8,5,4,2,20
191204484,4,7,6,8,7,32
191204485,1,0,2,9,9,21
191204486,5,1,3,4,7,20
191204487,6,8,3,0,8,25
191204488,4,9,6,5,1,25
191204489,2,6,4,5,0,17
191204490,0,6,1,3,4,14
191204491,1,2,9,7,7,26
191204492,3,9,6,8,0,26
191204493,0,6,5,9,6,26
191204494,5,8,0,0,2,15
191204495,1,8,5,7,8,29
191204496,4,1,0,2,8,15
191204497,1,7,7,6,0,21
191204498,1,8,7,6,6,28
191204499,3,1,4,6,3,17
191204500,5,5,6,0,2,18
191204501,9,4,6,2,0,21
191204502,9,6,1,4,3,23
191204503,9,7,6,7,7,36
191204504,0,5,3,5,6,19
191204505,4,4,7,2,2,19
191204506,3,7,4,0,7,21
191204507,9,8,9,8,7,41
191204508,1,2,1,9,5,18
191204509,5,8,9,1,1,24
191204510,0,1,0,8,7,16
191204511,8,4,8,5,7,32
191204512,0,1,5,6,1,13
191204513,8,7,6,8,9,38
191204514,9,0,5,0,4,18
191204515,2,6,8,1,9,26
191204516,2,3,9,1,3,18
191204517,1,8,7,6,0,22
191204518,5,6,0,7,8,26
191204519,3,5,7,4,3,22
191204520,6,1,6,7,7,27
191204521,2,4,6,6,8,26
191204522,5,3,0,7,6,21
191204523,3,2,4,2,0,11
191204524,2,7,2,3,8,22
191204525,3,0,9,5,2,19
191204526,5,8,2,4,4,23
191204527,2,5,6,8,2,23
191204528,8,6,4,3,2,23
191204529,7,7,4,6,0,24
191204530,3,9,3,9,9,33
191204531,9,2,7,2,3,23
191204532,0,8,8,7,0,23
191204533,5,4,8,8,2,27
191204534,7,0,0,8,6,21
191204535,2,7,2,4,5,20
191204536,5,8,7,3,0,23
191204537,8,5,7,6,5,31
191204538,4,9,9,8,4,34
191204539,4,1,5,0,7,17
191204540,4,4,0,5,0,13
191204541,4,4,3,7,4,22
191204542,1,7,1,2,9,20
191204543,0,1,0,6,6,13
191204544,5,7,1,9,3,25
191204545,6,6,4,5,9,30
191204546,6,7,2,5,2,22
191204547,8,4,7,6,4,29
191204548,6,5,5,8,9,33
191204549,4,5,3,0,4,16
191204550,8,8,6,5,3,30
191204551,4,4,7,3,0,18
191204552,5,9,7,4,9,34
191204553,2,3,3,8,7,23
191204554,9,6,2,0,8,25
191204555,4,3,6,8,7,28
191204556,1,2,7,9,0,19
191204557,4,4,6,3,2,19
191204558,8,0,5,9,3,25
191204559,5,3,2,8,2,20
191204560,8,5,9,4,2,28
191204561,7,0,4,5,5,21
191204562,8,2,8,5,3,26
191204563,1,5,9,7,5,27
191204564,9,4,9,2,1,25
191204565,6,5,3,0,9,23
191204566,3,2,5,0,8,18
191204567,5,7,7,1,9,29
191204568,1,2,7,2,4,16
191204569,2,8,9,7,2,28
191204570,1,2,9,3,1,16
191204571,6,4,2,8,1,21
191204572,4,9,5,1,7,26
191204573,4,1,1,5,8,19
191204574,2,3,5,0,8,18
191204575,7,5,8,8,0,28
191204576,6,5,7,7,1,26
191204577,6,5,6,5,9,31
191204578,5,2,4,5,5,21
191204579,0,7,4,8,4,23
191204580,9,8,1,9,5,32
191204581,7,5,3,8,0,23
191204582,6,3,8,3,4,24
191204583,6,5,5,1,0,17
191204584,8,6,0,1,3,18
191204585,7,0,7,4,7,25
191204586,3,6,4,1,9,23
191204587,1,9,6,5,2,23
191204588,0,4,1,5,1,11
191204589,9,8,0,3,8,28
191204590,1,6,4,9,7,27
191204591,6,1,0,6,3,16
191204592,6,2,0,0,7,15
191204593,4,3,9,3,0,19
191204594,0,5,3,4,0,12
191204595,2,2,0,9,1,14
191204596,4,2,3,5,4,18
191204597,7,2,8,4,9,30
191204598,7,1,1,2,3,14
191204599,5,7,6,9,5,32
191204600,4,6,9,8,9,36
191204601,9,4,4,6,7,30
191204602,0,9,7,6,4,26
191204603,0,9,3,4,0,16
191204604,9,3,4,7,6,29
191204605,0,9,3,6,2,20
191204606,7,5,4,5,7,28
191204607,8,4,8,2,7,29
191204608,4,7,3,8,8,30
191204609,2,6,8,1,4,21
191204610,3,1,1,9,2,16
191204611,0,4,3,4,5,16
191204612,3,5,3,5,0,16
191204613,1,5,8,5,3,22
191204614,7,9,2,6,6,30
191204615,2,6,1,0,7,16
191204616,8,3,3,2,6,22
191204617,6,5,7,6,6,30
191204618,1,5,2,1,0,9
191204619,2,1,0,6,0,9
191204620,5,7,4,9,7,32
191204621,6,2,2,7,8,25
191204622,0,9,3,5,4,21
191204623,7,3,2,8,3,23
191204624,8,8,1,2,9,28
191204625,6,4,9,0,7,26
191204626,9,8,2,8,6,33
191204627,2,4,9,9,4,28
191204628,1,2,2,4,8,17
191204629,8,5,8,4,7,32
191204630,9,0,3,4,3,19
191204631,8,1,2,8,6,25
191204632,2,0,4,8,8,22
191204633,1,2,5,6,2,16
191204634,5,6,7,3,9,30
191204635,5,0,6,3,7,21
191204636,2,9,1,0,0,12
191204637,3,5,4,4,1,17
191204638,9,4,0,3,4,20
191204639,9,1,5,8,8,31
191204640,2,5,5,0,9,21
191204641,7,1,7,7,1,23
191204642,2,4,2,4,9,21
191204643,1,2,7,3,9,22
191204644,2,8,0,5,7,22
191204645,0,8,8,3,6,25
191204646,1,6,8,6,8,29
191204647,6,1,1,7,4,19
191204648,4,1,1,6,3,15
191204649,9,2,0,9,1,21
191204650,5,3,5,0,0,13
191204651,2,7,2,4,2,17
191204652,5,4,8,3,0,20
191204653,8,3,3,2,7,23
191204654,1,4,4,5,1,15
191204655,3,8,0,3,7,21
191204656,2,5,0,5,0,12
191204657,4,0,5,3,8,20
191204658,2,3,5,1,7,18
191204659,6,9,3,9,6,33
191204660,6,6,6,7,0,25
191204661,0,5,1,4,3,13
191204662,4,4,3,1,4,16
191204663,8,0,1,8,9,26
191204664,0,0,4,4,4,12
191204665,2,8,7,1,2,20
191204666,5,6,3,4,8,26
191204667,0,0,4,3,9,16
191204668,8,6,1,7,1,23
191204669,0,0,3,4,6,13
191204670,6,4,7,4,5,26
191204671,2,7,4,0,9,22
191204672,8,6,7,5,4,30
191204673,1,2,1,9,7,20
191204674,1,5,3,6,2,17
191204675,8,1,1,5,7,22
191204676,3,7,1,1,0,12
191204677,0,3,9,0,0,12
191204678,9,0,4,9,6,28
191204679,9,9,9,4,4,35
191204680,5,1,1,0,5,12
191204681,3,3,4,2,1,13
191204682,6,4,9,5,2,26
191204683,5,8,0,2,2,17
191204684,7,1,1,1,1,11
191204685,2,4,3,0,3,12
191204686,0,1,6,9,5,21
191204687,4,5,7,6,7,29
191204688,7,9,2,2,8,28
191204689,3,2,0,7,0,12
191204690,7,7,2,8,0,24
191204691,1,9,9,8,1,28
191204692,8,2,7,4,9,30
191204693,1,2,8,1,7,19
191204694,5,3,7,2,6,23
191204695,1,3,9,0,8,21
191204696,2,4,8,7,4,25
191204697,2,9,2,8,5,26
191204698,3,3,5,7,2,20
191204699,7,8,1,6,5,27
191204700,7,7,7,7,8,36
191204701,8,5,6,5,7,31
191204702,4,0,3,8,2,17
191204703,5,3,8,1,6,23
191204704,2,0,1,8,8,19
191204705,3,3,5,6,9,26
191204706,5,8,9,0,6,28
191204707,4,9,2,4,6,25
191204708,6,6,6,4,7,29
191204709,7,8,6,4,9,34
191204710,7,7,7,5,5,31
191204711,9,9,1,8,8,35
191204712,3,2,6,3,5,19
191204713,6,9,5,7,8,35
191204714,6,1,6,8,8,29
191204715,6,3,7,3,9,28
191204716,4,2,1,8,4,19
191204717,3,3,3,9,9,27
191204718,5,3,7,3,6,24
191204719,0,1,0,0,8,9
191204720,6,4,2,3,2,17
191204721,1,9,0,0,0,10
191204722,0,6,4,4,4,18
191204723,6,9,8,0,0,23
191204724,6,8,7,9,0,30
191204725,2,2,7,6,3,20
191204726,4,8,9,2,5,28
191204727,2,3,0,6,1,12
191204728,9,0,9,2,1,21
191204729,0,3,5,7,5,20
191204730,1,8,2,0,6,17
191204731,9,2,2,9,2,24
191204732,4,4,3,4,1,16
191204733,7,3,8,8,7,33
191204734,1,9,8,3,9,30
191204735,0,8,3,7,6,24
191204736,4,1,2,7,6,20
191204737,5,4,7,9,0,25
191204738,1,3,4,9,4,21
191204739,3,0,2,0,5,10
191204740,9,4,4,4,7,28
191204741,9,9,2,6,8,34
191204742,4,2,2,6,3,17
191204743,3,0,4,0,8,15
191204744,9,4,5,3,6,27
191204745,1,9,0,3,3,16
191204746,6,5,7,5,6,29
191204747,5,1,4,3,7,20
191204748,6,0,5,1,8,20
191204749,5,7,3,5,1,21
191204750,7,0,8,7,7,29
191204751,9,9,6,5,2,31
191204752,2,4,0,6,2,14
191204753,8,7,1,7,1,24
191204754,9,8,1,9,3,30
191204755,0,4,6,2,9,21
191204756,2,3,2,3,6,16
191204757,2,6,4,3,5,20
191204758,6,1,7,6,4,24
191204759,4,0,0,6,9,19
191204760,2,9,2,2,5,20
191204761,5,2,4,0,8,19
191204762,7,8,5,1,6,27
191204763,8,2,5,8,7,30
191204764,1,0,4,4,9,18
191204765,4,8,6,8,1,27
191204766,8,2,7,5,9,31
191204767,2,1,0,5,0,8
191204768,8,0,4,2,3,17
191204769,8,5,6,5,0,24
191204770,7,6,8,5,1,27
191204771,7,3,3,8,7,28
191204772,9,0,1,1,9,20
191204773,1,0,9,8,7,25
191204774,3,5,9,2,2,21
191204775,7,5,9,6,4,31
191204776,1,1,4,8,0,14
191204777,9,7,6,2,6,30
191204778,2,7,6,6,3,24
191204779,1,7,5,6,2,21
191204780,2,9,7,3,8,29
191204781,8,8,3,2,2,23
191204782,8,7,2,7,3,27
191204783,0,1,5,7,6,19
191204784,4,1,2,1,4,12
191204785,1,3,5,0,4,13
191204786,6,4,7,0,0,17
191204787,1,1,8,7,6,23
191204788,0,5,8,7,2,22
191204789,6,4,5,9,7,31
191204790,6,1,9,4,4,24
191204791,0,2,0,0,4,6
191204792,2,6,6,9,5,28
191204793,5,9,8,3,7,32
191204794,1,9,3,3,5,21
191204795,9,9,8,7,2,35
191204796,2,5,7,2,8,24
191204797,7,9,3,9,9,37
191204798,1,4,6,6,0,17
191204799,9,9,1,0,6,25
191204800,8,5,0,9,6,28
191204801,1,2,3,5,5,16
191204802,5,7,2,6,6,26
191204803,3,9,9,9,3,33
191204804,1,0,4,0,6,11
191204805,1,5,4,3,2,15
191204806,3,1,5,3,3,15
191204807,7,2,4,4,6,23
191204808,6,2,8,3,7,26
191204809,5,4,5,3,6,23
191204810,4,2,8,5,9,28
191204811,3,5,9,3,4,24
191204812,6,4,2,3,4,19
191204813,0,8,4,7,4,23
191204814,6,1,3,4,5,19
191204815,4,7,9,7,2,29
191204816,7,6,9,3,1,26
191204817,7,1,2,2,1,13
191204818,8,6,7,6,1,28
191204819,6,4,8,3,4,25
191204820,4,8,6,8,8,34
191204821,5,3,4,5,6,23
191204822,9,4,8,1,1,23
191204823,6,2,7,1,6,22
191204824,4,9,1,1,4,19
191204825,5,2,8,2,3,20
191204826,8,2,2,5,9,26
191204827,6,6,9,3,3,27
191204828,6,0,4,3,6,19
191204829,6,5,3,1,0,15
191204830,5,9,5,9,4,32
191204831,2,2,0,0,0,4
191204832,5,3,8,9,2,27
191204833,6,3,4,5,5,23
191204834,6,1,1,3,8,19
191204835,2,2,8,5,1,18
191204836,7,2,0,5,2,16
191204837,8,6,7,2,2,25
191204838,8,7,7,9,2,33
191204839,9,3,2,8,7,29
191204840,1,2,1,1,1,6
191204841,9,9,4,2,4,28
191204842,0,5,2,6,2,15
191204843,8,2,4,6,1,21
191204844,4,9,1,2,2,18
191204845,0,3,1,7,8,19
191204846,1,1,3,9,5,19
191204847,5,5,9,3,6,28
191204848,1,3,3,4,8,19
191204849,9,9,3,1,0,22
191204850,9,6,1,3,6,25
191204851,1,3,2,0,1,7
191204852,1,9,0,4,0,14
191204853,9,4,4,9,2,28
191204854,1,9,6,3,3,22
191204855,1,5,9,6,9,30
191204856,0,8,4,1,6,19
191204857,9,7,1,9,7,33
191204858,8,8,4,4,9,33
191204859,5,1,3,8,9,26
191204860,0,6,0,5,7,18
191204861,6,2,4,6,5,23
191204862,9,7,4,4,5,29
191204863,6,9,7,5,1,28
191204864,5,5,8,2,6,26
191204865,6,9,9,6,0,30
191204866,9,2,6,6,3,26
191204867,5,6,4,0,6,21
191204868,3,9,5,4,1,22
191204869,6,0,0,2,0,8
191204870,9,5,4,4,0,22
191204871,3,5,8,6,7,29
191204872,8,3,2,2,1,16
191204873,1,4,3,1,9,18
191204874,8,7,3,8,5,31
191204875,7,0,8,6,5,26
191204876,2,1,1,8,6,18
191204877,7,1,5,5,2,20
191204878,5,7,1,1,8,22
191204879,0,5,4,4,0,13
191204880,7,9,4,7,7,34
191204881,8,1,9,4,6,28
191204882,9,4,6,6,1,26
191204883,0,1,2,1,9,13
191204884,9,3,0,5,7,24
191204885,6,6,7,8,0,27
191204886,6,2,9,9,9,35
191204887,1,2,4,2,7,16
191204888,2,2,2,7,3,16
191204889,0,5,0,7,1,13
191204890,8,3,1,0,2,14
191204891,2,3,7,1,0,13
191204892,4,3,5,7,9,28
191204893,1,4,7,0,7,19
191204894,9,5,7,5,8,34
191204895,5,7,8,7,0,27
191204896,6,7,1,0,6,20
191204897,7,7,8,7,3,32
191204898,5,0,7,0,2,14
191204899,1,3,4,5,5,18
191204900,7,1,9,1,4,22
191204901,1,1,8,3,1,14
191204902,0,6,6,0,0,12
191204903,1,8,1,3,6,19
191204904,7,7,5,4,9,32
191204905,9,2,0,4,3,18
191204906,6,2,2,8,9,27
191204907,5,6,1,0,6,18
191204908,7,7,4,2,1,21
191204909,4,8,8,7,8,35
191204910,0,8,4,5,6,23
191204911,9,6,0,3,5,23
191204912,8,2,6,5,4,25
191204913,0,4,5,1,3,13
191204914,6,5,5,7,0,23
191204915,4,9,7,2,1,23
191204916,5,4,1,0,8,18
191204917,2,9,7,3,5,26
191204918,6,9,9,6,9,39
191204919,1,6,4,7,7,25
191204920,9,1,4,9,0,23
191204921,0,2,2,0,3,7
191204922,4,6,0,4,0,14
191204923,3,9,4,7,5,28
191204924,4,9,7,3,2,25
191204925,5,6,3,8,7,29
191204926,4,4,8,3,4,23
191204927,3,1,4,4,8,20
191204928,0,8,1,7,4,20
191204929,4,1,5,6,4,20
191204930,4,8,7,0,6,25
191204931,0,3,3,7,6,19
191204932,8,9,1,7,8,33
191204933,9,1,8,3,2,23
191204934,3,7,3,9,1,23
191204935,8,6,6,5,8,33
191204936,5,6,7,3,8,29
191204937,9,2,6,8,9,34
191204938,8,3,8,4,7,30
191204939,4,4,1,2,7,18
191204940,2,4,9,4,3,22
191204941,0,9,1,3,5,18
191204942,3,3,9,8,2,25
191204943,5,7,6,8,9,35
191204944,7,4,3,3,9,26
191204945,9,2,2,9,9,31
191204946,8,5,7,9,0,29
191204947,7,0,3,8,3,21
191204948,9,9,3,5,0,26
191204949,4,3,2,8,7,24
191204950,4,6,8,3,9,30
191204951,9,6,8,4,3,30
191204952,9,4,7,1,3,24
191204953,2,5,4,6,2,19
191204954,6,8,2,2,8,26
191204955,0,8,6,9,4,27
191204956,9,3,0,3,2,17
191204957,8,7,6,9,5,35
191204958,3,7,9,5,5,29
191204959,3,4,8,5,7,27
191204960,9,3,5,0,1,18
191204961,3,9,1,5,5,23
191204962,8,9,1,3,1,22
191204963,0,8,3,3,2,16
191204964,7,4,8,5,8,32
191204965,3,5,0,9,0,17
191204966,3,5,6,6,7,27
191204967,7,5,4,9,5,30
191204968,8,0,9,6,3,26
191204969,2,8,4,5,1,20
191204970,5,9,1,7,9,31
191204971,2,1,9,0,8,20
191204972,1,1,4,2,1,9
191204973,9,3,5,8,9,34
191204974,7,8,7,7,9,38
191204975,4,1,9,3,8,25
191204976,8,3,7,8,6,32
191204977,6,0,8,0,7,21
191204978,2,3,0,9,6,20
191204979,6,8,2,1,4,21
191204980,7,1,3,9,3,23
191204981,1,3,0,8,6,18
191204982,4,0,9,8,8,29
191204983,5,8,7,8,0,28
191204984,0,8,0,5,5,18
191204985,8,1,4,7,5,25
191204986,8,3,0,2,5,18
191204987,6,2,8,3,2,21
191204988,9,6,4,6,3,28
191204989,6,3,9,2,3,23
191204990,0,1,6,3,6,16
191204991,8,1,8,2,1,20
191204992,1,0,1,2,4,8
191204993,1,4,1,2,3,11
191204994,7,0,8,3,0,18
191204995,3,2,7,1,4,17
191204996,6,0,4,3,0,13
191204997,1,2,5,7,5,20
191204998,2,3,8,0,8,21
191204999,3,6,9,1,1,20
1912041000,1,7,8,9,7,32
1912041001,6,4,9,5,7,31
1912041002,9,3,3,0,3,18
1912041003,8,3,5,1,2,19
1912041004,7,3,1,6,5,22
1912041005,0,4,3,2,8,17
1912041006,3,3,4,9,7,26
1912041007,6,9,9,0,1,25
1912041008,5,3,0,5,1,14
1912041009,2,7,8,1,7,25
1912041010,9,2,3,1,2,17
1912041011,1,0,5,8,3,17
1912041012,4,0,5,1,7,17
1912041013,9,9,2,0,6,26
1912041014,4,0,8,9,9,30
1912041015,7,2,0,8,2,19
1912041016,0,4,5,7,7,23
1912041017,7,0,0,1,7,15
1912041018,8,2,2,5,7,24
1912041019,9,3,8,7,3,30
1912041020,5,4,0,5,5,19
1912041021,9,3,6,7,5,30
1912041022,7,2,1,1,0,11
1912041023,2,5,7,7,2,23
1912041024,2,8,1,6,8,25
1912041025,3,2,7,6,6,24
1912041026,3,3,7,3,6,22
1912041027,4,7,8,3,8,30
1912041028,3,9,3,4,2,21
1912041029,1,1,9,1,0,12
1912041030,9,1,0,9,8,27
1912041031,7,9,6,8,0,30
1912041032,1,1,6,2,5,15
1912041033,5,8,5,8,4,30
1912041034,8,9,6,5,2,30
1912041035,5,6,0,3,6,20
1912041036,6,4,7,8,9,34
1912041037,3,3,2,3,5,16
1912041038,0,2,0,8,7,17
1912041039,0,8,4,8,6,26
1912041040,1,6,5,3,5,20
1912041041,0,9,5,5,2,21
1912041042,1,2,0,3,0,6
1912041043,8,8,7,1,6,30
1912041044,0,5,6,6,7,24
1912041045,3,7,2,0,3,15
1912041046,7,1,4,2,8,22
1912041047,8,0,0,4,8,20
1912041048,2,9,9,4,2,26
1912041049,3,8,6,8,7,32
1912041050,5,0,5,0,1,11
1912041051,0,6,9,9,1,25
1912041052,5,3,1,1,4,14
1912041053,5,5,8,9,4,31
1912041054,0,0,4,9,6,19
1912041055,7,5,8,6,9,35
1912041056,3,4,9,3,5,24
1912041057,6,4,4,4,2,20
1912041058,8,6,4,0,6,24
1912041059,0,3,8,3,6,20
1912041060,3,3,9,7,1,23
1912041061,1,0,0,1,0,2
1912041062,5,7,4,2,5,23
1912041063,4,8,3,9,6,30
1912041064,7,8,6,7,3,31
1912041065,3,4,7,8,0,22
1912041066,6,3,6,7,0,22
1912041067,4,0,5,7,1,17
1912041068,5,1,3,3,0,12
1912041069,8,8,6,7,9,38
1912041070,6,8,5,0,0,19
1912041071,7,1,3,2,2,15
1912041072,3,0,9,8,6,26
1912041073,4,3,9,6,3,25
1912041074,7,3,1,1,5,17
1912041075,9,3,5,9,0,26
1912041076,7,3,3,9,9,31
1912041077,7,2,1,8,6,24
1912041078,6,2,9,7,2,26
1912041079,1,6,3,6,8,24
1912041080,6,5,3,1,7,22
1912041081,3,3,6,3,2,17
1912041082,9,0,0,2,7,18
1912041083,6,0,2,5,4,17
1912041084,8,7,3,9,1,28
1912041085,4,2,1,0,2,9
1912041086,1,3,0,4,7,15
1912041087,1,7,5,4,4,21
1912041088,7,6,7,8,6,34
1912041089,7,0,2,3,1,13
1912041090,8,3,1,9,7,28
1912041091,1,4,6,4,5,20
1912041092,8,7,8,1,4,28
1912041093,8,4,0,7,2,21
1912041094,7,5,0,3,2,17
1912041095,1,4,2,0,7,14
1912041096,0,2,3,5,6,16
1912041097,5,9,1,8,3,26
1912041098,2,8,1,7,2,20
1912041099,6,0,7,1,7,21
1912041100,0,3,4,0,7,14
1912041101,5,6,1,8,8,28
1912041102,3,1,9,2,3,18
1912041103,6,0,7,2,2,17
1912041104,6,9,9,8,2,34
1912041105,8,5,0,7,4,24
191205001,0,8,1,9,6,24
191205002,1,2,4,0,1,8
191205003,2,5,6,0,2,15
191205004,7,2,8,0,8,25
191205005,2,1,2,6,0,11
191205006,8,4,8,9,2,31
191205007,9,7,6,5,1,28
191205008,8,7,2,1,9,27
191205009,9,1,8,7,0,25
191205010,2,6,8,6,4,26
191205011,9,5,3,5,9,31
191205012,1,6,5,4,7,23
191205013,2,9,8,7,5,31
191205014,6,2,4,7,1,20
191205015,9,1,5,6,9,30
191205016,3,8,4,7,4,26
191205017,8,5,5,9,2,29
191205018,8,3,5,9,4,29
191205019,2,3,5,9,3,22
191205020,4,8,2,7,1,22
191205021,0,1,2,9,4,16
191205022,1,5,4,6,4,20
191205023,0,9,1,3,3,16
191205024,1,4,0,6,5,16
191205025,1,4,6,1,7,19
191205026,1,0,3,9,0,13
191205027,1,8,6,5,1,21
191205028,0,4,2,2,4,12
191205029,9,1,4,8,6,28
191205030,3,4,5,5,6,23
191205031,6,2,3,2,6,19
191205032,8,2,4,1,1,16
191205033,2,1,6,9,8,26
191205034,2,3,0,2,9,16
191205035,5,0,1,6,7,19
191205036,8,7,1,3,2,21
191205037,5,2,5,1,3,16
191205038,4,3,5,7,4,23
191205039,2,3,8,3,1,17
191205040,6,3,8,4,3,24
191205041,2,9,9,4,0,24
191205042,2,0,9,4,8,23
191205043,4,1,8,7,5,25
191205044,9,6,1,0,7,23
191205045,2,5,9,1,8,25
191205046,2,9,4,7,7,29
191205047,2,3,4,0,3,12
191205048,0,6,4,5,6,21
191205049,5,1,0,7,7,20
191205050,2,3,6,0,0,11
191205051,3,2,8,1,2,16
191205052,1,1,4,9,8,23
191205053,6,8,4,7,2,27
191205054,3,0,0,4,2,9
191205055,5,5,8,9,3,30
191205056,1,5,1,3,1,11
191205057,1,4,0,5,3,13
191205058,4,4,2,2,4,16
191205059,1,3,3,9,0,16
191205060,5,1,4,1,6,17
191205061,4,7,5,9,7,32
191205062,4,9,0,7,6,26
191205063,7,7,0,2,2,18
191205064,7,7,4,7,4,29
191205065,1,5,9,4,5,24
191205066,6,0,6,3,7,22
191205067,1,2,4,1,0,8
191205068,7,0,2,1,9,19
191205069,8,3,6,7,1,25
191205070,8,2,6,3,5,24
191205071,0,1,7,9,1,18
191205072,3,6,3,1,8,21
191205073,5,6,2,2,1,16
191205074,5,9,7,1,6,28
191205075,9,2,4,0,4,19
191205076,5,9,3,7,2,26
191205077,9,2,4,9,0,24
191205078,3,1,7,9,0,20
191205079,4,0,5,2,2,13
191205080,3,0,7,0,0,10
191205081,9,1,7,4,1,22
191205082,5,2,8,7,9,31
191205083,7,7,4,9,7,34
191205084,7,9,6,5,9,36
191205085,3,8,7,7,9,34
191205086,7,1,7,5,5,25
191205087,4,4,6,1,2,17
191205088,0,2,9,5,6,22
191205089,8,7,7,6,9,37
191205090,9,7,6,9,6,37
191205091,5,0,8,3,3,19
191205092,0,0,5,3,6,14
191205093,8,5,8,0,9,30
191205094,4,7,4,9,5,29
191205095,5,8,1,7,9,30
191205096,1,5,5,1,7,19
191205097,3,6,8,4,9,30
191205098,6,7,3,2,1,19
191205099,7,2,6,8,1,24
191205100,0,8,6,4,8,26
191205101,7,8,0,2,4,21
191205102,9,2,6,5,4,26
191205103,8,0,5,4,9,26
191205104,8,5,1,3,7,24
191205105,5,2,6,7,8,28
191205106,2,8,0,2,8,20
191205107,6,7,8,2,0,23
191205108,5,3,0,1,7,16
191205109,8,1,5,6,7,27
191205110,3,2,0,6,4,15
191205111,1,7,0,5,5,18
191205112,9,4,4,0,7,24
191205113,6,6,6,7,7,32
191205114,0,2,4,0,7,13
191205115,5,7,7,4,9,32
191205116,1,8,3,2,9,23
191205117,8,2,3,5,3,21
191205118,0,7,2,2,9,20
191205119,5,2,2,1,5,15
191205120,7,9,5,2,7,30
191205121,8,3,0,1,2,14
191205122,3,5,2,1,9,20
191205123,4,0,9,8,9,30
191205124,3,4,4,4,8,23
191205125,5,6,6,8,6,31
191205126,7,7,5,5,0,24
191205127,4,7,8,7,8,34
191205128,4,4,3,3,2,16
191205129,6,9,8,0,4,27
191205130,8,7,2,7,8,32
191205131,0,0,2,8,4,14
191205132,2,8,3,8,7,28
191205133,1,5,8,0,2,16
191205134,4,9,7,9,3,32
191205135,2,0,5,0,1,8
191205136,0,4,5,7,8,24
191205137,0,2,1,0,3,6
191205138,0,1,1,3,7,12
191205139,0,2,0,8,9,19
191205140,3,1,4,6,4,18
191205141,7,8,2,5,0,22
191205142,4,7,3,5,5,24
191205143,5,4,3,5,6,23
191205144,6,2,3,5,3,19
191205145,7,8,0,5,7,27
191205146,3,4,2,4,0,13
191205147,1,3,9,1,4,18
191205148,7,4,3,4,8,26
191205149,3,1,7,2,4,17
191205150,0,9,8,7,2,26
191205151,0,2,1,1,3,7
191205152,2,3,4,8,6,23
191205153,7,0,4,5,7,23
191205154,7,4,0,1,9,21
191205155,4,8,0,9,2,23
191205156,5,2,7,0,3,17
191205157,8,0,9,5,5,27
191205158,2,0,4,3,8,17
191205159,0,3,5,9,6,23
191205160,9,1,6,7,8,31
191205161,8,7,9,8,7,39
191205162,8,4,3,0,8,23
191205163,3,3,8,8,2,24
191205164,5,8,3,7,0,23
191205165,3,7,3,6,2,21
191205166,3,1,4,9,5,22
191205167,8,6,2,6,6,28
191205168,1,9,4,9,5,28
191205169,0,8,5,7,4,24
191205170,4,3,1,9,5,22
191205171,8,7,1,0,0,16
191205172,6,1,3,7,2,19
191205173,7,1,1,2,2,13
191205174,5,6,4,6,9,30
191205175,2,5,9,8,5,29
191205176,9,3,7,3,8,30
191205177,3,2,2,6,5,18
191205178,9,4,0,5,1,19
191205179,3,8,5,2,0,18
191205180,3,7,8,0,8,26
191205181,6,7,3,5,4,25
191205182,0,6,0,6,0,12
191205183,4,0,6,8,9,27
191205184,1,1,4,1,9,16
191205185,5,5,0,6,0,16
191205186,7,5,4,6,2,24
191205187,8,4,3,6,0,21
191205188,7,4,7,7,4,29
191205189,7,6,8,7,8,36
191205190,7,8,3,1,6,25
191205191,7,7,0,5,3,22
191205192,3,7,0,3,9,22
191205193,6,8,6,5,8,33
191205194,2,9,5,3,5,24
191205195,8,8,1,2,2,21
191205196,0,0,1,6,2,9
191205197,6,0,2,4,3,15
191205198,3,9,6,7,9,34
191205199,9,0,4,1,0,14
191205200,1,6,4,0,4,15
191205201,5,8,9,6,9,37
191205202,1,0,2,6,1,10
191205203,7,2,0,0,6,15
191205204,3,0,8,6,0,17
191205205,7,1,6,6,2,22
191205206,7,0,3,2,1,13
191205207,8,6,9,8,1,32
191205208,1,2,5,7,8,23
191205209,5,3,7,9,9,33
191205210,1,5,8,3,7,24
191205211,7,6,8,2,5,28
191205212,4,7,4,0,9,24
191205213,8,5,0,2,0,15
191205214,7,5,2,9,7,30
191205215,8,4,2,6,4,24
191205216,4,8,7,7,6,32
191205217,5,6,1,1,9,22
191205218,3,6,7,1,3,20
191205219,4,7,4,2,0,17
191205220,3,7,9,6,9,34
191205221,0,3,4,5,4,16
191205222,3,2,4,7,5,21
191205223,2,7,8,8,4,29
191205224,4,0,7,4,9,24
191205225,9,2,5,0,4,20
191205226,9,0,9,5,2,25
191205227,0,9,0,0,2,11
191205228,4,0,8,1,1,14
191205229,8,4,3,9,8,32
191205230,2,0,6,2,8,18
191205231,9,6,5,1,6,27
191205232,1,3,7,4,7,22
191205233,0,3,3,9,4,19
191205234,4,4,4,5,1,18
191205235,0,8,3,3,9,23
191205236,3,3,2,3,2,13
191205237,7,3,1,5,6,22
191205238,9,0,1,7,5,22
191205239,1,2,8,7,3,21
191205240,1,7,6,6,9,29
191205241,3,8,9,1,3,24
191205242,3,1,2,2,5,13
191205243,6,9,6,3,0,24
191205244,0,9,5,8,2,24
191205245,0,9,0,9,1,19
191205246,5,3,7,3,3,21
191205247,2,6,2,3,4,17
191205248,5,3,0,9,8,25
191205249,3,3,0,3,7,16
191205250,2,1,8,0,2,13
191205251,0,9,7,1,8,25
191205252,1,0,3,9,4,17
191205253,3,3,2,8,2,18
191205254,1,9,7,1,7,25
191205255,7,7,2,8,6,30
191205256,7,8,7,6,7,35
191205257,5,2,1,2,3,13
191205258,1,5,3,6,1,16
191205259,0,4,1,2,6,13
191205260,0,6,7,6,7,26
191205261,6,8,0,6,4,24
191205262,1,3,0,8,7,19
191205263,3,8,2,2,5,20
191205264,4,1,1,3,1,10
191205265,2,6,5,9,4,26
191205266,7,7,6,1,2,23
191205267,2,9,5,8,6,30
191205268,2,3,7,2,9,23
191205269,1,5,4,4,6,20
191205270,8,7,1,6,4,26
191205271,8,8,1,2,0,19
191205272,2,9,2,5,6,24
191205273,7,3,7,6,9,32
191205274,0,2,8,7,9,26
191205275,3,3,8,1,6,21
191205276,1,8,5,6,2,22
191205277,2,0,7,9,1,19
191205278,9,4,7,1,9,30
191205279,9,8,1,0,6,24
191205280,8,0,3,2,6,19
191205281,9,5,2,8,0,24
191205282,5,0,3,2,4,14
191205283,1,1,6,9,1,18
191205284,1,4,8,3,1,17
191205285,9,9,0,0,1,19
191205286,4,6,5,6,5,26
191205287,5,2,2,4,0,13
191205288,9,3,6,0,4,22
191205289,4,0,4,8,7,23
191205290,2,2,5,4,7,20
191205291,6,0,9,2,8,25
191205292,7,4,5,5,1,22
191205293,4,2,4,0,4,14
191205294,5,5,2,4,4,20
191205295,9,3,4,9,8,33
191205296,8,9,7,3,0,27
191205297,1,3,8,5,9,26
191205298,8,0,1,8,7,24
191205299,2,8,6,3,1,20
191205300,6,4,8,8,6,32
191205301,9,0,8,9,6,32
191205302,7,7,4,6,9,33
191205303,2,2,9,6,2,21
191205304,2,1,7,1,0,11
191205305,6,9,2,1,1,19
191205306,7,2,8,3,1,21
191205307,1,3,7,8,5,24
191205308,0,0,4,7,8,19
191205309,0,4,7,9,6,26
191205310,1,1,2,4,2,10
191205311,8,9,2,1,6,26
191205312,2,9,8,9,6,34
191205313,6,1,2,5,7,21
191205314,4,9,4,7,4,28
191205315,6,6,1,1,7,21
191205316,6,6,9,2,7,30
191205317,1,9,8,6,7,31
191205318,0,8,3,6,7,24
191205319,6,5,0,6,6,23
191205320,2,8,2,2,5,19
191205321,2,7,1,6,7,23
191205322,0,1,3,4,2,10
191205323,4,4,9,2,4,23
191205324,9,7,5,3,5,29
191205325,3,0,5,7,2,17
191205326,1,2,6,5,6,20
191205327,5,0,8,5,7,25
191205328,2,7,4,2,9,24
191205329,5,2,8,9,5,29
191205330,8,1,0,4,5,18
191205331,1,2,9,7,6,25
191205332,4,1,7,0,6,18
191205333,1,9,4,6,5,25
191205334,8,1,8,7,9,33
191205335,8,8,2,1,6,25
191205336,8,2,4,2,5,21
191205337,0,1,7,6,9,23
191205338,3,6,3,2,6,20
191205339,0,5,5,4,4,18
191205340,6,8,3,6,4,27
191205341,1,5,2,2,2,12
191205342,7,7,8,2,8,32
191205343,4,4,4,7,3,22
191205344,9,7,3,9,7,35
191205345,7,4,4,8,4,27
191205346,0,7,6,1,6,20
191205347,3,5,8,4,8,28
191205348,5,9,6,8,2,30
191205349,6,4,4,9,4,27
191205350,9,7,3,9,1,29
191205351,0,2,9,9,9,29
191205352,3,8,8,5,1,25
191205353,4,7,8,8,8,35
191205354,1,1,7,5,6,20
191205355,2,1,5,2,4,14
191205356,1,8,3,6,7,25
191205357,3,9,8,1,6,27
191205358,1,4,0,4,4,13
191205359,6,9,4,2,8,29
191205360,5,4,0,5,4,18
191205361,1,6,0,8,0,15
191205362,6,0,8,0,9,23
191205363,9,5,2,4,5,25
191205364,1,9,9,5,4,28
191205365,7,1,6,2,7,23
191205366,2,2,9,0,8,21
191205367,9,9,6,6,0,30
191205368,8,2,8,2,0,20
191205369,4,4,1,9,7,25
191205370,9,7,9,4,7,36
191205371,6,3,5,8,7,29
191205372,4,5,2,1,4,16
191205373,1,1,5,4,3,14
191205374,8,2,2,3,1,16
191205375,0,1,8,7,9,25
191205376,8,0,7,6,6,27
191205377,3,4,5,3,9,24
191205378,0,0,6,1,0,7
191205379,7,6,1,9,8,31
191205380,1,5,3,9,0,18
191205381,0,1,9,9,4,23
191205382,2,6,0,2,4,14
191205383,8,2,6,3,7,26
191205384,4,8,3,9,5,29
191205385,0,7,6,9,9,31
191205386,4,1,7,7,1,20
191205387,6,3,8,2,4,23
191205388,5,4,3,4,6,22
191205389,0,0,7,3,7,17
191205390,9,3,1,9,0,22
191205391,7,8,5,3,7,30
191205392,4,9,1,3,7,24
191205393,5,6,2,2,7,22
191205394,4,7,6,1,9,27
191205395,4,5,4,8,8,29
191205396,7,0,0,3,9,19
191205397,7,1,5,1,9,23
191205398,9,3,5,3,1,21
191205399,6,2,3,7,3,21
191205400,9,2,9,6,7,33
191205401,6,1,7,6,7,27
191205402,2,6,9,8,0,25
191205403,5,0,9,5,5,24
191205404,2,2,1,2,2,9
191205405,2,4,7,4,0,17
191205406,6,4,7,9,3,29
191205407,8,0,9,5,9,31
191205408,6,8,0,3,5,22
191205409,4,3,3,1,3,14
191205410,0,1,6,0,1,8
191205411,6,3,2,9,7,27
191205412,9,4,2,1,4,20
191205413,0,1,7,6,5,19
191205414,6,6,8,6,9,35
191205415,4,9,9,1,5,28
191205416,2,6,2,2,6,18
191205417,9,9,9,9,4,40
191205418,0,0,8,7,1,16
191205419,3,3,1,6,7,20
191205420,1,5,5,0,6,17
191205421,9,1,7,0,1,18
191205422,6,7,6,4,8,31
191205423,9,7,5,9,4,34
191205424,0,0,2,4,6,12
191205425,4,8,9,6,5,32
191205426,3,6,1,8,9,27
191205427,0,3,3,2,8,16
191205428,4,9,3,4,5,25
191205429,7,1,2,6,8,24
191205430,8,8,7,0,0,23
191205431,3,7,4,7,8,29
191205432,5,1,9,3,7,25
191205433,0,7,9,0,8,24
191205434,7,5,7,0,3,22
191205435,4,2,4,4,8,22
191205436,9,0,1,8,8,26
191205437,5,8,4,1,6,24
191205438,1,5,6,1,1,14
191205439,6,1,6,0,5,18
191205440,3,6,0,0,9,18
191205441,6,0,5,4,5,20
191205442,0,2,6,9,4,21
191205443,0,3,9,9,0,21
191205444,0,7,7,9,5,28
191205445,2,0,4,5,1,12
191205446,7,7,3,3,8,28
191205447,3,5,1,3,2,14
191205448,3,7,5,3,6,24
191205449,2,6,5,1,0,14
191205450,7,2,7,3,8,27
191205451,9,5,5,4,9,32
191205452,2,4,6,7,5,24
191205453,4,0,3,7,4,18
191205454,0,6,6,0,7,19
191205455,7,9,1,6,7,30
191205456,8,8,0,2,5,23
191205457,2,5,1,7,2,17
191205458,7,9,6,6,9,37
191205459,3,6,9,6,6,30
191205460,9,9,6,8,9,41
191205461,4,1,7,4,8,24
191205462,2,9,0,1,1,13
191205463,8,5,8,5,9,35
191205464,3,2,3,1,7,16
191205465,6,5,7,1,3,22
191205466,3,6,6,9,2,26
191205467,0,7,5,9,2,23
191205468,1,0,7,2,5,15
191205469,6,5,5,0,5,21
191205470,4,4,3,3,8,22
191205471,4,7,5,7,7,30
191205472,9,4,0,1,8,22
191205473,2,7,3,3,5,20
191205474,0,0,2,6,9,17
191205475,9,1,7,3,6,26
191205476,1,0,2,4,2,9
191205477,4,4,5,9,0,22
191205478,2,1,1,6,5,15
191205479,3,1,2,7,1,14
191205480,3,0,6,9,5,23
191205481,6,6,8,0,5,25
191205482,3,2,3,8,4,20
191205483,4,7,3,1,4,19
191205484,8,1,2,0,3,14
191205485,4,7,0,3,2,16
191205486,1,4,8,2,6,21
191205487,5,6,5,6,0,22
191205488,4,7,4,7,9,31
191205489,7,5,0,3,8,23
191205490,6,8,4,6,5,29
191205491,7,5,6,0,6,24
191205492,7,0,6,5,6,24
191205493,8,1,4,1,5,19
191205494,0,9,0,5,2,16
191205495,7,8,1,5,5,26
191205496,4,4,9,2,3,22
191205497,3,4,6,2,6,21
191205498,7,2,2,0,0,11
191205499,7,2,5,2,2,18
191205500,8,8,9,5,5,35
191205501,7,6,9,9,9,40
191205502,2,3,6,2,2,15
191205503,8,7,1,7,3,26
191205504,3,2,9,5,0,19
191205505,6,2,8,0,2,18
191205506,9,4,3,2,8,26
191205507,6,6,9,4,4,29
191205508,6,8,4,7,0,25
191205509,8,0,6,8,6,28
191205510,8,4,4,3,7,26
191205511,3,6,3,6,0,18
191205512,7,8,0,5,5,25
191205513,3,2,0,4,6,15
191205514,7,2,4,0,9,22
191205515,2,8,5,0,2,17
191205516,7,3,9,3,2,24
191205517,4,2,3,9,0,18
191205518,7,7,6,2,1,23
191205519,0,3,9,2,7,21
191205520,6,2,5,7,9,29
191205521,9,9,9,9,9,45
191205522,9,3,7,7,5,31
191205523,4,4,9,1,4,22
191205524,1,6,6,2,5,20
191205525,9,0,3,9,8,29
191205526,3,2,1,0,7,13
191205527,7,2,9,8,6,32
191205528,1,1,9,9,7,27
191205529,5,9,5,9,3,31
191205530,7,0,3,0,9,19
191205531,8,6,6,3,4,27
191205532,8,7,4,8,4,31
191205533,1,5,2,8,6,22
191205534,8,9,2,0,6,25
191205535,0,2,0,4,4,10
191205536,7,8,8,6,5,34
191205537,5,2,8,1,2,18
191205538,0,1,9,9,6,25
191205539,7,6,4,3,0,20
191205540,5,5,3,0,2,15
191205541,3,8,4,0,9,24
191205542,8,3,8,6,4,29
191205543,1,2,2,9,3,17
191205544,3,2,2,4,4,15
191205545,7,2,9,4,9,31
191205546,0,9,5,7,0,21
191205547,7,9,7,3,5,31
191205548,4,4,2,7,7,24
191205549,3,5,4,2,7,21
191205550,9,5,3,9,4,30
191205551,5,3,7,6,0,21
191205552,1,7,3,3,9,23
191205553,2,7,8,9,2,28
191205554,3,6,5,5,2,21
191205555,6,6,4,0,3,19
191205556,0,5,4,3,9,21
191205557,3,7,4,8,8,30
191205558,2,7,1,2,7,19
191205559,6,4,3,9,0,22
191205560,7,0,6,7,6,26
191205561,6,3,6,2,1,18
191205562,4,4,6,5,0,19
191205563,4,2,3,1,4,14
191205564,7,8,2,6,1,24
191205565,4,5,8,7,3,27
191205566,5,2,7,5,5,24
191205567,4,4,7,5,2,22
191205568,2,0,0,3,2,7
191205569,1,2,5,3,4,15
191205570,4,1,0,2,3,10
191205571,5,4,4,7,1,21
191205572,1,3,6,1,8,19
191205573,7,1,0,0,9,17
191205574,5,7,2,4,8,26
191205575,1,6,2,4,3,16
191205576,6,0,7,5,7,25
191205577,8,9,2,5,4,28
191205578,6,5,2,2,6,21
191205579,9,2,8,1,0,20
191205580,4,3,0,2,7,16
191205581,3,3,2,1,1,10
191205582,9,3,1,9,2,24
191205583,1,7,2,1,4,15
191205584,8,0,4,0,0,12
191205585,6,2,5,7,3,23
191205586,4,9,2,8,9,32
191205587,6,0,2,8,9,25
191205588,0,6,7,5,4,22
191205589,4,7,8,0,5,24
191205590,5,2,3,3,3,16
191205591,1,7,6,9,1,24
191205592,7,9,5,6,0,27
191205593,8,3,9,6,3,29
191205594,7,7,7,6,2,29
191205595,9,7,5,0,0,21
191205596,2,6,0,5,7,20
191205597,8,8,4,2,7,29
191205598,1,2,7,0,7,17
191205599,1,5,3,4,6,19
191205600,9,4,5,6,5,29
191205601,2,1,2,9,1,15
191205602,3,6,7,3,9,28
191205603,7,5,2,1,4,19
191205604,3,8,9,2,3,25
191205605,8,4,4,4,2,22
191205606,4,6,4,0,8,22
191205607,3,4,3,7,5,22
191205608,9,4,1,3,7,24
191205609,4,3,9,5,5,26
191205610,9,1,8,0,4,22
191205611,7,9,9,8,4,37
191205612,1,1,9,2,4,17
191205613,3,6,4,0,6,19
191205614,2,1,8,3,9,23
191205615,8,4,3,9,6,30
191205616,8,6,5,3,5,27
191205617,2,6,0,5,3,16
191205618,6,8,1,0,4,19
191205619,6,0,7,3,1,17
191205620,5,8,1,9,2,25
191205621,2,4,2,8,9,25
191205622,3,3,1,1,0,8
191205623,6,5,2,1,3,17
191205624,9,1,8,1,9,28
191205625,7,6,2,1,7,23
191205626,8,8,6,7,2,31
191205627,4,0,1,5,7,17
191205628,3,0,2,6,8,19
191205629,1,8,7,2,4,22
191205630,5,0,7,4,4,20
191205631,2,5,8,4,4,23
191205632,8,0,5,3,1,17
191205633,9,0,8,9,9,35
191205634,7,6,3,8,6,30
191205635,9,0,8,1,3,21
191205636,0,1,7,5,8,21
191205637,4,6,7,5,3,25
191205638,9,6,3,0,1,19
191205639,5,5,2,3,9,24
191205640,0,4,4,8,9,25
191205641,9,9,0,0,5,23
191205642,3,3,4,5,4,19
191205643,0,8,9,1,6,24
191205644,0,0,4,3,8,15
191205645,8,2,4,9,6,29
191205646,0,2,4,2,4,12
191205647,8,9,5,3,4,29
191205648,0,7,8,1,9,25
191205649,9,2,8,8,0,27
191205650,1,2,6,3,5,17
191205651,0,5,9,8,8,30
191205652,1,6,8,1,1,17
191205653,8,2,8,8,6,32
191205654,8,8,9,2,7,34
191205655,4,2,2,7,4,19
191205656,3,1,8,0,6,18
191205657,1,2,7,4,7,21
191205658,0,6,8,1,0,15
191205659,6,7,2,7,1,23
191205660,4,8,7,5,9,33
191205661,6,9,0,8,6,29
191205662,3,0,8,9,9,29
191205663,8,4,0,9,5,26
191205664,3,3,7,4,3,20
191205665,4,4,6,8,7,29
191205666,6,3,9,6,4,28
191205667,2,8,5,5,1,21
191205668,9,2,6,0,2,19
191205669,2,9,6,3,7,27
191205670,9,2,4,8,1,24
191205671,3,5,9,3,9,29
191205672,7,5,4,9,0,25
191205673,7,2,0,8,1,18
191205674,2,7,2,2,8,21
191205675,8,9,0,1,4,22
191205676,2,0,2,7,4,15
191205677,7,8,3,8,0,26
191205678,9,6,2,3,1,21
191205679,1,3,7,0,2,13
191205680,8,8,3,7,6,32
191205681,0,2,4,5,3,14
191205682,1,0,2,3,2,8
191205683,2,8,6,6,0,22
191205684,3,8,4,1,3,19
191205685,3,8,0,7,6,24
191205686,9,6,5,0,1,21
191205687,0,4,3,8,1,16
191205688,2,4,5,0,6,17
191205689,7,6,2,2,9,26
191205690,3,3,3,8,7,24
191205691,7,1,7,7,0,22
191205692,4,4,1,3,3,15
191205693,5,2,1,3,2,13
191205694,4,3,1,5,4,17
191205695,8,8,5,1,3,25
191205696,4,4,0,3,3,14
191205697,7,5,1,7,8,28
191205698,8,4,6,8,2,28
191205699,7,2,8,7,3,27
191205700,4,3,0,1,7,15
191205701,5,7,1,7,6,26
191205702,4,1,5,5,4,19
191205703,7,7,1,4,1,20
191205704,3,9,4,0,1,17
191205705,8,2,2,7,8,27
191205706,5,7,2,6,9,29
191205707,3,6,5,9,9,32
191205708,3,2,5,1,7,18
191205709,3,3,7,7,2,22
191205710,5,6,8,4,4,27
191205711,6,0,7,1,6,20
191205712,1,9,4,1,2,17
191205713,5,5,6,9,8,33
191205714,3,8,9,2,0,22
191205715,2,0,5,8,0,15
191205716,9,3,4,1,8,25
191205717,4,3,7,0,2,16
191205718,8,9,8,5,5,35
191205719,7,0,3,3,0,13
191205720,9,9,2,4,2,26
191205721,1,7,6,5,2,21
191205722,1,1,9,3,5,19
191205723,6,8,4,0,9,27
191205724,6,5,6,6,3,26
191205725,7,7,0,8,3,25
191205726,6,0,3,5,2,16
191205727,4,4,0,0,3,11
191205728,4,6,2,6,3,21
191205729,7,1,3,0,9,20
191205730,8,4,7,5,2,26
191205731,8,4,7,6,0,25
191205732,3,1,5,8,1,18
191205733,0,8,0,0,9,17
191205734,4,9,7,6,8,34
191205735,5,4,6,7,6,28
191205736,1,0,0,3,7,11
191205737,5,2,0,0,1,8
191205738,4,9,4,4,5,26
191205739,9,9,1,6,9,34
191205740,5,7,2,4,9,27
191205741,4,9,1,8,3,25
191205742,8,9,4,5,6,32
191205743,6,9,7,3,1,26
191205744,2,0,0,1,8,11
191205745,3,9,9,5,5,31
191205746,1,0,9,9,4,23
191205747,6,6,8,8,3,31
191205748,0,8,7,0,2,17
191205749,4,9,2,5,0,20
191205750,9,8,6,6,4,33
191205751,2,9,2,9,5,27
191205752,8,6,4,3,0,21
191205753,7,4,7,6,1,25
191205754,3,8,8,3,4,26
191205755,3,3,8,8,3,25
191205756,3,4,0,4,4,15
191205757,9,7,9,7,4,36
191205758,3,5,4,4,3,19
191205759,7,7,9,2,7,32
191205760,6,9,2,3,1,21
191205761,2,2,4,9,5,22
191205762,7,2,9,7,5,30
191205763,2,1,6,5,2,16
191205764,5,2,8,8,2,25
191205765,8,8,2,1,0,19
191205766,2,2,6,7,2,19
191205767,6,9,6,9,6,36
191205768,6,9,3,1,5,24
191205769,0,7,1,4,2,14
191205770,3,5,9,6,0,23
191205771,8,9,8,4,3,32
191205772,0,9,6,8,3,26
191205773,5,3,1,6,4,19
191205774,5,2,2,4,7,20
191205775,0,1,3,2,3,9
191205776,1,0,7,5,9,22
191205777,7,6,3,3,8,27
191205778,0,0,6,4,8,18
191205779,4,8,7,1,6,26
191205780,1,1,7,1,9,19
191205781,0,9,1,0,9,19
191205782,5,9,0,6,7,27
191205783,1,6,8,9,5,29
191205784,8,7,2,3,0,20
191205785,4,0,6,2,7,19
191205786,6,9,8,8,9,40
191205787,7,9,4,6,1,27
191205788,9,5,6,6,9,35
191205789,3,3,0,9,7,22
191205790,3,9,5,7,1,25
191205791,1,6,7,1,6,21
191205792,1,6,5,2,8,22
191205793,0,8,2,8,5,23
191205794,0,5,5,6,8,24
191205795,5,7,8,1,7,28
191205796,7,6,6,7,8,34
191205797,9,3,4,1,0,17
191205798,7,6,7,5,2,27
191205799,4,3,2,4,2,15
191205800,5,9,3,7,8,32
191205801,9,5,2,4,4,24
191205802,6,9,5,6,5,31
191205803,5,6,8,9,2,30
191205804,3,7,1,8,6,25
191205805,1,0,5,4,7,17
191205806,9,0,4,1,9,23
191205807,2,0,0,0,5,7
191205808,1,3,1,5,9,19
191205809,3,6,5,0,0,14
191205810,6,1,5,4,4,20
191205811,2,2,5,6,0,15
191205812,8,5,7,7,0,27
191205813,0,3,0,5,3,11
191205814,4,8,1,5,5,23
191205815,0,4,3,5,8,20
191205816,8,1,5,6,0,20
191205817,5,0,7,7,0,19
191205818,1,1,7,2,1,12
191205819,4,2,6,9,8,29
191205820,8,9,8,7,2,34
191205821,4,6,3,5,0,18
191205822,8,8,0,3,6,25
191205823,5,5,1,3,1,15
191205824,6,9,2,5,6,28
191205825,9,3,4,0,2,18
191205826,6,9,5,2,8,30
191205827,6,6,2,0,1,15
191205828,4,4,4,5,4,21
191205829,7,2,3,6,1,19
191205830,1,1,1,3,9,15
191205831,4,8,9,9,0,30
191205832,0,8,5,1,1,15
191205833,5,2,7,4,6,24
191205834,4,8,4,3,8,27
191205835,0,2,2,1,6,11
191205836,7,2,2,3,2,16
191205837,4,5,9,0,1,19
191205838,5,7,8,2,1,23
191205839,8,6,5,3,6,28
191205840,8,5,1,8,4,26
191205841,6,9,5,2,0,22
191205842,1,3,9,9,8,30
191205843,0,6,7,1,0,14
191205844,9,4,3,3,4,23
191205845,8,7,1,1,0,17
191205846,4,7,0,4,6,21
191205847,7,6,4,5,9,31
191205848,6,6,4,1,3,20
191205849,1,4,4,7,1,17
191205850,0,2,0,2,8,12
191205851,3,8,1,9,3,24
191205852,1,4,4,8,4,21
191205853,7,9,3,1,0,20
191205854,2,7,8,5,8,30
191205855,3,5,7,4,6,25
191205856,5,9,7,2,0,23
191205857,1,1,9,9,8,28
191205858,7,5,7,4,1,24
191205859,3,1,6,0,6,16
191205860,8,1,6,7,0,22
191205861,3,8,0,5,7,23
191205862,8,8,1,1,7,25
191205863,6,5,4,6,1,22
191205864,5,5,6,7,8,31
191205865,7,8,4,8,6,33
191205866,3,1,3,1,6,14
191205867,3,1,2,1,9,16
191205868,1,0,7,4,6,18
191205869,3,6,8,2,9,28
191205870,3,7,3,2,3,18
191205871,5,0,8,6,2,21
191205872,5,9,7,4,4,29
191205873,5,7,7,0,0,19
191205874,0,5,7,8,5,25
191205875,6,9,4,7,6,32
191205876,0,5,3,8,0,16
191205877,9,1,2,6,6,24
191205878,3,0,0,6,3,12
191205879,8,1,7,7,5,28
191205880,3,6,1,1,6,17
191205881,5,1,4,6,3,19
191205882,3,4,0,2,2,11
191205883,5,2,2,6,1,16
191205884,1,0,5,9,3,18
191205885,0,8,9,2,5,24
191205886,9,1,9,9,6,34
191205887,1,0,9,6,0,16
191205888,5,2,9,2,8,26
191205889,9,6,1,5,7,28
191205890,2,4,1,0,9,16
191205891,0,7,5,8,0,20
191205892,2,5,7,0,9,23
191205893,9,7,1,7,4,28
191205894,1,5,5,6,1,18
191205895,6,3,0,6,9,24
191205896,4,0,7,1,1,13
191205897,9,6,1,8,2,26
191205898,8,6,2,9,8,33
191205899,4,1,8,0,2,15
191205900,1,4,5,6,1,17
191205901,9,7,0,4,0,20
191205902,1,8,4,1,6,20
191205903,3,6,7,6,0,22
191205904,3,7,4,1,5,20
191205905,2,5,9,6,5,27
191205906,8,0,1,4,3,16
191205907,6,4,2,0,6,18
191205908,2,4,2,6,0,14
191205909,3,7,6,0,4,20
191205910,0,8,9,5,4,26
191205911,3,0,4,9,3,19
191205912,4,4,5,9,1,23
191205913,3,7,1,5,5,21
191205914,7,7,3,5,0,22
191205915,8,1,1,8,7,25
191205916,4,5,2,8,0,19
191205917,9,1,3,3,7,23
191205918,2,5,7,9,6,29
191205919,8,0,3,0,5,16
191205920,7,8,6,2,5,28
191205921,0,1,5,3,6,15
191205922,7,2,0,2,4,15
191205923,4,7,4,2,3,20
191205924,3,5,5,7,5,25
191205925,2,7,9,7,8,33
191205926,4,5,6,4,5,24
191205927,3,6,7,0,0,16
191205928,0,0,2,6,8,16
191205929,0,5,9,5,8,27
191205930,5,0,3,4,6,18
191205931,5,6,5,4,1,21
191205932,3,2,4,0,8,17
191205933,8,6,7,1,2,24
191205934,8,3,6,9,3,29
191205935,8,9,1,5,6,29
191205936,5,3,5,0,6,19
191205937,4,9,3,5,1,22
191205938,4,2,5,7,4,22
191205939,2,5,5,6,0,18
191205940,2,7,4,1,1,15
191205941,1,7,7,3,6,24
191205942,7,4,6,3,3,23
191205943,6,6,4,3,9,28
191205944,8,0,9,7,7,31
191205945,8,4,4,4,9,29
191205946,3,3,5,0,0,11
191205947,6,6,1,0,3,16
191205948,2,0,7,8,2,19
191205949,0,2,4,5,4,15
191205950,0,6,7,2,2,17
191205951,8,0,4,4,8,24
191205952,0,5,0,2,4,11
191205953,4,3,5,4,1,17
191205954,2,7,1,7,9,26
191205955,9,2,7,3,7,28
191205956,9,8,6,6,3,32
191205957,8,3,3,3,9,26
191205958,0,2,7,0,0,9
191205959,6,5,8,5,5,29
191205960,9,6,9,1,7,32
191205961,6,0,3,9,4,22
191205962,0,2,4,7,4,17
191205963,6,9,1,4,2,22
191205964,4,9,2,7,5,27
191205965,1,5,1,5,0,12
191205966,5,1,3,6,1,16
191205967,6,8,4,1,0,19
191205968,4,6,2,9,4,25
191205969,4,8,6,4,5,27
191205970,9,0,6,5,8,28
191205971,1,9,4,8,6,28
191205972,7,9,5,1,0,22
191205973,9,7,2,6,0,24
191205974,4,7,1,2,2,16
191205975,7,7,5,3,2,24
191205976,6,7,5,8,8,34
191205977,4,7,2,6,8,27
191205978,9,5,2,3,3,22
191205979,7,5,2,2,0,16
191205980,8,9,4,7,6,34
191205981,8,2,6,6,3,25
191205982,9,4,3,4,5,25
191205983,1,6,4,5,9,25
191205984,2,7,1,3,5,18
191205985,7,4,8,2,7,28
191205986,8,8,7,2,4,29
191205987,0,9,9,1,8,27
191205988,6,9,9,9,1,34
191205989,5,5,7,6,0,23
191205990,4,9,4,7,0,24
191205991,9,9,2,9,4,33
191205992,6,3,4,4,6,23
191205993,4,0,2,1,3,10
191205994,4,6,1,8,4,23
191205995,1,8,6,6,1,22
191205996,9,8,6,0,2,25
191205997,7,8,6,4,2,27
191205998,4,5,1,5,2,17
191205999,6,6,3,8,1,24
1912051000,5,4,6,8,3,26
1912051001,9,6,7,9,1,32
1912051002,6,9,0,6,8,29
1912051003,6,8,7,1,8,30
1912051004,5,8,0,7,9,29
1912051005,0,2,2,6,2,12
1912051006,3,8,7,1,3,22
1912051007,5,6,6,4,4,25
1912051008,8,8,7,7,4,34
1912051009,0,3,1,1,5,10
1912051010,5,6,6,2,6,25
1912051011,2,6,3,8,8,27
1912051012,7,4,1,5,2,19
1912051013,9,9,0,1,7,26
1912051014,4,1,7,2,4,18
1912051015,8,4,5,7,9,33
1912051016,2,9,6,0,5,22
1912051017,8,0,9,8,6,31
1912051018,0,5,8,6,4,23
1912051019,2,8,3,2,0,15
1912051020,6,0,7,0,4,17
1912051021,8,2,7,3,6,26
1912051022,6,0,6,9,0,21
1912051023,7,4,8,0,4,23
1912051024,7,5,2,3,4,21
1912051025,8,7,5,0,1,21
1912051026,0,6,1,8,2,17
1912051027,2,0,1,3,4,10
1912051028,6,9,2,9,5,31
1912051029,2,3,2,8,9,24
1912051030,0,9,5,2,6,22
1912051031,2,9,8,6,2,27
1912051032,2,2,8,1,7,20
1912051033,6,0,6,2,3,17
1912051034,8,1,9,0,3,21
1912051035,6,9,2,1,2,20
1912051036,5,2,1,1,2,11
1912051037,8,2,9,0,2,21
1912051038,2,3,0,7,4,16
1912051039,7,5,7,4,7,30
1912051040,6,9,5,5,7,32
1912051041,0,8,6,8,3,25
1912051042,7,5,6,8,6,32
1912051043,3,2,9,0,9,23
1912051044,5,2,7,0,4,18
1912051045,6,9,9,4,5,33
1912051046,6,3,4,8,5,26
1912051047,8,7,2,9,5,31
1912051048,5,1,0,4,1,11
1912051049,6,8,8,6,7,35
1912051050,3,1,7,5,9,25
1912051051,4,3,6,6,2,21
1912051052,3,6,1,3,8,21
1912051053,6,2,5,2,8,23
1912051054,3,0,4,8,3,18
1912051055,6,8,6,4,0,24
1912051056,2,1,2,6,5,16
1912051057,1,8,3,1,6,19
1912051058,6,0,0,8,9,23
1912051059,5,6,8,6,1,26
1912051060,3,9,5,0,6,23
1912051061,4,5,5,7,0,21
1912051062,4,7,0,0,2,13
1912051063,3,8,9,8,4,32
1912051064,0,5,2,0,9,16
1912051065,5,4,5,8,7,29
1912051066,8,8,5,6,3,30
1912051067,8,1,7,2,7,25
1912051068,5,1,6,5,4,21
1912051069,1,8,7,0,1,17
1912051070,7,9,2,2,9,29
1912051071,4,3,5,8,7,27
1912051072,7,2,5,6,2,22
1912051073,3,7,1,5,7,23
1912051074,2,5,8,3,2,20
1912051075,1,2,5,2,2,12
1912051076,9,6,0,7,7,29
1912051077,7,7,8,5,4,31
1912051078,2,6,3,0,5,16
1912051079,9,2,1,3,3,18
1912051080,8,1,4,3,7,23
1912051081,1,9,7,9,7,33
1912051082,2,2,3,5,0,12
1912051083,5,9,9,5,1,29
1912051084,8,6,7,1,0,22
1912051085,8,9,3,7,6,33
1912051086,9,3,7,0,9,28
1912051087,4,2,7,4,6,23
1912051088,6,8,4,1,5,24
1912051089,6,6,5,5,4,26
1912051090,2,0,9,7,7,25
1912051091,5,6,8,5,3,27
1912051092,8,4,8,2,1,23
1912051093,0,7,7,5,5,24
1912051094,8,4,9,2,6,29
1912051095,3,5,5,5,4,22
1912051096,7,8,3,2,2,22
1912051097,2,7,4,5,8,26
1912051098,5,4,5,4,5,23
1912051099,5,9,9,7,7,37
1912051100,2,6,7,1,5,21
1912051101,5,0,1,2,8,16
1912051102,3,1,1,6,5,16
1912051103,8,3,8,2,8,29
1912051104,8,0,8,9,2,27
1912051105,2,7,3,5,7,24
191206001,0,4,7,7,4,22
191206002,7,2,3,9,2,23
191206003,0,7,9,2,7,25
191206004,7,0,1,3,5,16
191206005,8,4,7,9,1,29
191206006,7,7,8,7,6,35
191206007,4,6,8,0,2,20
191206008,4,1,0,7,9,21
191206009,8,9,3,2,9,31
191206010,6,7,8,6,5,32
191206011,3,9,9,2,2,25
191206012,2,1,6,6,6,21
191206013,6,8,7,7,4,32
191206014,4,6,5,9,2,26
191206015,1,1,3,0,5,10
191206016,9,0,9,3,8,29
191206017,5,0,5,4,3,17
191206018,1,3,7,4,9,24
191206019,6,9,4,7,2,28
191206020,9,1,3,6,1,20
191206021,3,2,2,0,4,11
191206022,2,0,4,0,1,7
191206023,2,8,2,9,1,22
191206024,0,6,0,7,2,15
191206025,4,8,2,6,0,20
191206026,1,3,3,9,3,19
191206027,8,0,4,3,1,16
191206028,3,9,2,2,8,24
191206029,2,6,5,0,8,21
191206030,7,8,3,3,9,30
191206031,4,4,5,5,2,20
191206032,9,9,0,2,6,26
191206033,3,1,8,7,3,22
191206034,3,9,4,9,5,30
191206035,6,4,4,7,0,21
191206036,8,5,3,6,0,22
191206037,1,8,2,5,8,24
191206038,6,9,5,2,2,24
191206039,4,1,3,0,1,9
191206040,1,3,3,7,7,21
191206041,1,7,3,3,6,20
191206042,1,3,3,8,5,20
191206043,9,3,9,6,5,32
191206044,7,6,1,6,1,21
191206045,8,3,5,5,7,28
191206046,2,8,5,2,3,20
191206047,2,6,4,3,6,21
191206048,5,4,9,7,9,34
191206049,3,5,2,1,4,15
191206050,3,0,5,9,8,25
191206051,8,8,2,7,4,29
191206052,3,2,7,8,7,27
191206053,7,7,8,7,8,37
191206054,2,4,9,9,6,30
191206055,9,6,1,3,8,27
191206056,6,9,8,1,4,28
191206057,5,7,4,3,8,27
191206058,2,2,1,6,0,11
191206059,9,5,5,4,8,31
191206060,0,2,5,8,4,19
191206061,1,1,0,9,3,14
191206062,0,3,3,6,5,17
191206063,4,0,3,6,7,20
191206064,0,8,7,4,4,23
191206065,7,9,9,0,0,25
191206066,3,6,8,5,2,24
191206067,8,3,9,9,5,34
191206068,8,7,4,7,6,32
191206069,0,1,0,8,4,13
191206070,5,9,6,7,7,34
191206071,9,9,9,0,4,31
191206072,2,5,2,4,2,15
191206073,6,7,5,2,8,28
191206074,6,3,0,1,8,18
191206075,7,8,5,8,0,28
191206076,6,6,1,4,3,20
191206077,1,5,2,0,7,15
191206078,3,0,9,5,8,25
191206079,5,2,7,3,0,17
191206080,0,0,8,6,3,17
191206081,4,9,0,9,1,23
191206082,4,7,5,8,9,33
191206083,1,4,0,4,5,14
191206084,5,6,4,7,5,27
191206085,7,5,4,5,6,27
191206086,9,8,9,9,2,37
191206087,1,5,1,2,8,17
191206088,5,9,8,6,2,30
191206089,5,4,2,3,8,22
191206090,7,3,9,3,7,29
191206091,1,8,1,9,2,21
191206092,2,2,0,3,2,9
191206093,5,8,8,9,8,38
191206094,9,4,9,6,1,29
191206095,1,3,5,1,1,11
191206096,1,7,2,0,5,15
191206097,7,0,4,3,8,22
191206098,1,4,4,8,8,25
191206099,0,2,0,5,2,9
191206100,7,3,8,1,3,22
191206101,9,1,9,3,2,24
191206102,8,0,0,3,1,12
191206103,2,0,6,7,4,19
191206104,3,8,7,3,5,26
191206105,6,1,2,4,1,14
191206106,1,7,1,8,3,20
191206107,7,9,6,3,4,29
191206108,1,0,9,0,6,16
191206109,7,2,1,1,7,18
191206110,5,7,6,4,9,31
191206111,5,7,8,8,8,36
191206112,3,4,6,7,9,29
191206113,4,3,7,4,5,23
191206114,1,7,5,2,1,16
191206115,0,8,9,3,8,28
191206116,3,9,9,3,2,26
191206117,1,9,9,7,7,33
191206118,7,4,8,0,6,25
191206119,6,1,8,3,8,26
191206120,0,6,8,2,5,21
191206121,4,7,0,2,1,14
191206122,4,7,3,1,5,20
191206123,3,2,7,3,1,16
191206124,6,9,7,0,5,27
191206125,2,3,7,2,6,20
191206126,5,9,0,6,9,29
191206127,7,1,9,1,5,23
191206128,0,6,7,5,0,18
191206129,0,0,3,1,3,7
191206130,9,6,9,3,5,32
191206131,3,6,6,0,0,15
191206132,7,7,8,3,2,27
191206133,2,2,5,0,6,15
191206134,6,4,0,7,3,20
191206135,2,6,3,2,4,17
191206136,4,0,2,8,2,16
191206137,7,3,0,9,3,22
191206138,6,0,8,0,1,15
191206139,7,0,6,8,4,25
191206140,3,7,7,2,7,26
191206141,4,3,1,4,1,13
191206142,5,5,2,4,9,25
191206143,5,4,7,7,1,24
191206144,5,3,5,2,0,15
191206145,5,1,0,1,8,15
191206146,7,4,9,0,8,28
191206147,0,8,6,1,9,24
191206148,8,3,3,7,4,25
191206149,0,0,6,8,6,20
191206150,2,4,1,1,4,12
191206151,1,1,0,8,0,10
191206152,6,3,4,0,9,22
191206153,7,5,6,5,5,28
191206154,3,7,5,0,5,20
191206155,9,0,3,8,0,20
191206156,0,7,0,0,2,9
191206157,2,5,2,5,7,21
191206158,8,0,1,2,7,18
191206159,5,9,4,7,0,25
191206160,3,5,0,5,8,21
191206161,0,2,3,7,8,20
191206162,5,4,8,3,5,25
191206163,2,7,6,2,7,24
191206164,8,1,0,3,1,13
191206165,6,8,8,0,4,26
191206166,3,2,5,1,2,13
191206167,8,8,0,3,8,27
191206168,2,0,8,8,4,22
191206169,3,4,4,8,0,19
191206170,4,0,3,7,1,15
191206171,6,8,5,7,4,30
191206172,3,1,5,7,1,17
191206173,3,0,6,5,2,16
191206174,0,9,7,0,9,25
191206175,5,9,3,3,5,25
191206176,2,3,2,3,9,19
191206177,0,2,3,0,3,8
191206178,4,7,2,5,4,22
191206179,2,1,4,5,5,17
191206180,5,3,0,3,5,16
191206181,2,3,0,6,6,17
191206182,6,6,4,3,2,21
191206183,5,0,0,5,3,13
191206184,3,1,4,8,3,19
191206185,4,5,0,8,5,22
191206186,0,0,8,0,6,14
191206187,0,5,5,0,7,17
191206188,1,0,4,9,2,16
191206189,4,1,0,3,5,13
191206190,2,0,2,4,1,9
191206191,1,2,6,4,8,21
191206192,6,2,3,3,5,19
191206193,3,6,2,0,9,20
191206194,7,5,5,1,3,21
191206195,1,7,2,2,8,20
191206196,3,4,7,1,8,23
191206197,4,6,8,8,5,31
191206198,6,4,9,0,5,24
191206199,2,2,5,7,8,24
191206200,0,2,7,6,1,16
191206201,4,5,6,0,8,23
191206202,5,5,5,5,7,27
191206203,7,6,6,6,8,33
191206204,1,9,7,4,2,23
191206205,7,5,1,8,5,26
191206206,9,7,3,1,5,25
191206207,1,4,5,0,1,11
191206208,6,9,8,1,0,24
191206209,5,4,7,9,6,31
191206210,5,6,4,5,4,24
191206211,3,3,6,5,6,23
191206212,2,8,2,3,1,16
191206213,2,3,0,2,8,15
191206214,7,6,7,2,9,31
191206215,4,0,8,2,8,22
191206216,1,5,5,8,0,19
191206217,2,4,0,6,4,16
191206218,6,2,5,6,6,25
191206219,8,9,5,1,6,29
191206220,0,4,7,5,4,20
191206221,9,0,2,4,9,24
191206222,1,7,7,1,5,21
191206223,6,4,4,8,9,31
191206224,9,8,0,4,6,27
191206225,8,8,6,6,1,29
191206226,3,1,6,6,6,22
191206227,1,9,6,6,9,31
191206228,4,7,8,4,9,32
191206229,7,2,5,1,3,18
191206230,0,6,5,2,6,19
191206231,3,1,2,6,7,19
191206232,1,7,9,1,8,26
191206233,2,3,2,0,0,7
191206234,5,1,2,9,9,26
191206235,8,3,6,7,5,29
191206236,5,5,7,2,3,22
191206237,8,8,7,1,5,29
191206238,3,1,8,3,0,15
191206239,0,2,9,9,1,21
191206240,8,6,3,2,8,27
191206241,3,3,0,9,6,21
191206242,3,4,8,9,3,27
191206243,7,1,3,9,7,27
191206244,9,2,0,8,8,27
191206245,1,8,5,0,4,18
191206246,9,8,3,0,6,26
191206247,6,3,1,3,8,21
191206248,9,7,6,5,3,30
191206249,0,4,0,1,9,14
191206250,4,5,2,9,2,22
191206251,4,9,2,7,7,29
191206252,7,9,4,8,8,36
191206253,3,3,6,4,3,19
191206254,6,0,2,6,5,19
191206255,3,8,9,5,9,34
191206256,1,1,4,2,2,10
191206257,0,1,8,4,4,17
191206258,6,5,0,5,8,24
191206259,5,0,4,0,9,18
191206260,6,4,9,2,3,24
191206261,2,9,4,0,6,21
191206262,7,1,2,1,3,14
191206263,2,0,8,0,1,11
191206264,8,0,2,1,3,14
191206265,0,8,3,6,3,20
191206266,3,4,6,8,2,23
191206267,1,2,1,3,8,15
191206268,2,4,6,6,1,19
191206269,0,4,2,5,7,18
191206270,0,7,3,8,1,19
191206271,0,8,5,8,1,22
191206272,1,5,0,5,2,13
191206273,1,1,7,3,1,13
191206274,3,6,4,5,7,25
191206275,5,3,0,6,5,19
191206276,9,6,7,3,4,29
191206277,0,5,2,8,5,20
191206278,2,3,1,8,5,19
191206279,7,7,9,4,1,28
191206280,8,3,4,3,0,18
191206281,0,3,0,5,8,16
191206282,0,4,3,5,2,14
191206283,1,4,0,0,3,8
191206284,8,3,6,7,9,33
191206285,1,7,3,3,0,14
191206286,9,8,1,2,3,23
191206287,4,1,7,9,2,23
191206288,9,9,7,3,9,37
191206289,7,6,0,9,3,25
191206290,1,8,1,3,9,22
191206291,6,9,7,8,4,34
191206292,5,2,1,4,8,20
191206293,3,1,3,1,5,13
191206294,7,6,5,3,3,24
191206295,3,8,1,2,9,23
191206296,4,2,9,4,2,21
191206297,2,0,6,4,8,20
191206298,4,1,1,1,3,10
191206299,5,4,2,4,9,24
191206300,6,4,9,3,4,26
191206301,9,2,2,3,5,21
191206302,9,5,6,1,4,25
191206303,2,5,1,6,0,14
191206304,1,3,2,3,0,9
191206305,0,5,4,4,2,15
191206306,7,7,5,2,5,26
191206307,6,5,3,5,3,22
191206308,1,0,6,4,4,15
191206309,2,4,9,2,2,19
191206310,3,0,4,0,1,8
191206311,7,6,6,3,6,28
191206312,6,5,2,0,3,16
191206313,4,1,7,9,9,30
191206314,2,4,6,1,5,18
191206315,7,9,5,1,9,31
191206316,0,0,8,6,0,14
191206317,3,2,3,5,3,16
191206318,8,3,7,1,6,25
191206319,9,6,3,6,2,26
191206320,2,7,1,5,3,18
191206321,2,5,7,9,4,27
191206322,9,7,2,3,4,25
191206323,4,8,6,0,6,24
191206324,6,1,4,7,6,24
191206325,9,8,5,4,7,33
191206326,7,0,3,3,1,14
191206327,1,3,8,0,6,18
191206328,0,4,1,7,4,16
191206329,0,3,0,7,5,15
191206330,0,1,3,6,7,17
191206331,0,3,4,8,6,21
191206332,3,1,2,7,6,19
191206333,3,2,3,4,5,17
191206334,4,3,3,9,5,24
191206335,7,6,8,6,8,35
191206336,9,4,4,6,4,27
191206337,6,5,2,5,3,21
191206338,5,2,6,3,4,20
191206339,1,7,5,2,5,20
191206340,7,1,5,8,1,22
191206341,1,4,0,0,9,14
191206342,7,2,2,2,0,13
191206343,2,4,4,4,9,23
191206344,5,8,7,3,8,31
191206345,4,0,2,1,6,13
191206346,9,6,2,5,3,25
191206347,9,1,7,0,6,23
191206348,1,8,3,4,4,20
191206349,9,3,9,2,9,32
191206350,2,6,2,8,4,22
191206351,5,2,4,6,6,23
191206352,6,2,2,0,8,18
191206353,7,5,6,4,1,23
191206354,1,4,5,4,9,23
191206355,0,3,3,0,3,9
191206356,6,9,3,2,2,22
191206357,6,7,5,0,7,25
191206358,0,6,5,7,5,23
191206359,6,5,3,5,6,25
191206360,5,0,5,2,5,17
191206361,6,7,8,7,8,36
191206362,9,1,3,2,9,24
191206363,3,8,3,3,8,25
191206364,8,8,2,1,4,23
191206365,8,4,1,3,0,16
191206366,0,1,5,3,7,16
191206367,4,7,0,1,9,21
191206368,5,5,4,0,0,14
191206369,8,9,6,9,9,41
191206370,5,6,8,9,4,32
191206371,6,6,7,4,6,29
191206372,7,0,2,5,8,22
191206373,4,0,3,4,6,17
191206374,6,3,7,2,9,27
191206375,8,0,4,7,5,24
191206376,1,6,4,6,1,18
191206377,3,8,8,2,7,28
191206378,3,4,0,7,2,16
191206379,6,3,5,9,4,27
191206380,3,4,0,6,7,20
191206381,0,9,9,4,8,30
191206382,8,1,0,9,7,25
191206383,0,9,9,8,4,30
191206384,7,8,7,0,0,22
191206385,6,0,9,6,4,25
191206386,4,6,9,2,9,30
191206387,1,9,9,9,9,37
191206388,9,9,3,6,4,31
191206389,2,0,4,9,9,24
191206390,4,3,0,0,2,9
191206391,3,5,3,1,4,16
191206392,8,9,9,0,1,27
191206393,4,9,5,7,8,33
191206394,6,3,9,2,8,28
191206395,3,0,0,8,0,11
191206396,2,8,8,6,9,33
191206397,0,9,4,6,9,28
191206398,2,3,0,5,1,11
191206399,9,2,4,6,8,29
191206400,5,5,7,2,7,26
191206401,9,6,4,1,5,25
191206402,7,8,2,0,3,20
191206403,4,1,9,2,6,22
191206404,4,0,8,3,2,17
191206405,3,3,8,4,8,26
191206406,4,4,1,9,1,19
191206407,4,7,5,2,2,20
191206408,0,7,9,4,5,25
191206409,4,0,8,7,1,20
191206410,1,5,3,1,6,16
191206411,8,6,0,1,2,17
191206412,9,6,1,4,7,27
191206413,4,1,2,3,6,16
191206414,5,6,0,1,3,15
191206415,0,0,6,3,0,9
191206416,2,0,1,9,8,20
191206417,5,5,6,2,9,27
191206418,0,0,5,1,6,12
191206419,8,4,9,6,0,27
191206420,5,2,9,8,8,32
191206421,4,1,4,4,9,22
191206422,5,8,4,8,0,25
191206423,1,3,4,0,8,16
191206424,0,3,9,2,3,17
191206425,7,7,3,7,7,31
191206426,0,1,5,0,4,10
191206427,0,8,0,5,3,16
191206428,0,0,6,6,7,19
191206429,6,9,2,5,2,24
191206430,1,9,8,3,5,26
191206431,3,3,2,7,4,19
191206432,2,8,6,8,2,26
191206433,5,5,2,2,2,16
191206434,4,0,1,0,5,10
191206435,9,4,9,2,2,26
191206436,7,3,9,8,5,32
191206437,1,0,2,4,7,14
191206438,9,2,7,1,2,21
191206439,3,1,2,2,9,17
191206440,0,8,2,5,0,15
191206441,0,8,3,2,5,18
191206442,3,0,0,2,2,7
191206443,9,0,6,2,5,22
191206444,8,5,5,2,6,26
191206445,6,4,5,1,4,20
191206446,1,6,7,4,6,24
191206447,9,5,4,0,5,23
191206448,3,9,7,5,3,27
191206449,8,3,8,8,1,28
191206450,4,2,0,4,1,11
191206451,4,2,4,7,7,24
191206452,0,5,4,5,5,19
191206453,7,1,6,7,8,29
191206454,1,6,9,2,6,24
191206455,4,7,8,6,3,28
191206456,0,9,6,8,1,24
191206457,2,7,2,0,3,14
191206458,4,2,1,2,2,11
191206459,6,2,5,2,7,22
191206460,4,7,1,0,9,21
191206461,2,0,7,9,0,18
191206462,6,6,5,0,0,17
191206463,2,5,4,3,9,23
191206464,9,5,3,7,3,27
191206465,9,7,5,7,1,29
191206466,6,1,2,9,2,20
191206467,0,3,5,6,1,15
191206468,4,7,1,3,3,18
191206469,8,2,7,0,1,18
191206470,5,4,9,0,3,21
191206471,1,5,0,2,1,9
191206472,4,6,8,8,9,35
191206473,0,5,8,8,5,26
191206474,3,3,7,4,2,19
191206475,2,2,9,9,7,29
191206476,1,4,5,5,7,22
191206477,4,4,7,1,0,16
191206478,7,0,5,8,5,25
191206479,2,6,7,8,0,23
191206480,0,7,3,3,8,21
191206481,4,6,0,9,9,28
191206482,3,4,2,9,7,25
191206483,9,3,8,6,4,30
191206484,8,7,1,1,6,23
191206485,0,1,5,4,2,12
191206486,9,6,9,9,7,40
191206487,0,0,1,2,9,12
191206488,5,4,0,4,8,21
191206489,2,0,4,2,5,13
191206490,5,4,5,2,4,20
191206491,6,9,7,3,8,33
191206492,2,6,8,0,0,16
191206493,0,9,3,0,5,17
191206494,5,4,4,1,7,21
191206495,1,1,1,2,2,7
191206496,2,8,9,0,5,24
191206497,4,5,4,2,1,16
191206498,4,1,3,6,4,18
191206499,7,5,4,6,3,25
191206500,1,3,0,6,8,18
191206501,4,4,5,3,9,25
191206502,8,1,1,0,6,16
191206503,5,6,8,2,6,27
191206504,1,9,1,1,1,13
191206505,4,0,3,6,6,19
191206506,0,5,6,0,8,19
191206507,4,6,9,0,9,28
191206508,6,3,8,3,2,22
191206509,3,7,2,3,8,23
191206510,5,3,6,7,5,26
191206511,9,1,3,3,8,24
191206512,0,4,4,2,7,17
191206513,8,3,0,5,1,17
191206514,9,4,4,5,4,26
191206515,5,7,8,8,1,29
191206516,7,8,2,6,9,32
191206517,2,2,2,8,8,22
191206518,9,7,4,6,0,26
191206519,8,1,5,1,6,21
191206520,6,1,4,4,9,24
191206521,8,8,1,9,4,30
191206522,0,7,1,9,6,23
191206523,4,2,7,7,4,24
191206524,7,8,2,8,3,28
191206525,4,1,1,4,8,18
191206526,7,0,2,8,9,26
191206527,2,8,0,0,7,17
191206528,5,7,5,1,0,18
191206529,7,6,6,0,3,22
191206530,7,9,3,0,5,24
191206531,0,2,1,9,8,20
191206532,3,6,2,9,1,21
191206533,4,9,3,8,9,33
191206534,2,4,4,7,2,19
191206535,7,4,8,7,9,35
191206536,9,7,3,5,0,24
191206537,9,2,6,6,6,29
191206538,4,5,8,3,9,29
191206539,2,8,6,6,6,28
191206540,7,4,6,2,4,23
191206541,2,2,2,3,3,12
191206542,7,6,9,8,3,33
191206543,9,1,2,6,9,27
191206544,1,7,4,7,6,25
191206545,4,6,9,0,2,21
191206546,4,3,1,6,4,18
191206547,5,0,8,8,4,25
191206548,8,4,9,6,1,28
191206549,6,9,1,3,8,27
191206550,2,4,2,8,7,23
191206551,5,4,7,1,8,25
191206552,8,2,4,9,5,28
191206553,0,5,8,5,7,25
191206554,0,6,6,8,2,22
191206555,2,4,8,5,2,21
191206556,3,6,8,9,8,34
191206557,2,6,0,7,4,19
191206558,5,6,3,0,2,16
191206559,3,9,1,1,0,14
191206560,3,5,8,4,4,24
191206561,9,5,6,5,2,27
191206562,1,4,0,5,1,11
191206563,1,3,3,3,9,19
191206564,0,7,7,1,1,16
191206565,9,7,6,0,4,26
191206566,4,3,4,1,3,15
191206567,9,0,6,9,6,30
191206568,8,0,0,5,7,20
191206569,0,0,3,7,7,17
191206570,7,8,4,9,0,28
191206571,8,7,6,3,8,32
191206572,5,1,7,1,9,23
191206573,8,8,1,2,1,20
191206574,5,2,9,4,0,20
191206575,9,9,0,8,5,31
191206576,8,1,7,6,9,31
191206577,2,3,9,7,1,22
191206578,3,5,6,1,2,17
191206579,2,4,2,0,7,15
191206580,2,5,4,7,3,21
191206581,7,6,5,1,7,26
191206582,3,8,0,3,9,23
191206583,5,2,1,3,4,15
191206584,9,8,4,1,2,24
191206585,2,3,7,9,1,22
191206586,0,6,7,1,8,22
191206587,3,2,7,0,2,14
191206588,3,2,0,1,2,8
191206589,0,4,4,4,9,21
191206590,0,0,4,0,9,13
191206591,7,0,1,4,6,18
191206592,9,2,0,8,2,21
191206593,2,7,9,9,4,31
191206594,3,2,8,5,2,20
191206595,1,7,4,5,8,25
191206596,5,1,4,4,4,18
191206597,9,4,9,5,4,31
191206598,7,3,2,7,9,28
191206599,1,1,2,1,1,6
191206600,3,7,0,2,5,17
191206601,7,3,3,4,9,26
191206602,6,0,3,2,1,12
191206603,0,5,9,9,6,29
191206604,2,6,7,0,7,22
191206605,6,3,0,8,0,17
191206606,1,6,8,6,4,25
191206607,4,3,7,4,1,19
191206608,9,0,7,8,2,26
191206609,0,1,6,8,2,17
191206610,9,4,3,8,1,25
191206611,3,8,3,1,2,17
191206612,9,8,0,2,5,24
191206613,4,6,0,9,1,20
191206614,6,0,4,7,4,21
191206615,6,4,9,5,5,29
191206616,5,3,6,3,5,22
191206617,9,7,1,5,4,26
191206618,0,8,6,2,7,23
191206619,5,7,5,2,4,23
191206620,3,6,3,3,0,15
191206621,8,5,8,5,5,31
191206622,0,2,4,7,1,14
191206623,0,8,7,6,0,21
191206624,4,7,0,7,5,23
191206625,6,0,8,7,7,28
191206626,7,9,6,4,2,28
191206627,7,4,3,4,6,24
191206628,7,8,1,8,0,24
191206629,4,4,9,7,9,33
191206630,9,7,8,5,5,34
191206631,9,9,5,9,8,40
191206632,6,0,0,6,2,14
191206633,8,9,6,0,5,28
191206634,7,4,8,8,7,34
191206635,4,3,2,1,9,19
191206636,3,9,9,2,7,30
191206637,0,1,4,0,1,6
191206638,0,0,4,0,8,12
191206639,3,7,6,1,9,26
191206640,4,4,3,5,4,20
191206641,4,0,6,9,6,25
191206642,8,4,8,5,3,28
191206643,0,7,7,0,8,22
191206644,3,9,7,0,0,19
191206645,6,8,2,3,2,21
191206646,8,2,5,4,1,20
191206647,4,6,7,3,8,28
191206648,6,3,4,4,1,18
191206649,7,0,6,0,7,20
191206650,3,7,7,7,6,30
191206651,1,5,6,0,6,18
191206652,8,9,5,4,6,32
191206653,6,6,3,8,2,25
191206654,9,0,6,5,5,25
191206655,8,1,2,6,6,23
191206656,6,2,5,5,3,21
191206657,1,3,9,1,3,17
191206658,1,0,2,8,1,12
191206659,1,9,5,9,7,31
191206660,8,8,9,2,2,29
191206661,8,8,8,7,1,32
191206662,5,8,2,0,1,16
191206663,0,3,4,2,6,15
191206664,3,8,9,0,6,26
191206665,8,0,1,8,2,19
191206666,0,5,3,0,3,11
191206667,6,9,3,3,3,24
191206668,6,0,1,6,8,21
191206669,4,3,9,3,4,23
191206670,5,0,0,3,1,9
191206671,6,8,4,2,0,20
191206672,6,1,8,7,9,31
191206673,1,4,1,5,3,14
191206674,8,6,7,2,5,28
191206675,2,4,4,2,0,12
191206676,1,8,4,9,1,23
191206677,2,6,0,4,3,15
191206678,8,4,9,2,9,32
191206679,2,8,6,7,8,31
191206680,1,4,3,9,2,19
191206681,5,8,5,4,9,31
191206682,4,3,2,6,6,21
191206683,3,8,2,1,7,21
191206684,0,9,9,3,7,28
191206685,2,1,0,4,3,10
191206686,9,1,3,0,1,14
191206687,1,3,8,6,0,18
191206688,2,4,7,7,6,26
191206689,0,9,7,5,2,23
191206690,2,0,6,4,6,18
191206691,2,9,2,3,8,24
191206692,9,3,6,1,6,25
191206693,8,4,6,2,4,24
191206694,6,4,7,1,0,18
191206695,4,9,8,4,2,27
191206696,9,0,8,1,8,26
191206697,2,8,0,4,4,18
191206698,8,5,3,5,9,30
191206699,6,0,5,0,1,12
191206700,6,0,1,8,8,23
191206701,3,4,3,6,1,17
191206702,2,1,7,1,3,14
191206703,0,9,7,1,3,20
191206704,6,5,3,2,6,22
191206705,6,9,8,8,0,31
191206706,9,5,8,3,2,27
191206707,5,6,4,5,7,27
191206708,4,8,7,0,3,22
191206709,6,7,7,7,8,35
191206710,4,7,6,4,4,25
191206711,9,9,9,0,3,30
191206712,4,1,6,3,7,21
191206713,4,5,2,7,7,25
191206714,0,2,6,1,5,14
191206715,8,4,1,5,5,23
191206716,5,8,2,2,6,23
191206717,1,6,1,3,2,13
191206718,8,9,5,2,1,25
191206719,8,4,8,3,3,26
191206720,0,3,4,2,9,18
191206721,2,2,7,7,0,18
191206722,5,2,4,6,2,19
191206723,2,1,7,9,4,23
191206724,5,0,6,9,7,27
191206725,5,8,5,4,7,29
191206726,1,1,1,0,0,3
191206727,5,0,1,3,7,16
191206728,6,9,9,9,2,35
191206729,4,3,6,8,6,27
191206730,8,8,9,1,1,27
191206731,9,5,6,0,6,26
191206732,5,4,3,2,7,21
191206733,0,6,3,0,8,17
191206734,7,4,7,8,8,34
191206735,9,2,5,4,2,22
191206736,7,6,6,1,2,22
191206737,2,8,1,9,1,21
191206738,9,2,9,0,9,29
191206739,9,1,8,5,8,31
191206740,6,8,8,3,8,33
191206741,5,9,1,7,8,30
191206742,4,1,2,2,8,17
191206743,1,0,1,6,4,12
191206744,7,7,1,7,3,25
191206745,2,9,0,7,8,26
191206746,1,9,2,0,3,15
191206747,3,1,9,5,9,27
191206748,5,1,4,2,1,13
191206749,3,5,7,7,5,27
191206750,2,8,9,3,4,26
191206751,4,2,6,4,1,17
191206752,1,9,3,9,6,28
191206753,6,2,3,3,7,21
191206754,5,8,7,4,7,31
191206755,2,2,2,5,1,12
191206756,8,5,4,7,8,32
191206757,7,9,5,7,3,31
191206758,9,2,4,2,7,24
191206759,4,5,8,3,2,22
191206760,5,7,9,4,4,29
191206761,0,5,5,5,5,20
191206762,6,3,8,5,2,24
191206763,2,2,4,2,8,18
191206764,7,0,4,1,4,16
191206765,2,1,4,0,9,16
191206766,7,5,3,0,8,23
191206767,2,2,2,6,1,13
191206768,6,8,6,0,6,26
191206769,0,1,2,3,5,11
191206770,2,8,8,7,4,29
191206771,2,9,4,9,6,30
191206772,6,3,3,4,1,17
191206773,6,9,4,8,4,31
191206774,5,1,9,7,3,25
191206775,7,8,1,6,5,27
191206776,6,6,6,4,7,29
191206777,4,6,3,3,9,25
191206778,6,7,3,9,3,28
191206779,7,3,9,4,3,26
191206780,8,1,6,8,4,27
191206781,9,1,5,2,6,23
191206782,5,4,6,9,9,33
191206783,8,1,9,6,7,31
191206784,4,1,5,3,4,17
191206785,3,0,1,2,5,11
191206786,5,0,7,5,7,24
191206787,7,5,3,3,3,21
191206788,5,5,2,9,4,25
191206789,6,5,3,3,1,18
191206790,4,7,8,2,7,28
191206791,0,9,1,5,3,18
191206792,7,2,8,6,4,27
191206793,4,3,3,1,8,19
191206794,0,6,1,6,4,17
191206795,3,5,8,6,4,26
191206796,9,1,2,8,1,21
191206797,5,4,1,8,7,25
191206798,5,8,1,6,6,26
191206799,4,9,6,1,1,21
191206800,3,7,9,1,7,27
191206801,2,3,5,6,7,23
191206802,6,7,4,9,3,29
191206803,4,5,8,1,3,21
191206804,8,2,5,9,9,33
191206805,2,5,3,8,9,27
191206806,4,6,4,2,4,20
191206807,9,6,1,6,1,23
191206808,5,9,6,9,9,38
191206809,7,8,2,7,5,29
191206810,0,0,4,1,4,9
191206811,1,6,6,3,7,23
191206812,9,4,7,7,2,29
191206813,3,0,9,6,7,25
191206814,9,1,2,8,8,28
191206815,9,9,1,8,3,30
191206816,0,2,0,6,2,10
191206817,9,5,5,3,4,26
191206818,9,0,4,7,1,21
191206819,2,2,4,7,8,23
191206820,7,2,0,9,6,24
191206821,2,2,5,0,2,11
191206822,8,3,5,7,0,23
191206823,3,4,6,1,5,19
191206824,2,5,5,5,4,21
191206825,6,4,2,0,9,21
191206826,2,0,6,9,6,23
191206827,5,2,0,8,8,23
191206828,3,4,7,5,4,23
191206829,9,8,6,2,5,30
191206830,8,2,7,7,9,33
191206831,6,5,8,0,5,24
191206832,7,3,7,1,8,26
191206833,9,7,3,7,3,29
191206834,2,9,9,4,9,33
191206835,5,6,5,4,3,23
191206836,8,9,6,5,7,35
191206837,9,2,7,3,1,22
191206838,0,0,6,8,0,14
191206839,1,7,4,0,1,13
191206840,9,2,5,3,9,28
191206841,0,7,3,1,9,20
191206842,3,4,7,2,3,19
191206843,0,0,8,1,8,17
191206844,8,9,2,3,0,22
191206845,9,7,4,2,5,27
191206846,5,8,4,5,9,31
191206847,6,1,1,9,6,23
191206848,5,3,0,1,2,11
191206849,9,3,4,7,8,31
191206850,7,2,6,7,9,31
191206851,7,3,5,2,5,22
191206852,4,8,8,9,1,30
191206853,1,3,0,5,2,11
191206854,2,5,9,7,4,27
191206855,2,2,7,9,6,26
191206856,7,7,4,4,8,30
191206857,8,8,5,9,5,35
191206858,8,1,1,4,4,18
191206859,1,0,1,0,3,5
191206860,0,8,8,4,9,29
191206861,7,9,2,7,7,32
191206862,8,8,3,1,7,27
191206863,8,1,7,5,3,24
191206864,7,5,1,5,1,19
191206865,2,8,5,1,0,16
191206866,6,3,2,1,9,21
191206867,9,3,5,7,4,28
191206868,5,3,9,0,7,24
191206869,0,0,1,0,8,9
191206870,1,7,3,9,5,25
191206871,4,5,3,7,5,24
191206872,1,5,8,7,5,26
191206873,1,1,7,3,5,17
191206874,8,5,4,5,6,28
191206875,4,8,2,2,1,17
191206876,6,2,0,3,8,19
191206877,8,3,8,5,8,32
191206878,7,2,7,0,9,25
191206879,5,4,6,5,1,21
191206880,7,7,5,7,5,31
191206881,9,4,1,5,2,21
191206882,7,1,8,8,6,30
191206883,4,4,9,8,0,25
191206884,0,5,0,1,6,12
191206885,3,4,6,3,0,16
191206886,1,4,3,6,9,23
191206887,9,8,7,9,1,34
191206888,8,9,8,1,3,29
191206889,0,5,9,8,0,22
191206890,7,7,5,3,5,27
191206891,1,4,1,2,0,8
191206892,7,0,9,4,1,21
191206893,9,3,8,7,5,32
191206894,2,6,0,3,5,16
191206895,0,1,7,3,1,12
191206896,3,5,4,8,5,25
191206897,1,6,3,8,5,23
191206898,8,6,4,6,2,26
191206899,9,9,0,5,2,25
191206900,4,6,5,3,8,26
191206901,4,2,8,8,8,30
191206902,4,0,3,4,5,16
191206903,3,8,9,8,8,36
191206904,9,2,5,4,5,25
191206905,4,1,5,2,0,12
191206906,7,4,3,7,0,21
191206907,5,9,4,5,3,26
191206908,5,4,9,2,3,23
191206909,3,5,3,5,3,19
191206910,7,0,9,5,4,25
191206911,3,0,2,5,8,18
191206912,9,9,0,8,0,26
191206913,8,1,7,1,4,21
191206914,5,7,5,9,1,27
191206915,7,6,4,9,2,28
191206916,7,1,8,3,5,24
191206917,0,0,1,6,6,13
191206918,2,5,5,3,1,16
191206919,6,7,7,0,7,27
191206920,0,5,6,8,2,21
191206921,0,1,0,8,6,15
191206922,0,1,4,1,8,14
191206923,2,7,6,8,0,23
191206924,1,6,1,6,3,17
191206925,7,0,6,7,4,24
191206926,0,6,9,1,8,24
191206927,3,3,2,0,9,17
191206928,8,7,1,0,4,20
191206929,0,5,5,8,1,19
191206930,1,6,7,3,0,17
191206931,0,8,9,9,1,27
191206932,0,5,9,0,0,14
191206933,9,8,2,4,2,25
191206934,0,9,3,0,3,15
191206935,8,9,7,8,6,38
191206936,9,6,3,0,8,26
191206937,9,1,3,7,6,26
191206938,9,8,9,2,1,29
191206939,1,3,7,2,9,22
191206940,7,6,0,7,5,25
191206941,8,0,8,1,1,18
191206942,9,2,0,0,7,18
191206943,8,6,1,1,9,25
191206944,6,1,6,7,8,28
191206945,1,7,1,2,3,14
191206946,1,0,6,4,1,12
191206947,5,8,2,8,3,26
191206948,2,7,7,7,1,24
191206949,7,3,8,7,2,27
191206950,1,9,1,5,0,16
191206951,1,6,9,2,4,22
191206952,5,1,0,4,3,13
191206953,5,2,8,5,7,27
191206954,3,4,3,7,7,24
191206955,8,2,6,7,3,26
191206956,1,1,3,4,2,11
191206957,5,1,6,2,0,14
191206958,1,2,9,1,6,19
191206959,5,6,3,9,5,28
191206960,2,0,5,4,4,15
191206961,1,5,9,2,5,22
191206962,7,0,8,3,8,26
191206963,6,2,4,2,2,16
191206964,8,7,3,4,3,25
191206965,3,5,4,5,2,19
191206966,5,9,5,0,4,23
191206967,7,8,8,8,9,40
191206968,8,3,9,4,9,33
191206969,7,5,4,6,7,29
191206970,8,1,7,3,3,22
191206971,8,9,2,5,8,32
191206972,9,7,5,0,7,28
191206973,8,0,1,5,3,17
191206974,9,0,3,5,6,23
191206975,4,3,9,5,2,23
191206976,5,6,7,2,6,26
191206977,7,5,1,9,1,23
191206978,1,3,5,3,5,17
191206979,9,0,2,4,1,16
191206980,5,9,3,1,8,26
191206981,4,6,4,0,9,23
191206982,0,4,4,8,1,17
191206983,4,3,7,7,7,28
191206984,8,0,1,9,8,26
191206985,1,5,1,1,3,11
191206986,8,7,6,8,1,30
191206987,9,7,3,1,0,20
191206988,9,2,1,5,4,21
191206989,9,6,0,5,2,22
191206990,6,2,3,6,7,24
191206991,2,2,7,7,8,26
191206992,1,1,3,9,5,19
191206993,2,0,3,2,5,12
191206994,6,8,2,9,9,34
191206995,1,5,5,4,0,15
191206996,7,2,0,5,8,22
191206997,4,4,9,0,9,26
191206998,2,2,9,5,6,24
191206999,5,8,7,0,2,22
1912061000,2,7,5,9,8,31
1912061001,1,3,6,5,6,21
1912061002,3,3,8,8,1,23
1912061003,5,4,6,0,4,19
1912061004,2,5,3,0,8,18
1912061005,8,8,5,6,4,31
1912061006,3,4,0,4,9,20
1912061007,4,5,7,5,2,23
1912061008,5,3,9,7,8,32
1912061009,3,7,8,7,5,30
1912061010,7,0,8,5,6,26
1912061011,7,6,0,5,1,19
1912061012,5,1,5,6,6,23
1912061013,4,6,4,4,7,25
1912061014,4,2,9,4,9,28
1912061015,0,6,6,5,6,23
1912061016,8,7,0,3,3,21
1912061017,4,6,0,1,8,19
1912061018,6,6,2,5,5,24
1912061019,8,5,2,5,2,22
1912061020,3,6,4,1,9,23
1912061021,3,4,2,9,6,24
1912061022,3,3,8,8,4,26
1912061023,0,9,2,3,9,23
1912061024,0,8,1,8,1,18
1912061025,3,1,6,1,0,11
1912061026,2,7,7,9,1,26
1912061027,5,7,4,8,8,32
1912061028,8,2,3,9,4,26
1912061029,6,1,1,8,5,21
1912061030,0,7,2,7,9,25
1912061031,0,3,2,8,4,17
1912061032,5,0,5,8,1,19
1912061033,3,8,4,8,7,30
1912061034,3,5,7,0,0,15
1912061035,2,9,5,4,0,20
1912061036,7,0,9,3,3,22
1912061037,0,6,3,4,1,14
1912061038,7,9,8,0,2,26
1912061039,1,3,2,5,0,11
1912061040,2,4,5,7,2,20
1912061041,8,4,3,7,8,30
1912061042,9,4,7,8,1,29
1912061043,9,0,1,2,4,16
1912061044,4,3,2,1,0,10
1912061045,9,2,8,9,1,29
1912061046,0,0,9,0,0,9
1912061047,2,6,8,0,5,21
1912061048,2,1,1,4,0,8
1912061049,7,6,5,7,6,31
1912061050,4,6,7,9,6,32
1912061051,6,3,0,2,7,18
1912061052,2,3,3,2,3,13
1912061053,9,5,8,9,5,36
1912061054,2,0,7,2,8,19
1912061055,8,4,2,2,4,20
1912061056,2,7,6,0,4,19
1912061057,1,2,0,5,7,15
1912061058,2,7,3,9,6,27
1912061059,2,0,6,9,1,18
1912061060,2,6,1,2,9,20
1912061061,8,3,5,6,5,27
1912061062,7,8,9,0,1,25
1912061063,4,4,6,7,8,29
1912061064,7,6,1,6,6,26
1912061065,0,7,6,1,8,22
1912061066,8,1,9,7,7,32
1912061067,1,8,1,4,0,14
1912061068,1,3,8,8,1,21
1912061069,6,9,0,5,8,28
1912061070,4,8,0,7,5,24
1912061071,8,6,1,8,9,32
1912061072,4,6,6,8,1,25
1912061073,8,1,7,7,2,25
1912061074,3,2,9,0,4,18
1912061075,2,9,1,5,6,23
1912061076,6,3,0,0,5,14
1912061077,7,9,6,1,4,27
1912061078,1,9,1,8,6,25
1912061079,7,6,4,9,1,27
1912061080,8,3,4,1,6,22
1912061081,3,4,1,1,6,15
1912061082,9,1,1,4,4,19
1912061083,9,2,3,9,0,23
1912061084,2,1,9,5,2,19
1912061085,7,8,4,2,9,30
1912061086,8,1,0,9,1,19
1912061087,3,1,0,4,7,15
1912061088,5,5,6,5,0,21
1912061089,9,0,2,7,0,18
1912061090,4,2,5,9,8,28
1912061091,0,9,7,0,0,16
1912061092,8,1,9,8,8,34
1912061093,2,8,8,3,9,30
1912061094,8,0,1,0,8,17
1912061095,9,7,8,9,4,37
1912061096,8,9,6,5,2,30
1912061097,2,3,8,7,7,27
1912061098,3,3,8,0,8,22
1912061099,9,2,6,8,7,32
1912061100,4,3,7,8,1,23
1912061101,5,1,9,1,6,22
1912061102,1,2,4,9,1,17
1912061103,7,1,7,3,6,24
1912061104,4,1,6,5,5,21
1912061105,2,2,3,2,2,11
191207001,3,4,9,6,8,30
191207002,5,9,2,8,4,28
191207003,8,4,2,1,0,15
191207004,4,0,9,3,8,24
191207005,0,3,4,5,5,17
191207006,9,3,3,3,6,24
191207007,8,0,8,8,9,33
191207008,9,2,9,6,4,30
191207009,1,6,9,1,6,23
191207010,3,5,3,3,5,19
191207011,2,8,9,7,3,29
191207012,9,4,7,0,1,21
191207013,0,1,2,7,6,16
191207014,9,7,4,9,0,29
191207015,6,0,6,1,4,17
191207016,8,2,3,3,5,21
191207017,1,1,2,1,0,5
191207018,5,4,7,5,3,24
191207019,3,6,4,2,3,18
191207020,0,2,8,6,5,21
191207021,3,0,5,9,5,22
191207022,9,4,3,6,0,22
191207023,9,9,9,4,6,37
191207024,0,8,2,6,9,25
191207025,5,8,2,5,9,29
191207026,9,4,4,3,6,26
191207027,7,3,4,0,9,23
191207028,9,4,3,9,6,31
191207029,1,4,3,7,4,19
191207030,1,1,8,6,1,17
191207031,1,1,1,5,4,12
191207032,7,1,5,2,3,18
191207033,9,3,2,5,0,19
191207034,1,1,9,6,5,22
191207035,1,2,6,7,3,19
191207036,3,7,3,8,7,28
191207037,4,9,7,9,7,36
191207038,9,6,7,4,1,27
191207039,3,1,7,1,3,15
191207040,9,7,3,9,8,36
191207041,0,0,1,0,0,1
191207042,4,3,0,1,3,11
191207043,1,3,4,5,7,20
191207044,1,6,7,4,7,25
191207045,6,6,3,5,9,29
191207046,9,0,6,8,6,29
191207047,7,6,7,6,9,35
191207048,4,4,7,1,5,21
191207049,1,8,9,7,1,26
191207050,5,4,9,9,2,29
191207051,3,9,9,1,7,29
191207052,4,5,3,1,8,21
191207053,8,5,7,1,4,25
191207054,6,7,2,1,3,19
191207055,8,0,8,6,0,22
191207056,2,2,6,3,8,21
191207057,1,6,4,4,7,22
191207058,3,5,9,4,6,27
191207059,2,9,3,1,4,19
191207060,9,9,6,9,3,36
191207061,7,8,8,0,3,26
191207062,3,8,8,4,6,29
191207063,8,1,3,7,3,22
191207064,7,6,5,9,6,33
191207065,2,8,9,3,1,23
191207066,0,7,4,0,1,12
191207067,9,1,1,9,7,27
191207068,3,3,8,9,8,31
191207069,2,1,6,6,2,17
191207070,3,8,4,0,5,20
191207071,9,6,3,1,3,22
191207072,4,9,4,5,9,31
191207073,1,7,7,0,1,16
191207074,5,1,3,4,9,22
191207075,9,4,0,0,1,14
191207076,8,0,3,4,7,22
191207077,8,3,7,3,7,28
191207078,4,1,4,9,7,25
191207079,4,9,7,3,8,31
191207080,1,7,7,3,8,26
191207081,0,3,1,0,1,5
191207082,9,1,4,8,1,23
191207083,8,6,2,7,8,31
191207084,7,0,5,5,5,22
191207085,4,1,8,3,1,17
191207086,9,0,4,4,5,22
191207087,3,1,8,2,1,15
191207088,8,5,9,9,7,38
191207089,1,1,1,8,1,12
191207090,0,0,3,2,7,12
191207091,1,0,5,8,3,17
191207092,8,4,4,1,5,22
191207093,1,7,6,3,2,19
191207094,9,4,7,3,5,28
191207095,0,4,7,0,8,19
191207096,9,5,5,5,1,25
191207097,5,8,3,9,2,27
191207098,0,1,9,3,9,22
191207099,3,2,3,1,6,15
191207100,6,7,8,5,5,31
191207101,4,5,9,3,3,24
191207102,3,6,4,9,6,28
191207103,2,3,2,4,1,12
191207104,1,2,8,9,7,27
191207105,2,3,7,1,3,16
191207106,2,6,5,4,1,18
191207107,2,6,4,7,5,24
191207108,5,5,2,9,6,27
191207109,6,8,2,1,9,26
191207110,0,9,2,7,7,25
191207111,3,8,6,0,9,26
191207112,6,3,3,3,1,16
191207113,3,3,1,8,5,20
191207114,1,3,4,4,8,20
191207115,4,4,7,3,0,18
191207116,9,7,0,7,8,31
191207117,4,4,6,1,6,21
191207118,5,7,1,5,7,25
191207119,4,3,4,6,5,22
191207120,3,8,7,7,8,33
191207121,4,9,8,1,6,28
191207122,3,1,9,5,6,24
191207123,0,6,5,3,9,23
191207124,6,6,9,6,1,28
191207125,8,1,3,3,6,21
191207126,4,4,7,7,7,29
191207127,8,6,7,9,8,38
191207128,8,8,5,2,7,30
191207129,4,5,6,6,3,24
191207130,5,8,5,3,6,27
191207131,1,2,0,0,3,6
191207132,1,0,1,4,8,14
191207133,6,2,5,7,7,27
191207134,2,0,5,6,1,14
191207135,4,0,8,7,0,19
191207136,6,8,1,8,9,32
191207137,5,2,0,7,8,22
191207138,8,4,4,0,1,17
191207139,7,3,5,3,5,23
191207140,7,9,6,0,2,24
191207141,9,1,8,7,1,26
191207142,9,2,3,8,6,28
191207143,2,7,7,8,0,24
191207144,1,4,9,8,9,31
191207145,0,8,5,4,1,18
191207146,0,7,0,2,5,14
191207147,6,4,7,7,5,29
191207148,1,6,0,0,7,14
191207149,3,3,3,6,0,15
191207150,3,4,0,7,3,17
191207151,4,8,4,1,6,23
191207152,6,5,8,2,5,26
191207153,0,5,3,2,0,10
191207154,9,3,3,4,6,25
191207155,7,4,6,6,4,27
191207156,6,1,3,2,9,21
191207157,4,0,3,8,1,16
191207158,6,1,5,6,7,25
191207159,6,2,2,7,0,17
191207160,6,6,8,0,0,20
191207161,2,3,6,2,1,14
191207162,2,9,9,5,1,26
191207163,3,6,3,5,8,25
191207164,2,9,5,9,0,25
191207165,9,3,9,9,3,33
191207166,5,8,8,8,9,38
191207167,1,6,9,9,6,31
191207168,1,1,5,3,1,11
191207169,8,9,2,9,5,33
191207170,4,3,4,7,2,20
191207171,1,9,3,5,0,18
191207172,7,7,0,6,9,29
191207173,2,0,7,5,2,16
191207174,2,9,4,8,1,24
191207175,3,3,5,1,2,14
191207176,9,8,1,2,7,27
191207177,7,9,1,1,3,21
191207178,3,0,9,8,0,20
191207179,6,2,9,5,8,30
191207180,0,0,7,7,1,15
191207181,9,8,6,7,2,32
191207182,7,3,9,3,5,27
191207183,0,9,0,2,8,19
191207184,9,9,5,9,5,37
191207185,0,1,1,8,5,15
191207186,5,8,1,5,1,20
191207187,4,5,9,6,4,28
191207188,0,8,2,0,5,15
191207189,0,9,8,9,1,27
191207190,5,9,7,5,4,30
191207191,9,6,7,5,0,27
191207192,2,1,9,6,3,21
191207193,5,2,7,9,0,23
191207194,6,6,2,0,3,17
191207195,3,1,2,3,7,16
191207196,7,4,8,4,1,24
191207197,0,6,3,9,2,20
191207198,9,5,3,1,0,18
191207199,8,6,5,2,4,25
191207200,3,4,9,8,8,32
191207201,8,1,1,7,4,21
191207202,2,9,5,8,9,33
191207203,5,8,5,2,2,22
191207204,6,2,7,2,0,17
191207205,1,8,3,0,7,19
191207206,7,1,4,9,9,30
191207207,7,7,5,8,2,29
191207208,5,4,2,8,8,27
191207209,4,9,2,6,3,24
191207210,6,4,3,8,2,23
191207211,8,9,2,4,7,30
191207212,7,0,5,7,7,26
191207213,0,1,3,0,4,8
191207214,3,0,9,9,7,28
191207215,1,2,2,0,2,7
191207216,7,4,4,0,8,23
191207217,7,6,3,2,3,21
191207218,1,5,6,9,2,23
191207219,1,0,2,2,1,6
191207220,4,1,7,6,0,18
191207221,0,5,4,9,9,27
191207222,0,2,6,2,7,17
191207223,2,5,7,3,2,19
191207224,7,0,1,8,9,25
191207225,8,3,2,9,9,31
191207226,8,9,5,9,3,34
191207227,7,8,5,9,3,32
191207228,3,7,1,0,4,15
191207229,3,5,1,4,2,15
191207230,7,0,3,1,2,13
191207231,5,7,6,7,8,33
191207232,7,3,8,0,0,18
191207233,9,8,3,7,2,29
191207234,2,0,8,0,6,16
191207235,1,2,5,5,9,22
191207236,1,2,9,5,4,21
191207237,7,7,1,9,7,31
191207238,5,6,4,5,0,20
191207239,9,9,6,7,2,33
191207240,4,8,4,7,5,28
191207241,5,1,8,0,9,23
191207242,3,7,1,4,0,15
191207243,3,8,2,3,1,17
191207244,8,8,6,6,3,31
191207245,4,6,7,4,0,21
191207246,0,7,1,4,7,19
191207247,5,3,6,1,0,15
191207248,2,1,9,9,5,26
191207249,3,3,5,1,3,15
191207250,3,8,0,3,4,18
191207251,8,2,4,3,0,17
191207252,7,2,7,7,9,32
191207253,0,3,2,5,3,13
191207254,5,1,8,1,1,16
191207255,4,1,6,7,3,21
191207256,2,6,1,0,2,11
191207257,7,3,1,8,4,23
191207258,8,4,6,6,5,29
191207259,7,3,0,8,0,18
191207260,1,9,7,4,3,24
191207261,3,3,1,9,5,21
191207262,9,8,9,3,7,36
191207263,3,6,1,8,7,25
191207264,3,7,7,2,8,27
191207265,1,6,3,3,0,13
191207266,5,9,6,5,6,31
191207267,4,3,4,0,5,16
191207268,6,7,4,3,8,28
191207269,5,8,7,5,4,29
191207270,3,0,4,1,0,8
191207271,7,0,5,1,7,20
191207272,4,1,1,4,1,11
191207273,9,2,1,6,5,23
191207274,1,8,6,9,5,29
191207275,6,2,8,0,3,19
191207276,4,7,2,1,9,23
191207277,2,4,5,8,0,19
191207278,5,8,8,3,1,25
191207279,6,6,0,3,0,15
191207280,6,5,2,8,5,26
191207281,0,8,9,1,7,25
191207282,2,5,7,7,6,27
191207283,1,7,3,4,4,19
191207284,3,5,2,1,8,19
191207285,4,2,6,8,9,29
191207286,5,1,1,5,3,15
191207287,2,6,1,5,0,14
191207288,4,8,4,8,3,27
191207289,1,9,0,1,1,12
191207290,8,7,9,2,3,29
191207291,8,1,7,4,9,29
191207292,1,8,5,1,2,17
191207293,7,4,0,3,0,14
191207294,9,4,6,2,7,28
191207295,1,1,3,7,9,21
191207296,3,3,8,5,1,20
191207297,3,5,7,4,5,24
191207298,5,0,6,4,1,16
191207299,5,9,7,7,9,37
191207300,9,3,3,4,7,26
191207301,8,0,8,5,7,28
191207302,1,7,1,7,4,20
191207303,0,1,0,8,8,17
191207304,7,6,9,3,1,26
191207305,1,7,3,5,5,21
191207306,8,3,4,8,7,30
191207307,3,5,3,2,7,20
191207308,1,9,9,5,6,30
191207309,6,8,1,4,8,27
191207310,2,4,5,5,6,22
191207311,6,0,2,6,9,23
191207312,9,8,9,7,0,33
191207313,1,1,5,1,3,11
191207314,9,3,0,5,2,19
191207315,2,6,8,3,3,22
191207316,5,6,0,2,6,19
191207317,1,4,3,9,4,21
191207318,1,1,3,5,7,17
191207319,1,0,5,0,9,15
191207320,0,9,8,4,5,26
191207321,4,8,2,0,4,18
191207322,3,8,2,5,1,19
191207323,3,1,4,0,0,8
191207324,4,0,0,5,7,16
191207325,4,7,4,1,4,20
191207326,4,1,1,1,5,12
191207327,4,0,6,6,1,17
191207328,2,8,2,5,6,23
191207329,1,9,8,5,2,25
191207330,5,6,3,5,8,27
191207331,3,1,8,4,8,24
191207332,4,0,9,8,3,24
191207333,8,1,9,6,0,24
191207334,1,6,4,5,0,16
191207335,1,1,4,1,8,15
191207336,3,9,0,4,6,22
191207337,4,8,8,0,9,29
191207338,5,1,4,6,7,23
191207339,2,5,9,2,8,26
191207340,4,0,9,4,3,20
191207341,5,0,5,4,5,19
191207342,3,9,6,3,9,30
191207343,8,3,0,1,3,15
191207344,1,7,0,0,5,13
191207345,0,3,4,6,4,17
191207346,6,6,0,5,0,17
191207347,4,1,8,9,8,30
191207348,8,6,1,5,3,23
191207349,2,1,8,0,7,18
191207350,2,2,9,7,1,21
191207351,0,4,5,5,6,20
191207352,4,8,5,9,1,27
191207353,6,8,1,7,1,23
191207354,0,7,5,2,7,21
191207355,2,0,2,2,1,7
191207356,1,5,3,8,0,17
191207357,1,3,4,0,9,17
191207358,4,1,5,4,0,14
191207359,4,5,8,6,8,31
191207360,7,5,9,3,5,29
191207361,4,2,9,5,5,25
191207362,6,8,9,5,2,30
191207363,2,0,3,1,7,13
191207364,6,1,6,1,3,17
191207365,0,8,5,0,7,20
191207366,1,3,0,6,4,14
191207367,3,2,6,8,8,27
191207368,6,0,5,3,3,17
191207369,1,0,5,0,4,10
191207370,9,2,9,3,0,23
191207371,5,6,5,1,9,26
191207372,2,8,4,5,1,20
191207373,6,4,5,5,6,26
191207374,6,0,9,7,8,30
191207375,1,4,2,7,2,16
191207376,2,4,6,7,1,20
191207377,3,5,5,7,9,29
191207378,1,1,3,7,6,18
191207379,1,4,1,9,0,15
191207380,9,7,7,0,2,25
191207381,2,6,8,5,8,29
191207382,3,3,8,0,5,19
191207383,3,0,9,6,5,23
191207384,1,8,0,7,1,17
191207385,0,8,9,9,0,26
191207386,3,2,7,5,4,21
191207387,5,3,1,4,3,16
191207388,3,6,9,2,0,20
191207389,0,8,4,0,2,14
191207390,4,5,4,1,5,19
191207391,0,6,4,5,6,21
191207392,6,7,9,9,5,36
191207393,1,6,4,2,1,14
191207394,1,8,1,7,9,26
191207395,6,6,8,4,5,29
191207396,3,1,4,8,5,21
191207397,4,5,2,1,2,14
191207398,2,3,7,1,6,19
191207399,0,6,6,7,5,24
191207400,1,7,4,4,4,20
191207401,6,1,2,4,7,20
191207402,2,1,3,0,9,15
191207403,1,9,5,9,0,24
191207404,1,1,7,9,8,26
191207405,5,8,2,6,1,22
191207406,1,6,8,4,6,25
191207407,0,9,0,6,0,15
191207408,8,1,2,5,0,16
191207409,4,8,7,4,6,29
191207410,8,8,2,9,5,32
191207411,2,6,3,4,5,20
191207412,1,4,6,4,5,20
191207413,0,6,6,3,2,17
191207414,9,0,5,5,5,24
191207415,3,5,1,7,7,23
191207416,2,8,0,8,0,18
191207417,5,9,1,4,2,21
191207418,8,5,4,6,6,29
191207419,1,3,3,8,6,21
191207420,4,5,7,8,3,27
191207421,5,9,7,6,3,30
191207422,3,3,8,2,3,19
191207423,5,4,6,4,9,28
191207424,9,6,9,8,9,41
191207425,9,8,6,8,3,34
191207426,5,0,3,0,6,14
191207427,0,3,8,7,3,21
191207428,8,7,7,1,9,32
191207429,1,6,8,6,2,23
191207430,4,6,6,7,6,29
191207431,1,7,4,3,2,17
191207432,8,6,6,5,6,31
191207433,2,0,9,2,9,22
191207434,4,4,4,5,5,22
191207435,4,0,5,4,1,14
191207436,8,7,9,2,1,27
191207437,0,8,9,6,7,30
191207438,7,2,3,6,6,24
191207439,2,8,9,4,1,24
191207440,4,4,0,2,2,12
191207441,9,9,7,1,2,28
191207442,3,4,5,2,0,14
191207443,6,2,3,5,1,17
191207444,6,4,6,5,5,26
191207445,2,0,9,7,8,26
191207446,0,1,3,0,5,9
191207447,5,8,1,2,0,16
191207448,4,0,2,5,1,12
191207449,2,9,0,1,2,14
191207450,1,6,9,3,4,23
191207451,9,8,9,1,4,31
191207452,5,5,5,6,4,25
191207453,1,2,9,6,2,20
191207454,7,0,0,1,7,15
191207455,7,0,5,6,4,22
191207456,4,2,2,9,3,20
191207457,3,0,7,0,3,13
191207458,3,3,4,9,0,19
191207459,9,7,0,7,9,32
191207460,2,6,4,7,6,25
191207461,0,0,5,8,9,22
191207462,8,5,6,9,0,28
191207463,4,6,8,9,3,30
191207464,6,2,3,4,5,20
191207465,3,5,2,5,0,15
191207466,6,0,3,9,9,27
191207467,5,8,0,6,2,21
191207468,3,9,5,0,9,26
191207469,3,7,8,0,9,27
191207470,9,8,9,4,8,38
191207471,6,5,9,0,6,26
191207472,0,7,2,0,1,10
191207473,5,3,6,3,8,25
191207474,8,3,9,0,8,28
191207475,6,0,2,7,2,17
191207476,9,3,7,3,2,24
191207477,5,6,8,5,8,32
191207478,0,9,2,6,1,18
191207479,7,7,1,3,3,21
191207480,8,0,8,6,3,25
191207481,6,8,7,6,0,27
191207482,9,7,7,8,9,40
191207483,6,7,1,3,5,22
191207484,7,6,3,7,9,32
191207485,9,5,1,6,0,21
191207486,2,4,0,2,3,11
191207487,6,2,7,5,4,24
191207488,1,3,7,3,2,16
191207489,4,0,0,8,0,12
191207490,4,9,4,6,5,28
191207491,0,1,1,9,3,14
191207492,5,9,4,1,6,25
191207493,0,6,2,3,1,12
191207494,3,0,6,6,7,22
191207495,7,2,9,8,0,26
191207496,3,4,4,8,1,20
191207497,4,6,8,3,8,29
191207498,3,8,5,4,1,21
191207499,9,3,5,7,5,29
191207500,9,4,3,8,2,26
191207501,1,5,4,4,6,20
191207502,3,3,9,1,6,22
191207503,1,2,2,6,2,13
191207504,7,8,9,7,2,33
191207505,7,6,1,7,4,25
191207506,5,1,0,0,6,12
191207507,7,3,0,0,3,13
191207508,0,1,2,6,8,17
191207509,6,1,9,6,9,31
191207510,6,9,2,8,3,28
191207511,5,6,9,9,4,33
191207512,3,4,3,4,5,19
191207513,5,6,1,2,5,19
191207514,5,0,4,6,5,20
191207515,6,3,7,8,3,27
191207516,7,2,9,4,1,23
191207517,2,8,7,0,6,23
191207518,6,1,8,3,2,20
191207519,4,2,8,4,8,26
191207520,1,7,2,4,1,15
191207521,6,4,5,3,4,22
191207522,0,7,5,8,4,24
191207523,8,8,4,6,0,26
191207524,5,3,3,6,5,22
191207525,5,7,6,5,5,28
191207526,4,8,7,4,5,28
191207527,7,2,1,5,7,22
191207528,6,5,3,3,7,24
191207529,2,3,3,6,2,16
191207530,5,1,2,9,3,20
191207531,4,9,5,2,6,26
191207532,6,0,2,0,9,17
191207533,5,7,1,3,1,17
191207534,9,9,4,8,7,37
191207535,9,9,8,2,2,30
191207536,0,8,4,5,5,22
191207537,9,9,0,5,0,23
191207538,6,4,1,0,8,19
191207539,5,7,0,3,3,18
191207540,1,0,5,7,1,14
191207541,2,1,6,8,1,18
191207542,0,7,2,6,0,15
191207543,0,6,2,1,6,15
191207544,3,6,5,0,8,22
191207545,6,8,0,2,9,25
191207546,6,7,7,0,8,28
191207547,3,2,5,5,7,22
191207548,7,6,6,1,4,24
191207549,0,7,8,1,6,22
191207550,6,1,6,2,8,23
191207551,3,4,6,0,6,19
191207552,4,7,8,1,2,22
191207553,1,7,8,9,9,34
191207554,8,1,0,2,0,11
191207555,8,4,4,6,8,30
191207556,1,6,2,3,2,14
191207557,8,1,8,1,2,20
191207558,1,6,9,0,1,17
191207559,2,9,0,3,4,18
191207560,0,9,9,5,2,25
191207561,0,6,9,6,3,24
191207562,1,2,3,2,1,9
191207563,7,7,8,2,0,24
191207564,2,6,1,0,8,17
191207565,9,1,5,6,0,21
191207566,8,9,9,4,1,31
191207567,3,1,2,0,6,12
191207568,5,6,9,1,6,27
191207569,8,1,8,1,9,27
191207570,4,9,7,1,0,21
191207571,5,5,3,8,3,24
191207572,2,2,3,1,3,11
191207573,7,7,3,7,6,30
191207574,7,8,7,7,7,36
191207575,2,3,6,6,8,25
191207576,9,1,4,3,0,17
191207577,4,8,1,3,1,17
191207578,1,9,3,3,4,20
191207579,8,2,0,9,9,28
191207580,9,9,1,8,4,31
191207581,5,5,6,4,0,20
191207582,5,9,0,0,7,21
191207583,9,9,8,9,8,43
191207584,2,6,6,4,1,19
191207585,7,5,9,5,7,33
191207586,7,7,5,1,9,29
191207587,7,1,5,0,6,19
191207588,7,8,6,0,4,25
191207589,1,8,7,9,8,33
191207590,1,8,9,4,7,29
191207591,2,3,9,5,4,23
191207592,5,7,5,3,0,20
191207593,7,8,5,5,7,32
191207594,8,9,9,1,8,35
191207595,1,9,8,9,9,36
191207596,4,7,2,5,7,25
191207597,7,6,2,5,9,29
191207598,5,7,4,2,1,19
191207599,7,6,9,1,7,30
191207600,9,6,2,9,4,30
191207601,2,6,3,4,2,17
191207602,8,1,9,4,2,24
191207603,0,4,2,4,6,16
191207604,7,8,1,7,6,29
191207605,4,9,1,3,1,18
191207606,4,2,9,3,6,24
191207607,8,7,7,9,1,32
191207608,6,8,2,2,6,24
191207609,9,8,4,3,8,32
191207610,8,5,0,8,4,25
191207611,3,1,9,1,0,14
191207612,1,8,3,3,4,19
191207613,0,6,8,6,4,24
191207614,5,2,6,1,8,22
191207615,7,1,3,6,0,17
191207616,9,1,6,8,5,29
191207617,1,2,5,0,6,14
191207618,2,3,1,1,4,11
191207619,0,3,9,5,6,23
191207620,9,5,9,4,6,33
191207621,4,9,1,2,2,18
191207622,6,2,3,1,3,15
191207623,6,6,4,8,1,25
191207624,1,2,2,1,7,13
191207625,7,1,2,9,3,22
191207626,4,3,3,7,8,25
191207627,3,2,1,8,7,21
191207628,6,3,5,8,7,29
191207629,1,7,2,8,2,20
191207630,9,5,6,9,4,33
191207631,7,8,0,6,0,21
191207632,6,8,3,9,5,31
191207633,9,8,2,4,5,28
191207634,5,0,7,5,2,19
191207635,9,7,2,0,3,21
191207636,1,7,8,1,5,22
191207637,1,2,0,6,9,18
191207638,8,0,2,8,0,18
191207639,5,3,2,4,9,23
191207640,2,0,4,9,1,16
191207641,1,1,5,2,9,18
191207642,3,6,0,0,6,15
191207643,3,1,2,0,9,15
191207644,5,9,2,8,2,26
191207645,0,1,0,0,0,1
191207646,5,5,8,2,5,25
191207647,6,7,3,8,1,25
191207648,3,2,7,7,1,20
191207649,3,2,6,9,1,21
191207650,9,1,1,3,8,22
191207651,3,1,2,9,0,15
191207652,1,8,9,1,6,25
191207653,2,4,8,9,9,32
191207654,9,4,1,6,1,21
191207655,0,1,3,4,9,17
191207656,8,0,0,8,2,18
191207657,7,1,2,7,8,25
191207658,5,0,6,8,1,20
191207659,1,2,1,9,1,14
191207660,5,0,4,5,6,20
191207661,9,5,3,0,6,23
191207662,5,9,5,3,7,29
191207663,4,7,1,9,5,26
191207664,5,1,1,6,1,14
191207665,1,6,5,7,3,22
191207666,0,5,3,1,9,18
191207667,4,7,7,3,0,21
191207668,2,0,0,0,2,4
191207669,6,5,0,0,2,13
191207670,4,1,6,4,6,21
191207671,0,1,6,6,5,18
191207672,1,2,7,1,5,16
191207673,3,8,3,9,4,27
191207674,7,7,3,3,6,26
191207675,4,8,9,8,1,30
191207676,6,4,7,8,2,27
191207677,9,4,8,4,4,29
191207678,7,9,3,9,6,34
191207679,9,7,7,6,2,31
191207680,5,7,5,6,9,32
191207681,4,8,0,4,4,20
191207682,0,3,0,4,6,13
191207683,5,4,8,6,8,31
191207684,0,6,8,8,0,22
191207685,6,8,4,7,8,33
191207686,3,4,2,9,1,19
191207687,8,1,4,6,0,19
191207688,3,9,5,9,9,35
191207689,8,6,1,0,2,17
191207690,8,2,1,8,2,21
191207691,5,1,2,1,6,15
191207692,9,7,8,5,0,29
191207693,1,0,1,1,4,7
191207694,5,8,6,0,8,27
191207695,6,9,1,7,9,32
191207696,0,1,2,1,6,10
191207697,0,9,0,5,2,16
191207698,5,3,5,3,0,16
191207699,5,7,3,3,6,24
191207700,0,8,3,1,7,19
191207701,5,9,6,5,3,28
191207702,9,7,8,7,8,39
191207703,8,7,9,9,3,36
191207704,9,2,0,7,0,18
191207705,1,8,0,7,2,18
191207706,0,0,9,7,2,18
191207707,2,9,3,0,7,21
191207708,0,5,6,7,9,27
191207709,8,0,2,2,5,17
191207710,8,2,6,4,8,28
191207711,6,1,9,9,4,29
191207712,2,7,9,0,2,20
191207713,9,4,1,2,5,21
191207714,0,9,7,6,2,24
191207715,9,6,9,2,4,30
191207716,9,8,2,4,6,29
191207717,2,2,0,2,2,8
191207718,0,6,4,0,0,10
191207719,9,0,8,5,3,25
191207720,3,2,7,9,7,28
191207721,6,6,4,3,8,27
191207722,3,7,5,0,6,21
191207723,2,1,3,4,1,11
191207724,2,3,0,4,7,16
191207725,7,9,1,1,0,18
191207726,4,0,1,9,6,20
191207727,6,6,6,0,9,27
191207728,1,9,1,2,2,15
191207729,1,6,8,2,3,20
191207730,6,6,4,5,5,26
191207731,6,1,2,1,1,11
191207732,6,6,7,6,9,34
191207733,2,3,4,8,4,21
191207734,6,8,2,1,8,25
191207735,7,9,8,4,5,33
191207736,9,7,1,8,8,33
191207737,6,0,9,0,6,21
191207738,6,7,3,8,6,30
191207739,6,1,4,4,4,19
191207740,3,9,4,2,2,20
191207741,3,3,3,3,4,16
191207742,6,3,1,0,5,15
191207743,2,2,1,1,3,9
191207744,7,4,4,1,4,20
191207745,6,3,1,7,8,25
191207746,2,3,0,0,2,7
191207747,9,4,9,9,8,39
191207748,0,6,9,8,0,23
191207749,3,4,6,7,5,25
191207750,5,1,6,4,2,18
191207751,9,2,4,2,2,19
191207752,0,4,7,6,5,22
191207753,6,3,8,2,6,25
191207754,5,2,1,8,3,19
191207755,7,6,7,1,8,29
191207756,8,3,8,4,5,28
191207757,0,3,6,3,5,17
191207758,9,4,8,2,4,27
191207759,2,7,3,5,3,20
191207760,7,2,1,9,9,28
191207761,1,6,7,8,2,24
191207762,5,2,7,8,1,23
191207763,3,8,5,2,7,25
191207764,4,5,6,4,7,26
191207765,3,6,6,7,5,27
191207766,0,6,6,4,5,21
191207767,3,3,5,6,1,18
191207768,9,1,2,3,7,22
191207769,5,7,8,2,7,29
191207770,2,1,9,4,6,22
191207771,1,6,0,3,3,13
191207772,1,8,6,8,2,25
191207773,1,4,5,2,9,21
191207774,4,9,9,3,4,29
191207775,9,4,2,3,0,18
191207776,0,5,1,0,8,14
191207777,3,2,8,1,3,17
191207778,7,4,8,5,8,32
191207779,2,0,7,7,9,25
191207780,5,0,6,1,6,18
191207781,7,4,7,3,1,22
191207782,1,4,1,1,4,11
191207783,5,8,6,3,4,26
191207784,3,5,8,8,9,33
191207785,3,0,8,8,3,22
191207786,5,2,7,3,2,19
191207787,9,3,8,9,5,34
191207788,0,8,5,5,6,24
191207789,7,1,4,3,0,15
191207790,5,5,7,2,5,24
191207791,9,6,5,2,4,26
191207792,7,6,8,2,9,32
191207793,7,4,6,4,3,24
191207794,1,0,8,7,0,16
191207795,5,1,4,0,9,19
191207796,0,4,9,8,3,24
191207797,3,7,7,3,9,29
191207798,3,0,4,4,5,16
191207799,4,8,6,3,8,29
191207800,3,4,1,3,9,20
191207801,6,7,7,0,5,25
191207802,7,9,7,1,2,26
191207803,5,5,1,8,5,24
191207804,4,5,8,9,5,31
191207805,1,5,1,9,2,18
191207806,2,0,4,4,6,16
191207807,5,9,8,3,4,29
191207808,7,3,5,9,4,28
191207809,9,6,2,4,1,22
191207810,5,2,3,2,1,13
191207811,3,8,0,3,5,19
191207812,6,0,1,7,8,22
191207813,7,0,0,2,9,18
191207814,2,3,9,1,4,19
191207815,5,4,6,5,0,20
191207816,8,9,4,1,8,30
191207817,4,1,0,9,6,20
191207818,9,0,1,4,7,21
191207819,1,3,6,3,0,13
191207820,5,8,6,3,2,24
191207821,8,0,2,4,8,22
191207822,1,0,5,2,0,8
191207823,0,1,0,8,3,12
191207824,4,2,0,5,6,17
191207825,7,5,0,6,1,19
191207826,2,9,0,3,2,16
191207827,6,5,0,5,5,21
191207828,7,1,0,3,9,20
191207829,7,3,1,3,2,16
191207830,1,6,2,9,6,24
191207831,9,8,7,9,3,36
191207832,4,2,3,4,3,16
191207833,0,1,7,9,7,24
191207834,9,3,0,1,2,15
191207835,5,5,5,3,4,22
191207836,0,6,1,2,7,16
191207837,1,6,3,8,1,19
191207838,2,2,4,8,1,17
191207839,6,2,8,9,6,31
191207840,0,3,2,1,1,7
191207841,5,4,8,6,1,24
191207842,1,8,4,0,9,22
191207843,0,6,8,2,3,19
191207844,2,4,5,4,5,20
191207845,5,7,2,1,1,16
191207846,3,2,5,1,8,19
191207847,4,9,8,0,7,28
191207848,4,3,4,0,2,13
191207849,8,8,6,5,1,28
191207850,7,8,4,6,0,25
191207851,1,5,3,1,3,13
191207852,2,0,1,8,2,13
191207853,5,9,3,5,7,29
191207854,5,4,5,4,8,26
191207855,5,0,6,3,4,18
191207856,5,7,1,3,2,18
191207857,6,0,5,9,2,22
191207858,7,5,1,2,2,17
191207859,9,9,8,4,7,37
191207860,0,0,7,5,0,12
191207861,8,7,6,6,3,30
191207862,7,9,4,5,3,28
191207863,4,5,9,0,0,18
191207864,2,7,0,6,8,23
191207865,9,8,1,3,5,26
191207866,6,1,5,3,0,15
191207867,2,8,4,0,3,17
191207868,2,4,0,6,6,18
191207869,0,1,4,7,0,12
191207870,6,8,8,3,6,31
191207871,5,2,8,4,0,19
191207872,8,0,0,2,6,16
191207873,7,0,2,5,3,17
191207874,8,6,0,1,5,20
191207875,5,9,3,0,0,17
191207876,0,1,8,4,1,14
191207877,1,4,2,9,1,17
191207878,4,4,4,8,2,22
191207879,6,9,1,5,2,23
191207880,3,9,9,4,2,27
191207881,9,7,0,9,6,31
191207882,4,8,7,7,3,29
191207883,5,8,3,7,5,28
191207884,5,4,5,9,8,31
191207885,8,5,6,5,5,29
191207886,4,2,0,6,1,13
191207887,5,0,8,3,1,17
191207888,3,0,8,1,7,19
191207889,1,5,0,6,1,13
191207890,0,4,0,5,4,13
191207891,6,7,9,7,8,37
191207892,3,7,2,1,1,14
191207893,8,4,6,8,0,26
191207894,2,4,5,3,4,18
191207895,3,7,1,4,8,23
191207896,1,3,0,7,3,14
191207897,2,4,7,7,0,20
191207898,4,3,6,7,8,28
191207899,5,9,4,6,7,31
191207900,1,0,1,7,8,17
191207901,0,4,2,3,2,11
191207902,0,5,0,9,9,23
191207903,8,7,5,8,0,28
191207904,2,2,9,5,1,19
191207905,2,3,8,7,2,22
191207906,5,8,3,5,2,23
191207907,8,1,6,4,6,25
191207908,2,8,3,2,4,19
191207909,9,5,8,3,5,30
191207910,3,1,5,3,4,16
191207911,6,5,9,0,5,25
191207912,5,2,1,3,8,19
191207913,3,0,4,8,0,15
191207914,4,4,2,7,9,26
191207915,3,9,6,7,6,31
191207916,5,4,7,2,4,22
191207917,7,5,4,4,4,24
191207918,3,0,3,8,6,20
191207919,7,8,8,1,7,31
191207920,8,7,8,2,9,34
191207921,8,6,3,7,0,24
191207922,9,0,7,7,5,28
191207923,4,8,1,0,2,15
191207924,3,4,9,8,6,30
191207925,4,6,7,2,0,19
191207926,2,9,4,7,8,30
191207927,9,9,9,4,5,36
191207928,1,2,3,0,2,8
191207929,5,9,0,7,4,25
191207930,5,3,9,9,7,33
191207931,4,7,5,5,4,25
191207932,9,0,6,5,2,22
191207933,9,8,8,5,2,32
191207934,9,0,2,2,1,14
191207935,5,1,1,7,3,17
191207936,3,8,6,1,4,22
191207937,8,9,2,4,4,27
191207938,3,6,1,0,3,13
191207939,1,5,4,6,9,25
191207940,8,2,0,4,4,18
191207941,6,7,7,2,3,25
191207942,7,6,1,1,9,24
191207943,1,3,1,2,9,16
191207944,9,0,1,7,5,22
191207945,6,6,7,1,7,27
191207946,2,6,2,3,4,17
191207947,2,7,2,1,9,21
191207948,1,5,3,8,8,25
191207949,4,6,7,2,9,28
191207950,0,4,3,8,8,23
191207951,3,2,3,6,3,17
191207952,4,5,0,4,7,20
191207953,1,3,4,9,5,22
191207954,3,7,7,7,9,33
191207955,1,5,7,7,4,24
191207956,3,3,5,6,6,23
191207957,7,7,3,6,9,32
191207958,0,2,2,5,8,17
191207959,9,3,2,2,5,21
191207960,2,4,0,0,8,14
191207961,6,8,5,1,2,22
191207962,6,4,4,4,1,19
191207963,2,5,5,3,2,17
191207964,8,4,4,6,2,24
191207965,0,6,7,8,4,25
191207966,0,6,6,2,0,14
191207967,9,1,8,7,2,27
191207968,5,0,2,8,0,15
191207969,1,3,3,9,2,18
191207970,1,9,7,1,4,22
191207971,7,3,5,5,0,20
191207972,7,0,9,4,0,20
191207973,1,1,6,3,9,20
191207974,3,0,0,6,5,14
191207975,1,1,7,4,0,13
191207976,5,3,8,3,9,28
191207977,5,0,8,9,2,24
191207978,9,8,7,8,7,39
191207979,6,0,1,9,1,17
191207980,3,6,9,7,2,27
191207981,6,6,7,8,0,27
191207982,8,0,2,7,6,23
191207983,7,6,4,5,3,25
191207984,9,7,7,3,8,34
191207985,2,4,1,7,2,16
191207986,8,6,8,4,4,30
191207987,1,9,7,5,7,29
191207988,7,8,1,0,1,17
191207989,6,9,7,9,4,35
191207990,7,3,9,3,3,25
191207991,9,4,5,0,1,19
191207992,0,0,0,9,7,16
191207993,9,6,8,1,3,27
191207994,4,6,0,1,9,20
191207995,1,4,0,5,7,17
191207996,0,6,7,5,5,23
191207997,4,2,9,8,9,32
191207998,2,9,1,2,0,14
191207999,9,7,5,0,6,27
1912071000,8,3,2,7,7,27
1912071001,9,4,2,0,8,23
1912071002,4,3,7,6,1,21
1912071003,9,0,3,9,0,21
1912071004,3,3,4,6,3,19
1912071005,4,6,1,3,3,17
1912071006,5,6,9,7,9,36
1912071007,1,8,2,6,3,20
1912071008,1,8,7,6,8,30
1912071009,9,9,0,5,8,31
1912071010,3,0,3,4,5,15
1912071011,6,4,7,6,3,26
1912071012,5,2,1,1,7,16
1912071013,7,1,9,9,6,32
1912071014,9,5,4,0,1,19
1912071015,9,8,5,3,6,31
1912071016,4,8,2,6,9,29
1912071017,3,8,4,9,7,31
1912071018,9,2,3,7,9,30
1912071019,8,7,3,1,1,20
1912071020,6,0,5,9,7,27
1912071021,9,2,7,4,0,22
1912071022,3,3,4,2,0,12
1912071023,6,1,3,7,4,21
1912071024,4,8,4,0,5,21
1912071025,0,1,0,1,5,7
1912071026,9,3,6,0,6,24
1912071027,5,3,1,2,3,14
1912071028,1,5,0,4,5,15
1912071029,6,8,6,7,2,29
1912071030,3,1,3,2,6,15
1912071031,4,8,9,7,4,32
1912071032,9,8,8,8,6,39
1912071033,0,2,7,5,3,17
1912071034,0,2,5,2,0,9
1912071035,6,2,3,3,3,17
1912071036,1,4,2,3,6,16
1912071037,9,8,7,1,0,25
1912071038,3,7,7,4,3,24
1912071039,4,7,5,4,0,20
1912071040,8,1,4,4,9,26
1912071041,3,5,3,6,0,17
1912071042,8,9,3,2,7,29
1912071043,5,5,9,7,8,34
1912071044,0,1,4,1,4,10
1912071045,1,0,3,1,3,8
1912071046,2,2,3,5,7,19
1912071047,4,7,0,4,7,22
1912071048,7,9,1,7,9,33
1912071049,7,3,6,5,9,30
1912071050,5,7,4,3,4,23
1912071051,1,0,4,5,0,10
1912071052,2,6,1,9,1,19
1912071053,6,6,7,2,6,27
1912071054,1,0,5,1,9,16
1912071055,1,7,1,6,8,23
1912071056,4,3,7,4,2,20
1912071057,1,2,7,7,7,24
1912071058,0,6,2,9,1,18
1912071059,5,0,8,3,8,24
1912071060,1,0,5,3,7,16
1912071061,2,5,8,6,4,25
1912071062,2,8,8,2,2,22
1912071063,9,8,8,8,5,38
1912071064,8,1,5,7,6,27
1912071065,3,1,6,3,5,18
1912071066,5,4,4,8,0,21
1912071067,5,5,4,9,9,32
1912071068,3,7,0,2,7,19
1912071069,7,4,5,5,1,22
1912071070,2,1,3,5,5,16
1912071071,6,6,7,2,7,28
1912071072,4,3,7,9,1,24
1912071073,6,9,2,5,6,28
1912071074,8,6,1,7,3,25
1912071075,5,4,0,1,6,16
1912071076,8,5,9,2,4,28
1912071077,8,5,7,0,8,28
1912071078,1,5,0,8,7,21
1912071079,9,9,1,5,8,32
1912071080,6,2,2,1,0,11
1912071081,7,5,9,4,9,34
1912071082,6,2,9,3,4,24
1912071083,3,9,8,7,1,28
1912071084,9,1,8,4,7,29
1912071085,8,3,3,0,6,20
1912071086,8,3,1,6,2,20
1912071087,5,4,5,0,4,18
1912071088,7,2,5,3,9,26
1912071089,5,9,6,7,4,31
1912071090,7,2,0,9,1,19
1912071091,5,0,1,1,1,8
1912071092,3,9,1,4,6,23
1912071093,7,1,9,6,8,31
1912071094,0,9,4,9,5,27
1912071095,4,8,0,8,8,28
1912071096,2,0,6,1,7,16
1912071097,8,2,0,8,9,27
1912071098,6,2,5,9,2,24
1912071099,4,3,0,7,2,16
1912071100,1,1,9,8,1,20
1912071101,6,5,0,7,8,26
1912071102,2,3,4,2,4,15
1912071103,7,6,4,6,8,31
1912071104,5,8,4,9,5,31
1912071105,8,3,4,2,1,18
191208001,7,5,1,3,8,24
191208002,7,1,3,6,6,23
191208003,9,1,2,7,7,26
191208004,4,4,3,5,0,16
191208005,1,6,6,7,9,29
191208006,9,8,4,5,5,31
191208007,1,5,4,3,1,14
191208008,3,3,8,5,5,24
191208009,8,7,2,7,3,27
191208010,4,8,3,6,6,27
191208011,8,6,7,8,9,38
191208012,3,1,0,9,7,20
191208013,6,5,0,4,5,20
191208014,0,2,4,1,8,15
191208015,5,5,3,2,6,21
191208016,2,5,5,1,9,22
191208017,2,6,7,5,1,21
191208018,2,4,8,8,2,24
191208019,8,2,6,8,0,24
191208020,2,0,9,0,2,13
191208021,6,7,8,9,3,33
191208022,5,7,2,3,7,24
191208023,7,0,1,2,2,12
191208024,2,4,2,3,8,19
191208025,0,0,8,8,5,21
191208026,6,6,4,1,6,23
191208027,6,1,2,2,4,15
191208028,9,7,9,7,7,39
191208029,7,7,0,2,5,21
191208030,9,3,8,7,9,36
191208031,3,2,6,6,8,25
191208032,1,8,7,2,3,21
191208033,7,1,6,4,5,23
191208034,9,0,3,1,0,13
191208035,1,6,5,1,0,13
191208036,8,3,1,3,4,19
191208037,5,3,4,1,5,18
191208038,2,5,6,5,9,27
191208039,5,0,2,2,1,10
191208040,5,2,8,7,7,29
191208041,6,2,0,6,3,17
191208042,1,2,5,8,4,20
191208043,6,9,4,4,5,28
191208044,8,4,1,0,9,22
191208045,6,0,2,2,2,12
191208046,7,0,3,9,8,27
191208047,7,1,6,5,6,25
191208048,4,3,3,7,9,26
191208049,5,6,3,2,4,20
191208050,7,1,3,8,6,25
191208051,1,5,5,7,9,27
191208052,5,4,2,1,6,18
191208053,6,6,4,5,2,23
191208054,7,2,4,8,0,21
191208055,4,1,1,8,5,19
191208056,5,6,7,6,2,26
191208057,5,0,7,5,9,26
191208058,1,6,0,1,7,15
191208059,4,2,6,0,3,15
191208060,4,1,5,6,0,16
191208061,5,0,4,6,9,24
191208062,0,8,8,5,3,24
191208063,4,7,4,1,7,23
191208064,0,8,3,5,5,21
191208065,1,6,1,7,5,20
191208066,6,3,7,2,0,18
191208067,5,8,0,3,2,18
191208068,9,3,6,7,2,27
191208069,3,9,2,8,5,27
191208070,4,6,4,5,1,20
191208071,3,0,1,3,4,11
191208072,3,0,1,1,4,9
191208073,4,9,0,1,5,19
191208074,4,8,8,0,1,21
191208075,6,1,9,6,8,30
191208076,0,9,0,1,8,18
191208077,0,5,8,8,9,30
191208078,3,6,1,8,5,23
191208079,2,6,0,9,9,26
191208080,7,5,7,9,2,30
191208081,7,5,8,0,1,21
191208082,6,1,5,9,5,26
191208083,0,4,1,4,9,18
191208084,1,0,3,3,7,14
191208085,8,0,2,8,8,26
191208086,4,2,6,3,5,20
191208087,0,8,1,2,4,15
191208088,0,9,0,3,4,16
191208089,0,8,4,9,9,30
191208090,6,8,5,8,2,29
191208091,8,2,8,2,0,20
191208092,7,5,3,1,5,21
191208093,0,5,7,3,9,24
191208094,3,6,9,8,3,29
191208095,6,3,6,5,3,23
191208096,4,5,4,2,6,21
191208097,7,0,8,0,5,20
191208098,0,7,4,7,7,25
191208099,6,6,7,5,4,28
191208100,5,5,3,5,4,22
191208101,1,5,8,4,4,22
191208102,9,0,5,7,8,29
191208103,9,3,7,7,2,28
191208104,5,5,8,9,0,27
191208105,5,7,0,6,0,18
191208106,4,0,6,6,0,16
191208107,3,5,5,1,1,15
191208108,0,5,4,5,8,22
191208109,6,8,1,1,4,20
191208110,6,3,3,0,7,19
191208111,2,9,9,8,6,34
191208112,4,5,4,1,0,14
191208113,7,3,5,1,0,16
191208114,6,3,1,9,4,23
191208115,0,7,6,3,3,19
191208116,7,0,3,0,2,12
191208117,2,7,5,5,8,27
191208118,1,8,4,8,8,29
191208119,8,7,6,6,4,31
191208120,7,0,9,2,2,20
191208121,7,0,3,9,6,25
191208122,9,6,6,4,7,32
191208123,9,6,8,5,5,33
191208124,8,2,6,6,0,22
191208125,5,3,4,6,0,18
191208126,6,8,6,0,2,22
191208127,9,1,3,2,4,19
191208128,8,7,9,2,9,35
191208129,1,8,7,6,6,28
191208130,7,4,1,1,3,16
191208131,4,4,8,8,1,25
191208132,5,9,0,3,5,22
191208133,8,1,5,9,0,23
191208134,2,0,3,8,3,16
191208135,9,9,3,5,7,33
191208136,8,3,6,8,0,25
191208137,8,8,3,7,5,31
191208138,2,7,9,5,8,31
191208139,3,8,3,4,4,22
191208140,8,7,8,2,8,33
191208141,9,5,6,2,5,27
191208142,4,0,6,4,0,14
191208143,2,1,5,9,6,23
191208144,7,8,7,7,4,33
191208145,5,4,4,1,6,20
191208146,6,0,9,0,0,15
191208147,1,7,3,2,6,19
191208148,5,4,6,9,7,31
191208149,1,8,1,3,8,21
191208150,5,1,3,6,9,24
191208151,6,6,9,1,5,27
191208152,7,4,4,5,6,26
191208153,4,9,3,5,1,22
191208154,4,0,0,9,1,14
191208155,9,8,4,5,7,33
191208156,1,6,5,3,5,20
191208157,1,6,1,4,2,14
191208158,2,1,9,9,9,30
191208159,8,0,8,3,8,27
191208160,3,0,0,9,0,12
191208161,2,4,0,7,9,22
191208162,3,4,4,9,9,29
191208163,7,2,1,0,3,13
191208164,5,3,4,3,9,24
191208165,8,4,3,6,1,22
191208166,0,8,6,5,8,27
191208167,2,4,6,2,0,14
191208168,4,8,1,9,9,31
191208169,8,7,7,1,6,29
191208170,7,2,5,2,4,20
191208171,0,4,4,0,1,9
191208172,2,5,9,8,2,26
191208173,8,9,6,8,0,31
191208174,2,7,9,2,9,29
191208175,0,7,3,9,8,27
191208176,2,6,2,8,1,19
191208177,3,1,0,2,6,12
191208178,9,3,1,3,1,17
191208179,0,5,3,3,5,16
191208180,8,4,2,9,1,24
191208181,8,7,6,6,6,33
191208182,5,8,1,4,8,26
191208183,5,1,8,0,1,15
191208184,7,2,3,5,2,19
191208185,2,7,2,3,7,21
191208186,8,2,0,9,5,24
191208187,4,2,1,2,0,9
191208188,2,7,4,8,1,22
191208189,4,2,1,1,8,16
191208190,9,0,0,7,8,24
191208191,2,2,6,9,6,25
191208192,6,7,2,5,8,28
191208193,8,2,8,3,7,28
191208194,9,3,8,2,1,23
191208195,1,8,6,0,9,24
191208196,2,0,5,5,5,17
191208197,6,3,1,6,8,24
191208198,1,8,5,9,5,28
191208199,9,7,6,5,0,27
191208200,4,0,7,4,5,20
191208201,4,2,6,2,9,23
191208202,7,2,1,4,5,19
191208203,6,8,1,6,0,21
191208204,7,0,3,6,5,21
191208205,6,9,4,4,8,31
191208206,6,0,4,5,7,22
191208207,1,5,6,3,7,22
191208208,2,8,6,9,6,31
191208209,6,8,3,8,9,34
191208210,0,7,3,5,7,22
191208211,4,1,0,8,8,21
191208212,9,7,6,7,5,34
191208213,1,7,1,7,5,21
191208214,1,1,5,7,9,23
191208215,8,6,1,1,6,22
191208216,1,0,6,6,5,18
191208217,5,1,8,5,7,26
191208218,2,3,3,2,1,11
191208219,6,7,2,7,2,24
191208220,6,1,7,8,8,30
191208221,1,5,8,0,2,16
191208222,1,8,1,5,9,24
191208223,4,2,3,9,3,21
191208224,9,7,1,4,6,27
191208225,3,2,3,6,6,20
191208226,3,2,9,4,9,27
191208227,0,7,2,6,2,17
191208228,1,4,7,2,1,15
191208229,7,2,0,1,6,16
191208230,6,6,0,7,7,26
191208231,4,4,8,3,8,27
191208232,5,8,4,1,0,18
191208233,8,9,0,3,4,24
191208234,7,3,9,0,5,24
191208235,1,1,0,6,7,15
191208236,5,0,4,9,0,18
191208237,4,2,1,6,6,19
191208238,8,2,4,2,3,19
191208239,8,4,4,6,4,26
191208240,2,6,4,5,1,18
191208241,4,7,9,3,0,23
191208242,2,2,4,0,6,14
191208243,1,3,4,3,4,15
191208244,5,5,0,5,0,15
191208245,1,5,0,0,1,7
191208246,5,1,8,5,6,25
191208247,8,0,8,2,1,19
191208248,7,0,4,5,4,20
191208249,0,7,7,1,9,24
191208250,1,7,3,8,5,24
191208251,1,9,4,9,3,26
191208252,7,2,2,7,2,20
191208253,3,4,6,9,4,26
191208254,8,2,6,5,7,28
191208255,4,6,0,0,2,12
191208256,4,0,3,6,9,22
191208257,7,6,4,0,9,26
191208258,5,7,4,4,8,28
191208259,3,2,6,2,1,14
191208260,3,8,2,4,1,18
191208261,1,4,0,8,4,17
191208262,7,3,4,6,8,28
191208263,7,9,8,1,5,30
191208264,4,8,0,7,1,20
191208265,9,8,8,6,3,34
191208266,2,5,9,3,2,21
191208267,7,2,8,6,6,29
191208268,3,0,4,5,3,15
191208269,3,2,9,1,1,16
191208270,5,4,1,9,8,27
191208271,2,2,5,0,0,9
191208272,8,4,5,7,1,25
191208273,7,1,0,8,3,19
191208274,6,8,4,2,9,29
191208275,3,3,6,1,0,13
191208276,7,7,3,6,5,28
191208277,5,7,8,8,8,36
191208278,8,0,1,0,4,13
191208279,9,7,5,3,4,28
191208280,0,1,2,4,7,14
191208281,2,8,3,9,2,24
191208282,5,7,9,6,7,34
191208283,4,5,1,5,5,20
191208284,9,1,5,7,1,23
191208285,0,9,0,2,9,20
191208286,7,3,3,1,5,19
191208287,3,4,8,4,4,23
191208288,3,0,1,2,1,7
191208289,8,1,1,5,4,19
191208290,7,9,8,5,6,35
191208291,1,9,0,2,3,15
191208292,1,4,8,9,5,27
191208293,4,0,0,2,8,14
191208294,6,7,3,2,0,18
191208295,2,9,0,8,4,23
191208296,7,4,8,1,3,23
191208297,5,9,1,4,7,26
191208298,7,9,1,6,0,23
191208299,1,0,7,7,1,16
191208300,7,3,8,0,3,21
191208301,8,0,8,2,2,20
191208302,3,9,2,0,2,16
191208303,2,2,3,7,0,14
191208304,2,7,5,7,3,24
191208305,3,0,8,1,5,17
191208306,9,5,3,9,2,28
191208307,7,0,2,8,4,21
191208308,5,7,4,6,4,26
191208309,1,1,6,6,1,15
191208310,4,7,6,9,7,33
191208311,5,8,2,2,7,24
191208312,5,2,1,5,4,17
191208313,1,0,9,3,3,16
191208314,8,1,3,5,1,18
191208315,8,6,8,0,0,22
191208316,3,1,2,1,2,9
191208317,7,4,7,5,2,25
191208318,9,7,6,1,8,31
191208319,5,0,5,9,3,22
191208320,7,7,5,0,8,27
191208321,5,9,5,0,1,20
191208322,9,1,3,8,4,25
191208323,9,6,6,8,4,33
191208324,3,3,2,3,4,15
191208325,1,2,9,1,1,14
191208326,6,1,9,4,5,25
191208327,7,1,5,5,3,21
191208328,9,3,3,0,6,21
191208329,2,7,8,9,4,30
191208330,4,3,4,5,7,23
191208331,7,1,1,9,3,21
191208332,6,3,6,8,9,32
191208333,8,0,9,5,2,24
191208334,6,8,2,1,4,21
191208335,9,5,8,1,1,24
191208336,1,6,9,2,8,26
191208337,9,2,0,6,1,18
191208338,2,0,2,7,2,13
191208339,0,7,0,9,1,17
191208340,0,5,1,6,4,16
191208341,0,5,1,4,6,16
191208342,7,0,3,1,4,15
191208343,7,1,0,6,6,20
191208344,6,3,1,6,0,16
191208345,9,7,5,0,9,30
191208346,2,9,9,2,9,31
191208347,0,6,8,7,2,23
191208348,8,6,2,2,2,20
191208349,6,1,8,5,9,29
191208350,1,9,8,9,8,35
191208351,4,7,1,3,0,15
191208352,2,2,2,7,6,19
191208353,2,8,1,2,7,20
191208354,1,7,6,6,9,29
191208355,1,3,6,4,1,15
191208356,7,6,7,5,2,27
191208357,0,9,8,1,7,25
191208358,9,6,5,5,6,31
191208359,0,0,0,0,0,0
191208360,6,3,8,5,9,31
191208361,5,3,3,0,2,13
191208362,1,3,1,2,4,11
191208363,3,8,5,0,9,25
191208364,7,9,4,6,1,27
191208365,5,3,0,7,6,21
191208366,7,1,6,5,5,24
191208367,9,9,4,6,1,29
191208368,7,1,7,7,5,27
191208369,0,3,8,1,0,12
191208370,4,6,2,3,8,23
191208371,4,1,9,6,9,29
191208372,7,7,6,5,7,32
191208373,9,3,9,2,4,27
191208374,7,0,7,2,7,23
191208375,5,9,0,4,1,19
191208376,7,3,4,9,8,31
191208377,1,0,1,2,8,12
191208378,3,1,6,4,0,14
191208379,8,7,3,0,3,21
191208380,7,9,0,0,1,17
191208381,4,4,4,7,9,28
191208382,5,9,5,0,7,26
191208383,0,7,3,7,9,26
191208384,4,8,6,8,5,31
191208385,1,3,8,7,6,25
191208386,8,9,6,8,1,32
191208387,1,6,1,6,5,19
191208388,4,5,4,6,1,20
191208389,5,1,2,1,4,13
191208390,1,1,4,0,4,10
191208391,3,9,3,5,6,26
191208392,5,8,1,8,5,27
191208393,3,7,3,0,5,18
191208394,0,5,9,8,1,23
191208395,0,8,9,1,3,21
191208396,2,8,8,8,6,32
191208397,8,4,0,1,1,14
191208398,2,0,0,7,2,11
191208399,2,7,1,0,7,17
191208400,7,9,7,4,5,32
191208401,4,8,4,2,7,25
191208402,8,2,0,0,4,14
191208403,2,9,1,4,6,22
191208404,9,7,3,5,5,29
191208405,1,9,9,2,1,22
191208406,8,6,7,2,6,29
191208407,8,0,1,7,3,19
191208408,1,9,6,0,7,23
191208409,7,7,9,3,1,27
191208410,0,7,7,6,6,26
191208411,8,8,3,9,4,32
191208412,2,8,0,6,4,20
191208413,8,7,3,6,6,30
191208414,3,1,0,2,0,6
191208415,0,9,4,4,8,25
191208416,6,1,8,1,4,20
191208417,7,3,3,6,2,21
191208418,9,4,0,0,0,13
191208419,5,9,3,5,1,23
191208420,0,2,8,4,2,16
191208421,3,6,9,3,1,22
191208422,0,2,9,2,0,13
191208423,9,1,1,7,9,27
191208424,0,7,3,5,2,17
191208425,5,9,6,6,5,31
191208426,1,7,9,5,4,26
191208427,4,5,8,9,1,27
191208428,4,3,1,2,9,19
191208429,8,5,4,2,2,21
191208430,9,0,8,5,9,31
191208431,5,9,7,2,9,32
191208432,1,8,9,6,0,24
191208433,8,9,4,2,6,29
191208434,7,6,0,9,0,22
191208435,6,7,7,0,0,20
191208436,0,3,7,0,3,13
191208437,1,2,8,2,3,16
191208438,7,5,2,9,5,28
191208439,6,5,2,2,6,21
191208440,1,5,7,0,0,13
191208441,1,5,9,2,7,24
191208442,8,9,7,1,2,27
191208443,7,9,5,7,4,32
191208444,5,9,8,0,9,31
191208445,0,2,1,4,3,10
191208446,9,7,4,0,7,27
191208447,3,8,1,1,3,16
191208448,1,1,0,5,7,14
191208449,5,4,2,5,4,20
191208450,4,5,7,0,5,21
191208451,8,5,8,2,6,29
191208452,5,7,4,3,1,20
191208453,9,3,6,1,9,28
191208454,7,3,1,5,4,20
191208455,7,2,5,0,6,20
191208456,4,3,4,1,8,20
191208457,6,6,6,6,1,25
191208458,6,2,5,1,0,14
191208459,8,0,8,3,7,26
191208460,7,2,0,7,0,16
191208461,0,1,0,7,1,9
191208462,1,8,9,3,9,30
191208463,7,6,4,7,5,29
191208464,2,3,5,6,4,20
191208465,8,2,3,3,7,23
191208466,2,6,2,7,8,25
191208467,1,8,4,2,5,20
191208468,8,0,8,0,3,19
191208469,6,2,0,5,4,17
191208470,0,8,7,3,8,26
191208471,5,6,7,1,7,26
191208472,0,4,0,3,0,7
191208473,1,4,7,2,3,17
191208474,9,7,4,5,1,26
191208475,7,5,6,1,1,20
191208476,7,5,2,5,4,23
191208477,7,2,7,9,8,33
191208478,2,8,2,4,5,21
191208479,5,7,2,5,4,23
191208480,6,3,1,0,6,16
191208481,0,4,5,4,9,22
191208482,9,1,2,3,3,18
191208483,3,6,8,4,7,28
191208484,5,2,3,4,5,19
191208485,1,9,6,7,3,26
191208486,1,5,6,0,1,13
191208487,4,9,6,6,5,30
191208488,3,3,7,6,9,28
191208489,8,4,9,2,2,25
191208490,1,6,0,2,1,10
191208491,4,1,5,9,8,27
191208492,7,8,5,2,7,29
191208493,9,9,1,6,2,27
191208494,5,9,7,7,5,33
191208495,2,9,5,8,0,24
191208496,9,1,2,5,8,25
191208497,8,7,6,4,6,31
191208498,9,3,8,5,3,28
191208499,1,3,6,1,1,12
191208500,2,4,5,0,8,19
191208501,8,2,3,8,6,27
191208502,5,9,7,9,9,39
191208503,0,2,8,4,6,20
191208504,7,2,5,0,4,18
191208505,0,0,7,8,5,20
191208506,4,0,9,9,4,26
191208507,8,4,2,7,6,27
191208508,7,8,6,6,7,34
191208509,6,1,4,5,8,24
191208510,5,2,7,5,9,28
191208511,9,1,2,0,8,20
191208512,1,9,9,6,2,27
191208513,0,2,0,1,4,7
191208514,5,8,8,0,0,21
191208515,0,0,3,7,1,11
191208516,3,9,3,3,8,26
191208517,0,5,0,3,8,16
191208518,9,4,0,2,9,24
191208519,3,1,1,5,9,19
191208520,9,1,9,0,3,22
191208521,0,4,4,5,3,16
191208522,1,1,7,7,2,18
191208523,7,2,5,4,1,19
191208524,3,6,7,0,0,16
191208525,7,9,8,3,5,32
191208526,3,9,1,7,0,20
191208527,2,3,4,8,7,24
191208528,9,1,2,3,1,16
191208529,2,7,2,7,5,23
191208530,9,6,7,2,5,29
191208531,7,7,2,3,0,19
191208532,9,1,0,0,6,16
191208533,6,6,0,1,6,19
191208534,1,1,8,5,5,20
191208535,4,2,4,4,3,17
191208536,1,4,8,9,3,25
191208537,8,7,0,1,7,23
191208538,2,3,6,1,5,17
191208539,4,7,1,0,2,14
191208540,1,9,5,1,7,23
191208541,6,3,9,8,8,34
191208542,1,2,5,0,8,16
191208543,0,6,2,6,9,23
191208544,3,0,1,1,8,13
191208545,0,6,7,3,7,23
191208546,9,8,4,7,5,33
191208547,1,5,9,9,3,27
191208548,6,9,7,6,0,28
191208549,7,9,4,4,5,29
191208550,1,9,0,2,9,21
191208551,3,6,6,1,2,18
191208552,0,2,4,3,9,18
191208553,0,1,4,3,3,11
191208554,6,4,3,6,9,28
191208555,7,9,2,8,0,26
191208556,7,8,2,1,6,24
191208557,0,3,6,1,6,16
191208558,6,0,8,4,1,19
191208559,8,3,4,4,4,23
191208560,9,5,2,7,0,23
191208561,4,7,8,3,0,22
191208562,4,4,5,2,8,23
191208563,4,3,5,3,2,17
191208564,7,1,6,6,3,23
191208565,6,0,5,5,9,25
191208566,2,6,3,3,8,22
191208567,8,7,7,8,8,38
191208568,6,6,5,4,1,22
191208569,4,1,3,9,3,20
191208570,0,6,5,9,7,27
191208571,5,1,4,2,8,20
191208572,4,4,2,4,0,14
191208573,3,6,0,4,5,18
191208574,2,2,9,6,4,23
191208575,0,6,2,9,8,25
191208576,2,4,1,6,6,19
191208577,1,9,0,6,1,17
191208578,9,4,4,2,6,25
191208579,2,6,2,0,5,15
191208580,3,7,1,2,3,16
191208581,4,2,4,4,4,18
191208582,5,3,6,0,3,17
191208583,6,7,0,8,6,27
191208584,5,3,4,2,5,19
191208585,0,3,2,9,2,16
191208586,6,7,8,2,3,26
191208587,1,3,7,4,9,24
191208588,6,7,6,4,2,25
191208589,5,3,5,6,6,25
191208590,5,7,2,7,9,30
191208591,4,6,3,6,1,20
191208592,1,6,8,5,1,21
191208593,3,0,7,7,6,23
191208594,3,6,1,1,2,13
191208595,2,3,3,7,8,23
191208596,1,7,1,2,1,12
191208597,9,3,1,6,7,26
191208598,6,7,0,5,9,27
191208599,2,4,4,6,9,25
191208600,6,3,7,4,2,22
191208601,9,6,0,8,3,26
191208602,1,4,4,6,1,16
191208603,4,2,2,2,2,12
191208604,3,7,1,5,6,22
191208605,1,7,7,5,7,27
191208606,7,7,0,5,2,21
191208607,3,9,6,5,6,29
191208608,5,4,9,8,3,29
191208609,7,9,3,7,2,28
191208610,4,4,0,4,3,15
191208611,2,7,0,3,6,18
191208612,2,0,6,6,9,23
191208613,2,4,9,4,2,21
191208614,1,8,4,0,3,16
191208615,9,6,4,5,6,30
191208616,2,5,5,9,3,24
191208617,7,2,0,9,3,21
191208618,1,2,8,5,8,24
191208619,3,0,9,9,3,24
191208620,0,2,0,7,7,16
191208621,6,0,4,4,1,15
191208622,2,0,7,9,9,27
191208623,0,8,2,3,0,13
191208624,1,0,3,4,6,14
191208625,8,3,1,7,9,28
191208626,6,9,5,1,6,27
191208627,3,0,8,9,0,20
191208628,3,6,7,8,6,30
191208629,3,6,8,6,9,32
191208630,0,1,1,8,0,10
191208631,2,4,0,9,0,15
191208632,3,2,6,6,7,24
191208633,9,4,4,2,5,24
191208634,1,6,5,4,9,25
191208635,5,4,2,3,4,18
191208636,1,2,7,8,8,26
191208637,2,9,2,8,6,27
191208638,8,4,3,6,6,27
191208639,5,8,0,2,5,20
191208640,4,2,0,5,4,15
191208641,3,9,0,5,4,21
191208642,1,4,7,1,8,21
191208643,5,0,8,4,9,26
191208644,2,7,7,8,8,32
191208645,9,6,1,4,3,23
191208646,5,9,4,7,7,32
191208647,2,3,3,0,9,17
191208648,0,8,5,1,3,17
191208649,4,5,7,6,8,30
191208650,3,1,9,8,5,26
191208651,8,8,3,8,1,28
191208652,1,7,0,8,9,25
191208653,6,6,6,9,3,30
191208654,1,7,6,3,9,26
191208655,6,6,1,2,0,15
191208656,9,0,8,9,9,35
191208657,0,0,5,2,4,11
191208658,5,9,8,9,6,37
191208659,8,9,7,5,4,33
191208660,5,5,3,4,6,23
191208661,0,5,8,3,9,25
191208662,4,8,2,9,8,31
191208663,9,9,0,9,1,28
191208664,8,8,6,3,7,32
191208665,9,7,8,7,5,36
191208666,1,1,2,9,5,18
191208667,1,1,9,3,8,22
191208668,9,7,8,3,6,33
191208669,7,6,7,4,8,32
191208670,1,9,2,3,8,23
191208671,1,4,0,6,2,13
191208672,7,0,1,9,1,18
191208673,9,8,0,2,7,26
191208674,9,9,4,7,9,38
191208675,8,4,6,1,0,19
191208676,8,7,9,5,0,29
191208677,8,4,5,9,9,35
191208678,0,3,7,2,3,15
191208679,2,4,5,2,4,17
191208680,6,1,9,8,3,27
191208681,4,4,9,8,3,28
191208682,0,7,5,7,5,24
191208683,6,2,8,3,7,26
191208684,5,0,6,6,3,20
191208685,5,0,8,8,5,26
191208686,6,3,1,5,2,17
191208687,1,3,3,3,6,16
191208688,8,5,5,9,8,35
191208689,6,8,1,9,8,32
191208690,8,2,2,3,2,17
191208691,9,5,4,5,4,27
191208692,5,6,5,6,8,30
191208693,4,5,6,5,9,29
191208694,2,6,6,6,8,28
191208695,8,0,2,0,5,15
191208696,9,3,8,9,0,29
191208697,3,2,7,0,8,20
191208698,9,8,5,5,6,33
191208699,5,2,7,6,2,22
191208700,1,4,8,5,3,21
191208701,6,7,3,6,5,27
191208702,6,3,5,5,7,26
191208703,8,4,1,4,1,18
191208704,9,7,0,9,3,28
191208705,6,9,3,7,7,32
191208706,5,5,7,7,0,24
191208707,5,0,4,1,6,16
191208708,0,1,5,1,9,16
191208709,4,3,4,8,2,21
191208710,3,9,1,1,8,22
191208711,3,4,8,0,3,18
191208712,3,9,1,0,9,22
191208713,8,0,9,6,0,23
191208714,6,6,8,0,2,22
191208715,7,9,7,2,9,34
191208716,3,6,9,6,5,29
191208717,8,7,8,7,8,38
191208718,2,2,4,6,6,20
191208719,8,8,7,1,9,33
191208720,8,8,7,5,7,35
191208721,5,1,3,8,8,25
191208722,1,2,0,1,7,11
191208723,6,7,0,5,6,24
191208724,3,3,4,9,3,22
191208725,2,3,0,2,6,13
191208726,6,7,5,6,5,29
191208727,3,0,5,2,8,18
191208728,3,9,1,9,5,27
191208729,3,8,1,5,3,20
191208730,8,0,2,8,3,21
191208731,4,2,7,6,3,22
191208732,2,7,9,8,4,30
191208733,0,5,7,0,1,13
191208734,0,7,6,5,6,24
191208735,6,9,0,4,4,23
191208736,5,9,4,9,7,34
191208737,4,6,1,1,3,15
191208738,4,9,7,3,2,25
191208739,2,8,5,7,2,24
191208740,3,3,7,0,6,19
191208741,7,8,1,0,9,25
191208742,5,3,0,9,1,18
191208743,3,6,2,4,2,17
191208744,8,3,4,7,7,29
191208745,9,5,1,7,1,23
191208746,7,6,3,3,0,19
191208747,4,0,2,0,3,9
191208748,4,5,0,2,1,12
191208749,4,7,4,6,4,25
191208750,2,9,9,2,4,26
191208751,5,1,2,8,2,18
191208752,3,1,0,4,3,11
191208753,8,4,3,8,2,25
191208754,9,5,5,3,1,23
191208755,6,8,8,1,2,25
191208756,4,0,2,7,4,17
191208757,4,8,7,1,3,23
191208758,6,8,8,5,3,30
191208759,5,5,6,9,5,30
191208760,9,0,6,3,7,25
191208761,9,7,5,7,6,34
191208762,0,0,4,5,4,13
191208763,0,2,2,4,0,8
191208764,9,4,1,2,0,16
191208765,4,4,3,0,1,12
191208766,8,5,6,5,0,24
191208767,7,3,9,0,2,21
191208768,9,6,7,3,0,25
191208769,3,4,5,6,2,20
191208770,0,5,7,3,0,15
191208771,7,9,5,5,8,34
191208772,7,8,1,7,2,25
191208773,4,4,7,5,9,29
191208774,3,8,7,6,0,24
191208775,3,8,2,7,5,25
191208776,2,0,7,5,1,15
191208777,7,6,6,4,4,27
191208778,4,8,7,2,3,24
191208779,6,4,1,0,1,12
191208780,9,0,7,5,2,23
191208781,9,2,8,5,1,25
191208782,7,7,0,1,0,15
191208783,5,3,6,7,4,25
191208784,6,1,5,2,1,15
191208785,9,7,3,1,3,23
191208786,7,1,1,7,9,25
191208787,0,0,2,2,9,13
191208788,8,2,5,5,9,29
191208789,7,1,6,9,9,32
191208790,7,6,6,7,2,28
191208791,9,7,3,7,6,32
191208792,2,0,1,7,1,11
191208793,8,3,6,6,1,24
191208794,1,1,9,1,9,21
191208795,8,2,4,0,0,14
191208796,7,0,6,3,5,21
191208797,7,2,9,2,9,29
191208798,5,6,2,2,4,19
191208799,7,5,4,7,3,26
191208800,6,4,3,6,3,22
191208801,4,9,7,7,0,27
191208802,9,6,6,3,2,26
191208803,0,0,1,9,2,12
191208804,6,0,0,7,0,13
191208805,1,5,2,6,5,19
191208806,2,9,0,6,1,18
191208807,2,2,4,5,3,16
191208808,7,4,1,8,7,27
191208809,9,2,6,0,6,23
191208810,1,9,8,7,0,25
191208811,4,0,1,7,4,16
191208812,2,7,6,8,7,30
191208813,3,8,3,1,7,22
191208814,5,9,7,6,0,27
191208815,4,7,5,0,2,18
191208816,9,8,2,6,3,28
191208817,3,0,3,1,8,15
191208818,5,6,4,7,5,27
191208819,9,4,2,5,0,20
191208820,3,3,3,0,9,18
191208821,0,6,3,2,9,20
191208822,7,5,0,5,8,25
191208823,9,1,7,1,0,18
191208824,3,5,3,0,6,17
191208825,5,5,5,1,4,20
191208826,8,0,9,5,7,29
191208827,2,0,5,2,7,16
191208828,4,6,9,4,8,31
191208829,4,2,1,3,8,18
191208830,8,7,5,6,6,32
191208831,4,3,6,2,8,23
191208832,3,8,0,2,8,21
191208833,3,8,4,4,4,23
191208834,1,9,2,0,0,12
191208835,4,3,5,4,5,21
191208836,1,5,0,3,4,13
191208837,0,1,1,3,8,13
191208838,1,6,5,9,0,21
191208839,4,8,9,6,1,28
191208840,6,8,5,1,1,21
191208841,4,7,0,7,5,23
191208842,0,7,6,2,0,15
191208843,7,9,1,7,7,31
191208844,7,1,7,1,5,21
191208845,8,7,5,6,3,29
191208846,2,4,4,7,2,19
191208847,5,0,6,3,9,23
191208848,7,4,7,5,0,23
191208849,4,4,7,7,3,25
191208850,1,1,9,9,5,25
191208851,1,6,6,9,7,29
191208852,4,9,2,3,7,25
191208853,6,0,6,9,1,22
191208854,1,5,1,7,5,19
191208855,0,8,7,7,3,25
191208856,0,6,0,8,4,18
191208857,7,1,5,4,0,17
191208858,2,4,5,7,8,26
191208859,2,6,9,0,9,26
191208860,2,1,5,4,5,17
191208861,3,1,9,8,1,22
191208862,4,7,5,8,8,32
191208863,0,7,4,4,7,22
191208864,3,7,5,9,4,28
191208865,4,1,6,6,5,22
191208866,5,8,8,3,5,29
191208867,6,5,6,4,8,29
191208868,0,1,2,7,0,10
191208869,1,6,4,7,8,26
191208870,4,5,6,8,2,25
191208871,4,3,8,4,5,24
191208872,5,1,5,9,5,25
191208873,0,6,7,5,6,24
191208874,9,0,9,1,5,24
191208875,8,1,8,7,6,30
191208876,6,0,9,5,8,28
191208877,2,1,1,1,6,11
191208878,2,2,5,1,6,16
191208879,2,0,2,0,6,10
191208880,4,2,4,9,9,28
191208881,4,2,2,1,7,16
191208882,6,9,9,3,4,31
191208883,8,9,8,7,8,40
191208884,9,0,9,7,4,29
191208885,9,7,0,5,3,24
191208886,6,6,2,0,7,21
191208887,6,5,9,7,3,30
191208888,1,0,9,5,9,24
191208889,9,9,4,9,1,32
191208890,8,5,5,1,6,25
191208891,4,6,5,1,1,17
191208892,4,2,9,2,0,17
191208893,2,6,8,9,1,26
191208894,5,5,4,2,6,22
191208895,2,5,7,3,3,20
191208896,8,9,0,5,4,26
191208897,9,8,3,0,9,29
191208898,6,5,9,7,7,34
191208899,7,0,0,9,5,21
191208900,8,4,0,7,9,28
191208901,3,6,0,9,0,18
191208902,8,6,8,1,9,32
191208903,0,3,1,3,1,8
191208904,3,6,6,1,9,25
191208905,7,2,3,6,1,19
191208906,5,9,4,8,2,28
191208907,4,8,1,4,7,24
191208908,6,6,9,8,6,35
191208909,1,9,1,0,8,19
191208910,1,3,0,9,5,18
191208911,3,2,4,6,5,20
191208912,5,5,7,8,8,33
191208913,1,6,3,8,8,26
191208914,3,7,3,7,2,22
191208915,3,9,9,3,2,26
191208916,0,5,9,5,8,27
191208917,4,9,7,4,7,31
191208918,9,0,2,9,8,28
191208919,5,6,3,1,2,17
191208920,7,3,8,7,6,31
191208921,0,2,4,8,3,17
191208922,1,9,3,5,4,22
191208923,0,3,8,1,6,18
191208924,3,7,5,3,3,21
191208925,1,7,9,3,9,29
191208926,8,4,2,5,5,24
191208927,8,3,6,5,2,24
191208928,0,1,8,9,6,24
191208929,7,2,4,2,9,24
191208930,1,1,2,1,4,9
191208931,4,9,9,4,4,30
191208932,5,2,2,0,8,17
191208933,7,3,8,2,0,20
191208934,2,0,1,2,0,5
191208935,8,8,6,2,5,29
191208936,5,2,5,3,2,17
191208937,7,2,8,1,8,26
191208938,4,9,0,9,9,31
191208939,2,8,1,1,8,20
191208940,4,0,0,2,1,7
191208941,5,1,3,9,3,21
191208942,2,7,8,0,2,19
191208943,6,5,8,5,4,28
191208944,0,1,2,4,9,16
191208945,8,9,6,7,0,30
191208946,3,0,6,8,0,17
191208947,4,0,2,6,2,14
191208948,7,1,7,0,4,19
191208949,0,8,9,7,1,25
191208950,0,7,0,6,1,14
191208951,8,6,9,0,1,24
191208952,9,9,2,8,7,35
191208953,6,7,6,5,1,25
191208954,1,8,7,5,0,21
191208955,3,5,9,0,9,26
191208956,2,7,4,8,4,25
191208957,0,0,7,1,2,10
191208958,7,7,5,8,7,34
191208959,7,5,2,8,3,25
191208960,7,6,3,0,7,23
191208961,3,7,9,3,6,28
191208962,0,3,8,2,3,16
191208963,8,9,1,8,0,26
191208964,3,7,0,7,4,21
191208965,0,0,8,6,5,19
191208966,6,6,0,5,1,18
191208967,4,5,9,1,5,24
191208968,4,9,0,0,4,17
191208969,5,5,6,6,4,26
191208970,8,8,8,5,9,38
191208971,8,4,6,0,3,21
191208972,2,5,1,1,8,17
191208973,3,9,3,1,3,19
191208974,1,8,6,8,8,31
191208975,7,4,2,2,2,17
191208976,7,6,0,8,1,22
191208977,5,6,5,8,3,27
191208978,5,7,3,9,8,32
191208979,7,4,3,4,7,25
191208980,4,9,1,5,5,24
191208981,6,4,3,7,0,20
191208982,2,6,2,8,3,21
191208983,3,1,8,4,6,22
191208984,8,3,3,6,7,27
191208985,5,1,4,7,6,23
191208986,2,5,4,9,3,23
191208987,5,0,4,0,2,11
191208988,2,0,2,1,8,13
191208989,1,4,1,9,1,16
191208990,0,5,7,5,1,18
191208991,1,2,9,9,9,30
191208992,3,5,6,7,8,29
191208993,3,0,3,3,3,12
191208994,1,9,9,4,2,25
191208995,5,3,3,1,3,15
191208996,6,1,8,6,3,24
191208997,9,8,6,1,0,24
191208998,7,6,5,2,2,22
191208999,4,2,6,5,0,17
1912081000,1,5,0,9,8,23
1912081001,9,6,2,0,6,23
1912081002,4,6,0,9,7,26
1912081003,5,0,0,6,7,18
1912081004,0,0,1,3,9,13
1912081005,9,5,1,1,6,22
1912081006,8,7,8,7,2,32
1912081007,9,9,6,3,4,31
1912081008,0,4,5,5,8,22
1912081009,5,4,9,2,4,24
1912081010,4,4,7,1,1,17
1912081011,1,2,7,1,7,18
1912081012,5,5,0,6,9,25
1912081013,7,3,4,0,5,19
1912081014,1,4,3,0,9,17
1912081015,7,4,8,0,7,26
1912081016,6,0,1,6,0,13
1912081017,6,1,4,3,8,22
1912081018,8,6,7,0,5,26
1912081019,0,8,8,8,5,29
1912081020,2,4,9,5,0,20
1912081021,9,2,0,7,5,23
1912081022,4,2,5,2,3,16
1912081023,6,9,1,9,6,31
1912081024,3,6,0,4,4,17
1912081025,4,8,9,8,8,37
1912081026,6,4,6,8,5,29
1912081027,1,6,8,3,5,23
1912081028,7,6,6,2,2,23
1912081029,0,7,4,8,5,24
1912081030,3,6,6,0,8,23
1912081031,0,7,1,9,7,24
1912081032,9,7,7,3,7,33
1912081033,6,4,7,3,2,22
1912081034,1,0,8,9,6,24
1912081035,4,8,7,0,0,19
1912081036,6,3,9,5,4,27
1912081037,3,1,1,0,4,9
1912081038,0,7,9,3,8,27
1912081039,3,1,5,0,5,14
1912081040,2,2,3,3,2,12
1912081041,0,9,7,0,5,21
1912081042,2,2,4,3,3,14
1912081043,8,1,6,7,4,26
1912081044,8,9,2,5,4,28
1912081045,5,4,3,7,5,24
1912081046,8,5,0,8,6,27
1912081047,8,2,3,3,4,20
1912081048,1,3,4,8,6,22
1912081049,9,0,4,7,0,20
1912081050,8,2,8,8,7,33
1912081051,8,5,1,9,6,29
1912081052,4,6,6,3,8,27
1912081053,0,3,0,4,5,12
1912081054,2,6,0,3,0,11
1912081055,2,4,9,0,1,16
1912081056,1,7,6,4,7,25
1912081057,8,0,2,3,3,16
1912081058,1,9,1,9,1,21
1912081059,4,0,2,6,0,12
1912081060,6,1,8,1,1,17
1912081061,8,5,7,2,8,30
1912081062,9,3,8,9,2,31
1912081063,0,5,9,2,4,20
1912081064,2,5,9,0,7,23
1912081065,7,5,5,8,3,28
1912081066,5,6,8,4,3,26
1912081067,0,5,4,4,0,13
1912081068,8,7,7,5,4,31
1912081069,0,2,0,5,3,10
1912081070,7,6,8,0,6,27
1912081071,1,3,1,6,3,14
1912081072,5,6,3,7,4,25
1912081073,5,3,0,8,9,25
1912081074,1,1,1,8,3,14
1912081075,0,4,7,8,3,22
1912081076,4,4,0,6,4,18
1912081077,1,7,0,8,8,24
1912081078,5,2,3,6,0,16
1912081079,3,6,5,1,8,23
1912081080,9,3,8,2,9,31
1912081081,1,6,9,4,1,21
1912081082,4,1,6,7,1,19
1912081083,2,9,5,9,2,27
1912081084,7,6,3,7,4,27
1912081085,3,5,4,1,8,21
1912081086,6,0,1,9,7,23
1912081087,2,5,0,2,4,13
1912081088,3,2,2,3,1,11
1912081089,3,5,3,6,7,24
1912081090,4,8,4,6,7,29
1912081091,1,7,5,6,1,20
1912081092,5,8,5,4,2,24
1912081093,8,2,4,6,3,23
1912081094,7,4,8,8,1,28
1912081095,1,1,6,8,6,22
1912081096,9,7,1,5,0,22
1912081097,8,6,3,1,7,25
1912081098,0,0,4,6,7,17
1912081099,4,3,2,7,9,25
1912081100,0,1,6,5,1,13
1912081101,5,4,0,0,6,15
1912081102,1,4,8,6,2,21
1912081103,8,9,0,9,4,30
1912081104,5,7,0,4,8,24
1912081105,9,8,6,3,7,33
191209001,7,7,6,6,0,26
191209002,4,3,3,9,1,20
191209003,6,6,1,8,5,26
191209004,1,9,6,0,9,25
191209005,5,0,9,0,4,18
191209006,0,9,9,6,7,31
191209007,8,6,4,9,5,32
191209008,9,2,9,9,4,33
191209009,1,1,3,8,2,15
191209010,0,8,0,3,4,15
191209011,5,2,7,7,0,21
191209012,0,8,7,5,7,27
191209013,0,2,1,3,5,11
191209014,5,4,1,5,8,23
191209015,3,9,2,6,2,22
191209016,0,7,1,6,1,15
191209017,2,4,4,1,9,20
191209018,7,9,6,2,7,31
191209019,9,4,5,1,6,25
191209020,1,4,7,0,6,18
191209021,8,4,6,3,2,23
191209022,7,3,8,4,9,31
191209023,4,8,7,1,8,28
191209024,0,6,6,5,3,20
191209025,7,8,9,9,2,35
191209026,5,6,9,4,4,28
191209027,9,8,1,3,2,23
191209028,7,4,1,2,4,18
191209029,4,1,5,5,3,18
191209030,4,8,8,7,1,28
191209031,6,2,4,3,1,16
191209032,9,9,5,2,7,32
191209033,6,2,1,7,2,18
191209034,0,9,1,8,2,20
191209035,8,2,2,2,1,15
191209036,8,8,1,0,7,24
191209037,6,1,5,8,2,22
191209038,3,0,6,2,4,15
191209039,3,8,0,1,6,18
191209040,5,0,5,9,8,27
191209041,5,8,0,9,8,30
191209042,1,7,0,4,1,13
191209043,4,6,5,5,9,29
191209044,3,2,1,3,8,17
191209045,6,6,7,1,4,24
191209046,4,0,4,0,5,13
191209047,9,3,9,5,5,31
191209048,9,2,7,9,6,33
191209049,6,1,1,0,6,14
191209050,5,5,9,1,4,24
191209051,3,2,1,7,7,20
191209052,1,2,5,1,5,14
191209053,3,9,8,8,1,29
191209054,8,8,5,2,3,26
191209055,8,6,4,8,3,29
191209056,9,0,5,2,1,17
191209057,3,4,3,1,4,15
191209058,2,0,7,4,5,18
191209059,7,6,4,4,4,25
191209060,2,2,7,3,0,14
191209061,9,8,9,8,5,39
191209062,3,7,8,9,1,28
191209063,7,7,6,6,6,32
191209064,5,7,4,2,0,18
191209065,2,6,7,8,6,29
191209066,7,9,0,8,8,32
191209067,9,5,1,6,4,25
191209068,1,4,0,0,6,11
191209069,2,7,0,3,0,12
191209070,7,6,1,7,3,24
191209071,6,0,7,3,5,21
191209072,2,1,4,2,5,14
191209073,2,5,4,2,8,21
191209074,2,8,6,8,6,30
191209075,8,2,8,0,8,26
191209076,4,7,1,5,3,20
191209077,7,8,9,7,7,38
191209078,2,9,4,6,5,26
191209079,3,3,3,2,8,19
191209080,2,4,1,3,7,17
191209081,9,2,6,0,1,18
191209082,9,5,9,4,7,34
191209083,2,7,0,1,4,14
191209084,0,7,2,9,9,27
191209085,3,1,5,4,7,20
191209086,1,5,0,4,4,14
191209087,4,7,4,0,8,23
191209088,8,7,3,2,7,27
191209089,7,3,1,4,5,20
191209090,1,7,6,0,5,19
191209091,6,6,2,5,5,24
191209092,9,5,4,1,1,20
191209093,0,4,0,5,5,14
191209094,6,4,7,7,8,32
191209095,3,1,9,0,6,19
191209096,5,0,5,7,5,22
191209097,1,5,9,1,3,19
191209098,4,9,8,2,7,30
191209099,7,3,4,6,4,24
191209100,2,7,0,6,0,15
191209101,5,3,0,3,2,13
191209102,2,8,1,8,9,28
191209103,9,3,8,1,4,25
191209104,1,0,3,7,3,14
191209105,0,8,6,2,9,25
191209106,9,8,1,0,3,21
191209107,1,0,7,7,7,22
191209108,8,4,3,7,9,31
191209109,8,1,4,7,6,26
191209110,7,3,4,5,5,24
191209111,8,4,5,8,5,30
191209112,6,9,0,7,7,29
191209113,3,2,6,3,1,15
191209114,8,3,9,0,7,27
191209115,8,4,3,9,5,29
191209116,1,0,1,5,5,12
191209117,1,4,6,3,2,16
191209118,9,2,9,9,9,38
191209119,6,7,2,4,9,28
191209120,8,5,9,7,2,31
191209121,0,4,5,0,3,12
191209122,6,8,6,7,8,35
191209123,1,6,8,3,8,26
191209124,6,3,7,6,7,29
191209125,5,4,5,7,1,22
191209126,1,1,3,2,3,10
191209127,9,5,9,8,6,37
191209128,3,6,7,3,6,25
191209129,7,7,6,2,7,29
191209130,9,7,9,4,3,32
191209131,1,1,9,0,3,14
191209132,2,8,3,1,8,22
191209133,7,7,1,5,8,28
191209134,7,8,7,9,1,32
191209135,9,4,8,8,4,33
191209136,9,4,1,8,5,27
191209137,3,5,4,8,9,29
191209138,9,6,1,4,8,28
191209139,1,8,7,0,7,23
191209140,4,7,0,5,9,25
191209141,1,7,8,7,8,31
191209142,4,2,3,6,4,19
191209143,4,8,6,7,2,27
191209144,8,4,2,6,4,24
191209145,5,2,6,4,4,21
191209146,9,2,1,4,1,17
191209147,7,5,6,5,6,29
191209148,1,0,7,1,3,12
191209149,9,8,7,0,2,26
191209150,3,7,4,8,7,29
191209151,6,3,7,5,1,22
191209152,1,7,5,1,2,16
191209153,5,4,3,2,2,16
191209154,6,9,5,4,5,29
191209155,7,2,2,4,2,17
191209156,2,9,3,5,8,27
191209157,4,7,3,3,1,18
191209158,7,5,5,9,7,33
191209159,5,1,6,9,0,21
191209160,9,9,5,6,8,37
191209161,3,0,5,3,9,20
191209162,0,8,9,1,6,24
191209163,4,3,2,5,4,18
191209164,2,4,6,7,0,19
191209165,2,7,3,5,0,17
191209166,9,5,3,6,1,24
191209167,2,0,9,1,6,18
191209168,5,1,7,1,3,17
191209169,7,8,8,0,1,24
191209170,2,5,7,6,1,21
191209171,0,3,6,5,6,20
191209172,1,4,6,0,5,16
191209173,9,1,2,2,8,22
191209174,0,3,2,5,5,15
191209175,4,4,9,4,8,29
191209176,0,0,3,7,4,14
191209177,1,3,1,7,2,14
191209178,2,0,0,9,7,18
191209179,2,6,0,8,0,16
191209180,6,7,1,8,5,27
191209181,8,8,9,5,8,38
191209182,0,9,5,4,7,25
191209183,2,8,2,1,1,14
191209184,1,0,1,0,1,3
191209185,6,6,4,7,8,31
191209186,5,8,7,2,8,30
191209187,5,7,0,6,2,20
191209188,9,6,0,6,5,26
191209189,8,2,0,6,1,17
191209190,2,6,5,7,4,24
191209191,5,7,0,9,8,29
191209192,8,1,5,9,7,30
191209193,7,5,3,1,3,19
191209194,7,2,1,4,4,18
191209195,8,4,6,1,4,23
191209196,6,6,2,9,0,23
191209197,5,4,0,2,3,14
191209198,5,5,5,1,6,22
191209199,7,2,6,2,8,25
191209200,4,0,4,6,4,18
191209201,7,0,8,5,9,29
191209202,4,0,2,4,4,14
191209203,9,2,9,6,6,32
191209204,8,4,6,7,1,26
191209205,1,2,1,0,3,7
191209206,2,0,3,0,1,6
191209207,8,3,5,4,8,28
191209208,8,1,3,4,6,22
191209209,0,8,0,0,8,16
191209210,5,2,7,4,9,27
191209211,2,6,9,1,2,20
191209212,9,0,4,9,6,28
191209213,7,6,6,9,2,30
191209214,8,1,4,1,0,14
191209215,8,7,1,0,5,21
191209216,9,9,0,5,4,27
191209217,5,5,5,8,7,30
191209218,2,5,2,6,0,15
191209219,5,9,7,3,8,32
191209220,4,2,7,9,6,28
191209221,2,5,4,1,7,19
191209222,0,6,1,9,1,17
191209223,8,1,0,1,1,11
191209224,3,3,1,8,7,22
191209225,2,9,6,5,4,26
191209226,3,1,4,7,0,15
191209227,4,4,0,8,5,21
191209228,2,4,0,5,1,12
191209229,4,7,0,3,8,22
191209230,4,7,6,8,5,30
191209231,4,9,8,0,1,22
191209232,5,2,2,2,5,16
191209233,7,6,7,6,5,31
191209234,1,9,1,1,8,20
191209235,8,4,9,5,5,31
191209236,8,6,0,6,6,26
191209237,9,8,2,8,6,33
191209238,9,6,3,2,2,22
191209239,4,9,0,1,1,15
191209240,0,2,4,8,4,18
191209241,9,5,5,5,9,33
191209242,4,4,9,3,4,24
191209243,6,9,4,3,5,27
191209244,0,1,2,8,3,14
191209245,4,0,2,9,2,17
191209246,7,7,6,4,6,30
191209247,5,2,0,4,7,18
191209248,0,2,3,3,8,16
191209249,5,3,4,9,9,30
191209250,4,8,1,3,5,21
191209251,0,4,1,9,0,14
191209252,0,5,9,2,0,16
191209253,0,9,4,9,0,22
191209254,1,2,3,4,7,17
191209255,1,2,5,4,2,14
191209256,2,4,9,0,3,18
191209257,6,8,9,3,6,32
191209258,1,7,6,2,2,18
191209259,6,0,8,7,4,25
191209260,6,3,4,6,4,23
191209261,8,8,4,4,6,30
191209262,2,3,1,2,8,16
191209263,4,9,0,8,9,30
191209264,0,6,4,7,5,22
191209265,8,1,1,8,0,18
191209266,2,6,9,6,8,31
191209267,1,0,6,1,2,10
191209268,1,3,6,4,0,14
191209269,5,0,3,6,9,23
191209270,7,4,2,6,1,20
191209271,1,5,7,9,3,25
191209272,2,0,7,4,2,15
191209273,2,9,1,6,6,24
191209274,5,0,1,9,8,23
191209275,2,8,9,3,3,25
191209276,4,4,8,4,9,29
191209277,4,0,7,9,3,23
191209278,3,5,4,0,2,14
191209279,5,3,6,4,0,18
191209280,9,9,8,7,1,34
191209281,4,5,8,6,5,28
191209282,1,0,3,1,4,9
191209283,0,6,4,2,8,20
191209284,6,6,3,5,0,20
191209285,6,8,3,0,1,18
191209286,1,9,6,3,0,19
191209287,7,4,6,1,4,22
191209288,0,9,0,8,4,21
191209289,8,2,9,2,2,23
191209290,7,6,5,1,9,28
191209291,9,0,9,6,1,25
191209292,1,7,7,8,5,28
191209293,1,7,5,5,2,20
191209294,7,7,9,2,6,31
191209295,3,8,1,2,6,20
191209296,8,3,4,5,2,22
191209297,9,0,3,7,5,24
191209298,3,1,2,7,4,17
191209299,5,2,7,1,2,17
191209300,5,4,8,0,2,19
191209301,8,0,8,8,3,27
191209302,0,9,4,1,0,14
191209303,2,2,4,1,6,15
191209304,1,4,3,3,3,14
191209305,3,7,0,9,8,27
191209306,7,4,2,4,8,25
191209307,0,1,2,0,9,12
191209308,4,9,8,2,6,29
191209309,2,8,2,4,9,25
191209310,2,7,7,9,2,27
191209311,7,4,5,5,6,27
191209312,0,8,2,5,2,17
191209313,3,8,1,9,2,23
191209314,4,6,5,8,6,29
191209315,9,5,0,4,5,23
191209316,6,2,4,1,1,14
191209317,3,2,3,3,3,14
191209318,0,9,8,7,7,31
191209319,0,2,7,2,8,19
191209320,1,9,4,9,6,29
191209321,8,6,4,7,9,34
191209322,5,5,6,1,0,17
191209323,8,5,2,4,9,28
191209324,7,7,5,2,9,30
191209325,8,8,4,0,0,20
191209326,2,6,1,6,5,20
191209327,9,2,2,1,9,23
191209328,6,8,2,1,0,17
191209329,3,8,0,2,3,16
191209330,0,5,6,7,6,24
191209331,7,0,5,2,5,19
191209332,8,3,5,5,6,27
191209333,6,2,4,1,5,18
191209334,9,3,8,1,8,29
191209335,9,3,2,7,7,28
191209336,1,9,4,2,0,16
191209337,1,8,7,8,6,30
191209338,7,0,2,3,1,13
191209339,0,3,3,0,0,6
191209340,6,4,6,4,8,28
191209341,2,5,6,0,5,18
191209342,1,8,3,4,5,21
191209343,5,5,3,8,6,27
191209344,3,3,7,1,6,20
191209345,0,9,7,7,2,25
191209346,1,3,5,6,0,15
191209347,8,0,2,7,3,20
191209348,6,3,1,2,6,18
191209349,7,3,6,7,5,28
191209350,7,8,8,4,1,28
191209351,4,8,9,9,2,32
191209352,0,8,9,5,9,31
191209353,4,2,4,2,0,12
191209354,7,4,7,5,1,24
191209355,9,9,2,4,8,32
191209356,0,4,6,5,4,19
191209357,6,4,3,1,7,21
191209358,8,1,3,3,4,19
191209359,6,3,2,3,3,17
191209360,0,4,1,8,7,20
191209361,7,6,4,6,5,28
191209362,3,9,5,5,2,24
191209363,2,4,1,7,6,20
191209364,9,9,5,0,5,28
191209365,7,2,6,0,7,22
191209366,5,3,7,2,8,25
191209367,0,4,8,6,0,18
191209368,1,4,5,3,0,13
191209369,2,0,5,0,1,8
191209370,0,4,4,9,8,25
191209371,5,2,1,7,3,18
191209372,3,2,8,8,3,24
191209373,9,5,7,5,2,28
191209374,2,6,6,5,2,21
191209375,4,2,6,8,8,28
191209376,0,1,3,8,8,20
191209377,4,5,3,4,3,19
191209378,7,2,0,0,9,18
191209379,7,9,7,7,6,36
191209380,9,5,1,5,1,21
191209381,9,9,1,5,7,31
191209382,6,6,6,0,7,25
191209383,3,3,2,2,7,17
191209384,7,3,5,6,5,26
191209385,4,2,5,5,2,18
191209386,6,9,0,5,7,27
191209387,1,2,6,8,1,18
191209388,1,7,0,3,4,15
191209389,4,3,0,3,0,10
191209390,4,6,6,3,6,25
191209391,6,2,8,7,8,31
191209392,9,8,9,3,8,37
191209393,5,0,6,7,2,20
191209394,9,4,4,3,2,22
191209395,3,6,5,8,7,29
191209396,2,7,4,7,6,26
191209397,1,1,8,6,8,24
191209398,4,1,9,6,7,27
191209399,0,7,1,4,5,17
191209400,1,7,0,3,6,17
191209401,8,2,5,7,3,25
191209402,2,6,7,9,7,31
191209403,2,1,2,0,6,11
191209404,2,6,6,9,6,29
191209405,9,3,8,6,7,33
191209406,6,9,3,0,4,22
191209407,9,7,8,3,9,36
191209408,4,7,5,3,4,23
191209409,2,8,9,7,1,27
191209410,8,8,6,3,6,31
191209411,2,4,1,3,0,10
191209412,2,1,6,2,6,17
191209413,1,8,6,8,9,32
191209414,0,0,0,2,2,4
191209415,1,9,7,2,8,27
191209416,8,1,7,9,2,27
191209417,4,3,3,5,7,22
191209418,7,0,5,8,1,21
191209419,5,6,5,5,0,21
191209420,0,9,9,4,5,27
191209421,1,6,6,6,3,22
191209422,2,5,7,9,6,29
191209423,5,3,0,7,3,18
191209424,6,1,6,6,0,19
191209425,3,4,4,7,0,18
191209426,8,3,6,1,7,25
191209427,7,9,9,9,0,34
191209428,3,1,8,9,9,30
191209429,0,1,0,3,3,7
191209430,7,9,8,8,4,36
191209431,1,7,6,3,6,23
191209432,0,3,4,1,6,14
191209433,6,7,7,8,6,34
191209434,1,4,6,7,8,26
191209435,6,2,1,4,3,16
191209436,1,8,4,6,1,20
191209437,4,0,8,1,3,16
191209438,1,3,5,0,4,13
191209439,1,5,1,7,0,14
191209440,5,0,1,2,3,11
191209441,5,1,0,3,7,16
191209442,1,3,3,2,3,12
191209443,2,7,1,3,7,20
191209444,7,6,7,8,0,28
191209445,9,7,9,6,0,31
191209446,3,5,8,0,4,20
191209447,2,1,4,2,2,11
191209448,8,1,3,1,2,15
191209449,2,1,2,5,0,10
191209450,6,8,6,8,5,33
191209451,5,4,8,7,8,32
191209452,6,7,9,8,9,39
191209453,2,5,3,1,1,12
191209454,8,8,2,8,0,26
191209455,7,6,2,3,6,24
191209456,8,1,2,1,1,13
191209457,6,6,5,4,7,28
191209458,4,1,2,0,0,7
191209459,2,2,2,2,6,14
191209460,8,9,2,1,0,20
191209461,3,9,8,6,3,29
191209462,5,2,3,6,6,22
191209463,5,2,6,0,6,19
191209464,2,8,9,7,2,28
191209465,0,4,4,2,9,19
191209466,6,0,3,0,8,17
191209467,5,7,4,0,3,19
191209468,6,8,7,3,4,28
191209469,2,8,0,9,8,27
191209470,0,6,8,0,1,15
191209471,5,8,3,2,4,22
191209472,5,1,9,0,2,17
191209473,9,2,5,5,3,24
191209474,6,1,4,1,6,18
191209475,4,4,7,5,5,25
191209476,3,1,6,2,1,13
191209477,9,5,4,1,2,21
191209478,6,9,0,6,9,30
191209479,9,4,1,2,6,22
191209480,2,3,9,9,9,32
191209481,8,0,4,5,2,19
191209482,0,3,3,9,7,22
191209483,1,2,2,7,4,16
191209484,4,3,9,7,4,27
191209485,5,8,6,8,1,28
191209486,3,5,4,6,4,22
191209487,1,1,2,9,4,17
191209488,5,6,0,7,2,20
191209489,4,5,9,1,7,26
191209490,7,0,3,2,8,20
191209491,7,3,4,2,1,17
191209492,9,1,4,0,0,14
191209493,6,2,7,7,7,29
191209494,5,9,7,2,6,29
191209495,7,6,6,1,9,29
191209496,2,5,1,4,7,19
191209497,1,5,8,2,0,16
191209498,2,5,2,2,4,15
191209499,9,5,7,9,0,30
191209500,0,8,5,4,5,22
191209501,8,7,7,6,1,29
191209502,9,8,6,9,1,33
191209503,3,2,2,2,5,14
191209504,0,1,0,3,0,4
191209505,4,4,9,2,7,26
191209506,2,9,2,0,3,16
191209507,9,4,5,5,2,25
191209508,3,5,1,7,9,25
191209509,8,6,3,7,6,30
191209510,5,1,6,9,7,28
191209511,9,4,7,7,0,27
191209512,0,6,0,1,6,13
191209513,2,5,8,6,9,30
191209514,0,2,9,9,2,22
191209515,9,7,3,0,5,24
191209516,9,4,8,1,9,31
191209517,7,9,8,7,6,37
191209518,2,0,0,4,5,11
191209519,5,2,3,4,9,23
191209520,1,6,9,1,7,24
191209521,5,3,7,1,5,21
191209522,7,5,3,9,3,27
191209523,3,2,2,7,6,20
191209524,8,5,1,0,6,20
191209525,5,5,2,3,3,18
191209526,6,3,2,0,0,11
191209527,0,8,5,7,5,25
191209528,4,1,0,0,8,13
191209529,9,8,5,0,6,28
191209530,2,4,8,6,5,25
191209531,9,5,3,0,2,19
191209532,3,6,9,0,3,21
191209533,5,1,3,7,7,23
191209534,4,4,3,3,4,18
191209535,2,9,1,6,4,22
191209536,0,0,6,0,9,15
191209537,1,4,7,3,2,17
191209538,5,3,2,5,1,16
191209539,9,7,6,3,3,28
191209540,0,4,6,0,4,14
191209541,7,2,2,1,6,18
191209542,1,9,0,8,6,24
191209543,9,8,4,2,9,32
191209544,4,7,5,5,9,30
191209545,5,7,4,6,3,25
191209546,0,7,0,0,2,9
191209547,5,8,2,9,5,29
191209548,7,8,8,3,8,34
191209549,0,4,3,0,0,7
191209550,2,4,8,1,2,17
191209551,9,1,2,4,9,25
191209552,7,5,6,1,4,23
191209553,9,9,6,8,3,35
191209554,0,6,7,6,7,26
191209555,3,0,3,8,2,16
191209556,3,4,5,8,3,23
191209557,2,9,0,3,1,15
191209558,4,7,3,1,5,20
191209559,9,0,8,8,6,31
191209560,1,4,3,6,4,18
191209561,9,1,4,3,1,18
191209562,6,2,5,7,0,20
191209563,6,1,7,8,5,27
191209564,4,8,8,2,5,27
191209565,1,7,1,4,0,13
191209566,1,0,5,0,3,9
191209567,5,6,5,9,6,31
191209568,8,6,6,0,0,20
191209569,4,7,2,2,9,24
191209570,5,2,5,4,3,19
191209571,8,5,9,3,7,32
191209572,4,7,9,3,9,32
191209573,6,9,8,7,6,36
191209574,3,6,8,8,6,31
191209575,8,9,4,6,9,36
191209576,3,8,9,9,6,35
191209577,3,3,0,6,6,18
191209578,3,5,1,9,0,18
191209579,2,8,6,7,1,24
191209580,1,3,7,7,7,25
191209581,1,6,2,3,8,20
191209582,7,2,5,5,7,26
191209583,4,0,4,2,7,17
191209584,1,5,3,3,3,15
191209585,4,2,6,4,8,24
191209586,4,2,1,3,7,17
191209587,0,9,8,9,9,35
191209588,8,1,0,6,2,17
191209589,9,8,0,9,5,31
191209590,3,9,0,2,6,20
191209591,6,6,8,1,3,24
191209592,9,2,2,0,8,21
191209593,8,3,1,7,6,25
191209594,6,9,9,3,8,35
191209595,1,1,4,4,7,17
191209596,7,0,3,4,5,19
191209597,6,5,5,0,5,21
191209598,4,9,5,8,3,29
191209599,3,8,0,8,9,28
191209600,5,7,3,5,6,26
191209601,2,1,0,3,7,13
191209602,5,9,7,6,7,34
191209603,9,9,3,4,2,27
191209604,4,0,8,4,1,17
191209605,8,2,3,5,0,18
191209606,1,1,3,1,2,8
191209607,6,6,1,3,3,19
191209608,6,8,4,4,9,31
191209609,7,8,7,7,6,35
191209610,2,5,2,1,1,11
191209611,4,5,3,5,7,24
191209612,5,3,3,7,1,19
191209613,7,6,4,0,7,24
191209614,0,7,5,0,5,17
191209615,0,1,8,7,4,20
191209616,3,0,1,8,4,16
191209617,5,1,0,2,0,8
191209618,2,9,3,9,8,31
191209619,1,6,2,2,9,20
191209620,0,6,3,5,9,23
191209621,0,6,2,0,5,13
191209622,1,8,7,1,8,25
191209623,3,7,5,2,5,22
191209624,6,9,3,5,2,25
191209625,7,6,5,5,1,24
191209626,4,4,1,6,5,20
191209627,7,7,6,6,9,35
191209628,6,6,4,9,2,27
191209629,3,1,9,2,4,19
191209630,0,2,2,8,7,19
191209631,0,3,2,8,9,22
191209632,4,1,1,3,9,18
191209633,2,0,0,4,3,9
191209634,7,6,5,8,3,29
191209635,0,3,7,3,6,19
191209636,8,8,4,4,9,33
191209637,8,5,1,3,5,22
191209638,6,3,8,3,2,22
191209639,8,0,8,0,1,17
191209640,0,6,5,5,1,17
191209641,0,4,5,8,0,17
191209642,1,4,9,5,4,23
191209643,6,3,7,9,6,31
191209644,8,0,0,7,9,24
191209645,8,6,6,4,6,30
191209646,0,2,7,5,1,15
191209647,6,8,6,4,8,32
191209648,0,4,7,7,6,24
191209649,6,7,9,5,1,28
191209650,2,1,3,7,7,20
191209651,2,5,6,4,5,22
191209652,6,9,4,4,0,23
191209653,4,3,0,5,2,14
191209654,8,9,7,9,9,42
191209655,7,6,7,8,5,33
191209656,7,7,1,7,0,22
191209657,9,5,5,8,1,28
191209658,1,0,4,9,9,23
191209659,5,8,8,5,0,26
191209660,1,9,7,7,9,33
191209661,6,6,0,6,8,26
191209662,5,1,7,2,2,17
191209663,1,6,9,1,5,22
191209664,9,0,7,8,3,27
191209665,4,9,5,1,5,24
191209666,2,9,8,6,6,31
191209667,1,2,2,5,2,12
191209668,4,6,5,4,1,20
191209669,5,1,4,5,6,21
191209670,1,8,1,0,6,16
191209671,1,1,5,5,1,13
191209672,6,4,9,8,1,28
191209673,9,3,4,8,4,28
191209674,8,0,2,2,8,20
191209675,9,1,1,2,3,16
191209676,1,9,2,1,0,13
191209677,7,0,2,0,8,17
191209678,1,2,4,3,6,16
191209679,5,5,9,2,0,21
191209680,3,2,1,1,6,13
191209681,0,8,2,3,5,18
191209682,4,2,4,6,1,17
191209683,4,1,3,6,5,19
191209684,2,1,7,9,1,20
191209685,5,9,4,6,3,27
191209686,0,2,7,6,2,17
191209687,5,8,3,1,5,22
191209688,3,0,6,0,7,16
191209689,7,6,1,0,2,16
191209690,3,8,5,2,4,22
191209691,3,4,1,4,4,16
191209692,0,5,6,1,4,16
191209693,2,6,0,7,6,21
191209694,9,4,6,2,6,27
191209695,6,6,0,6,7,25
191209696,9,1,4,2,3,19
191209697,0,6,2,0,1,9
191209698,2,0,5,7,7,21
191209699,1,5,2,3,0,11
191209700,9,2,9,0,6,26
191209701,5,2,8,4,6,25
191209702,8,8,0,8,8,32
191209703,0,6,5,2,1,14
191209704,6,9,7,8,7,37
191209705,3,7,8,5,5,28
191209706,1,0,4,0,7,12
191209707,7,9,8,3,0,27
191209708,3,0,1,4,7,15
191209709,8,0,9,0,2,19
191209710,7,3,6,6,5,27
191209711,0,7,8,7,1,23
191209712,8,9,9,6,2,34
191209713,5,6,3,0,2,16
191209714,7,7,2,5,8,29
191209715,4,1,8,6,5,24
191209716,6,5,0,5,9,25
191209717,6,1,6,6,5,24
191209718,1,5,2,5,7,20
191209719,8,2,3,9,6,28
191209720,9,6,8,8,3,34
191209721,4,3,9,2,8,26
191209722,0,5,0,7,6,18
191209723,9,4,0,7,4,24
191209724,4,1,5,1,4,15
191209725,1,1,4,0,7,13
191209726,6,4,8,2,7,27
191209727,9,0,4,7,4,24
191209728,2,3,4,7,3,19
191209729,6,9,8,0,4,27
191209730,1,9,6,1,0,17
191209731,2,7,8,3,9,29
191209732,5,6,6,6,4,27
191209733,1,6,0,6,0,13
191209734,9,2,4,3,9,27
191209735,5,9,4,5,3,26
191209736,6,3,1,6,2,18
191209737,2,0,4,2,2,10
191209738,4,4,7,0,2,17
191209739,3,9,8,8,0,28
191209740,6,9,6,5,1,27
191209741,1,2,3,2,2,10
191209742,3,5,4,1,2,15
191209743,5,3,5,5,7,25
191209744,4,6,2,7,9,28
191209745,9,6,5,4,8,32
191209746,0,0,4,5,0,9
191209747,6,2,8,5,0,21
191209748,8,9,3,8,2,30
191209749,9,3,3,7,0,22
191209750,3,9,6,1,3,22
191209751,8,5,0,1,2,16
191209752,1,7,3,0,9,20
191209753,6,6,3,6,8,29
191209754,4,0,2,2,1,9
191209755,9,3,5,9,1,27
191209756,2,6,7,6,0,21
191209757,4,2,5,2,5,18
191209758,5,2,4,8,7,26
191209759,2,8,7,3,8,28
191209760,3,7,8,3,6,27
191209761,5,1,5,0,0,11
191209762,7,1,7,6,7,28
191209763,6,9,8,0,8,31
191209764,7,4,4,8,6,29
191209765,1,2,1,8,9,21
191209766,2,4,9,6,8,29
191209767,0,3,4,2,5,14
191209768,7,7,6,3,2,25
191209769,7,0,1,0,9,17
191209770,6,3,0,2,3,14
191209771,0,0,2,1,0,3
191209772,8,9,1,7,1,26
191209773,3,0,3,0,0,6
191209774,8,1,4,9,7,29
191209775,6,4,4,1,7,22
191209776,6,9,5,9,5,34
191209777,6,0,8,5,0,19
191209778,6,4,0,3,3,16
191209779,9,7,3,2,0,21
191209780,6,6,0,5,8,25
191209781,7,2,3,5,1,18
191209782,7,5,9,0,3,24
191209783,4,6,0,8,2,20
191209784,6,4,8,3,7,28
191209785,0,4,9,6,0,19
191209786,0,4,0,2,2,8
191209787,6,9,9,3,5,32
191209788,4,2,5,0,5,16
191209789,0,8,1,9,3,21
191209790,6,9,8,0,6,29
191209791,5,1,5,5,1,17
191209792,4,2,5,8,1,20
191209793,6,1,0,8,1,16
191209794,2,8,3,3,4,20
191209795,3,6,3,5,9,26
191209796,9,9,9,7,1,35
191209797,1,5,5,5,7,23
191209798,9,2,3,3,7,24
191209799,4,7,6,9,4,30
191209800,7,1,3,5,4,20
191209801,5,9,4,3,4,25
191209802,8,3,4,0,6,21
191209803,7,0,5,8,8,28
191209804,4,0,8,8,5,25
191209805,1,3,0,1,1,6
191209806,0,2,7,4,2,15
191209807,9,9,4,1,4,27
191209808,3,9,8,4,5,29
191209809,9,2,6,9,4,30
191209810,5,5,3,4,7,24
191209811,4,7,5,0,5,21
191209812,1,2,4,3,5,15
191209813,4,1,2,5,4,16
191209814,3,4,5,6,5,23
191209815,1,5,2,0,9,17
191209816,3,9,2,2,4,20
191209817,5,0,3,9,1,18
191209818,1,3,3,3,3,13
191209819,0,8,1,9,7,25
191209820,5,1,3,8,3,20
191209821,1,2,6,6,2,17
191209822,0,7,5,0,3,15
191209823,1,0,7,1,7,16
191209824,9,1,3,5,2,20
191209825,5,1,5,3,3,17
191209826,1,4,6,2,2,15
191209827,6,3,8,3,1,21
191209828,0,7,4,2,7,20
191209829,8,9,7,8,0,32
191209830,4,0,7,2,8,21
191209831,9,4,8,0,7,28
191209832,0,8,3,1,1,13
191209833,1,3,9,0,2,15
191209834,1,9,3,1,5,19
191209835,0,7,4,7,1,19
191209836,1,2,7,0,8,18
191209837,0,7,6,7,2,22
191209838,5,6,8,8,0,27
191209839,1,5,3,3,9,21
191209840,2,0,9,7,3,21
191209841,5,2,1,8,0,16
191209842,9,7,8,6,0,30
191209843,5,8,0,7,8,28
191209844,5,5,6,8,3,27
191209845,4,7,9,7,6,33
191209846,5,0,7,7,6,25
191209847,3,1,4,3,8,19
191209848,2,0,1,5,7,15
191209849,7,6,1,1,7,22
191209850,5,4,5,0,3,17
191209851,4,3,4,4,4,19
191209852,6,7,0,8,8,29
191209853,8,4,3,7,6,28
191209854,2,6,5,3,5,21
191209855,7,5,9,8,2,31
191209856,3,5,4,2,0,14
191209857,9,2,8,3,4,26
191209858,5,0,0,5,1,11
191209859,5,7,0,3,0,15
191209860,2,8,2,7,9,28
191209861,1,1,7,3,2,14
191209862,6,0,6,0,5,17
191209863,1,0,9,4,5,19
191209864,9,8,0,1,8,26
191209865,3,9,0,3,2,17
191209866,3,4,9,6,8,30
191209867,5,1,6,7,7,26
191209868,7,2,8,3,9,29
191209869,7,1,6,2,6,22
191209870,2,3,8,3,1,17
191209871,1,7,3,5,8,24
191209872,4,1,1,8,1,15
191209873,7,0,2,0,7,16
191209874,9,6,1,1,6,23
191209875,8,3,1,7,7,26
191209876,6,0,8,5,5,24
191209877,0,7,1,9,4,21
191209878,2,3,2,3,9,19
191209879,2,8,8,1,0,19
191209880,2,4,5,1,9,21
191209881,9,6,6,5,5,31
191209882,1,0,6,2,0,9
191209883,6,8,4,5,8,31
191209884,5,7,5,3,0,20
191209885,7,6,6,1,7,27
191209886,7,9,0,2,9,27
191209887,5,0,5,5,6,21
191209888,6,8,8,2,2,26
191209889,3,1,3,6,1,14
191209890,2,2,6,9,3,22
191209891,1,8,1,8,1,19
191209892,6,6,1,2,4,19
191209893,7,9,9,7,9,41
191209894,5,6,8,4,9,32
191209895,7,1,1,9,0,18
191209896,1,1,7,0,3,12
191209897,5,2,7,2,8,24
191209898,2,3,2,5,0,12
191209899,4,7,0,0,7,18
191209900,4,8,1,1,7,21
191209901,6,9,3,4,1,23
191209902,0,3,2,4,3,12
191209903,5,3,5,4,7,24
191209904,8,1,0,3,4,16
191209905,2,7,9,1,9,28
191209906,6,0,9,2,5,22
191209907,3,8,4,2,2,19
191209908,0,1,2,9,9,21
191209909,7,4,1,7,8,27
191209910,3,2,9,3,8,25
191209911,3,9,3,8,6,29
191209912,5,3,5,9,7,29
191209913,4,5,1,7,8,25
191209914,6,2,8,0,1,17
191209915,6,4,1,5,8,24
191209916,1,4,7,2,2,16
191209917,4,6,2,2,8,22
191209918,1,8,7,4,8,28
191209919,6,6,0,9,3,24
191209920,7,8,8,4,0,27
191209921,7,3,1,1,8,20
191209922,4,6,4,4,6,24
191209923,0,0,6,8,2,16
191209924,6,7,2,2,2,19
191209925,8,0,7,5,6,26
191209926,3,9,0,2,9,23
191209927,5,3,0,8,4,20
191209928,9,7,2,1,9,28
191209929,4,9,4,4,7,28
191209930,5,0,1,6,2,14
191209931,4,3,8,6,8,29
191209932,7,7,2,1,8,25
191209933,6,2,3,9,4,24
191209934,1,0,3,1,9,14
191209935,6,2,6,8,1,23
191209936,6,8,4,0,1,19
191209937,7,0,4,3,5,19
191209938,1,1,0,2,4,8
191209939,0,3,7,3,4,17
191209940,0,4,8,2,4,18
191209941,1,5,5,9,7,27
191209942,0,1,0,9,8,18
191209943,8,0,7,0,8,23
191209944,0,3,5,8,8,24
191209945,2,4,3,8,3,20
191209946,4,8,3,5,8,28
191209947,7,1,3,2,5,18
191209948,9,6,3,1,3,22
191209949,0,8,8,8,2,26
191209950,4,4,9,1,9,27
191209951,5,2,4,3,4,18
191209952,0,8,6,5,0,19
191209953,3,7,6,1,9,26
191209954,4,9,3,0,5,21
191209955,7,8,6,9,3,33
191209956,2,1,6,0,1,10
191209957,4,3,3,0,0,10
191209958,7,5,4,2,7,25
191209959,1,4,1,7,5,18
191209960,6,9,2,8,6,31
191209961,6,8,7,7,9,37
191209962,7,5,8,2,4,26
191209963,4,8,7,6,4,29
191209964,0,0,1,1,9,11
191209965,3,2,4,4,3,16
191209966,1,1,9,1,4,16
191209967,6,2,5,8,1,22
191209968,3,7,2,2,8,22
191209969,9,5,3,2,8,27
191209970,8,2,4,2,5,21
191209971,0,1,5,7,1,14
191209972,8,3,3,4,3,21
191209973,3,1,9,6,2,21
191209974,8,4,7,6,8,33
191209975,2,9,0,1,1,13
191209976,6,9,4,2,1,22
191209977,7,8,0,6,8,29
191209978,3,7,6,5,9,30
191209979,7,6,6,8,5,32
191209980,9,6,5,8,2,30
191209981,4,7,9,5,1,26
191209982,6,6,3,7,4,26
191209983,2,3,3,5,1,14
191209984,8,6,7,9,5,35
191209985,1,9,9,0,1,20
191209986,0,2,7,4,1,14
191209987,4,1,1,4,1,11
191209988,7,3,2,6,5,23
191209989,8,6,6,0,3,23
191209990,5,7,3,7,3,25
191209991,0,1,0,9,2,12
191209992,8,2,2,9,5,26
191209993,7,9,7,7,7,37
191209994,3,2,3,4,1,13
191209995,6,4,0,8,6,24
191209996,4,6,7,3,1,21
191209997,1,5,9,8,5,28
191209998,2,1,2,5,4,14
191209999,0,9,1,4,2,16
1912091000,7,3,1,0,2,13
1912091001,4,7,2,4,3,20
1912091002,0,5,8,4,0,17
1912091003,5,1,8,2,9,25
1912091004,9,6,2,4,8,29
1912091005,5,7,2,1,1,16
1912091006,9,0,7,1,3,20
1912091007,7,5,4,2,1,19
1912091008,0,4,5,1,9,19
1912091009,6,0,1,9,5,21
1912091010,1,4,3,3,1,12
1912091011,7,1,3,6,9,26
1912091012,5,0,9,4,2,20
1912091013,0,2,4,1,6,13
1912091014,1,9,0,5,4,19
1912091015,0,2,4,9,2,17
1912091016,9,8,9,3,1,30
1912091017,8,4,1,7,4,24
1912091018,1,8,3,4,2,18
1912091019,5,4,7,5,6,27
1912091020,1,6,5,4,8,24
1912091021,5,7,1,3,7,23
1912091022,9,8,0,4,2,23
1912091023,7,2,7,9,5,30
1912091024,1,8,5,9,4,27
1912091025,7,3,4,8,5,27
1912091026,8,6,0,5,5,24
1912091027,8,8,3,2,2,23
1912091028,0,2,3,9,7,21
1912091029,5,0,4,4,5,18
1912091030,9,7,3,5,1,25
1912091031,2,5,7,8,9,31
1912091032,7,1,7,4,9,28
1912091033,0,9,0,3,3,15
1912091034,2,0,7,9,8,26
1912091035,8,0,6,1,4,19
1912091036,1,6,3,6,8,24
1912091037,1,7,7,0,6,21
1912091038,3,7,2,0,2,14
1912091039,7,0,2,2,0,11
1912091040,5,5,2,8,0,20
1912091041,4,0,1,8,1,14
1912091042,6,6,2,6,8,28
1912091043,2,0,3,2,2,9
1912091044,1,0,5,4,0,10
1912091045,9,1,4,1,8,23
1912091046,9,5,6,1,0,21
1912091047,2,8,5,7,1,23
1912091048,6,0,5,7,6,24
1912091049,3,7,3,2,3,18
1912091050,3,8,6,6,4,27
1912091051,1,4,2,1,1,9
1912091052,8,6,3,1,2,20
1912091053,6,9,7,6,7,35
1912091054,8,7,5,4,0,24
1912091055,1,5,3,7,1,17
1912091056,4,3,4,1,4,16
1912091057,0,4,0,4,5,13
1912091058,7,0,8,9,9,33
1912091059,8,3,2,8,2,23
1912091060,7,6,4,1,6,24
1912091061,6,4,4,0,1,15
1912091062,8,8,4,8,4,32
1912091063,9,3,3,6,7,28
1912091064,1,9,7,2,5,24
1912091065,2,6,9,1,5,23
1912091066,8,6,1,4,2,21
1912091067,3,5,8,9,9,34
1912091068,3,7,2,3,9,24
1912091069,2,0,9,5,7,23
1912091070,8,0,9,3,6,26
1912091071,8,3,0,8,2,21
1912091072,6,4,0,1,8,19
1912091073,4,7,2,7,6,26
1912091074,0,3,1,7,8,19
1912091075,4,2,2,6,4,18
1912091076,4,7,5,1,4,21
1912091077,5,4,6,3,7,25
1912091078,7,3,0,6,4,20
1912091079,0,1,7,2,5,15
1912091080,3,0,5,1,3,12
1912091081,8,9,0,0,6,23
1912091082,8,4,3,1,8,24
1912091083,6,5,0,6,3,20
1912091084,5,8,1,9,8,31
1912091085,8,9,6,7,2,32
1912091086,0,1,0,1,2,4
1912091087,6,5,8,1,2,22
1912091088,5,0,3,0,4,12
1912091089,2,3,1,5,7,18
1912091090,1,0,3,8,9,21
1912091091,8,9,1,2,1,21
1912091092,5,5,5,1,1,17
1912091093,6,2,6,0,1,15
1912091094,6,3,4,0,7,20
1912091095,4,3,2,5,9,23
1912091096,8,0,5,0,2,15
1912091097,0,8,2,5,6,21
1912091098,9,2,3,7,4,25
1912091099,0,0,9,0,8,17
1912091100,1,5,7,9,6,28
1912091101,3,0,5,8,6,22
1912091102,7,1,4,9,3,24
1912091103,3,6,9,1,0,19
1912091104,7,0,2,9,6,24
1912091105,8,0,6,0,0,14
191210001,0,8,8,0,7,23
191210002,9,8,9,8,7,41
191210003,9,4,7,1,4,25
191210004,6,8,5,7,5,31
191210005,3,7,7,6,7,30
191210006,3,8,4,3,5,23
191210007,4,3,3,7,2,19
191210008,0,9,1,6,8,24
191210009,4,7,2,3,4,20
191210010,4,7,5,3,9,28
191210011,4,5,9,4,6,28
191210012,1,5,8,9,2,25
191210013,2,0,7,8,8,25
191210014,8,5,4,8,2,27
191210015,9,1,6,7,8,31
191210016,0,0,7,4,5,16
191210017,6,8,7,2,1,24
191210018,9,9,0,4,7,29
191210019,4,2,6,2,6,20
191210020,4,6,6,9,0,25
191210021,4,6,7,3,9,29
191210022,0,2,0,8,7,17
191210023,1,4,0,1,4,10
191210024,6,7,6,5,8,32
191210025,7,6,4,0,0,17
191210026,7,9,1,0,5,22
191210027,4,0,5,1,0,10
191210028,2,9,3,5,2,21
191210029,2,2,7,6,0,17
191210030,3,1,1,0,5,10
191210031,2,8,3,6,4,23
191210032,0,6,7,7,0,20
191210033,6,7,3,6,0,22
191210034,9,9,6,1,7,32
191210035,4,9,3,0,8,24
191210036,4,3,6,3,6,22
191210037,7,1,7,3,8,26
191210038,2,2,0,2,5,11
191210039,8,6,2,6,9,31
191210040,3,1,6,1,3,14
191210041,4,5,1,8,9,27
191210042,1,4,4,8,8,25
191210043,6,6,4,8,0,24
191210044,3,8,4,9,5,29
191210045,1,9,9,7,8,34
191210046,9,2,5,9,5,30
191210047,8,8,5,7,0,28
191210048,6,3,6,2,6,23
191210049,6,2,8,8,3,27
191210050,9,5,5,6,5,30
191210051,2,2,2,8,9,23
191210052,2,3,0,4,8,17
191210053,5,4,6,5,4,24
191210054,1,7,5,4,9,26
191210055,2,6,1,8,2,19
191210056,1,4,5,6,7,23
191210057,1,4,2,2,1,10
191210058,1,0,7,5,4,17
191210059,1,1,7,4,8,21
191210060,1,1,0,8,2,12
191210061,1,3,9,8,3,24
191210062,0,1,9,5,1,16
191210063,1,2,1,7,5,16
191210064,2,4,7,1,7,21
191210065,0,5,3,5,6,19
191210066,5,4,3,1,1,14
191210067,4,1,8,9,1,23
191210068,7,7,7,9,0,30
191210069,3,6,5,9,3,26
191210070,5,8,8,9,4,34
191210071,3,1,5,1,5,15
191210072,3,5,8,4,4,24
191210073,5,8,6,1,8,28
191210074,2,2,7,0,8,19
191210075,5,9,0,4,2,20
191210076,0,3,0,6,0,9
191210077,4,7,8,0,8,27
191210078,8,2,9,6,9,34
191210079,9,5,0,6,5,25
191210080,6,9,4,6,0,25
191210081,1,7,1,6,5,20
191210082,3,5,7,6,0,21
191210083,2,4,7,9,3,25
191210084,0,0,4,8,2,14
191210085,1,8,4,1,2,16
191210086,1,9,5,1,1,17
191210087,8,7,7,9,4,35
191210088,2,4,0,6,0,12
191210089,3,0,4,6,3,16
191210090,6,1,3,9,4,23
191210091,9,7,1,8,6,31
191210092,4,2,1,4,3,14
191210093,5,7,5,3,4,24
191210094,0,7,9,2,4,22
191210095,7,3,2,0,9,21
191210096,6,6,2,8,5,27
191210097,3,4,6,7,8,28
191210098,4,6,6,0,5,21
191210099,0,8,3,2,4,17
191210100,8,2,7,1,5,23
191210101,3,1,6,0,6,16
191210102,6,0,5,3,9,23
191210103,0,7,7,1,8,23
191210104,1,7,7,8,7,30
191210105,2,1,4,5,3,15
191210106,4,5,3,0,8,20
191210107,2,9,4,7,3,25
191210108,5,6,5,4,9,29
191210109,1,2,5,8,4,20
191210110,7,7,9,6,5,34
191210111,0,9,1,9,3,22
191210112,2,1,1,7,6,17
191210113,3,7,7,4,7,28
191210114,5,2,3,3,9,22
191210115,3,8,7,0,1,19
191210116,1,6,2,1,9,19
191210117,2,7,3,0,9,21
191210118,9,0,9,9,7,34
191210119,0,5,1,4,8,18
191210120,8,9,9,0,8,34
191210121,0,2,3,1,8,14
191210122,7,8,4,0,9,28
191210123,0,8,6,1,7,22
191210124,7,6,0,6,8,27
191210125,8,0,4,3,4,19
191210126,1,1,2,5,7,16
191210127,2,1,9,2,1,15
191210128,1,4,8,0,9,22
191210129,8,5,8,7,8,36
191210130,2,9,2,1,5,19
191210131,7,0,1,9,6,23
191210132,1,2,7,1,4,15
191210133,1,1,2,2,5,11
191210134,9,8,0,0,7,24
191210135,8,9,9,5,4,35
191210136,6,7,7,6,6,32
191210137,1,6,8,9,3,27
191210138,0,8,8,9,0,25
191210139,4,8,3,5,9,29
191210140,7,3,8,9,9,36
191210141,2,3,2,3,6,16
191210142,6,7,1,1,7,22
191210143,3,4,2,9,3,21
191210144,4,6,2,7,4,23
191210145,7,3,3,5,3,21
191210146,7,1,6,0,4,18
191210147,0,5,9,6,5,25
191210148,7,7,1,4,4,23
191210149,0,7,1,8,5,21
191210150,0,1,7,5,3,16
191210151,4,7,3,2,8,24
191210152,0,5,0,9,4,18
191210153,9,5,8,6,0,28
191210154,0,6,7,2,1,16
191210155,7,7,3,0,5,22
191210156,0,8,6,9,8,31
191210157,6,2,3,2,6,19
191210158,0,1,6,0,7,14
191210159,5,2,1,2,7,17
191210160,9,4,9,1,6,29
191210161,6,6,6,5,1,24
191210162,0,2,9,2,7,20
191210163,6,2,5,6,0,19
191210164,8,7,2,8,0,25
191210165,4,1,5,6,5,21
191210166,9,6,6,7,6,34
191210167,4,7,3,3,6,23
191210168,5,3,5,2,2,17
191210169,7,2,3,0,1,13
191210170,7,2,3,7,7,26
191210171,9,1,0,0,7,17
191210172,4,3,0,1,3,11
191210173,7,5,5,5,2,24
191210174,8,3,3,1,5,20
191210175,9,5,5,3,7,29
191210176,6,7,3,6,3,25
191210177,0,6,2,1,0,9
191210178,2,2,2,6,0,12
191210179,9,9,4,8,5,35
191210180,6,8,0,9,8,31
191210181,7,5,2,5,2,21
191210182,9,9,2,7,2,29
191210183,9,3,3,0,2,17
191210184,1,4,4,9,3,21
191210185,8,7,2,3,1,21
191210186,8,0,1,9,3,21
191210187,3,6,5,6,0,20
191210188,6,0,4,4,9,23
191210189,7,2,8,2,8,27
191210190,8,5,5,0,3,21
191210191,8,8,5,5,9,35
191210192,2,6,4,5,4,21
191210193,0,6,8,8,3,25
191210194,8,3,6,8,4,29
191210195,4,1,9,9,3,26
191210196,8,2,9,8,1,28
191210197,2,0,2,4,3,11
191210198,2,6,8,6,1,23
191210199,2,1,5,3,2,13
191210200,6,6,1,6,5,24
191210201,4,5,4,2,5,20
191210202,2,2,5,5,9,23
191210203,8,0,6,9,8,31
191210204,5,8,2,8,0,23
191210205,3,4,6,8,1,22
191210206,5,7,5,3,6,26
191210207,8,7,2,2,6,25
191210208,3,1,8,0,5,17
191210209,2,2,4,6,9,23
191210210,2,3,7,0,8,20
191210211,6,3,4,0,8,21
191210212,1,8,4,1,8,22
191210213,2,2,9,2,0,15
191210214,7,1,3,8,3,22
191210215,4,6,6,0,2,18
191210216,0,4,1,6,5,16
191210217,3,4,5,7,6,25
191210218,5,8,9,7,4,33
191210219,8,4,7,0,3,22
191210220,1,4,5,1,1,12
191210221,0,5,9,6,4,24
191210222,4,0,1,9,0,14
191210223,3,0,7,9,2,21
191210224,1,2,6,7,0,16
191210225,7,8,8,6,8,37
191210226,2,3,6,4,3,18
191210227,5,9,8,1,1,24
191210228,1,4,7,1,4,17
191210229,4,7,9,0,8,28
191210230,4,4,0,5,5,18
191210231,3,9,9,6,2,29
191210232,7,8,8,1,9,33
191210233,6,1,6,1,1,15
191210234,3,6,5,0,1,15
191210235,0,9,1,8,1,19
191210236,8,6,0,5,3,22
191210237,1,7,1,4,3,16
191210238,5,7,5,3,3,23
191210239,3,8,7,7,2,27
191210240,0,4,5,2,6,17
191210241,1,9,8,5,3,26
191210242,7,5,9,9,0,30
191210243,8,9,2,8,8,35
191210244,3,5,2,0,6,16
191210245,0,5,0,1,3,9
191210246,7,5,2,0,7,21
191210247,8,2,3,6,2,21
191210248,4,0,0,6,5,15
191210249,9,1,6,0,7,23
191210250,1,6,8,8,0,23
191210251,1,1,7,7,3,19
191210252,5,8,2,2,3,20
191210253,4,7,4,9,3,27
191210254,2,8,6,4,5,25
191210255,9,1,6,2,0,18
191210256,3,0,3,9,4,19
191210257,7,1,9,0,1,18
191210258,1,8,5,9,6,29
191210259,9,1,2,2,0,14
191210260,6,7,7,7,7,34
191210261,2,2,0,3,4,11
191210262,0,7,8,8,2,25
191210263,5,9,5,4,4,27
191210264,9,9,6,6,8,38
191210265,8,8,7,6,7,36
191210266,7,1,0,4,1,13
191210267,4,3,6,5,4,22
191210268,4,6,6,9,7,32
191210269,0,3,4,5,5,17
191210270,8,2,8,6,0,24
191210271,5,8,2,0,6,21
191210272,2,7,5,6,3,23
191210273,5,8,0,5,1,19
191210274,3,6,3,0,6,18
191210275,0,3,4,2,0,9
191210276,6,7,1,3,1,18
191210277,0,9,6,5,7,27
191210278,7,5,7,8,9,36
191210279,6,7,5,0,8,26
191210280,0,8,5,4,3,20
191210281,4,1,0,3,3,11
191210282,5,1,4,1,5,16
191210283,3,2,5,5,5,20
191210284,4,1,7,9,6,27
191210285,6,3,1,3,4,17
191210286,0,4,5,8,4,21
191210287,9,9,0,1,6,25
191210288,8,8,4,0,8,28
191210289,1,4,8,6,0,19
191210290,3,1,2,6,2,14
191210291,8,3,7,5,6,29
191210292,1,4,6,3,0,14
191210293,7,9,9,2,2,29
191210294,8,1,0,0,1,10
191210295,1,9,9,7,7,33
191210296,5,5,1,6,5,22
191210297,6,8,5,8,1,28
191210298,5,1,6,6,1,19
191210299,9,8,5,2,3,27
191210300,3,7,1,9,8,28
191210301,8,0,4,6,9,27
191210302,3,9,0,1,2,15
191210303,3,1,2,2,3,11
191210304,8,4,9,8,8,37
191210305,4,2,9,8,8,31
191210306,7,3,2,0,6,18
191210307,8,7,6,2,5,28
191210308,9,4,1,8,8,30
191210309,7,4,1,1,2,15
191210310,0,3,3,8,4,18
191210311,1,8,8,5,7,29
191210312,3,2,7,1,9,22
191210313,5,6,8,2,3,24
191210314,7,3,3,9,5,27
191210315,5,4,1,1,8,19
191210316,5,2,4,5,3,19
191210317,3,0,2,2,0,7
191210318,9,2,8,7,0,26
191210319,2,8,7,9,9,35
191210320,0,9,9,5,7,30
191210321,6,3,8,3,3,23
191210322,2,1,8,1,6,18
191210323,6,5,8,4,6,29
191210324,2,9,7,8,3,29
191210325,4,5,5,8,7,29
191210326,9,6,1,5,0,21
191210327,0,5,9,7,6,27
191210328,6,2,2,5,5,20
191210329,0,2,2,1,3,8
191210330,4,2,3,5,3,17
191210331,1,7,0,8,6,22
191210332,4,8,4,9,9,34
191210333,0,4,4,3,3,14
191210334,9,4,6,3,5,27
191210335,0,7,7,8,6,28
191210336,4,2,5,1,0,12
191210337,8,7,9,9,2,35
191210338,8,4,3,7,0,22
191210339,6,9,8,2,6,31
191210340,3,8,2,1,3,17
191210341,0,8,4,6,1,19
191210342,6,2,5,6,4,23
191210343,4,8,8,5,4,29
191210344,7,8,3,5,1,24
191210345,0,0,9,7,4,20
191210346,5,4,1,4,5,19
191210347,3,6,6,9,2,26
191210348,9,8,0,4,9,30
191210349,8,5,6,4,8,31
191210350,8,2,0,7,0,17
191210351,3,2,4,8,4,21
191210352,8,4,0,0,8,20
191210353,7,3,3,6,3,22
191210354,9,3,2,8,2,24
191210355,6,3,5,7,7,28
191210356,8,3,7,4,1,23
191210357,0,2,5,5,5,17
191210358,5,6,1,4,2,18
191210359,9,2,2,2,2,17
191210360,4,2,1,7,9,23
191210361,6,2,1,7,3,19
191210362,2,7,3,5,2,19
191210363,8,9,4,5,0,26
191210364,0,2,1,9,4,16
191210365,0,8,3,3,1,15
191210366,0,0,6,0,8,14
191210367,8,1,2,0,7,18
191210368,9,2,7,6,7,31
191210369,5,4,7,3,8,27
191210370,8,3,9,0,3,23
191210371,2,9,9,5,3,28
191210372,3,7,5,5,9,29
191210373,7,9,0,0,6,22
191210374,2,8,6,5,9,30
191210375,4,8,0,7,1,20
191210376,5,7,4,7,1,24
191210377,5,3,7,8,0,23
191210378,5,3,5,2,9,24
191210379,4,9,0,7,0,20
191210380,3,9,0,6,2,20
191210381,8,2,3,8,5,26
191210382,7,1,1,4,7,20
191210383,7,1,6,1,6,21
191210384,1,0,2,4,6,13
191210385,7,1,9,6,8,31
191210386,2,9,2,8,0,21
191210387,7,8,7,1,7,30
191210388,2,6,3,8,9,28
191210389,3,1,6,8,3,21
191210390,1,8,5,5,3,22
191210391,4,8,8,0,9,29
191210392,6,5,6,9,1,27
191210393,1,0,3,3,4,11
191210394,0,3,7,6,7,23
191210395,0,0,8,2,2,12
191210396,0,8,3,8,1,20
191210397,6,5,3,6,9,29
191210398,5,7,1,0,1,14
191210399,8,4,5,7,3,27
191210400,7,7,1,9,5,29
191210401,5,7,4,1,7,24
191210402,0,1,0,4,4,9
191210403,3,8,0,1,7,19
191210404,8,9,3,3,0,23
191210405,0,0,5,1,9,15
191210406,3,5,0,2,9,19
191210407,9,4,3,5,3,24
191210408,7,6,2,1,5,21
191210409,4,5,5,7,3,24
191210410,1,5,1,5,3,15
191210411,3,1,0,5,8,17
191210412,4,5,4,1,1,15
191210413,9,9,2,6,8,34
191210414,5,3,0,5,4,17
191210415,8,3,4,6,0,21
191210416,0,9,8,6,0,23
191210417,3,2,6,6,8,25
191210418,4,4,3,3,3,17
191210419,4,8,5,8,6,31
191210420,3,9,2,4,7,25
191210421,8,9,1,6,7,31
191210422,7,6,9,3,1,26
191210423,0,5,3,4,1,13
191210424,7,7,7,7,9,37
191210425,5,3,1,6,2,17
191210426,7,2,3,0,7,19
191210427,2,7,8,1,1,19
191210428,3,8,7,5,7,30
191210429,6,4,1,7,0,18
191210430,7,9,7,1,2,26
191210431,3,9,9,1,1,23
191210432,4,0,3,3,6,16
191210433,9,3,0,0,2,14
191210434,8,1,9,6,7,31
191210435,5,9,9,9,9,41
191210436,0,1,1,0,9,11
191210437,7,7,1,0,5,20
191210438,1,5,2,4,8,20
191210439,5,5,2,3,4,19
191210440,3,8,6,0,8,25
191210441,9,6,1,6,3,25
191210442,3,7,3,5,4,22
191210443,8,6,3,7,1,25
191210444,4,8,6,3,8,29
191210445,1,1,5,1,5,13
191210446,7,4,9,3,9,32
191210447,1,5,7,8,7,28
191210448,6,2,2,4,7,21
191210449,7,3,3,8,7,28
191210450,5,0,7,4,8,24
191210451,8,0,7,6,4,25
191210452,5,3,1,7,5,21
191210453,7,2,1,4,7,21
191210454,0,3,8,3,6,20
191210455,1,2,7,3,0,13
191210456,7,1,9,1,1,19
191210457,4,1,7,9,3,24
191210458,0,8,3,7,0,18
191210459,0,9,9,7,1,26
191210460,3,7,5,3,6,24
191210461,4,0,6,6,3,19
191210462,2,5,5,8,5,25
191210463,6,6,6,3,2,23
191210464,9,2,5,1,1,18
191210465,1,8,7,4,1,21
191210466,8,4,7,3,7,29
191210467,6,9,3,9,9,36
191210468,0,4,4,1,3,12
191210469,8,6,2,8,3,27
191210470,2,6,2,7,3,20
191210471,9,5,2,0,8,24
191210472,6,9,8,9,4,36
191210473,5,6,8,9,4,32
191210474,0,8,0,0,6,14
191210475,7,7,2,6,0,22
191210476,7,1,1,5,0,14
191210477,6,5,1,2,1,15
191210478,0,6,7,2,2,17
191210479,2,4,8,1,6,21
191210480,8,1,2,9,5,25
191210481,2,8,4,9,7,30
191210482,6,4,3,0,3,16
191210483,4,4,8,5,3,24
191210484,9,5,5,9,5,33
191210485,4,7,1,7,0,19
191210486,7,0,2,8,0,17
191210487,9,8,1,7,6,31
191210488,5,0,1,6,6,18
191210489,2,1,5,6,8,22
191210490,4,1,4,3,6,18
191210491,4,3,5,8,6,26
191210492,8,3,1,9,7,28
191210493,2,3,1,6,0,12
191210494,5,2,4,9,9,29
191210495,1,4,9,5,1,20
191210496,4,7,0,5,7,23
191210497,6,8,7,3,7,31
191210498,7,7,6,1,9,30
191210499,2,6,3,6,3,20
191210500,2,6,1,1,2,12
191210501,1,0,4,7,8,20
191210502,0,6,2,7,2,17
191210503,7,5,7,0,0,19
191210504,4,6,4,6,9,29
191210505,3,9,0,9,5,26
191210506,3,4,4,8,8,27
191210507,5,3,1,8,2,19
191210508,1,9,0,5,7,22
191210509,6,8,1,9,2,26
191210510,7,0,2,3,9,21
191210511,0,8,9,0,1,18
191210512,6,2,9,6,0,23
191210513,8,1,7,6,6,28
191210514,7,5,8,6,1,27
191210515,3,9,1,7,5,25
191210516,3,8,2,7,1,21
191210517,1,5,9,1,8,24
191210518,9,8,0,6,5,28
191210519,6,0,7,1,4,18
191210520,8,0,5,8,2,23
191210521,2,5,3,5,6,21
191210522,5,3,0,8,2,18
191210523,9,2,3,4,2,20
191210524,2,9,8,6,9,34
191210525,6,0,5,8,1,20
191210526,9,5,8,9,4,35
191210527,1,0,2,9,2,14
191210528,3,5,3,4,6,21
191210529,4,1,3,0,3,11
191210530,8,6,8,9,1,32
191210531,3,4,2,2,5,16
191210532,4,4,0,2,7,17
191210533,7,3,0,3,0,13
191210534,2,4,0,9,1,16
191210535,5,6,8,2,4,25
191210536,7,0,2,2,6,17
191210537,0,8,3,8,5,24
191210538,5,0,0,7,1,13
191210539,3,2,7,0,9,21
191210540,1,6,1,1,5,14
191210541,3,6,0,4,0,13
191210542,3,3,3,5,1,15
191210543,0,2,6,7,6,21
191210544,4,7,0,6,7,24
191210545,2,7,6,0,9,24
191210546,5,8,5,0,4,22
191210547,6,8,4,0,2,20
191210548,9,8,5,0,1,23
191210549,7,2,7,5,7,28
191210550,5,3,9,5,2,24
191210551,3,2,8,1,3,17
191210552,3,7,3,3,7,23
191210553,2,4,2,2,1,11
191210554,7,7,4,8,4,30
191210555,1,8,1,7,3,20
191210556,0,0,2,5,9,16
191210557,0,4,0,8,2,14
191210558,7,3,4,7,0,21
191210559,3,9,1,1,4,18
191210560,1,1,0,3,8,13
191210561,2,5,0,6,8,21
191210562,4,3,4,3,1,15
191210563,5,5,4,9,8,31
191210564,7,6,5,0,1,19
191210565,9,2,8,0,6,25
191210566,3,6,6,9,9,33
191210567,4,0,4,8,0,16
191210568,2,3,3,9,3,20
191210569,6,2,4,4,4,20
191210570,3,2,3,1,7,16
191210571,6,3,9,8,3,29
191210572,3,0,8,8,1,20
191210573,1,2,7,8,5,23
191210574,8,8,1,7,3,27
191210575,8,7,8,7,6,36
191210576,7,0,9,5,2,23
191210577,2,9,5,7,8,31
191210578,0,3,6,1,7,17
191210579,8,1,8,7,8,32
191210580,9,8,9,7,4,37
191210581,5,8,5,8,4,30
191210582,3,6,0,4,3,16
191210583,7,3,1,3,3,17
191210584,4,6,8,9,3,30
191210585,5,4,6,5,2,22
191210586,3,2,8,4,8,25
191210587,7,0,4,3,0,14
191210588,3,0,7,1,0,11
191210589,0,2,6,8,2,18
191210590,6,7,5,0,9,27
191210591,9,6,5,9,8,37
191210592,0,2,8,9,3,22
191210593,5,3,7,6,2,23
191210594,1,2,9,2,9,23
191210595,5,1,2,1,7,16
191210596,8,1,9,0,7,25
191210597,5,2,3,2,7,19
191210598,9,5,3,2,5,24
191210599,9,9,2,9,0,29
191210600,0,4,6,2,9,21
191210601,5,2,9,3,1,20
191210602,7,1,1,3,7,19
191210603,4,2,9,1,6,22
191210604,3,3,1,4,8,19
191210605,6,9,3,8,5,31
191210606,8,5,0,0,8,21
191210607,6,6,4,8,3,27
191210608,9,4,3,6,8,30
191210609,4,7,6,9,6,32
191210610,3,1,2,5,1,12
191210611,8,0,8,8,2,26
191210612,9,3,4,5,6,27
191210613,1,7,2,9,0,19
191210614,1,2,3,4,5,15
191210615,8,8,8,1,8,33
191210616,1,5,4,4,5,19
191210617,8,2,3,1,8,22
191210618,5,9,8,6,5,33
191210619,2,9,2,5,7,25
191210620,2,4,9,8,7,30
191210621,2,0,3,9,2,16
191210622,7,9,3,0,9,28
191210623,4,7,4,5,7,27
191210624,2,6,4,5,8,25
191210625,6,4,4,9,4,27
191210626,3,9,0,5,0,17
191210627,1,2,4,6,8,21
191210628,8,5,3,1,7,24
191210629,1,8,8,7,8,32
191210630,8,8,0,4,0,20
191210631,2,7,7,7,4,27
191210632,9,7,7,7,3,33
191210633,0,4,9,3,2,18
191210634,4,0,0,3,3,10
191210635,3,1,1,8,5,18
191210636,8,3,4,7,8,30
191210637,4,8,3,6,2,23
191210638,1,4,9,3,4,21
191210639,9,1,1,0,8,19
191210640,7,7,0,5,2,21
191210641,2,7,2,9,5,25
191210642,8,1,7,4,2,22
191210643,4,0,1,9,1,15
191210644,9,1,4,0,9,23
191210645,2,1,3,1,1,8
191210646,0,0,7,5,1,13
191210647,9,1,1,2,2,15
191210648,9,2,9,2,3,25
191210649,7,3,1,2,0,13
191210650,3,9,9,8,8,37
191210651,6,7,8,2,1,24
191210652,5,4,4,9,1,23
191210653,0,4,8,6,7,25
191210654,4,0,5,0,3,12
191210655,1,6,5,2,3,17
191210656,5,1,9,6,5,26
191210657,6,6,1,3,1,17
191210658,1,2,2,2,0,7
191210659,7,9,6,3,3,28
191210660,7,6,6,8,9,36
191210661,2,0,9,0,8,19
191210662,8,5,9,5,7,34
191210663,2,5,5,8,2,22
191210664,4,9,3,9,2,27
191210665,8,7,2,3,4,24
191210666,1,2,6,0,0,9
191210667,7,9,3,6,4,29
191210668,5,8,2,7,0,22
191210669,5,5,2,7,7,26
191210670,1,8,3,7,7,26
191210671,5,3,7,7,6,28
191210672,9,5,5,2,0,21
191210673,2,9,5,9,9,34
191210674,2,5,1,8,8,24
191210675,0,3,4,1,7,15
191210676,1,6,8,2,4,21
191210677,0,0,7,7,6,20
191210678,0,2,0,7,3,12
191210679,5,4,5,1,5,20
191210680,2,3,1,6,5,17
191210681,0,7,9,3,3,22
191210682,4,3,9,8,5,29
191210683,1,9,8,0,6,24
191210684,8,6,2,3,7,26
191210685,3,4,7,8,5,27
191210686,7,2,2,7,3,21
191210687,2,9,5,5,4,25
191210688,2,8,8,1,7,26
191210689,8,9,2,3,2,24
191210690,1,7,5,2,6,21
191210691,9,9,3,7,5,33
191210692,7,6,8,3,0,24
191210693,2,8,2,8,9,29
191210694,3,0,9,5,2,19
191210695,8,2,9,9,1,29
191210696,9,5,6,0,9,29
191210697,2,4,4,8,9,27
191210698,6,9,0,0,0,15
191210699,6,8,3,1,0,18
191210700,5,6,7,1,9,28
191210701,1,2,0,8,8,19
191210702,8,2,0,1,6,17
191210703,4,4,0,1,2,11
191210704,0,2,9,7,4,22
191210705,0,0,1,4,6,11
191210706,5,3,7,0,4,19
191210707,2,3,2,8,0,15
191210708,4,4,4,8,3,23
191210709,0,4,9,4,3,20
191210710,2,6,6,0,5,19
191210711,4,7,6,3,9,29
191210712,5,7,8,9,3,32
191210713,2,5,9,8,5,29
191210714,0,3,2,5,3,13
191210715,6,9,2,3,9,29
191210716,6,2,6,1,1,16
191210717,6,5,2,0,0,13
191210718,0,8,6,5,3,22
191210719,0,9,2,2,9,22
191210720,9,3,1,0,5,18
191210721,3,3,2,1,2,11
191210722,1,6,5,7,6,25
191210723,1,9,5,5,1,21
191210724,6,3,6,2,2,19
191210725,8,8,4,5,4,29
191210726,6,0,0,0,3,9
191210727,5,8,7,8,6,34
191210728,7,7,7,9,8,38
191210729,7,0,7,5,3,22
191210730,4,3,9,5,6,27
191210731,9,5,3,9,2,28
191210732,6,4,6,9,0,25
191210733,7,3,5,7,8,30
191210734,0,0,5,8,9,22
191210735,9,4,2,7,6,28
191210736,6,2,6,6,4,24
191210737,0,9,5,1,1,16
191210738,4,4,9,7,9,33
191210739,2,7,5,1,3,18
191210740,0,4,6,1,7,18
191210741,6,5,2,1,8,22
191210742,8,3,0,8,3,22
191210743,5,2,5,9,8,29
191210744,7,7,2,4,5,25
191210745,6,7,7,3,1,24
191210746,7,8,4,1,4,24
191210747,5,5,9,7,5,31
191210748,1,4,2,6,4,17
191210749,9,4,1,0,7,21
191210750,0,5,3,6,8,22
191210751,4,1,4,8,6,23
191210752,8,1,5,9,3,26
191210753,7,0,7,5,8,27
191210754,2,5,1,6,6,20
191210755,4,9,6,7,3,29
191210756,0,9,5,7,1,22
191210757,0,7,5,0,0,12
191210758,4,4,7,1,6,22
191210759,2,3,7,6,8,26
191210760,5,2,7,5,5,24
191210761,6,9,9,6,4,34
191210762,4,4,2,0,9,19
191210763,2,2,6,2,2,14
191210764,9,6,7,6,5,33
191210765,0,6,5,7,3,21
191210766,9,2,4,2,2,19
191210767,1,8,4,2,6,21
191210768,0,9,3,8,4,24
191210769,6,4,3,6,1,20
191210770,8,2,3,3,8,24
191210771,4,8,0,9,4,25
191210772,4,7,7,7,5,30
191210773,3,4,6,5,4,22
191210774,4,8,2,4,7,25
191210775,5,2,5,2,1,15
191210776,6,1,1,4,8,20
191210777,2,0,9,2,9,22
191210778,6,5,5,4,1,21
191210779,9,7,0,8,9,33
191210780,4,9,2,2,2,19
191210781,9,9,3,1,0,22
191210782,8,5,2,4,3,22
191210783,8,1,1,8,7,25
191210784,0,5,8,6,6,25
191210785,4,5,9,1,3,22
191210786,1,2,3,3,3,12
191210787,5,6,3,1,3,18
191210788,4,5,4,0,3,16
191210789,3,3,2,9,8,25
191210790,3,7,2,8,6,26
191210791,8,1,0,8,4,21
191210792,5,4,9,3,1,22
191210793,4,2,8,1,4,19
191210794,5,3,2,9,8,27
191210795,6,9,6,1,9,31
191210796,5,3,7,1,7,23
191210797,4,7,5,4,3,23
191210798,0,2,9,9,3,23
191210799,5,2,4,8,9,28
191210800,8,1,2,1,5,17
191210801,8,1,8,8,7,32
191210802,1,2,3,7,1,14
191210803,4,8,2,5,8,27
191210804,4,4,9,7,0,24
191210805,1,0,1,4,3,9
191210806,3,2,3,7,6,21
191210807,5,9,6,6,9,35
191210808,2,2,4,1,4,13
191210809,6,0,9,5,5,25
191210810,0,5,0,3,9,17
191210811,9,0,3,8,8,28
191210812,9,4,3,7,6,29
191210813,1,0,0,7,6,14
191210814,8,4,4,8,7,31
191210815,1,7,3,3,3,17
191210816,0,4,8,2,8,22
191210817,5,8,4,2,9,28
191210818,7,4,3,3,6,23
191210819,4,3,9,0,6,22
191210820,5,8,8,9,2,32
191210821,4,0,3,3,8,18
191210822,5,4,1,4,6,20
191210823,1,3,8,2,9,23
191210824,4,0,3,3,3,13
191210825,4,5,5,3,4,21
191210826,3,0,9,9,3,24
191210827,7,2,4,3,8,24
191210828,9,4,9,5,3,30
191210829,0,0,4,7,3,14
191210830,5,8,8,5,7,33
191210831,5,2,8,9,0,24
191210832,1,7,5,7,9,29
191210833,5,8,1,9,0,23
191210834,1,2,0,1,5,9
191210835,3,1,4,7,6,21
191210836,8,2,9,4,2,25
191210837,8,2,5,3,6,24
191210838,7,0,7,0,7,21
191210839,4,2,4,7,3,20
191210840,0,1,2,7,4,14
191210841,2,0,3,8,7,20
191210842,0,2,1,3,3,9
191210843,5,2,0,2,4,13
191210844,8,5,7,5,1,26
191210845,0,9,8,9,0,26
191210846,4,3,9,1,9,26
191210847,5,7,7,2,0,21
191210848,8,1,7,7,5,28
191210849,4,1,5,0,7,17
191210850,2,5,9,5,9,30
191210851,5,2,5,5,7,24
191210852,5,4,4,9,7,29
191210853,1,1,1,9,5,17
191210854,4,4,4,8,6,26
191210855,5,5,4,8,2,24
191210856,7,1,8,9,7,32
191210857,3,7,3,7,4,24
191210858,8,9,6,1,0,24
191210859,1,9,7,6,4,27
191210860,5,6,0,0,2,13
191210861,4,4,6,4,3,21
191210862,1,5,2,8,3,19
191210863,8,0,7,8,5,28
191210864,9,3,0,3,7,22
191210865,1,7,2,4,6,20
191210866,4,3,8,6,3,24
191210867,4,3,9,8,6,30
191210868,8,6,3,5,3,25
191210869,6,7,8,1,6,28
191210870,3,0,1,1,5,10
191210871,1,9,9,9,7,35
191210872,7,2,9,1,5,24
191210873,0,9,9,3,6,27
191210874,2,6,9,2,1,20
191210875,5,6,9,3,0,23
191210876,9,0,7,5,6,27
191210877,4,4,1,5,9,23
191210878,6,4,9,3,5,27
191210879,8,2,7,7,6,30
191210880,4,4,2,3,8,21
191210881,1,3,3,7,5,19
191210882,5,8,4,0,5,22
191210883,2,4,0,7,0,13
191210884,1,3,8,7,1,20
191210885,3,8,5,0,9,25
191210886,7,4,6,2,7,26
191210887,9,0,7,5,9,30
191210888,9,7,3,3,2,24
191210889,8,5,6,1,5,25
191210890,2,7,2,0,1,12
191210891,9,4,7,0,8,28
191210892,9,3,6,7,8,33
191210893,3,4,0,6,0,13
191210894,6,5,1,5,7,24
191210895,6,4,4,0,6,20
191210896,0,7,7,0,3,17
191210897,9,6,0,6,7,28
191210898,1,1,6,8,9,25
191210899,9,6,7,6,3,31
191210900,9,1,4,3,4,21
191210901,2,4,1,6,8,21
191210902,2,8,1,0,7,18
191210903,2,1,0,0,2,5
191210904,7,7,0,3,4,21
191210905,8,3,3,2,1,17
191210906,1,3,2,4,8,18
191210907,2,2,8,2,9,23
191210908,1,5,0,3,2,11
191210909,1,8,9,6,3,27
191210910,2,5,0,3,9,19
191210911,0,6,5,8,6,25
191210912,6,9,2,2,2,21
191210913,2,2,3,5,6,18
191210914,3,8,5,9,0,25
191210915,6,1,6,9,0,22
191210916,0,7,9,6,7,29
191210917,2,6,9,9,1,27
191210918,0,8,3,1,0,12
191210919,1,9,4,7,4,25
191210920,3,7,9,3,2,24
191210921,1,0,7,3,1,12
191210922,1,5,9,0,2,17
191210923,0,2,2,9,7,20
191210924,4,7,4,6,4,25
191210925,3,0,3,7,2,15
191210926,8,5,7,0,5,25
191210927,6,1,9,4,3,23
191210928,0,6,8,6,2,22
191210929,5,7,4,3,7,26
191210930,6,1,0,7,0,14
191210931,7,9,3,9,1,29
191210932,7,6,1,8,9,31
191210933,8,5,5,6,5,29
191210934,5,1,5,3,7,21
191210935,2,8,0,9,3,22
191210936,4,3,1,0,6,14
191210937,0,3,7,2,6,18
191210938,1,4,0,8,7,20
191210939,1,6,6,8,3,24
191210940,0,0,3,0,3,6
191210941,5,1,8,1,6,21
191210942,3,2,5,3,5,18
191210943,5,8,3,6,8,30
191210944,6,8,1,8,6,29
191210945,3,0,0,0,6,9
191210946,0,7,3,8,4,22
191210947,2,4,6,9,4,25
191210948,8,7,5,8,3,31
191210949,0,7,9,0,3,19
191210950,5,1,0,2,3,11
191210951,0,2,5,3,4,14
191210952,1,2,0,2,5,10
191210953,3,1,8,3,6,21
191210954,3,4,9,6,1,23
191210955,5,3,5,1,1,15
191210956,1,7,6,6,3,23
191210957,0,7,9,4,3,23
191210958,8,9,0,2,4,23
191210959,1,2,9,4,1,17
191210960,1,8,1,8,7,25
191210961,9,2,0,4,1,16
191210962,8,3,7,7,8,33
191210963,2,4,8,1,1,16
191210964,8,7,1,6,5,27
191210965,8,8,3,8,8,35
191210966,0,7,4,1,7,19
191210967,8,9,5,9,8,39
191210968,1,2,6,4,4,17
191210969,4,0,0,5,2,11
191210970,1,4,4,1,9,19
191210971,9,2,7,2,0,20
191210972,8,7,9,8,2,34
191210973,8,2,2,7,9,28
191210974,2,7,4,6,9,28
191210975,6,7,7,0,5,25
191210976,2,8,8,2,0,20
191210977,8,8,5,6,0,27
191210978,2,2,0,4,0,8
191210979,0,1,6,2,5,14
191210980,9,3,8,7,9,36
191210981,1,1,0,1,8,11
191210982,5,2,9,8,2,26
191210983,9,5,9,3,6,32
191210984,8,0,1,7,2,18
191210985,0,0,5,9,3,17
191210986,7,6,2,4,0,19
191210987,1,1,8,7,6,23
191210988,3,1,5,5,5,19
191210989,9,3,3,9,1,25
191210990,6,2,8,2,4,22
191210991,7,3,0,4,2,16
191210992,6,9,9,1,9,34
191210993,6,7,7,3,6,29
191210994,8,6,6,3,1,24
191210995,1,3,4,9,5,22
191210996,5,5,2,4,9,25
191210997,8,9,0,4,3,24
191210998,4,6,4,6,0,20
191210999,8,1,2,1,9,21
1912101000,9,6,4,0,7,26
1912101001,4,1,8,7,5,25
1912101002,0,3,4,3,7,17
1912101003,0,3,1,7,4,15
1912101004,2,0,8,0,5,15
1912101005,8,6,5,5,9,33
1912101006,1,2,8,3,6,20
1912101007,6,1,9,5,3,24
1912101008,8,8,6,6,5,33
1912101009,4,4,2,6,5,21
1912101010,2,2,8,6,9,27
1912101011,8,9,8,8,6,39
1912101012,6,9,2,2,1,20
1912101013,7,8,8,1,6,30
1912101014,9,1,4,7,7,28
1912101015,0,9,6,6,5,26
1912101016,3,6,4,0,8,21
1912101017,2,2,9,4,6,23
1912101018,7,7,2,5,3,24
1912101019,1,9,9,1,7,27
1912101020,5,7,6,0,1,19
1912101021,3,1,7,6,5,22
1912101022,7,9,1,7,3,27
1912101023,0,0,2,6,5,13
1912101024,7,1,5,1,7,21
1912101025,5,7,9,7,9,37
1912101026,3,7,3,2,5,20
1912101027,3,3,7,3,5,21
1912101028,6,0,5,4,7,22
1912101029,4,5,3,3,9,24
1912101030,3,2,1,8,5,19
1912101031,1,7,4,0,6,18
1912101032,4,1,0,7,0,12
1912101033,2,0,3,7,6,18
1912101034,2,0,0,0,1,3
1912101035,3,3,1,1,0,8
1912101036,4,8,8,9,0,29
1912101037,6,5,9,3,7,30
1912101038,3,7,6,3,3,22
1912101039,0,0,4,6,0,10
1912101040,6,9,3,7,3,28
1912101041,0,5,7,0,2,14
1912101042,9,5,4,8,3,29
1912101043,1,2,6,0,8,17
1912101044,8,2,2,1,0,13
1912101045,0,7,8,0,9,24
1912101046,1,0,0,3,7,11
1912101047,5,8,7,0,6,26
1912101048,0,7,7,9,5,28
1912101049,5,4,9,4,0,22
1912101050,7,0,6,2,3,18
1912101051,0,1,9,2,6,18
1912101052,4,5,5,7,4,25
1912101053,1,6,9,3,5,24
1912101054,4,1,8,1,5,19
1912101055,3,0,5,6,1,15
1912101056,3,7,0,3,9,22
1912101057,0,9,4,9,6,28
1912101058,7,0,5,9,4,25
1912101059,6,1,8,7,4,26
1912101060,5,9,1,8,3,26
1912101061,5,1,2,2,6,16
1912101062,1,8,0,5,3,17
1912101063,7,7,7,0,8,29
1912101064,4,8,1,7,9,29
1912101065,1,0,7,6,6,20
1912101066,0,4,8,1,6,19
1912101067,5,5,8,9,1,28
1912101068,2,8,3,8,4,25
1912101069,1,2,4,5,1,13
1912101070,4,6,4,0,3,17
1912101071,9,1,2,8,1,21
1912101072,8,1,8,7,1,25
1912101073,1,8,9,2,2,22
1912101074,2,6,6,4,7,25
1912101075,8,8,1,9,7,33
1912101076,7,4,7,9,7,34
1912101077,1,4,3,6,5,19
1912101078,2,9,0,7,4,22
1912101079,0,4,5,7,1,17
1912101080,8,4,1,8,2,23
1912101081,8,1,6,6,3,24
1912101082,3,2,9,8,8,30
1912101083,2,0,2,1,8,13
1912101084,8,3,1,4,0,16
1912101085,3,6,0,2,0,11
1912101086,2,1,5,4,7,19
1912101087,8,9,0,9,7,33
1912101088,8,9,6,6,3,32
1912101089,5,5,1,6,9,26
1912101090,4,3,0,9,9,25
1912101091,6,9,9,3,9,36
1912101092,4,0,5,2,8,19
1912101093,8,4,2,7,2,23
1912101094,7,7,9,5,9,37
1912101095,9,1,2,4,6,22
1912101096,3,3,8,3,9,26
1912101097,2,3,7,0,6,18
1912101098,7,6,4,2,0,19
1912101099,3,2,6,9,0,20
1912101100,8,7,2,1,6,24
1912101101,3,2,1,1,5,12
1912101102,6,5,6,8,5,30
1912101103,7,6,1,7,6,27
1912101104,0,5,4,0,8,17
1912101105,0,5,5,0,9,19
191211001,2,3,7,8,7,27
191211002,6,7,5,0,3,21
191211003,7,6,6,1,2,22
191211004,8,7,8,6,8,37
191211005,5,7,4,8,3,27
191211006,9,2,2,5,5,23
191211007,6,6,9,8,3,32
191211008,4,3,3,6,9,25
191211009,2,6,4,3,9,24
191211010,5,9,6,8,9,37
191211011,5,2,6,9,8,30
191211012,5,4,2,4,7,22
191211013,8,6,0,6,2,22
191211014,2,8,3,8,2,23
191211015,2,4,4,4,3,17
191211016,1,6,3,4,4,18
191211017,0,1,7,3,6,17
191211018,4,1,0,1,4,10
191211019,3,3,9,9,2,26
191211020,2,9,6,7,3,27
191211021,4,3,9,6,1,23
191211022,7,2,4,5,0,18
191211023,5,5,4,2,8,24
191211024,7,9,4,5,7,32
191211025,6,0,3,8,1,18
191211026,4,1,2,9,4,20
191211027,5,2,2,0,3,12
191211028,7,6,5,8,7,33
191211029,8,8,0,3,6,25
191211030,0,2,0,1,1,4
191211031,8,9,4,1,1,23
191211032,3,7,9,2,7,28
191211033,1,2,8,9,3,23
191211034,5,6,2,0,6,19
191211035,2,9,1,0,6,18
191211036,9,7,2,2,4,24
191211037,2,6,9,4,8,29
191211038,5,7,2,3,3,20
191211039,3,0,8,8,2,21
191211040,8,2,5,4,3,22
191211041,4,9,5,7,5,30
191211042,6,2,5,4,7,24
191211043,7,0,1,0,1,9
191211044,4,2,7,5,2,20
191211045,9,7,8,7,2,33
191211046,1,5,1,1,3,11
191211047,1,0,1,4,6,12
191211048,5,4,3,3,8,23
191211049,0,4,2,3,6,15
191211050,1,4,9,7,0,21
191211051,5,0,1,1,5,12
191211052,9,8,2,3,3,25
191211053,8,1,2,1,3,15
191211054,7,6,4,2,7,26
191211055,9,6,2,8,8,33
191211056,3,4,6,1,8,22
191211057,6,5,9,5,9,34
191211058,7,1,4,0,9,21
191211059,9,3,8,3,1,24
191211060,5,8,1,2,0,16
191211061,4,6,4,8,0,22
191211062,9,3,7,2,7,28
191211063,6,2,4,1,6,19
191211064,3,7,9,1,1,21
191211065,3,5,2,6,6,22
191211066,0,5,9,2,4,20
191211067,4,0,1,1,0,6
191211068,3,8,4,9,6,30
191211069,1,5,3,2,9,20
191211070,8,0,8,1,5,22
191211071,7,3,1,2,1,14
191211072,9,2,3,4,0,18
191211073,2,1,9,6,8,26
191211074,0,2,9,4,9,24
191211075,8,2,2,1,8,21
191211076,6,2,7,4,7,26
191211077,4,8,5,4,2,23
191211078,2,2,3,5,9,21
191211079,9,9,4,0,2,24
191211080,2,2,1,1,9,15
191211081,6,9,6,4,0,25
191211082,2,8,0,6,2,18
191211083,0,6,8,4,1,19
191211084,4,4,3,5,7,23
191211085,6,1,2,6,2,17
191211086,9,7,9,0,0,25
191211087,0,6,2,3,0,11
191211088,8,0,0,6,5,19
191211089,1,2,3,2,1,9
191211090,4,7,8,4,8,31
191211091,2,2,0,7,9,20
191211092,0,1,2,4,9,16
191211093,5,7,2,2,2,18
191211094,7,8,6,1,6,28
191211095,9,4,3,8,0,24
191211096,2,4,0,4,7,17
191211097,1,2,6,2,1,12
191211098,4,2,9,7,4,26
191211099,5,4,7,8,9,33
191211100,8,0,6,5,8,27
191211101,0,9,9,2,8,28
191211102,2,6,4,6,0,18
191211103,3,2,2,2,0,9
191211104,1,5,0,6,3,15
191211105,9,3,3,7,8,30
191211106,1,8,2,2,9,22
191211107,3,1,1,3,1,9
191211108,9,3,9,9,8,38
191211109,7,4,3,0,7,21
191211110,4,6,4,8,2,24
191211111,6,5,2,7,5,25
191211112,0,8,6,1,4,19
191211113,0,3,6,8,7,24
191211114,3,9,4,5,6,27
191211115,1,1,8,1,8,19
191211116,9,9,7,8,3,36
191211117,1,1,5,3,2,12
191211118,9,0,3,6,6,24
191211119,4,4,0,0,3,11
191211120,4,2,1,0,1,8
191211121,1,1,4,1,5,12
191211122,9,2,9,1,1,22
191211123,9,9,0,2,5,25
191211124,6,4,1,9,5,25
191211125,4,2,9,8,7,30
191211126,6,1,4,8,2,21
191211127,7,4,8,7,3,29
191211128,6,3,9,7,6,31
191211129,2,5,7,4,5,23
191211130,9,8,1,8,5,31
191211131,7,8,5,2,6,28
191211132,6,9,2,7,1,25
191211133,1,2,4,0,6,13
191211134,5,9,5,8,4,31
191211135,1,9,1,9,9,29
191211136,9,2,0,9,1,21
191211137,3,6,2,5,6,22
191211138,9,3,7,8,3,30
191211139,0,2,8,2,2,14
191211140,9,6,1,0,3,19
191211141,6,4,5,4,2,21
191211142,1,5,2,9,9,26
191211143,5,6,0,7,8,26
191211144,5,5,9,0,7,26
191211145,0,1,6,8,5,20
191211146,1,8,1,6,2,18
191211147,9,3,7,4,7,30
191211148,3,3,3,8,9,26
191211149,3,5,5,6,0,19
191211150,4,8,5,3,3,23
191211151,1,9,0,4,2,16
191211152,4,7,5,8,0,24
191211153,0,1,2,1,1,5
191211154,2,0,7,0,1,10
191211155,7,1,9,6,4,27
191211156,8,1,7,6,3,25
191211157,4,7,9,0,3,23
191211158,9,2,8,9,7,35
191211159,6,4,5,1,9,25
191211160,1,6,5,9,4,25
191211161,4,7,8,4,6,29
191211162,1,4,9,3,6,23
191211163,6,9,7,9,4,35
191211164,6,2,3,0,2,13
191211165,8,3,5,0,0,16
191211166,0,4,0,6,8,18
191211167,8,6,9,8,6,37
191211168,6,1,6,9,5,27
191211169,0,7,4,4,1,16
191211170,4,5,0,7,9,25
191211171,0,8,8,9,2,27
191211172,4,2,9,8,1,24
191211173,8,0,2,5,5,20
191211174,9,5,3,1,9,27
191211175,3,6,1,2,2,14
191211176,8,5,2,8,8,31
191211177,7,5,8,2,9,31
191211178,6,6,2,2,9,25
191211179,1,3,9,6,9,28
191211180,5,2,9,1,5,22
191211181,4,9,1,0,2,16
191211182,2,4,7,1,5,19
191211183,5,9,0,7,2,23
191211184,0,8,3,5,5,21
191211185,3,3,7,7,3,23
191211186,0,4,6,0,7,17
191211187,8,9,1,7,9,34
191211188,5,5,2,5,5,22
191211189,2,9,6,2,2,21
191211190,9,8,4,2,2,25
191211191,0,9,0,5,0,14
191211192,2,0,0,3,0,5
191211193,7,1,5,8,8,29
191211194,4,7,2,0,9,22
191211195,8,3,4,7,9,31
191211196,5,3,6,9,0,23
191211197,7,3,2,9,1,22
191211198,3,5,7,3,9,27
191211199,3,3,3,4,8,21
191211200,7,6,4,8,4,29
191211201,0,6,0,0,1,7
191211202,7,8,2,2,1,20
191211203,1,1,6,4,6,18
191211204,6,2,9,5,2,24
191211205,9,2,2,0,7,20
191211206,7,9,8,4,8,36
191211207,1,9,2,5,8,25
191211208,9,0,8,1,5,23
191211209,4,1,9,3,8,25
191211210,5,5,5,4,2,21
191211211,4,9,1,7,7,28
191211212,3,5,5,3,5,21
191211213,6,3,7,8,9,33
191211214,1,1,3,5,1,11
191211215,9,9,8,2,7,35
191211216,4,9,6,1,8,28
191211217,6,5,8,3,8,30
191211218,2,3,5,6,2,18
191211219,6,0,5,0,2,13
191211220,3,5,8,8,1,25
191211221,7,8,2,1,4,22
191211222,4,5,9,4,4,26
191211223,2,9,5,7,7,30
191211224,2,5,7,4,1,19
191211225,8,8,6,7,1,30
191211226,3,0,8,2,0,13
191211227,7,7,5,3,0,22
191211228,2,3,0,8,1,14
191211229,6,3,2,9,7,27
191211230,9,5,7,7,9,37
191211231,8,7,6,6,0,27
191211232,8,7,4,8,6,33
191211233,4,4,9,5,2,24
191211234,8,7,5,3,4,27
191211235,9,3,6,0,8,26
191211236,4,1,1,5,5,16
191211237,9,1,3,7,7,27
191211238,7,2,0,0,8,17
191211239,6,1,4,5,7,23
191211240,6,1,4,6,5,22
191211241,2,1,5,5,0,13
191211242,3,4,9,4,1,21
191211243,5,3,5,9,5,27
191211244,6,0,9,3,0,18
191211245,2,1,8,8,3,22
191211246,3,6,3,4,7,23
191211247,8,3,1,2,7,21
191211248,9,9,3,4,1,26
191211249,4,2,2,3,9,20
191211250,7,5,4,4,3,23
191211251,6,1,7,9,2,25
191211252,4,6,2,8,0,20
191211253,6,6,7,4,5,28
191211254,7,8,1,7,9,32
191211255,7,8,2,7,6,30
191211256,1,1,4,2,1,9
191211257,1,8,0,3,5,17
191211258,0,0,5,6,4,15
191211259,1,5,4,4,1,15
191211260,1,2,6,6,6,21
191211261,3,3,1,8,8,23
191211262,8,4,8,2,7,29
191211263,2,7,4,1,7,21
191211264,9,0,2,2,1,14
191211265,1,7,2,5,1,16
191211266,0,6,7,6,3,22
191211267,5,8,5,8,2,28
191211268,3,9,6,6,8,32
191211269,9,7,3,6,1,26
191211270,7,7,0,2,6,22
191211271,2,2,6,4,2,16
191211272,5,9,6,9,8,37
191211273,6,2,2,0,5,15
191211274,7,6,9,1,1,24
191211275,7,7,0,8,6,28
191211276,6,1,0,4,2,13
191211277,5,8,3,7,5,28
191211278,5,0,5,8,4,22
191211279,8,6,7,2,7,30
191211280,6,2,1,8,4,21
191211281,9,8,4,7,0,28
191211282,8,4,8,0,5,25
191211283,6,1,4,4,2,17
191211284,6,9,7,2,8,32
191211285,2,4,4,0,6,16
191211286,2,1,1,9,0,13
191211287,5,1,9,1,0,16
191211288,3,5,5,1,4,18
191211289,1,3,9,9,0,22
191211290,5,0,0,3,9,17
191211291,4,2,8,7,5,26
191211292,0,6,5,6,2,19
191211293,6,0,2,3,9,20
191211294,5,5,6,5,9,30
191211295,0,5,0,7,3,15
191211296,2,2,4,7,3,18
191211297,2,5,8,7,0,22
191211298,4,5,9,6,5,29
191211299,7,9,1,2,6,25
191211300,2,0,0,5,8,15
191211301,1,5,7,3,1,17
191211302,9,5,9,6,0,29
191211303,9,9,2,8,2,30
191211304,5,4,5,7,5,26
191211305,8,1,7,3,0,19
191211306,0,6,4,6,6,22
191211307,5,8,3,4,0,20
191211308,9,3,2,4,5,23
191211309,9,2,0,3,2,16
191211310,5,2,1,4,0,12
191211311,8,7,7,0,4,26
191211312,9,6,3,7,5,30
191211313,6,4,5,7,3,25
191211314,4,5,9,0,3,21
191211315,5,5,5,7,7,29
191211316,3,3,5,0,2,13
191211317,3,2,6,9,6,26
191211318,1,4,7,6,4,22
191211319,4,0,7,4,9,24
191211320,6,4,4,3,9,26
191211321,3,0,1,1,7,12
191211322,9,4,4,4,3,24
191211323,1,1,7,2,0,11
191211324,1,4,6,7,7,25
191211325,4,9,9,7,9,38
191211326,0,1,3,3,4,11
191211327,2,1,1,5,9,18
191211328,3,9,6,8,8,34
191211329,5,0,4,1,5,15
191211330,1,7,8,2,3,21
191211331,3,9,2,1,3,18
191211332,0,1,0,8,7,16
191211333,0,6,3,4,8,21
191211334,4,6,2,0,0,12
191211335,9,5,0,3,0,17
191211336,2,1,3,2,7,15
191211337,3,6,1,8,2,20
191211338,5,4,5,5,4,23
191211339,8,4,4,3,9,28
191211340,3,1,5,6,2,17
191211341,5,2,5,1,1,14
191211342,1,9,3,6,1,20
191211343,4,6,7,6,3,26
191211344,6,6,5,1,8,26
191211345,1,9,7,1,5,23
191211346,8,5,7,1,2,23
191211347,9,0,5,6,0,20
191211348,4,2,3,2,6,17
191211349,7,5,8,6,2,28
191211350,2,4,4,0,4,14
191211351,6,5,6,8,7,32
191211352,5,7,2,2,8,24
191211353,2,9,2,9,5,27
191211354,6,9,8,5,3,31
191211355,3,7,1,8,8,27
191211356,0,4,0,4,4,12
191211357,4,4,6,5,3,22
191211358,7,6,7,7,0,27
191211359,7,2,9,4,8,30
191211360,9,2,2,5,8,26
191211361,5,5,0,7,6,23
191211362,7,5,2,3,4,21
191211363,8,5,9,2,7,31
191211364,8,3,5,2,1,19
191211365,8,4,2,3,8,25
191211366,8,9,6,3,6,32
191211367,2,4,3,6,9,24
191211368,7,1,0,9,3,20
191211369,2,7,0,8,0,17
191211370,1,9,9,3,3,25
191211371,4,3,6,0,2,15
191211372,4,6,0,1,9,20
191211373,0,3,7,3,2,15
191211374,2,1,3,9,8,23
191211375,9,0,5,0,6,20
191211376,1,7,7,8,6,29
191211377,9,1,2,3,0,15
191211378,9,3,5,2,8,27
191211379,0,7,8,7,2,24
191211380,1,9,5,0,2,17
191211381,5,6,6,5,5,27
191211382,0,3,3,3,8,17
191211383,3,1,6,9,5,24
191211384,0,9,2,1,6,18
191211385,6,3,7,1,0,17
191211386,2,5,3,1,7,18
191211387,7,3,8,6,9,33
191211388,6,0,5,6,4,21
191211389,3,9,5,8,3,28
191211390,3,0,6,8,5,22
191211391,8,3,5,0,1,17
191211392,4,8,5,1,9,27
191211393,9,2,7,1,5,24
191211394,4,1,5,2,1,13
191211395,2,0,7,9,1,19
191211396,5,0,2,0,6,13
191211397,0,8,3,1,8,20
191211398,7,7,5,4,4,27
191211399,7,1,8,8,1,25
191211400,4,8,4,5,5,26
191211401,7,7,1,0,1,16
191211402,7,8,2,2,2,21
191211403,2,7,8,2,8,27
191211404,1,4,1,0,5,11
191211405,9,1,3,1,8,22
191211406,2,6,8,9,9,34
191211407,8,9,8,4,4,33
191211408,5,8,4,5,5,27
191211409,4,7,7,3,8,29
191211410,6,0,8,2,5,21
191211411,7,6,6,4,1,24
191211412,3,2,9,7,1,22
191211413,8,3,1,8,0,20
191211414,6,9,2,6,5,28
191211415,8,8,0,2,2,20
191211416,7,4,1,6,5,23
191211417,3,8,9,4,9,33
191211418,8,0,1,8,3,20
191211419,7,7,8,8,2,32
191211420,2,2,6,6,2,18
191211421,4,1,4,3,1,13
191211422,8,5,2,0,3,18
191211423,8,2,7,2,7,26
191211424,7,6,0,4,5,22
191211425,9,7,3,6,0,25
191211426,1,4,3,7,8,23
191211427,5,3,2,6,4,20
191211428,8,7,7,3,9,34
191211429,3,4,3,5,3,18
191211430,8,3,1,4,8,24
191211431,8,7,0,4,4,23
191211432,3,6,2,2,0,13
191211433,5,9,7,4,2,27
191211434,1,5,3,7,7,23
191211435,7,1,3,1,7,19
191211436,9,1,4,5,1,20
191211437,6,5,2,8,5,26
191211438,2,7,5,8,4,26
191211439,1,0,8,4,7,20
191211440,2,8,1,2,0,13
191211441,0,0,3,5,1,9
191211442,0,6,3,7,4,20
191211443,9,0,2,2,6,19
191211444,1,4,6,0,2,13
191211445,0,3,6,7,4,20
191211446,9,3,8,3,3,26
191211447,0,1,9,0,3,13
191211448,2,4,5,7,8,26
191211449,5,2,3,5,0,15
191211450,7,4,0,7,5,23
191211451,7,0,6,0,4,17
191211452,2,1,4,7,0,14
191211453,6,1,4,7,8,26
191211454,6,2,0,0,9,17
191211455,0,4,1,9,1,15
191211456,7,9,9,3,3,31
191211457,7,7,7,8,7,36
191211458,9,3,7,9,0,28
191211459,8,3,5,6,8,30
191211460,3,0,5,7,5,20
191211461,5,2,6,3,5,21
191211462,1,3,5,4,8,21
191211463,6,1,3,4,9,23
191211464,9,7,8,1,3,28
191211465,0,5,1,1,4,11
191211466,1,7,3,6,6,23
191211467,0,8,2,4,2,16
191211468,2,1,4,7,7,21
191211469,6,9,5,9,0,29
191211470,7,8,0,5,9,29
191211471,5,0,4,8,8,25
191211472,4,4,0,4,0,12
191211473,5,2,2,3,9,21
191211474,9,8,9,1,0,27
191211475,9,4,2,8,9,32
191211476,9,7,2,4,6,28
191211477,0,2,3,2,8,15
191211478,1,6,0,9,8,24
191211479,0,3,3,5,4,15
191211480,7,5,1,2,4,19
191211481,2,2,2,0,3,9
191211482,4,5,4,7,7,27
191211483,9,4,7,0,6,26
191211484,0,4,2,2,2,10
191211485,4,9,3,9,0,25
191211486,6,6,0,2,9,23
191211487,3,5,6,0,1,15
191211488,7,7,8,0,2,24
191211489,9,3,9,8,3,32
191211490,9,8,4,6,8,35
191211491,9,3,7,6,8,33
191211492,0,0,5,7,5,17
191211493,0,7,2,0,0,9
191211494,6,2,5,5,3,21
191211495,5,6,2,2,4,19
191211496,3,8,2,1,8,22
191211497,3,2,6,8,2,21
191211498,1,8,2,4,5,20
191211499,4,3,6,2,8,23
191211500,1,6,3,0,8,18
191211501,2,1,0,0,9,12
191211502,3,5,3,1,2,14
191211503,3,3,9,1,8,24
191211504,8,8,7,7,7,37
191211505,9,1,5,6,5,26
191211506,3,5,3,2,7,20
191211507,1,7,4,2,0,14
191211508,5,3,9,6,5,28
191211509,3,5,2,3,1,14
191211510,5,7,1,2,6,21
191211511,6,4,9,2,4,25
191211512,7,8,7,9,8,39
191211513,0,9,2,0,2,13
191211514,6,9,3,5,9,32
191211515,5,2,2,2,5,16
191211516,8,4,1,7,3,23
191211517,1,9,3,8,2,23
191211518,6,9,1,9,5,30
191211519,9,6,5,3,2,25
191211520,6,3,9,7,8,33
191211521,4,4,6,7,1,22
191211522,0,8,3,1,9,21
191211523,4,8,4,4,2,22
191211524,1,9,2,9,5,26
191211525,4,0,8,9,9,30
191211526,1,9,3,2,5,20
191211527,2,0,6,1,7,16
191211528,8,5,1,4,4,22
191211529,0,7,9,7,1,24
191211530,8,8,1,3,1,21
191211531,4,0,5,2,2,13
191211532,7,4,1,0,3,15
191211533,9,3,2,1,5,20
191211534,6,7,0,9,0,22
191211535,8,3,4,4,8,27
191211536,5,0,2,9,4,20
191211537,7,5,7,6,0,25
191211538,9,9,2,1,4,25
191211539,6,2,7,7,4,26
191211540,5,9,3,9,2,28
191211541,9,0,5,7,5,26
191211542,8,7,2,8,2,27
191211543,5,5,3,1,5,19
191211544,1,1,7,2,1,12
191211545,1,6,0,7,4,18
191211546,7,2,9,4,6,28
191211547,5,5,9,9,1,29
191211548,5,4,0,2,2,13
191211549,6,5,3,0,2,16
191211550,3,6,0,2,3,14
191211551,8,8,2,1,2,21
191211552,3,0,9,1,6,19
191211553,3,7,4,1,0,15
191211554,8,6,4,3,4,25
191211555,5,5,2,4,3,19
191211556,2,8,5,8,4,27
191211557,9,9,1,0,1,20
191211558,3,2,3,9,8,25
191211559,8,8,2,8,8,34
191211560,4,0,0,9,4,17
191211561,3,6,0,9,7,25
191211562,4,1,0,8,9,22
191211563,6,9,5,2,8,30
191211564,5,4,9,4,9,31
191211565,4,4,6,7,3,24
191211566,6,9,7,8,1,31
191211567,2,5,7,5,0,19
191211568,7,8,5,9,7,36
191211569,8,8,6,4,2,28
191211570,5,7,6,9,0,27
191211571,2,6,4,9,6,27
191211572,5,0,3,3,0,11
191211573,9,5,0,6,8,28
191211574,3,3,3,4,4,17
191211575,3,1,2,8,6,20
191211576,4,2,3,8,0,17
191211577,3,0,3,2,8,16
191211578,5,1,4,6,4,20
191211579,0,9,5,2,2,18
191211580,5,8,3,4,8,28
191211581,8,5,3,5,6,27
191211582,1,5,0,1,0,7
191211583,7,8,9,6,0,30
191211584,9,3,2,5,0,19
191211585,2,4,5,5,0,16
191211586,1,7,0,5,3,16
191211587,2,8,7,7,3,27
191211588,1,5,6,8,0,20
191211589,9,6,8,4,3,30
191211590,2,2,6,7,2,19
191211591,8,7,4,3,0,22
191211592,6,7,1,5,7,26
191211593,1,7,8,5,9,30
191211594,0,7,6,5,6,24
191211595,5,4,9,1,1,20
191211596,8,0,3,1,3,15
191211597,0,9,1,5,3,18
191211598,0,1,3,2,5,11
191211599,3,0,0,1,9,13
191211600,0,6,8,3,4,21
191211601,4,6,8,4,7,29
191211602,6,0,7,5,9,27
191211603,7,8,2,9,0,26
191211604,8,5,0,1,7,21
191211605,1,5,6,1,9,22
191211606,3,1,7,4,6,21
191211607,4,8,0,3,3,18
191211608,6,7,9,0,0,22
191211609,2,5,6,9,1,23
191211610,8,3,6,9,3,29
191211611,0,8,5,7,3,23
191211612,2,3,8,2,5,20
191211613,6,7,3,0,7,23
191211614,6,1,1,3,1,12
191211615,5,0,4,5,1,15
191211616,2,8,9,3,4,26
191211617,5,5,7,1,3,21
191211618,6,0,7,4,2,19
191211619,8,5,5,5,2,25
191211620,1,3,4,9,1,18
191211621,8,6,6,5,2,27
191211622,3,6,5,2,4,20
191211623,9,4,1,0,9,23
191211624,1,7,2,0,8,18
191211625,9,3,5,3,3,23
191211626,0,6,2,0,8,16
191211627,7,0,1,8,7,23
191211628,9,8,8,1,8,34
191211629,6,7,4,3,3,23
191211630,2,8,3,2,5,20
191211631,1,5,8,2,8,24
191211632,4,5,1,8,8,26
191211633,0,7,1,0,7,15
191211634,5,6,2,2,3,18
191211635,4,8,0,9,7,28
191211636,9,6,8,1,1,25
191211637,0,9,5,8,6,28
191211638,9,6,6,7,3,31
191211639,2,1,1,3,3,10
191211640,4,8,6,7,8,33
191211641,0,1,1,9,9,20
191211642,5,7,6,7,3,28
191211643,1,0,1,1,2,5
191211644,3,4,9,9,7,32
191211645,7,7,6,0,6,26
191211646,3,1,2,8,1,15
191211647,7,0,2,7,9,25
191211648,6,0,9,3,7,25
191211649,4,8,2,5,0,19
191211650,4,6,2,7,7,26
191211651,3,8,7,6,2,26
191211652,7,6,9,0,2,24
191211653,0,6,0,0,3,9
191211654,3,7,9,0,9,28
191211655,3,0,9,9,5,26
191211656,2,4,4,7,6,23
191211657,7,3,5,3,3,21
191211658,6,1,9,9,2,27
191211659,2,5,9,1,1,18
191211660,8,5,7,7,7,34
191211661,0,6,6,8,9,29
191211662,2,0,8,2,6,18
191211663,2,9,5,3,2,21
191211664,9,7,1,3,0,20
191211665,3,3,0,0,6,12
191211666,5,2,9,8,7,31
191211667,8,7,6,1,6,28
191211668,2,0,6,1,8,17
191211669,9,9,2,5,1,26
191211670,8,4,4,2,7,25
191211671,7,1,2,4,9,23
191211672,8,6,2,1,0,17
191211673,5,5,4,1,0,15
191211674,9,4,1,2,8,24
191211675,5,3,6,1,9,24
191211676,1,8,8,2,2,21
191211677,4,5,1,5,1,16
191211678,2,8,6,9,9,34
191211679,8,6,6,8,2,30
191211680,2,1,0,6,3,12
191211681,5,7,7,6,3,28
191211682,1,9,7,5,4,26
191211683,3,6,2,7,3,21
191211684,3,1,2,0,9,15
191211685,1,3,4,2,2,12
191211686,3,3,7,1,4,18
191211687,6,1,8,3,5,23
191211688,4,8,1,0,9,22
191211689,5,5,8,5,1,24
191211690,6,4,6,3,0,19
191211691,0,4,4,4,7,19
191211692,1,5,0,9,2,17
191211693,6,0,7,3,1,17
191211694,2,7,2,2,7,20
191211695,0,6,3,6,6,21
191211696,1,9,7,6,9,32
191211697,6,5,9,1,3,24
191211698,5,4,1,3,6,19
191211699,5,9,5,8,7,34
191211700,8,8,8,0,9,33
191211701,2,5,3,3,7,20
191211702,7,8,2,8,1,26
191211703,1,5,5,8,6,25
191211704,9,6,2,3,0,20
191211705,9,0,4,3,3,19
191211706,6,0,3,6,4,19
191211707,7,0,4,0,1,12
191211708,6,5,8,1,1,21
191211709,0,5,9,8,0,22
191211710,8,1,0,5,5,19
191211711,3,6,3,5,3,20
191211712,0,3,9,7,0,19
191211713,2,2,6,6,6,22
191211714,2,9,1,1,9,22
191211715,5,2,8,3,5,23
191211716,7,5,3,9,8,32
191211717,5,6,4,3,5,23
191211718,3,8,3,2,4,20
191211719,3,5,5,5,4,22
191211720,2,1,3,6,7,19
191211721,1,2,2,7,7,19
191211722,3,3,7,0,6,19
191211723,4,6,6,7,0,23
191211724,2,6,3,9,3,23
191211725,3,6,8,5,2,24
191211726,3,4,3,3,9,22
191211727,9,5,8,2,6,30
191211728,0,4,9,0,3,16
191211729,5,4,4,5,4,22
191211730,7,0,6,5,6,24
191211731,0,7,3,7,2,19
191211732,4,1,0,6,9,20
191211733,9,8,3,8,7,35
191211734,3,4,2,9,7,25
191211735,6,6,3,6,3,24
191211736,5,0,9,1,1,16
191211737,8,5,8,9,0,30
191211738,7,7,7,1,0,22
191211739,0,2,2,9,9,22
191211740,2,5,9,8,9,33
191211741,9,5,7,5,9,35
191211742,6,5,3,6,7,27
191211743,9,0,3,3,6,21
191211744,3,3,2,2,2,12
191211745,9,3,5,1,0,18
191211746,8,6,5,5,2,26
191211747,7,6,7,3,7,30
191211748,4,0,9,6,6,25
191211749,2,3,7,3,2,17
191211750,7,8,4,0,3,22
191211751,2,9,5,3,3,22
191211752,1,9,8,0,3,21
191211753,0,0,1,5,8,14
191211754,3,2,9,0,4,18
191211755,0,2,1,6,2,11
191211756,9,0,4,9,1,23
191211757,2,2,8,3,8,23
191211758,1,6,3,0,3,13
191211759,3,1,7,8,0,19
191211760,9,1,2,4,2,18
191211761,8,9,9,1,2,29
191211762,5,8,5,7,1,26
191211763,4,6,6,8,1,25
191211764,4,2,9,8,6,29
191211765,3,8,1,9,5,26
191211766,8,8,0,0,6,22
191211767,0,7,0,9,8,24
191211768,4,2,9,1,8,24
191211769,7,4,0,3,0,14
191211770,5,1,2,5,8,21
191211771,9,4,9,2,6,30
191211772,2,9,4,5,9,29
191211773,8,4,8,7,3,30
191211774,2,1,6,9,6,24
191211775,2,2,5,0,4,13
191211776,0,2,3,6,0,11
191211777,8,4,9,7,6,34
191211778,3,9,4,0,6,22
191211779,9,1,3,3,6,22
191211780,3,5,0,4,6,18
191211781,1,6,7,8,4,26
191211782,7,6,9,1,8,31
191211783,9,2,1,0,8,20
191211784,5,1,0,4,5,15
191211785,3,5,8,7,4,27
191211786,7,4,1,0,0,12
191211787,7,0,9,9,9,34
191211788,4,5,6,2,2,19
191211789,8,2,8,2,7,27
191211790,4,8,6,1,3,22
191211791,9,2,5,7,5,28
191211792,5,6,4,7,8,30
191211793,8,5,8,0,4,25
191211794,9,5,6,4,0,24
191211795,1,7,4,0,4,16
191211796,0,2,3,2,5,12
191211797,4,0,2,9,7,22
191211798,7,2,2,0,8,19
191211799,6,2,8,1,7,24
191211800,6,0,4,1,2,13
191211801,5,6,4,8,0,23
191211802,2,4,8,9,5,28
191211803,5,6,3,0,8,22
191211804,2,2,0,9,2,15
191211805,0,9,8,9,8,34
191211806,9,7,3,7,3,29
191211807,7,4,3,8,2,24
191211808,3,9,2,6,8,28
191211809,0,8,1,2,8,19
191211810,0,9,4,7,0,20
191211811,3,9,6,6,7,31
191211812,4,1,9,9,7,30
191211813,5,2,0,7,5,19
191211814,0,1,9,9,7,26
191211815,5,8,0,6,6,25
191211816,1,9,1,8,3,22
191211817,3,3,2,0,2,10
191211818,2,8,2,9,1,22
191211819,7,7,0,6,7,27
191211820,7,8,7,4,5,31
191211821,5,9,7,9,7,37
191211822,1,5,4,7,4,21
191211823,4,3,1,5,4,17
191211824,8,3,3,7,6,27
191211825,1,2,8,3,3,17
191211826,9,1,5,3,3,21
191211827,8,2,7,1,6,24
191211828,9,2,4,6,3,24
191211829,0,8,8,8,4,28
191211830,9,9,4,0,3,25
191211831,2,8,5,6,8,29
191211832,5,1,2,1,0,9
191211833,4,7,9,2,5,27
191211834,3,2,9,1,6,21
191211835,3,8,6,8,3,28
191211836,2,0,1,6,3,12
191211837,6,5,7,7,5,30
191211838,7,2,0,6,0,15
191211839,0,5,3,3,0,11
191211840,8,3,8,7,2,28
191211841,6,2,5,8,8,29
191211842,3,8,7,1,0,19
191211843,0,8,6,1,3,18
191211844,6,3,1,6,7,23
191211845,7,7,2,8,5,29
191211846,6,5,3,9,0,23
191211847,6,2,2,7,0,17
191211848,6,0,1,4,1,12
191211849,8,5,4,4,8,29
191211850,2,3,5,6,1,17
191211851,1,9,0,1,3,14
191211852,3,6,7,0,8,24
191211853,8,8,5,6,2,29
191211854,3,5,7,0,6,21
191211855,2,4,8,9,6,29
191211856,2,4,9,0,7,22
191211857,6,8,0,1,9,24
191211858,8,8,6,1,7,30
191211859,4,2,3,2,8,19
191211860,7,2,5,7,7,28
191211861,1,5,7,8,1,22
191211862,5,1,7,3,8,24
191211863,0,2,6,9,8,25
191211864,2,4,1,6,4,17
191211865,2,7,7,1,0,17
191211866,1,3,6,9,9,28
191211867,4,6,3,7,6,26
191211868,9,4,2,1,8,24
191211869,9,7,8,8,7,39
191211870,2,4,7,3,9,25
191211871,2,3,6,9,4,24
191211872,7,5,4,0,2,18
191211873,7,4,6,2,1,20
191211874,9,0,9,7,4,29
191211875,4,4,0,9,4,21
191211876,5,5,8,9,4,31
191211877,3,6,2,8,8,27
191211878,1,3,3,3,4,14
191211879,3,4,1,7,4,19
191211880,5,5,8,4,2,24
191211881,8,4,5,2,0,19
191211882,0,5,4,5,6,20
191211883,9,8,1,4,0,22
191211884,3,3,1,5,0,12
191211885,7,3,2,4,6,22
191211886,2,5,1,2,5,15
191211887,9,5,3,6,5,28
191211888,9,7,2,8,1,27
191211889,2,0,3,3,4,12
191211890,5,5,5,8,3,26
191211891,2,7,8,8,5,30
191211892,6,0,2,1,4,13
191211893,7,5,4,4,1,21
191211894,4,1,7,0,0,12
191211895,7,8,7,8,2,32
191211896,9,6,0,5,2,22
191211897,6,1,5,1,8,21
191211898,5,2,0,7,3,17
191211899,6,4,0,9,3,22
191211900,3,1,4,5,7,20
191211901,0,9,4,1,5,19
191211902,9,4,6,4,3,26
191211903,7,1,1,1,2,12
191211904,3,4,1,0,7,15
191211905,6,4,6,6,1,23
191211906,4,5,8,2,2,21
191211907,0,0,7,6,3,16
191211908,6,6,0,6,2,20
191211909,3,7,1,4,5,20
191211910,0,8,8,3,5,24
191211911,4,8,5,6,2,25
191211912,9,4,8,9,9,39
191211913,4,3,5,5,7,24
191211914,2,2,3,9,3,19
191211915,1,1,7,1,4,14
191211916,7,7,5,1,7,27
191211917,4,3,1,8,4,20
191211918,3,9,4,5,3,24
191211919,8,2,4,8,5,27
191211920,9,7,1,9,9,35
191211921,6,8,8,4,8,34
191211922,0,4,7,5,9,25
191211923,2,0,5,9,4,20
191211924,6,6,2,5,2,21
191211925,8,1,0,8,3,20
191211926,4,2,5,0,7,18
191211927,8,7,5,0,8,28
191211928,9,5,0,1,8,23
191211929,8,6,5,3,3,25
191211930,3,3,9,5,8,28
191211931,9,3,9,7,6,34
191211932,1,0,9,9,7,26
191211933,9,0,5,6,5,25
191211934,7,8,4,6,5,30
191211935,1,6,2,5,5,19
191211936,3,9,1,2,0,15
191211937,6,7,0,6,1,20
191211938,7,4,2,2,6,21
191211939,0,2,0,5,7,14
191211940,4,8,9,3,0,24
191211941,0,4,5,8,5,22
191211942,7,5,0,3,7,22
191211943,9,6,4,2,4,25
191211944,1,6,8,0,6,21
191211945,2,2,1,9,1,15
191211946,1,5,5,2,4,17
191211947,1,2,3,1,3,10
191211948,3,7,7,5,6,28
191211949,9,1,6,4,3,23
191211950,4,0,7,0,0,11
191211951,1,9,1,7,9,27
191211952,7,7,6,1,8,29
191211953,1,6,2,7,5,21
191211954,2,4,8,5,0,19
191211955,2,8,3,0,1,14
191211956,7,9,3,9,0,28
191211957,5,5,0,7,0,17
191211958,8,6,3,7,7,31
191211959,6,7,7,0,3,23
191211960,0,3,0,8,7,18
191211961,4,6,5,0,9,24
191211962,1,8,2,3,9,23
191211963,4,0,6,5,2,17
191211964,4,1,2,6,3,16
191211965,3,7,8,1,0,19
191211966,7,5,3,6,5,26
191211967,5,9,9,7,2,32
191211968,5,0,1,7,1,14
191211969,1,4,9,4,5,23
191211970,9,3,7,8,1,28
191211971,9,2,3,7,2,23
191211972,2,8,5,3,9,27
191211973,9,0,1,6,1,17
191211974,5,1,3,3,8,20
191211975,0,6,2,0,7,15
191211976,8,8,1,4,9,30
191211977,9,9,7,1,4,30
191211978,4,7,5,4,9,29
191211979,1,3,5,7,4,20
191211980,8,5,8,3,5,29
191211981,5,6,3,9,0,23
191211982,0,8,0,3,9,20
191211983,7,3,9,1,4,24
191211984,3,9,8,1,1,22
191211985,3,1,5,3,8,20
191211986,7,1,0,4,7,19
191211987,1,2,4,9,8,24
191211988,1,0,9,4,5,19
191211989,6,4,4,6,9,29
191211990,1,7,2,8,0,18
191211991,3,6,4,2,5,20
191211992,2,1,6,2,7,18
191211993,7,6,7,3,1,24
191211994,8,4,2,8,3,25
191211995,7,9,5,1,5,27
191211996,5,9,3,9,1,27
191211997,8,9,3,7,4,31
191211998,8,2,3,5,1,19
191211999,4,7,1,2,1,15
1912111000,1,6,4,9,8,28
1912111001,2,4,1,7,6,20
1912111002,5,5,2,8,8,28
1912111003,2,8,8,8,9,35
1912111004,9,0,0,3,8,20
1912111005,6,0,0,4,2,12
1912111006,0,7,5,8,4,24
1912111007,1,0,4,0,5,10
1912111008,3,3,0,9,1,16
1912111009,0,4,1,1,2,8
1912111010,2,1,4,4,9,20
1912111011,0,8,7,0,8,23
1912111012,5,2,4,9,7,27
1912111013,0,7,1,8,2,18
1912111014,0,6,6,7,0,19
1912111015,2,6,5,4,9,26
1912111016,0,0,1,1,3,5
1912111017,9,3,7,5,3,27
1912111018,5,3,9,3,4,24
1912111019,3,5,3,9,9,29
1912111020,0,0,0,7,0,7
1912111021,7,0,1,1,5,14
1912111022,0,6,1,7,0,14
1912111023,2,9,9,5,4,29
1912111024,5,3,3,4,7,22
1912111025,3,8,3,4,9,27
1912111026,7,7,3,0,2,19
1912111027,1,6,3,8,3,21
1912111028,0,1,9,3,1,14
1912111029,7,7,5,1,0,20
1912111030,1,4,7,4,6,22
1912111031,8,1,6,0,5,20
1912111032,9,5,8,0,5,27
1912111033,3,2,3,4,6,18
1912111034,6,7,9,4,9,35
1912111035,1,7,2,3,1,14
1912111036,4,9,8,7,8,36
1912111037,7,2,0,4,2,15
1912111038,0,3,9,6,4,22
1912111039,1,3,6,4,4,18
1912111040,7,8,0,1,9,25
1912111041,0,9,7,3,8,27
1912111042,2,6,9,4,1,22
1912111043,4,8,2,1,2,17
1912111044,5,8,2,8,7,30
1912111045,4,3,0,7,4,18
1912111046,1,3,6,7,1,18
1912111047,3,8,5,5,2,23
1912111048,0,5,9,5,5,24
1912111049,1,0,5,4,3,13
1912111050,7,8,5,6,8,34
1912111051,7,5,7,4,2,25
1912111052,5,4,5,3,8,25
1912111053,7,8,7,9,1,32
1912111054,2,1,1,5,8,17
1912111055,8,8,5,7,3,31
1912111056,8,7,1,6,3,25
1912111057,2,8,7,2,6,25
1912111058,7,5,9,3,8,32
1912111059,6,9,2,2,7,26
1912111060,9,5,6,8,7,35
1912111061,8,5,1,2,7,23
1912111062,0,3,9,5,6,23
1912111063,8,6,9,2,2,27
1912111064,9,0,7,0,3,19
1912111065,5,6,6,6,4,27
1912111066,5,0,2,2,1,10
1912111067,4,2,2,2,5,15
1912111068,3,9,5,5,1,23
1912111069,0,1,5,2,6,14
1912111070,8,1,2,8,2,21
1912111071,5,3,4,6,3,21
1912111072,6,6,8,4,1,25
1912111073,8,4,2,6,8,28
1912111074,1,0,5,4,2,12
1912111075,2,6,0,6,3,17
1912111076,7,3,0,7,8,25
1912111077,9,3,5,8,7,32
1912111078,4,7,5,5,6,27
1912111079,0,1,9,5,9,24
1912111080,0,6,7,4,2,19
1912111081,3,9,0,8,4,24
1912111082,6,9,8,2,7,32
1912111083,2,7,3,2,4,18
1912111084,8,3,6,3,5,25
1912111085,5,2,7,8,3,25
1912111086,6,1,2,5,6,20
1912111087,7,4,4,2,7,24
1912111088,9,8,7,8,7,39
1912111089,7,2,1,1,6,17
1912111090,8,1,1,4,2,16
1912111091,7,9,5,6,5,32
1912111092,1,5,5,8,0,19
1912111093,5,8,0,8,8,29
1912111094,0,4,4,3,9,20
1912111095,3,2,2,4,3,14
1912111096,5,4,9,0,8,26
1912111097,8,5,0,5,7,25
1912111098,7,1,7,8,6,29
1912111099,7,2,1,3,2,15
1912111100,7,0,0,3,2,12
1912111101,2,4,7,0,8,21
1912111102,4,7,0,5,2,18
1912111103,9,0,6,9,0,24
1912111104,8,7,7,4,5,31
1912111105,4,2,4,8,9,27
191212001,6,5,8,1,8,28
191212002,9,2,0,0,0,11
191212003,4,4,8,6,0,22
191212004,6,0,3,3,8,20
191212005,1,4,2,6,3,16
191212006,2,7,0,5,2,16
191212007,1,5,8,6,4,24
191212008,4,6,0,1,5,16
191212009,3,6,1,5,6,21
191212010,9,1,9,4,4,27
191212011,9,2,5,4,3,23
191212012,2,1,0,2,5,10
191212013,4,3,4,1,7,19
191212014,8,6,5,4,3,26
191212015,1,7,6,5,1,20
191212016,0,9,1,5,0,15
191212017,9,6,1,5,3,24
191212018,3,9,4,3,7,26
191212019,0,7,5,4,8,24
191212020,2,1,8,1,3,15
191212021,4,4,5,9,6,28
191212022,6,4,8,0,0,18
191212023,4,5,9,2,2,22
191212024,9,3,6,1,6,25
191212025,8,8,6,0,9,31
191212026,6,1,8,2,2,19
191212027,4,5,9,9,7,34
191212028,9,6,6,2,8,31
191212029,7,6,0,4,8,25
191212030,6,5,5,4,6,26
191212031,1,0,3,2,0,6
191212032,5,8,3,1,1,18
191212033,7,6,1,3,0,17
191212034,9,1,9,2,3,24
191212035,1,8,5,5,2,21
191212036,4,5,4,9,1,23
191212037,2,9,9,7,7,34
191212038,8,5,4,6,7,30
191212039,6,7,3,2,3,21
191212040,4,9,7,4,2,26
191212041,7,2,5,2,4,20
191212042,2,7,1,2,0,12
191212043,1,9,7,2,7,26
191212044,8,8,8,4,0,28
191212045,7,2,4,6,1,20
191212046,2,3,3,8,6,22
191212047,4,9,6,4,3,26
191212048,3,6,5,3,5,22
191212049,3,2,2,5,2,14
191212050,7,2,0,4,4,17
191212051,8,5,4,6,4,27
191212052,8,4,7,5,2,26
191212053,7,8,5,3,7,30
191212054,3,9,5,9,9,35
191212055,5,7,4,4,7,27
191212056,9,5,0,5,5,24
191212057,7,3,8,8,8,34
191212058,2,5,9,0,8,24
191212059,5,7,9,3,8,32
191212060,9,9,5,9,0,32
191212061,3,8,3,0,2,16
191212062,4,6,1,1,4,16
191212063,6,2,5,5,8,26
191212064,3,1,3,3,4,14
191212065,4,5,4,7,3,23
191212066,9,3,1,2,3,18
191212067,5,5,0,3,9,22
191212068,4,2,7,1,9,23
191212069,5,4,4,7,0,20
191212070,3,3,3,4,7,20
191212071,3,6,5,7,7,28
191212072,9,7,2,1,7,26
191212073,4,0,4,2,3,13
191212074,6,2,9,0,3,20
191212075,4,7,9,8,3,31
191212076,2,8,1,9,2,22
191212077,1,9,3,0,8,21
191212078,8,4,6,2,6,26
191212079,2,4,3,3,4,16
191212080,8,3,7,3,3,24
191212081,3,5,3,0,8,19
191212082,7,2,8,1,6,24
191212083,7,0,1,9,7,24
191212084,5,6,9,9,2,31
191212085,5,7,2,1,1,16
191212086,3,6,6,8,7,30
191212087,8,1,4,3,8,24
191212088,2,4,6,9,5,26
191212089,1,6,6,5,8,26
191212090,7,7,2,0,1,17
191212091,5,3,3,2,3,16
191212092,3,4,6,9,5,27
191212093,3,8,5,2,5,23
191212094,1,7,3,9,4,24
191212095,1,0,0,1,8,10
191212096,6,7,7,8,8,36
191212097,3,4,4,0,1,12
191212098,4,1,3,8,9,25
191212099,8,9,4,4,6,31
191212100,9,0,4,5,9,27
191212101,3,3,7,0,1,14
191212102,8,8,8,4,7,35
191212103,6,3,6,4,0,19
191212104,2,0,0,1,5,8
191212105,7,7,3,1,6,24
191212106,0,3,8,5,0,16
191212107,2,9,1,5,6,23
191212108,8,4,1,0,6,19
191212109,6,6,4,9,8,33
191212110,6,5,2,3,2,18
191212111,4,1,0,9,2,16
191212112,1,3,4,7,5,20
191212113,3,4,1,3,5,16
191212114,3,8,5,1,5,22
191212115,2,9,0,2,4,17
191212116,1,2,5,7,3,18
191212117,7,1,5,2,8,23
191212118,1,4,0,5,2,12
191212119,4,4,7,4,4,23
191212120,8,7,1,7,7,30
191212121,4,6,8,8,0,26
191212122,8,0,2,8,1,19
191212123,5,4,6,3,0,18
191212124,8,8,0,0,5,21
191212125,9,5,7,8,3,32
191212126,6,4,1,6,5,22
191212127,7,5,8,8,0,28
191212128,0,4,8,8,5,25
191212129,6,7,0,4,9,26
191212130,0,5,9,4,0,18
191212131,5,5,5,7,5,27
191212132,8,3,6,0,1,18
191212133,1,7,2,3,9,22
191212134,0,8,4,9,8,29
191212135,0,0,6,9,4,19
191212136,1,8,0,2,8,19
191212137,6,7,7,1,6,27
191212138,6,4,6,8,9,33
191212139,7,9,4,9,6,35
191212140,4,7,8,5,7,31
191212141,3,1,5,9,0,18
191212142,8,8,0,7,1,24
191212143,7,2,8,2,9,28
191212144,3,8,3,0,5,19
191212145,9,9,9,7,6,40
191212146,4,8,3,0,8,23
191212147,8,1,7,5,9,30
191212148,6,1,6,9,2,24
191212149,8,0,3,5,3,19
191212150,9,0,3,1,3,16
191212151,3,0,7,9,9,28
191212152,9,5,0,1,4,19
191212153,5,0,6,5,3,19
191212154,4,0,7,9,4,24
191212155,2,5,0,8,5,20
191212156,5,0,8,2,0,15
191212157,4,7,8,3,9,31
191212158,7,7,2,1,0,17
191212159,9,9,1,6,1,26
191212160,4,5,6,7,4,26
191212161,3,0,5,2,2,12
191212162,2,5,3,1,9,20
191212163,2,7,2,4,5,20
191212164,9,3,8,7,8,35
191212165,1,0,5,2,3,11
191212166,6,9,9,6,7,37
191212167,9,2,1,8,5,25
191212168,2,1,4,3,9,19
191212169,8,0,9,8,2,27
191212170,8,7,9,0,1,25
191212171,2,5,9,5,4,25
191212172,8,0,6,3,0,17
191212173,7,1,9,3,0,20
191212174,6,5,2,4,8,25
191212175,3,0,2,2,8,15
191212176,7,0,0,9,2,18
191212177,8,0,1,5,3,17
191212178,5,1,0,8,0,14
191212179,1,3,4,2,7,17
191212180,4,5,3,4,2,18
191212181,3,1,8,7,5,24
191212182,3,0,8,0,3,14
191212183,6,2,8,8,5,29
191212184,5,6,5,5,4,25
191212185,0,7,2,4,4,17
191212186,6,8,9,4,3,30
191212187,6,4,6,7,6,29
191212188,4,2,5,3,5,19
191212189,2,8,7,4,2,23
191212190,1,9,5,5,9,29
191212191,9,3,3,9,3,27
191212192,9,8,2,0,8,27
191212193,3,7,2,7,4,23
191212194,9,1,8,6,4,28
191212195,5,3,2,2,5,17
191212196,6,1,2,9,1,19
191212197,5,7,6,1,3,22
191212198,6,7,5,9,6,33
191212199,9,9,0,5,9,32
191212200,0,3,3,2,8,16
191212201,8,0,2,6,8,24
191212202,1,1,5,4,4,15
191212203,9,9,1,6,4,29
191212204,9,9,2,4,8,32
191212205,4,5,2,7,9,27
191212206,3,6,8,1,1,19
191212207,7,9,8,1,2,27
191212208,8,2,7,5,6,28
191212209,6,0,6,3,6,21
191212210,6,9,2,3,2,22
191212211,5,2,2,9,0,18
191212212,6,4,8,7,9,34
191212213,2,8,4,4,3,21
191212214,4,7,2,3,4,20
191212215,1,7,4,1,8,21
191212216,2,1,9,5,3,20
191212217,1,0,5,9,0,15
191212218,4,9,2,5,2,22
191212219,0,1,7,8,7,23
191212220,3,7,9,0,7,26
191212221,9,6,5,9,6,35
191212222,2,5,4,7,4,22
191212223,5,0,6,0,2,13
191212224,3,7,4,1,7,22
191212225,9,8,1,0,9,27
191212226,3,5,4,2,1,15
191212227,2,6,6,1,7,22
191212228,1,9,2,9,3,24
191212229,3,0,7,2,8,20
191212230,8,3,6,1,8,26
191212231,7,7,5,4,3,26
191212232,2,7,4,3,4,20
191212233,7,2,1,4,9,23
191212234,9,6,8,0,1,24
191212235,2,9,2,2,0,15
191212236,7,5,9,3,2,26
191212237,1,8,5,6,0,20
191212238,8,3,3,9,0,23
191212239,7,5,7,3,8,30
191212240,7,6,4,7,7,31
191212241,8,4,9,5,9,35
191212242,7,2,7,0,5,21
191212243,5,1,9,2,9,26
191212244,6,0,8,0,0,14
191212245,6,8,2,7,1,24
191212246,0,9,2,0,7,18
191212247,0,4,6,3,1,14
191212248,0,3,2,6,2,13
191212249,1,0,8,5,0,14
191212250,2,1,7,6,7,23
191212251,2,4,6,4,5,21
191212252,6,0,2,9,4,21
191212253,0,6,1,4,0,11
191212254,5,4,2,2,4,17
191212255,9,8,9,0,0,26
191212256,2,2,0,3,8,15
191212257,2,3,8,4,9,26
191212258,2,1,0,1,8,12
191212259,5,0,1,7,7,20
191212260,4,2,3,4,6,19
191212261,8,1,4,0,7,20
191212262,7,7,7,4,3,28
191212263,4,4,3,2,0,13
191212264,6,4,7,7,3,27
191212265,8,2,5,0,5,20
191212266,0,1,7,0,7,15
191212267,1,9,3,1,9,23
191212268,6,2,8,2,1,19
191212269,6,5,9,6,4,30
191212270,9,1,0,2,9,21
191212271,8,0,3,3,2,16
191212272,6,3,8,7,7,31
191212273,4,1,2,4,7,18
191212274,5,5,7,1,8,26
191212275,3,3,5,9,4,24
191212276,0,5,7,1,0,13
191212277,0,6,7,3,9,25
191212278,6,8,5,6,2,27
191212279,8,5,3,7,1,24
191212280,3,4,4,2,3,16
191212281,4,6,7,2,4,23
191212282,8,6,7,7,1,29
191212283,7,5,4,9,5,30
191212284,3,2,7,7,0,19
191212285,1,1,6,5,7,20
191212286,8,5,9,9,2,33
191212287,9,1,6,0,1,17
191212288,3,9,4,6,3,25
191212289,9,0,7,0,6,22
191212290,6,3,6,0,4,19
191212291,0,6,8,2,1,17
191212292,5,2,1,9,5,22
191212293,0,2,1,7,0,10
191212294,3,3,1,3,3,13
191212295,9,0,5,5,3,22
191212296,9,0,4,4,6,23
191212297,1,4,8,4,1,18
191212298,1,0,3,0,8,12
191212299,6,9,7,1,3,26
191212300,4,9,0,5,4,22
191212301,3,4,1,8,3,19
191212302,9,6,7,0,0,22
191212303,4,1,9,3,0,17
191212304,1,5,4,1,2,13
191212305,8,1,1,7,6,23
191212306,3,1,5,7,6,22
191212307,5,2,6,3,9,25
191212308,7,3,7,3,8,28
191212309,5,7,5,3,2,22
191212310,3,2,1,9,6,21
191212311,2,7,2,1,6,18
191212312,0,4,7,5,5,21
191212313,5,7,8,9,2,31
191212314,7,6,9,1,5,28
191212315,5,8,7,5,2,27
191212316,6,5,2,0,1,14
191212317,4,3,5,9,4,25
191212318,1,0,2,2,0,5
191212319,7,7,8,8,0,30
191212320,7,1,0,9,0,17
191212321,3,0,0,2,2,7
191212322,1,6,9,1,3,20
191212323,0,3,9,1,2,15
191212324,3,2,9,4,2,20
191212325,6,4,8,3,5,26
191212326,0,9,2,2,1,14
191212327,9,4,6,9,5,33
191212328,2,3,9,7,7,28
191212329,3,0,3,2,4,12
191212330,6,1,2,0,5,14
191212331,5,1,5,4,5,20
191212332,2,2,6,3,2,15
191212333,2,4,5,9,9,29
191212334,8,8,0,5,7,28
191212335,3,4,8,7,1,23
191212336,8,9,4,8,3,32
191212337,2,6,4,3,1,16
191212338,1,2,2,2,2,9
191212339,7,2,8,3,1,21
191212340,9,1,5,4,3,22
191212341,2,8,0,9,0,19
191212342,7,0,7,2,8,24
191212343,4,2,5,9,2,22
191212344,9,9,6,8,9,41
191212345,8,9,5,1,9,32
191212346,1,4,2,9,6,22
191212347,1,1,8,4,4,18
191212348,8,8,9,3,1,29
191212349,7,9,3,5,7,31
191212350,0,8,1,5,5,19
191212351,3,4,7,7,8,29
191212352,0,0,1,2,1,4
191212353,2,6,7,8,7,30
191212354,2,5,0,8,8,23
191212355,3,1,2,2,2,10
191212356,0,8,0,2,0,10
191212357,2,0,6,4,0,12
191212358,9,4,3,5,9,30
191212359,8,8,2,4,2,24
191212360,0,7,2,9,3,21
191212361,5,9,4,8,5,31
191212362,6,1,7,5,0,19
191212363,1,4,8,8,9,30
191212364,8,3,4,1,7,23
191212365,2,2,8,5,3,20
191212366,3,7,8,9,7,34
191212367,8,0,5,6,4,23
191212368,6,0,9,0,6,21
191212369,7,4,3,8,5,27
191212370,7,1,8,3,5,24
191212371,1,0,6,3,6,16
191212372,6,1,0,3,5,15
191212373,5,8,9,3,3,28
191212374,4,0,0,1,3,8
191212375,0,1,1,5,3,10
191212376,7,9,5,6,9,36
191212377,4,4,8,7,7,30
191212378,4,0,1,5,5,15
191212379,9,2,9,1,5,26
191212380,3,5,8,3,2,21
191212381,1,6,0,9,0,16
191212382,0,1,6,5,5,17
191212383,5,7,0,7,3,22
191212384,0,2,4,3,6,15
191212385,8,8,3,9,8,36
191212386,0,1,1,0,0,2
191212387,9,6,3,8,1,27
191212388,1,9,1,4,6,21
191212389,4,3,3,7,6,23
191212390,2,0,5,9,9,25
191212391,2,6,6,6,4,24
191212392,4,0,8,7,4,23
191212393,8,9,6,5,2,30
191212394,0,6,0,2,0,8
191212395,5,7,7,2,8,29
191212396,0,1,9,3,3,16
191212397,0,8,6,6,0,20
191212398,4,1,8,0,6,19
191212399,1,1,4,4,6,16
191212400,7,3,0,5,0,15
191212401,3,6,4,0,3,16
191212402,0,1,0,2,1,4
191212403,1,9,3,6,4,23
191212404,6,5,0,6,0,17
191212405,7,8,1,8,1,25
191212406,8,2,9,3,2,24
191212407,0,9,0,2,6,17
191212408,1,0,0,7,4,12
191212409,6,9,4,8,1,28
191212410,9,2,7,5,1,24
191212411,4,1,7,2,1,15
191212412,2,7,7,7,9,32
191212413,5,8,7,2,8,30
191212414,0,0,2,6,0,8
191212415,1,4,7,1,8,21
191212416,2,2,4,9,7,24
191212417,9,9,1,7,2,28
191212418,6,7,4,0,5,22
191212419,8,6,2,6,1,23
191212420,6,4,0,6,2,18
191212421,9,6,0,4,0,19
191212422,0,9,4,9,0,22
191212423,4,0,0,2,8,14
191212424,7,4,7,4,1,23
191212425,5,9,5,6,4,29
191212426,0,5,7,5,5,22
191212427,3,8,7,8,8,34
191212428,2,5,2,6,3,18
191212429,5,6,5,2,0,18
191212430,1,6,4,2,2,15
191212431,3,2,5,2,6,18
191212432,9,5,2,8,5,29
191212433,0,2,2,6,9,19
191212434,5,2,2,8,2,19
191212435,4,6,3,3,5,21
191212436,8,7,1,5,1,22
191212437,3,6,6,9,1,25
191212438,9,9,7,7,3,35
191212439,9,4,0,4,9,26
191212440,6,3,5,1,4,19
191212441,8,3,1,4,9,25
191212442,3,9,6,0,0,18
191212443,9,6,4,3,6,28
191212444,5,0,4,5,4,18
191212445,6,3,2,3,9,23
191212446,2,3,6,7,5,23
191212447,3,8,8,9,4,32
191212448,5,9,1,1,0,16
191212449,3,2,7,6,0,18
191212450,8,0,3,2,1,14
191212451,9,6,1,8,1,25
191212452,2,0,3,6,8,19
191212453,2,1,8,0,5,16
191212454,4,8,5,3,7,27
191212455,4,7,5,6,2,24
191212456,0,2,6,8,9,25
191212457,5,6,6,7,0,24
191212458,7,9,2,4,7,29
191212459,6,7,6,3,9,31
191212460,1,5,8,2,6,22
191212461,6,7,0,4,6,23
191212462,2,3,7,0,0,12
191212463,6,8,1,9,1,25
191212464,2,4,9,3,6,24
191212465,4,2,3,1,8,18
191212466,4,6,1,2,0,13
191212467,5,6,5,8,8,32
191212468,5,8,0,7,1,21
191212469,0,7,7,1,1,16
191212470,9,1,7,7,8,32
191212471,8,5,9,3,8,33
191212472,6,4,4,4,7,25
191212473,8,4,2,2,7,23
191212474,8,1,9,1,7,26
191212475,8,5,7,7,1,28
191212476,2,3,0,0,5,10
191212477,6,7,3,1,2,19
191212478,9,9,2,9,6,35
191212479,5,5,3,5,5,23
191212480,7,2,8,0,0,17
191212481,5,7,8,7,3,30
191212482,4,9,5,2,4,24
191212483,8,8,5,4,0,25
191212484,8,5,0,5,3,21
191212485,6,4,3,0,9,22
191212486,8,1,8,1,1,19
191212487,8,7,9,6,6,36
191212488,1,3,1,9,3,17
191212489,2,6,8,0,3,19
191212490,8,8,2,1,9,28
191212491,2,2,1,7,7,19
191212492,9,5,0,9,5,28
191212493,3,2,1,2,0,8
191212494,6,6,7,8,9,36
191212495,8,0,4,6,2,20
191212496,9,0,5,4,5,23
191212497,6,8,0,3,2,19
191212498,6,3,8,5,5,27
191212499,7,0,0,1,5,13
191212500,9,9,5,8,6,37
191212501,6,1,8,7,1,23
191212502,5,5,6,5,6,27
191212503,3,8,8,3,5,27
191212504,9,1,9,2,2,23
191212505,6,0,0,2,2,10
191212506,4,9,8,3,2,26
191212507,1,6,5,2,6,20
191212508,6,2,1,2,8,19
191212509,2,4,5,9,0,20
191212510,6,8,4,8,1,27
191212511,7,1,1,3,3,15
191212512,4,1,6,0,6,17
191212513,9,0,6,3,7,25
191212514,8,0,4,1,9,22
191212515,0,6,6,7,2,21
191212516,3,7,4,3,8,25
191212517,7,7,4,4,1,23
191212518,8,5,8,2,0,23
191212519,1,9,2,0,9,21
191212520,3,6,9,4,1,23
191212521,5,0,3,7,5,20
191212522,4,1,1,6,1,13
191212523,6,2,7,6,4,25
191212524,4,7,7,4,6,28
191212525,1,1,3,7,3,15
191212526,5,0,3,9,6,23
191212527,2,5,0,3,2,12
191212528,1,0,4,9,2,16
191212529,1,5,5,0,3,14
191212530,0,5,4,3,9,21
191212531,6,7,0,7,4,24
191212532,7,9,1,5,5,27
191212533,6,4,8,6,6,30
191212534,5,6,3,8,1,23
191212535,4,9,3,5,2,23
191212536,7,5,6,7,8,33
191212537,8,1,3,9,3,24
191212538,9,0,6,0,6,21
191212539,8,1,7,8,6,30
191212540,3,4,4,5,1,17
191212541,5,8,2,4,4,23
191212542,9,5,4,6,5,29
191212543,7,3,5,4,4,23
191212544,8,7,2,6,9,32
191212545,2,3,6,3,2,16
191212546,1,5,4,6,4,20
191212547,9,2,7,0,6,24
191212548,2,6,6,2,3,19
191212549,0,8,3,5,8,24
191212550,7,4,4,5,3,23
191212551,1,3,4,0,2,10
191212552,6,3,0,6,9,24
191212553,7,4,1,3,8,23
191212554,2,5,9,2,2,20
191212555,9,5,4,0,6,24
191212556,6,7,8,5,7,33
191212557,1,7,5,8,6,27
191212558,9,5,6,3,0,23
191212559,9,0,9,6,8,32
191212560,5,9,6,4,7,31
191212561,4,8,7,4,0,23
191212562,4,3,6,0,9,22
191212563,1,9,4,3,4,21
191212564,5,3,9,2,6,25
191212565,9,2,5,7,3,26
191212566,0,6,1,4,4,15
191212567,9,4,0,1,6,20
191212568,9,5,0,4,3,21
191212569,6,5,8,0,3,22
191212570,3,8,8,0,1,20
191212571,6,6,3,0,2,17
191212572,2,7,0,1,7,17
191212573,6,4,7,3,1,21
191212574,2,9,0,5,7,23
191212575,1,7,5,8,3,24
191212576,8,7,9,6,5,35
191212577,5,5,4,9,6,29
191212578,8,6,3,6,4,27
191212579,1,3,8,5,0,17
191212580,6,4,9,2,1,22
191212581,6,4,9,1,9,29
191212582,9,1,7,6,5,28
191212583,6,9,5,1,7,28
191212584,5,0,5,6,9,25
191212585,4,5,3,7,5,24
191212586,5,7,9,8,8,37
191212587,0,2,2,5,8,17
191212588,1,8,7,3,1,20
191212589,3,6,7,9,5,30
191212590,1,4,4,4,3,16
191212591,1,9,5,7,6,28
191212592,5,1,1,4,7,18
191212593,6,2,9,4,5,26
191212594,2,0,9,7,4,22
191212595,6,6,0,0,0,12
191212596,0,1,4,3,2,10
191212597,3,3,4,3,5,18
191212598,0,5,2,3,9,19
191212599,6,6,4,1,6,23
191212600,8,8,3,0,5,24
191212601,2,1,9,3,8,23
191212602,3,0,1,6,5,15
191212603,2,6,8,1,9,26
191212604,6,6,8,6,6,32
191212605,6,7,2,7,4,26
191212606,1,5,1,1,6,14
191212607,6,7,2,4,0,19
191212608,0,8,3,5,4,20
191212609,7,7,4,7,4,29
191212610,0,1,3,1,8,13
191212611,7,6,4,9,3,29
191212612,9,4,8,9,7,37
191212613,6,9,7,2,6,30
191212614,2,7,9,8,6,32
191212615,4,0,5,4,2,15
191212616,3,3,1,8,5,20
191212617,5,7,2,4,2,20
191212618,0,8,9,0,5,22
191212619,1,6,3,2,9,21
191212620,1,8,2,4,0,15
191212621,7,7,6,2,4,26
191212622,6,9,7,0,1,23
191212623,8,7,9,6,8,38
191212624,6,0,8,2,1,17
191212625,7,0,8,0,4,19
191212626,8,0,3,7,4,22
191212627,0,5,5,1,2,13
191212628,5,6,4,5,7,27
191212629,6,9,5,6,9,35
191212630,4,2,4,5,9,24
191212631,3,4,7,6,0,20
191212632,1,0,2,7,7,17
191212633,4,1,5,9,4,23
191212634,4,9,2,1,7,23
191212635,2,7,0,3,8,20
191212636,2,6,4,0,8,20
191212637,6,0,8,8,3,25
191212638,4,3,6,6,1,20
191212639,1,5,1,8,9,24
191212640,6,8,2,3,0,19
191212641,8,8,3,2,5,26
191212642,1,0,8,7,1,17
191212643,1,2,8,1,8,20
191212644,2,2,9,2,3,18
191212645,1,2,1,4,7,15
191212646,5,0,7,7,1,20
191212647,0,6,2,2,9,19
191212648,0,2,0,4,7,13
191212649,6,0,8,9,3,26
191212650,3,9,4,9,1,26
191212651,0,5,6,6,5,22
191212652,2,1,8,5,2,18
191212653,8,2,3,0,1,14
191212654,5,9,6,3,9,32
191212655,3,9,4,2,7,25
191212656,9,0,1,6,2,18
191212657,5,7,7,2,6,27
191212658,5,4,0,5,2,16
191212659,8,7,3,6,6,30
191212660,2,2,0,5,6,15
191212661,4,0,9,6,4,23
191212662,0,3,2,0,9,14
191212663,1,7,5,3,1,17
191212664,0,7,0,1,5,13
191212665,4,0,8,9,0,21
191212666,5,3,4,5,4,21
191212667,4,0,6,1,1,12
191212668,2,4,5,2,9,22
191212669,1,2,3,4,3,13
191212670,0,5,3,9,1,18
191212671,5,8,6,7,5,31
191212672,8,9,0,5,8,30
191212673,8,3,3,9,4,27
191212674,5,9,3,4,6,27
191212675,9,1,8,3,5,26
191212676,4,3,6,8,4,25
191212677,3,6,2,6,1,18
191212678,7,4,4,1,1,17
191212679,9,4,2,7,9,31
191212680,8,6,5,5,7,31
191212681,2,1,2,3,2,10
191212682,8,7,9,3,1,28
191212683,0,8,4,1,6,19
191212684,5,6,5,1,8,25
191212685,1,6,6,6,6,25
191212686,4,2,9,7,3,25
191212687,4,9,9,7,4,33
191212688,4,8,3,8,1,24
191212689,3,3,6,9,0,21
191212690,3,2,2,4,4,15
191212691,5,0,6,1,2,14
191212692,5,6,1,8,7,27
191212693,2,3,3,6,5,19
191212694,6,2,9,8,3,28
191212695,9,1,2,4,1,17
191212696,2,5,6,2,5,20
191212697,9,0,7,9,6,31
191212698,7,6,2,1,8,24
191212699,8,4,6,0,1,19
191212700,9,6,8,7,7,37
191212701,9,0,0,2,8,19
191212702,9,3,2,9,3,26
191212703,4,0,1,5,0,10
191212704,4,1,9,4,2,20
191212705,4,7,9,8,0,28
191212706,1,5,1,6,3,16
191212707,6,7,2,5,3,23
191212708,0,4,5,4,6,19
191212709,5,6,0,6,3,20
191212710,2,8,8,8,3,29
191212711,7,1,5,9,4,26
191212712,0,9,9,3,3,24
191212713,6,5,9,4,6,30
191212714,5,4,9,6,0,24
191212715,6,2,9,6,0,23
191212716,2,7,5,9,3,26
191212717,6,6,1,2,7,22
191212718,3,3,8,4,6,24
191212719,4,7,4,5,1,21
191212720,0,9,1,1,6,17
191212721,3,9,9,3,6,30
191212722,7,9,7,2,8,33
191212723,7,7,2,5,0,21
191212724,5,5,7,9,7,33
191212725,0,0,4,2,3,9
191212726,8,7,0,0,0,15
191212727,8,2,2,2,5,19
191212728,5,4,0,0,3,12
191212729,7,4,8,5,7,31
191212730,5,3,4,1,2,15
191212731,3,3,6,7,7,26
191212732,0,1,5,6,1,13
191212733,1,8,0,2,2,13
191212734,4,9,2,1,0,16
191212735,8,3,2,0,1,14
191212736,8,2,6,1,0,17
191212737,3,8,1,3,9,24
191212738,5,7,4,4,2,22
191212739,9,3,8,7,3,30
191212740,6,7,5,7,8,33
191212741,1,7,5,9,4,26
191212742,6,3,3,4,6,22
191212743,6,7,7,7,5,32
191212744,8,8,0,0,1,17
191212745,3,6,2,0,6,17
191212746,9,4,1,0,1,15
191212747,8,5,5,7,6,31
191212748,8,0,2,9,5,24
191212749,4,2,9,0,2,17
191212750,8,1,7,7,6,29
191212751,5,2,0,4,2,13
191212752,5,5,0,2,3,15
191212753,7,3,6,3,2,21
191212754,7,3,8,2,1,21
191212755,9,5,2,6,6,28
191212756,5,4,0,9,8,26
191212757,4,7,5,0,7,23
191212758,9,0,8,1,1,19
191212759,8,4,6,0,0,18
191212760,8,8,1,1,3,21
191212761,9,6,1,1,2,19
191212762,3,5,5,7,1,21
191212763,3,0,2,3,6,14
191212764,3,5,5,4,0,17
191212765,4,5,4,7,0,20
191212766,3,9,6,6,2,26
191212767,8,7,3,0,8,26
191212768,2,2,4,5,6,19
191212769,5,7,1,7,5,25
191212770,7,2,3,7,6,25
191212771,0,5,1,7,6,19
191212772,8,3,6,1,9,27
191212773,9,1,5,3,8,26
191212774,5,0,2,2,7,16
191212775,8,6,1,5,3,23
191212776,1,8,3,2,5,19
191212777,9,3,2,8,9,31
191212778,2,8,0,9,1,20
191212779,0,6,2,5,9,22
191212780,9,0,6,1,5,21
191212781,6,3,5,0,7,21
191212782,6,6,7,8,8,35
191212783,2,7,9,3,1,22
191212784,2,8,5,3,4,22
191212785,2,6,4,7,6,25
191212786,7,8,7,1,0,23
191212787,3,2,1,1,6,13
191212788,8,1,2,1,0,12
191212789,0,0,8,9,4,21
191212790,1,3,5,3,1,13
191212791,7,7,9,4,1,28
191212792,0,1,1,4,6,12
191212793,0,7,0,4,9,20
191212794,7,6,2,2,4,21
191212795,7,3,4,4,6,24
191212796,1,8,0,6,4,19
191212797,3,3,8,1,8,23
191212798,8,4,0,2,1,15
191212799,8,8,0,9,8,33
191212800,9,4,9,8,2,32
191212801,8,9,6,1,2,26
191212802,0,1,0,6,7,14
191212803,0,9,5,2,0,16
191212804,9,1,4,3,1,18
191212805,5,3,8,5,9,30
191212806,9,5,6,9,1,30
191212807,6,1,9,5,4,25
191212808,5,3,5,9,1,23
191212809,6,5,9,0,5,25
191212810,8,5,6,2,6,27
191212811,1,7,4,1,4,17
191212812,1,1,2,0,5,9
191212813,9,3,0,1,3,16
191212814,9,8,7,4,0,28
191212815,9,0,7,1,1,18
191212816,0,4,9,3,9,25
191212817,8,6,3,6,3,26
191212818,3,6,4,5,5,23
191212819,9,4,4,9,1,27
191212820,0,8,8,2,5,23
191212821,0,1,0,9,2,12
191212822,5,2,0,9,3,19
191212823,0,3,9,5,8,25
191212824,5,8,0,3,8,24
191212825,5,4,3,7,2,21
191212826,6,9,1,2,1,19
191212827,3,0,5,3,6,17
191212828,6,7,5,0,0,18
191212829,4,9,0,1,5,19
191212830,5,4,0,4,0,13
191212831,9,5,9,2,6,31
191212832,0,4,3,6,4,17
191212833,1,1,6,9,0,17
191212834,7,9,4,7,1,28
191212835,6,2,9,7,7,31
191212836,2,3,1,7,0,13
191212837,4,3,0,2,1,10
191212838,6,2,2,4,7,21
191212839,0,4,4,5,2,15
191212840,6,1,3,6,0,16
191212841,8,7,5,9,1,30
191212842,2,8,1,8,9,28
191212843,2,3,0,5,7,17
191212844,4,2,9,4,5,24
191212845,5,0,6,6,9,26
191212846,2,3,0,3,8,16
191212847,3,7,5,4,9,28
191212848,0,9,0,6,1,16
191212849,6,9,7,8,9,39
191212850,9,6,5,6,3,29
191212851,6,8,4,4,7,29
191212852,7,5,2,4,9,27
191212853,8,7,0,8,7,30
191212854,4,8,9,8,5,34
191212855,3,6,0,3,7,19
191212856,2,5,1,2,2,12
191212857,2,9,3,8,9,31
191212858,0,3,2,0,5,10
191212859,4,5,5,4,0,18
191212860,2,1,4,4,5,16
191212861,4,5,0,3,6,18
191212862,1,1,2,3,1,8
191212863,9,9,9,9,5,41
191212864,9,8,4,2,6,29
191212865,5,9,3,3,2,22
191212866,5,3,1,1,7,17
191212867,6,4,6,3,9,28
191212868,3,9,3,9,1,25
191212869,2,6,9,0,6,23
191212870,5,8,9,6,1,29
191212871,7,1,3,0,3,14
191212872,9,2,5,4,7,27
191212873,3,0,8,4,8,23
191212874,0,3,6,6,9,24
191212875,5,0,1,5,6,17
191212876,7,4,6,3,7,27
191212877,5,7,8,0,4,24
191212878,9,6,4,4,5,28
191212879,5,9,3,9,8,34
191212880,1,5,7,8,0,21
191212881,8,8,0,9,0,25
191212882,3,9,0,1,3,16
191212883,6,6,7,6,4,29
191212884,3,2,0,1,5,11
191212885,4,3,2,4,9,22
191212886,4,1,7,0,7,19
191212887,7,4,7,8,5,31
191212888,5,8,8,8,5,34
191212889,0,2,3,0,1,6
191212890,0,6,4,3,3,16
191212891,2,5,9,9,3,28
191212892,3,9,0,0,5,17
191212893,7,7,4,3,5,26
191212894,0,8,6,2,6,22
191212895,4,9,8,1,9,31
191212896,6,2,8,9,3,28
191212897,1,4,6,3,6,20
191212898,9,8,4,6,3,30
191212899,5,8,5,1,0,19
191212900,3,9,9,7,1,29
191212901,8,2,0,8,2,20
191212902,4,1,6,0,0,11
191212903,5,5,2,3,0,15
191212904,5,4,2,6,7,24
191212905,3,3,8,9,9,32
191212906,3,0,8,3,8,22
191212907,7,0,6,8,0,21
191212908,2,8,5,9,4,28
191212909,4,1,8,6,6,25
191212910,4,7,4,4,3,22
191212911,0,3,8,9,6,26
191212912,3,6,5,3,8,25
191212913,8,9,6,9,8,40
191212914,3,8,1,8,9,29
191212915,7,8,8,4,8,35
191212916,7,1,1,6,8,23
191212917,4,4,5,5,1,19
191212918,8,6,1,8,0,23
191212919,4,4,5,5,4,22
191212920,9,8,9,7,5,38
191212921,3,5,6,2,6,22
191212922,6,6,8,3,8,31
191212923,5,7,0,4,3,19
191212924,6,8,3,4,1,22
191212925,9,8,1,5,8,31
191212926,9,1,7,2,4,23
191212927,3,7,7,0,3,20
191212928,9,1,6,1,6,23
191212929,8,2,6,0,7,23
191212930,4,8,8,9,3,32
191212931,7,8,1,6,4,26
191212932,2,7,1,5,0,15
191212933,0,0,9,2,1,12
191212934,0,3,7,9,1,20
191212935,4,0,4,8,8,24
191212936,3,8,8,3,8,30
191212937,3,2,0,9,8,22
191212938,0,7,0,0,8,15
191212939,4,7,4,2,3,20
191212940,3,4,4,5,1,17
191212941,8,3,3,4,2,20
191212942,1,7,3,3,2,16
191212943,9,5,9,0,5,28
191212944,2,0,4,3,9,18
191212945,7,1,0,6,9,23
191212946,6,1,1,1,9,18
191212947,5,7,4,4,6,26
191212948,1,3,5,6,9,24
191212949,8,6,0,9,2,25
191212950,2,6,5,3,2,18
191212951,4,5,2,4,6,21
191212952,8,1,2,4,7,22
191212953,3,4,2,6,6,21
191212954,0,5,6,9,0,20
191212955,0,5,8,4,5,22
191212956,6,3,1,2,9,21
191212957,0,1,9,5,8,23
191212958,2,8,0,5,2,17
191212959,5,1,7,3,5,21
191212960,8,7,3,1,2,21
191212961,4,1,5,9,8,27
191212962,0,3,2,3,3,11
191212963,7,7,6,8,8,36
191212964,6,4,8,6,0,24
191212965,0,5,4,5,4,18
191212966,4,2,4,5,7,22
191212967,9,5,8,3,7,32
191212968,0,7,9,7,9,32
191212969,6,1,6,6,0,19
191212970,1,5,1,6,8,21
191212971,3,0,8,6,0,17
191212972,4,7,8,4,3,26
191212973,6,4,4,0,7,21
191212974,6,2,6,1,9,24
191212975,5,6,9,0,0,20
191212976,4,0,4,0,6,14
191212977,5,9,1,4,2,21
191212978,2,5,8,8,7,30
191212979,5,3,2,3,2,15
191212980,9,9,4,6,6,34
191212981,2,0,4,3,7,16
191212982,2,2,7,1,7,19
191212983,5,8,6,5,7,31
191212984,6,1,2,7,4,20
191212985,1,1,1,8,5,16
191212986,4,9,4,7,2,26
191212987,5,0,0,7,2,14
191212988,6,0,1,0,4,11
191212989,1,6,9,2,3,21
191212990,9,1,2,9,8,29
191212991,2,2,9,3,1,17
191212992,3,6,8,2,0,19
191212993,7,0,8,6,0,21
191212994,5,5,2,1,7,20
191212995,3,9,9,5,3,29
191212996,9,5,3,7,3,27
191212997,7,3,2,9,2,23
191212998,5,7,5,2,2,21
191212999,3,4,8,6,2,23
1912121000,1,2,8,9,2,22
1912121001,4,0,3,4,4,15
1912121002,4,9,2,5,9,29
1912121003,1,1,8,7,2,19
1912121004,0,7,5,0,4,16
1912121005,1,8,4,3,1,17
1912121006,7,2,4,6,8,27
1912121007,4,3,5,2,1,15
1912121008,8,2,2,3,2,17
1912121009,1,5,6,5,5,22
1912121010,5,6,8,6,1,26
1912121011,6,4,5,3,8,26
1912121012,5,3,1,4,0,13
1912121013,3,0,7,6,7,23
1912121014,0,6,8,0,2,16
1912121015,7,8,6,2,7,30
1912121016,0,2,2,0,2,6
1912121017,9,3,7,1,1,21
1912121018,5,7,2,9,8,31
1912121019,0,6,9,3,7,25
1912121020,5,0,7,5,7,24
1912121021,2,4,5,5,4,20
1912121022,0,9,2,1,2,14
1912121023,4,1,2,3,2,12
1912121024,1,7,7,3,2,20
1912121025,5,9,4,5,7,30
1912121026,1,8,0,2,0,11
1912121027,6,3,6,6,7,28
1912121028,8,9,6,7,9,39
1912121029,4,9,0,0,1,14
1912121030,3,8,0,3,1,15
1912121031,9,1,4,3,3,20
1912121032,2,3,9,8,6,28
1912121033,1,8,4,2,6,21
1912121034,7,8,5,8,7,35
1912121035,7,3,4,2,5,21
1912121036,9,5,7,9,8,38
1912121037,7,4,1,3,7,22
1912121038,1,1,4,2,9,17
1912121039,6,9,6,5,5,31
1912121040,2,5,5,1,0,13
1912121041,7,9,0,7,7,30
1912121042,7,1,0,8,6,22
1912121043,3,3,9,7,1,23
1912121044,2,5,5,4,3,19
1912121045,1,1,2,4,8,16
1912121046,5,0,0,4,5,14
1912121047,9,8,0,7,6,30
1912121048,1,2,5,6,0,14
1912121049,5,3,1,9,8,26
1912121050,0,7,8,7,5,27
1912121051,4,7,9,9,1,30
1912121052,6,6,3,5,7,27
1912121053,4,9,2,9,0,24
1912121054,8,4,7,1,1,21
1912121055,0,7,8,3,4,22
1912121056,7,8,7,6,0,28
1912121057,7,2,0,0,4,13
1912121058,5,0,5,0,6,16
1912121059,4,6,6,2,9,27
1912121060,7,5,5,0,4,21
1912121061,7,6,0,3,8,24
1912121062,3,2,5,5,8,23
1912121063,0,0,8,2,3,13
1912121064,9,4,3,7,7,30
1912121065,9,0,6,9,9,33
1912121066,9,9,1,8,9,36
1912121067,3,9,0,5,0,17
1912121068,4,3,2,0,1,10
1912121069,9,3,5,8,3,28
1912121070,5,2,6,7,2,22
1912121071,6,0,5,9,7,27
1912121072,2,7,1,3,9,22
1912121073,1,1,5,2,6,15
1912121074,3,8,5,2,4,22
1912121075,5,8,7,7,8,35
1912121076,0,7,4,2,0,13
1912121077,4,0,4,2,4,14
1912121078,5,4,9,5,1,24
1912121079,5,8,8,0,1,22
1912121080,6,8,8,7,3,32
1912121081,3,4,9,3,5,24
1912121082,3,5,9,2,1,20
1912121083,0,1,8,7,3,19
1912121084,7,7,0,7,4,25
1912121085,9,4,2,5,2,22
1912121086,3,6,1,6,5,21
1912121087,7,8,7,8,7,37
1912121088,1,1,5,8,8,23
1912121089,5,1,3,1,7,17
1912121090,2,9,2,9,9,31
1912121091,0,7,1,2,1,11
1912121092,7,8,1,0,5,21
1912121093,7,7,7,6,9,36
1912121094,4,3,3,4,2,16
1912121095,1,2,8,4,3,18
1912121096,4,9,7,1,0,21
1912121097,3,3,0,9,8,23
1912121098,8,3,2,4,9,26
1912121099,1,2,9,4,8,24
1912121100,5,6,0,1,1,13
1912121101,9,9,1,4,4,27
1912121102,1,9,3,5,1,19
1912121103,9,7,6,0,4,26
1912121104,0,2,3,2,2,9
1912121105,6,3,2,3,2,16
191213001,2,4,0,2,1,9
191213002,1,6,4,7,0,18
191213003,7,2,6,1,7,23
191213004,2,0,8,1,7,18
191213005,8,1,8,9,0,26
191213006,8,0,7,0,9,24
191213007,3,8,2,6,2,21
191213008,9,6,5,9,2,31
191213009,2,1,4,4,0,11
191213010,6,8,5,6,5,30
191213011,6,5,9,7,9,36
191213012,1,2,5,0,3,11
191213013,4,3,7,4,6,24
191213014,7,9,6,6,7,35
191213015,6,8,8,2,1,25
191213016,4,5,3,1,9,22
191213017,2,9,8,5,4,28
191213018,0,8,6,7,4,25
191213019,8,0,2,4,3,17
191213020,4,0,6,4,5,19
191213021,0,4,4,4,1,13
191213022,7,1,6,6,7,27
191213023,4,1,3,6,1,15
191213024,6,0,9,8,3,26
191213025,1,5,4,9,9,28
191213026,7,2,2,6,8,25
191213027,3,0,5,0,4,12
191213028,7,2,5,2,1,17
191213029,7,4,6,5,9,31
191213030,4,2,1,4,1,12
191213031,6,5,6,6,1,24
191213032,6,4,2,2,4,18
191213033,4,2,8,9,9,32
191213034,1,2,4,8,5,20
191213035,4,7,3,2,8,24
191213036,7,1,7,6,8,29
191213037,7,4,4,7,8,30
191213038,3,9,3,2,7,24
191213039,2,6,2,7,0,17
191213040,5,4,3,9,4,25
191213041,0,6,9,8,4,27
191213042,8,3,2,2,1,16
191213043,8,5,4,3,2,22
191213044,8,0,4,7,0,19
191213045,0,5,0,8,3,16
191213046,2,5,0,9,3,19
191213047,9,2,2,2,3,18
191213048,5,8,6,1,6,26
191213049,4,8,5,1,3,21
191213050,1,9,9,6,7,32
191213051,7,9,2,7,6,31
191213052,8,9,9,5,4,35
191213053,6,7,9,6,2,30
191213054,3,6,6,7,5,27
191213055,5,9,4,8,1,27
191213056,7,0,5,6,8,26
191213057,5,4,0,7,5,21
191213058,8,1,1,5,6,21
191213059,2,6,8,7,4,27
191213060,5,8,9,7,4,33
191213061,1,6,4,2,5,18
191213062,7,9,3,0,0,19
191213063,0,2,5,6,5,18
191213064,2,5,9,3,5,24
191213065,6,4,0,3,4,17
191213066,1,2,2,3,3,11
191213067,0,8,6,4,8,26
191213068,0,1,5,2,0,8
191213069,3,9,6,7,2,27
191213070,8,0,6,8,2,24
191213071,6,7,9,4,5,31
191213072,0,9,4,1,1,15
191213073,4,7,3,4,5,23
191213074,4,3,4,7,2,20
191213075,0,6,8,1,7,22
191213076,1,1,5,7,2,16
191213077,7,7,4,0,2,20
191213078,7,4,4,2,0,17
191213079,1,4,5,4,1,15
191213080,2,3,7,5,7,24
191213081,8,7,2,0,4,21
191213082,8,4,9,0,0,21
191213083,2,9,5,6,7,29
191213084,3,8,1,5,2,19
191213085,2,6,6,5,6,25
191213086,6,1,9,8,2,26
191213087,5,8,6,5,0,24
191213088,4,4,9,7,9,33
191213089,7,6,1,5,4,23
191213090,2,8,0,9,5,24
191213091,2,1,9,9,6,27
191213092,2,1,1,1,8,13
191213093,9,8,9,5,9,40
191213094,9,8,4,7,1,29
191213095,1,4,1,0,1,7
191213096,7,7,0,9,4,27
191213097,5,7,9,3,3,27
191213098,3,2,5,0,7,17
191213099,7,2,7,9,4,29
191213100,0,6,0,5,2,13
191213101,0,5,4,2,2,13
191213102,7,2,2,4,5,20
191213103,5,3,0,6,9,23
191213104,9,3,6,1,7,26
191213105,2,3,6,2,9,22
191213106,5,2,8,4,1,20
191213107,8,4,5,8,8,33
191213108,9,0,0,8,7,24
191213109,7,7,4,1,0,19
191213110,5,8,8,3,8,32
191213111,1,3,8,4,7,23
191213112,6,9,3,3,6,27
191213113,0,6,1,1,9,17
191213114,9,2,0,5,2,18
191213115,8,2,5,2,8,25
191213116,0,6,1,7,5,19
191213117,6,1,3,9,5,24
191213118,2,8,3,3,3,19
191213119,2,0,6,5,5,18
191213120,3,7,2,0,7,19
191213121,0,2,3,3,8,16
191213122,2,2,9,0,6,19
191213123,0,6,3,8,7,24
191213124,8,1,9,7,1,26
191213125,8,7,6,4,1,26
191213126,5,1,5,2,5,18
191213127,4,6,0,9,5,24
191213128,4,9,0,3,1,17
191213129,5,0,1,5,2,13
191213130,0,0,9,8,8,25
191213131,5,0,5,4,5,19
191213132,0,9,1,9,8,27
191213133,0,3,8,4,9,24
191213134,5,1,8,9,4,27
191213135,2,2,6,8,9,27
191213136,3,9,9,0,3,24
191213137,1,8,1,1,0,11
191213138,9,0,4,3,7,23
191213139,8,9,5,5,0,27
191213140,6,2,9,2,4,23
191213141,4,0,9,7,3,23
191213142,1,6,4,6,7,24
191213143,0,9,8,5,9,31
191213144,5,1,1,2,6,15
191213145,5,4,4,5,0,18
191213146,2,9,6,3,9,29
191213147,8,6,0,7,5,26
191213148,7,7,4,5,4,27
191213149,2,6,5,0,0,13
191213150,8,4,5,6,3,26
191213151,6,1,9,1,6,23
191213152,5,2,6,7,4,24
191213153,4,8,9,9,3,33
191213154,3,4,8,3,1,19
191213155,7,4,6,2,4,23
191213156,2,8,8,8,0,26
191213157,5,0,0,4,1,10
191213158,9,9,7,8,2,35
191213159,7,5,6,9,4,31
191213160,4,1,2,3,3,13
191213161,6,7,0,8,8,29
191213162,4,5,2,3,2,16
191213163,9,9,4,0,8,30
191213164,9,6,7,3,2,27
191213165,0,4,1,8,7,20
191213166,0,8,6,8,4,26
191213167,3,0,9,0,4,16
191213168,4,1,1,0,8,14
191213169,5,9,8,4,4,30
191213170,7,1,5,5,9,27
191213171,4,9,6,3,7,29
191213172,0,6,0,3,7,16
191213173,8,9,7,8,7,39
191213174,5,3,3,8,4,23
191213175,8,0,5,9,4,26
191213176,4,4,3,4,9,24
191213177,3,5,4,8,9,29
191213178,8,3,4,0,3,18
191213179,5,5,4,2,5,21
191213180,7,7,5,8,3,30
191213181,3,2,1,7,5,18
191213182,4,1,4,1,7,17
191213183,3,1,5,2,8,19
191213184,8,6,2,5,7,28
191213185,3,6,7,4,6,26
191213186,4,0,0,1,0,5
191213187,5,3,7,5,6,26
191213188,2,3,5,4,7,21
191213189,4,0,6,1,9,20
191213190,9,3,4,7,0,23
191213191,9,6,6,7,1,29
191213192,3,1,4,8,9,25
191213193,9,3,9,8,5,34
191213194,8,8,8,1,2,27
191213195,1,1,6,6,8,22
191213196,6,9,8,4,4,31
191213197,2,8,3,7,1,21
191213198,3,1,8,6,0,18
191213199,9,6,0,9,1,25
191213200,4,6,8,0,4,22
191213201,5,2,1,2,9,19
191213202,8,3,9,2,7,29
191213203,9,2,1,3,6,21
191213204,9,5,0,5,4,23
191213205,1,8,0,7,8,24
191213206,2,7,8,8,7,32
191213207,8,0,3,9,6,26
191213208,2,6,8,2,5,23
191213209,9,8,7,4,5,33
191213210,5,7,6,8,6,32
191213211,4,1,0,1,7,13
191213212,8,5,3,5,7,28
191213213,0,8,3,6,4,21
191213214,5,4,9,7,8,33
191213215,5,1,6,0,5,17
191213216,9,6,9,0,3,27
191213217,2,2,2,8,3,17
191213218,3,4,0,8,7,22
191213219,4,2,0,9,1,16
191213220,3,7,5,8,0,23
191213221,3,5,9,2,4,23
191213222,1,1,4,9,3,18
191213223,2,1,8,5,9,25
191213224,8,2,4,7,5,26
191213225,6,6,9,1,5,27
191213226,3,1,9,8,4,25
191213227,5,6,0,9,8,28
191213228,9,2,9,3,5,28
191213229,7,3,1,2,9,22
191213230,6,7,9,4,4,30
191213231,8,6,9,5,4,32
191213232,5,3,4,3,1,16
191213233,3,6,4,2,1,16
191213234,1,9,7,7,4,28
191213235,1,1,7,3,3,15
191213236,0,8,3,2,4,17
191213237,1,1,0,9,9,20
191213238,2,2,3,4,9,20
191213239,1,3,4,2,5,15
191213240,8,0,1,5,5,19
191213241,4,5,2,8,0,19
191213242,6,6,0,2,1,15
191213243,9,6,4,5,8,32
191213244,7,5,8,5,8,33
191213245,3,7,8,4,5,27
191213246,5,2,5,9,1,22
191213247,4,3,2,9,1,19
191213248,6,5,5,0,7,23
191213249,1,0,8,1,2,12
191213250,0,5,2,5,7,19
191213251,9,7,6,0,9,31
191213252,5,2,8,1,6,22
191213253,8,0,5,8,9,30
191213254,7,4,0,2,7,20
191213255,3,8,9,2,0,22
191213256,2,5,6,6,0,19
191213257,5,7,9,4,7,32
191213258,9,4,5,3,6,27
191213259,0,9,1,7,5,22
191213260,3,9,2,6,7,27
191213261,8,0,0,8,6,22
191213262,8,0,2,6,1,17
191213263,8,1,0,1,7,17
191213264,8,6,7,5,0,26
191213265,9,0,0,2,2,13
191213266,1,7,5,8,9,30
191213267,2,0,2,6,3,13
191213268,0,7,0,4,2,13
191213269,7,1,7,6,3,24
191213270,8,5,5,3,1,22
191213271,0,8,7,7,4,26
191213272,7,6,8,2,5,28
191213273,1,5,9,9,4,28
191213274,5,2,9,6,6,28
191213275,5,5,1,0,7,18
191213276,1,9,6,1,4,21
191213277,6,9,5,9,7,36
191213278,7,9,8,7,9,40
191213279,1,9,2,2,9,23
191213280,7,4,9,8,1,29
191213281,2,0,0,4,1,7
191213282,2,8,9,8,3,30
191213283,2,2,4,9,8,25
191213284,5,3,5,3,8,24
191213285,4,4,0,5,6,19
191213286,2,4,7,1,8,22
191213287,7,4,3,7,3,24
191213288,6,8,6,2,7,29
191213289,4,8,7,6,4,29
191213290,5,5,9,6,4,29
191213291,5,1,9,8,4,27
191213292,6,7,5,8,3,29
191213293,3,0,3,6,6,18
191213294,3,6,6,2,1,18
191213295,2,7,7,7,2,25
191213296,9,4,5,6,8,32
191213297,8,8,0,1,3,20
191213298,0,0,8,9,9,26
191213299,2,9,4,3,9,27
191213300,1,5,3,5,4,18
191213301,5,3,9,9,8,34
191213302,5,0,3,5,6,19
191213303,1,6,1,2,8,18
191213304,4,0,3,1,0,8
191213305,0,1,0,3,9,13
191213306,8,4,7,3,4,26
191213307,1,2,4,2,2,11
191213308,8,4,5,7,0,24
191213309,6,5,4,3,6,24
191213310,8,2,7,0,1,18
191213311,5,1,1,2,5,14
191213312,8,9,2,5,7,31
191213313,3,5,8,7,9,32
191213314,3,8,3,1,5,20
191213315,3,2,1,2,5,13
191213316,6,0,6,1,6,19
191213317,9,2,9,6,9,35
191213318,2,2,3,7,2,16
191213319,0,1,1,7,9,18
191213320,9,4,8,8,2,31
191213321,2,2,7,0,7,18
191213322,5,6,1,7,7,26
191213323,3,4,3,2,8,20
191213324,5,1,2,0,3,11
191213325,0,6,7,6,2,21
191213326,5,9,9,4,3,30
191213327,8,8,1,3,4,24
191213328,2,1,7,5,2,17
191213329,0,8,0,1,4,13
191213330,0,6,4,3,9,22
191213331,0,6,2,6,4,18
191213332,3,3,5,7,4,22
191213333,3,1,3,2,4,13
191213334,0,3,1,5,6,15
191213335,1,5,4,2,3,15
191213336,9,3,9,2,9,32
191213337,3,5,9,5,6,28
191213338,7,4,4,9,3,27
191213339,7,3,5,9,1,25
191213340,3,5,2,5,6,21
191213341,1,4,9,2,5,21
191213342,4,6,5,4,0,19
191213343,0,5,4,8,2,19
191213344,1,2,4,1,0,8
191213345,1,6,9,2,5,23
191213346,1,2,6,0,0,9
191213347,5,6,1,1,9,22
191213348,6,3,3,8,7,27
191213349,9,0,9,2,4,24
191213350,5,1,1,7,0,14
191213351,6,5,6,5,7,29
191213352,1,1,9,1,0,12
191213353,8,9,0,8,2,27
191213354,8,0,0,2,2,12
191213355,3,9,3,5,0,20
191213356,4,4,5,2,7,22
191213357,8,7,9,4,6,34
191213358,2,8,9,0,6,25
191213359,4,9,4,2,5,24
191213360,6,5,1,0,2,14
191213361,4,1,5,1,9,20
191213362,9,0,7,0,7,23
191213363,6,7,6,9,4,32
191213364,6,7,2,4,4,23
191213365,0,4,1,5,9,19
191213366,8,8,8,4,2,30
191213367,0,0,6,3,3,12
191213368,0,8,5,0,7,20
191213369,4,6,1,6,2,19
191213370,8,3,3,7,5,26
191213371,6,9,2,0,5,22
191213372,4,3,6,3,2,18
191213373,9,1,3,8,6,27
191213374,6,8,4,3,5,26
191213375,2,9,6,2,0,19
191213376,4,8,8,5,8,33
191213377,6,4,0,2,1,13
191213378,6,8,2,5,8,29
191213379,0,2,1,3,5,11
191213380,1,0,4,5,1,11
191213381,1,7,0,1,2,11
191213382,7,3,0,3,0,13
191213383,4,4,3,8,0,19
191213384,7,2,1,2,4,16
191213385,1,4,9,8,4,26
191213386,6,8,6,3,1,24
191213387,2,7,2,3,2,16
191213388,8,9,4,0,4,25
191213389,7,2,4,6,2,21
191213390,1,1,7,8,0,17
191213391,9,8,6,7,6,36
191213392,3,3,6,8,4,24
191213393,5,5,7,7,0,24
191213394,1,8,8,7,8,32
191213395,9,8,0,6,4,27
191213396,6,0,3,5,3,17
191213397,0,6,3,2,2,13
191213398,1,0,2,6,9,18
191213399,2,3,3,9,1,18
191213400,7,7,4,3,3,24
191213401,4,7,4,7,7,29
191213402,5,2,7,6,8,28
191213403,9,6,3,3,0,21
191213404,1,9,0,3,6,19
191213405,5,2,6,6,8,27
191213406,1,4,5,9,4,23
191213407,9,6,9,7,7,38
191213408,6,6,9,7,6,34
191213409,0,5,6,1,6,18
191213410,0,6,7,7,4,24
191213411,3,5,3,8,3,22
191213412,1,4,5,3,4,17
191213413,9,7,3,1,9,29
191213414,2,4,2,8,4,20
191213415,3,1,6,0,7,17
191213416,0,9,4,6,3,22
191213417,6,2,4,0,0,12
191213418,1,2,9,3,8,23
191213419,4,5,1,8,6,24
191213420,7,6,0,1,0,14
191213421,5,0,8,1,5,19
191213422,8,3,1,3,4,19
191213423,7,0,8,6,7,28
191213424,6,6,1,4,8,25
191213425,2,3,9,5,9,28
191213426,8,9,0,6,3,26
191213427,3,4,2,4,9,22
191213428,6,2,2,0,3,13
191213429,9,7,7,0,3,26
191213430,2,1,6,0,3,12
191213431,2,3,2,3,2,12
191213432,4,8,6,3,4,25
191213433,3,8,9,4,1,25
191213434,4,2,1,1,9,17
191213435,0,7,3,9,4,23
191213436,6,1,4,5,3,19
191213437,7,5,7,1,7,27
191213438,7,4,2,7,5,25
191213439,7,4,4,6,4,25
191213440,7,0,3,2,6,18
191213441,0,0,9,6,4,19
191213442,1,2,5,3,5,16
191213443,3,3,6,9,3,24
191213444,6,3,2,0,7,18
191213445,8,3,0,9,2,22
191213446,2,1,2,7,1,13
191213447,7,5,3,9,1,25
191213448,6,0,1,8,0,15
191213449,4,8,6,2,5,25
191213450,8,5,8,8,1,30
191213451,4,6,4,8,3,25
191213452,3,1,0,1,6,11
191213453,4,5,7,4,7,27
191213454,3,3,6,1,1,14
191213455,1,4,2,1,7,15
191213456,0,3,8,6,5,22
191213457,0,1,0,5,8,14
191213458,6,5,5,7,7,30
191213459,8,1,3,7,2,21
191213460,0,8,1,0,0,9
191213461,8,7,2,3,1,21
191213462,2,1,6,8,2,19
191213463,0,5,2,6,5,18
191213464,1,2,1,8,3,15
191213465,2,6,7,7,6,28
191213466,3,9,4,0,9,25
191213467,2,1,4,7,5,19
191213468,0,2,4,0,5,11
191213469,2,4,4,7,4,21
191213470,1,9,4,1,6,21
191213471,5,2,2,5,0,14
191213472,7,1,8,2,8,26
191213473,6,4,1,7,7,25
191213474,3,3,9,0,8,23
191213475,1,6,8,7,5,27
191213476,6,7,3,2,3,21
191213477,3,1,0,1,8,13
191213478,3,0,1,9,9,22
191213479,9,2,2,7,6,26
191213480,0,9,8,2,1,20
191213481,5,3,8,1,7,24
191213482,6,3,4,1,0,14
191213483,8,8,4,0,6,26
191213484,3,0,5,7,1,16
191213485,4,9,4,4,5,26
191213486,1,9,1,8,9,28
191213487,7,9,5,8,6,35
191213488,2,9,0,3,5,19
191213489,3,9,1,4,4,21
191213490,2,0,0,5,4,11
191213491,7,3,8,6,0,24
191213492,7,6,4,5,6,28
191213493,9,8,7,5,3,32
191213494,8,7,7,9,6,37
191213495,9,8,8,3,4,32
191213496,7,8,5,9,5,34
191213497,7,0,9,8,1,25
191213498,8,2,7,4,7,28
191213499,5,4,8,8,0,25
191213500,2,5,2,2,0,11
191213501,4,4,8,5,9,30
191213502,5,2,3,6,5,21
191213503,0,5,5,2,3,15
191213504,8,0,1,5,2,16
191213505,2,7,9,1,6,25
191213506,9,2,8,1,1,21
191213507,5,4,1,8,8,26
191213508,8,8,4,9,6,35
191213509,5,9,3,8,7,32
191213510,1,7,7,6,0,21
191213511,0,4,6,9,4,23
191213512,9,3,4,2,1,19
191213513,9,1,9,9,8,36
191213514,5,2,9,3,0,19
191213515,0,4,1,3,8,16
191213516,6,9,3,0,4,22
191213517,6,2,9,4,9,30
191213518,7,4,9,9,5,34
191213519,4,0,1,8,8,21
191213520,7,7,9,6,2,31
191213521,4,4,2,6,6,22
191213522,6,8,5,8,6,33
191213523,1,7,7,5,4,24
191213524,3,2,4,9,6,24
191213525,0,5,0,6,3,14
191213526,8,4,7,7,4,30
191213527,7,6,6,4,2,25
191213528,9,1,0,6,9,25
191213529,8,7,2,0,5,22
191213530,2,2,0,6,3,13
191213531,7,3,6,2,6,24
191213532,5,9,5,8,3,30
191213533,0,2,3,2,1,8
191213534,2,0,7,5,3,17
191213535,9,2,2,0,4,17
191213536,2,5,7,1,8,23
191213537,7,6,4,2,2,21
191213538,9,5,1,2,4,21
191213539,5,4,9,7,3,28
191213540,3,2,4,9,3,21
191213541,6,3,9,0,0,18
191213542,7,3,8,1,3,22
191213543,6,6,8,7,1,28
191213544,1,1,2,6,4,14
191213545,1,6,1,8,6,22
191213546,5,9,9,0,6,29
191213547,5,2,8,1,7,23
191213548,9,5,2,5,2,23
191213549,6,6,2,9,2,25
191213550,4,6,7,3,0,20
191213551,0,9,1,3,0,13
191213552,5,6,2,0,9,22
191213553,5,4,0,4,9,22
191213554,4,5,0,1,9,19
191213555,8,2,9,0,4,23
191213556,6,4,3,1,3,17
191213557,4,6,9,4,3,26
191213558,5,5,6,3,1,20
191213559,6,9,4,7,8,34
191213560,3,4,5,4,1,17
191213561,5,5,4,7,2,23
191213562,1,3,4,0,5,13
191213563,4,2,5,7,2,20
191213564,5,1,6,7,4,23
191213565,3,8,5,5,4,25
191213566,9,8,3,1,9,30
191213567,2,8,4,1,7,22
191213568,8,8,6,3,4,29
191213569,0,8,5,6,6,25
191213570,9,7,3,4,0,23
191213571,0,7,6,0,6,19
191213572,2,3,3,5,7,20
191213573,1,6,0,8,6,21
191213574,7,0,2,0,7,16
191213575,3,7,6,5,3,24
191213576,2,6,4,2,4,18
191213577,4,5,5,2,3,19
191213578,6,7,3,4,0,20
191213579,5,9,6,5,6,31
191213580,3,9,9,3,1,25
191213581,4,1,2,0,5,12
191213582,2,9,8,0,0,19
191213583,4,4,2,8,1,19
191213584,7,6,8,3,3,27
191213585,1,5,7,4,8,25
191213586,9,1,9,2,3,24
191213587,4,9,2,7,2,24
191213588,0,7,6,6,4,23
191213589,3,4,0,8,1,16
191213590,0,4,9,4,5,22
191213591,0,0,2,0,2,4
191213592,8,0,2,9,8,27
191213593,6,5,3,7,4,25
191213594,6,9,8,7,0,30
191213595,6,8,7,2,2,25
191213596,7,5,6,4,4,26
191213597,5,4,0,2,7,18
191213598,1,0,6,5,2,14
191213599,1,0,1,3,1,6
191213600,0,4,8,5,6,23
191213601,7,2,5,9,3,26
191213602,0,9,7,7,2,25
191213603,1,5,6,6,4,22
191213604,3,7,6,8,3,27
191213605,8,7,3,0,1,19
191213606,2,0,8,7,2,19
191213607,9,8,6,7,2,32
191213608,6,7,7,8,1,29
191213609,2,4,7,8,2,23
191213610,5,9,8,1,9,32
191213611,1,0,6,0,6,13
191213612,7,9,9,4,9,38
191213613,6,3,3,4,0,16
191213614,5,9,3,5,4,26
191213615,7,6,4,4,5,26
191213616,9,6,9,7,5,36
191213617,9,1,6,7,5,28
191213618,9,9,2,1,0,21
191213619,7,1,1,2,9,20
191213620,4,9,7,1,5,26
191213621,2,4,2,3,1,12
191213622,7,2,7,3,0,19
191213623,2,2,4,6,9,23
191213624,2,0,4,5,7,18
191213625,0,1,2,6,6,15
191213626,8,9,7,5,6,35
191213627,1,5,4,4,6,20
191213628,9,5,7,7,1,29
191213629,1,0,2,6,8,17
191213630,8,8,0,8,5,29
191213631,8,5,0,7,8,28
191213632,5,1,1,2,8,17
191213633,1,0,2,4,3,10
191213634,9,5,2,5,4,25
191213635,7,9,0,7,3,26
191213636,3,1,8,8,0,20
191213637,4,9,5,7,1,26
191213638,6,3,2,4,0,15
191213639,6,5,9,1,5,26
191213640,8,5,1,0,2,16
191213641,6,5,1,5,4,21
191213642,6,1,6,0,5,18
191213643,1,7,8,6,7,29
191213644,5,0,2,2,6,15
191213645,5,1,4,5,2,17
191213646,2,0,7,1,7,17
191213647,6,8,0,3,7,24
191213648,5,8,3,2,7,25
191213649,7,4,9,9,2,31
191213650,0,3,2,9,4,18
191213651,1,5,4,1,4,15
191213652,1,7,5,3,0,16
191213653,1,2,1,3,8,15
191213654,4,1,9,9,4,27
191213655,5,4,6,5,2,22
191213656,9,3,4,0,6,22
191213657,6,9,3,8,1,27
191213658,0,7,3,9,3,22
191213659,1,6,0,8,8,23
191213660,2,4,4,9,4,23
191213661,4,2,1,9,0,16
191213662,4,0,6,7,7,24
191213663,4,0,2,2,0,8
191213664,9,1,7,0,9,26
191213665,1,2,8,2,3,16
191213666,6,0,8,4,0,18
191213667,3,7,5,7,2,24
191213668,1,7,1,7,3,19
191213669,9,1,9,9,7,35
191213670,2,2,1,3,8,16
191213671,0,5,0,2,9,16
191213672,1,0,4,6,1,12
191213673,6,1,8,6,6,27
191213674,2,9,6,8,0,25
191213675,3,9,0,2,5,19
191213676,9,0,3,8,5,25
191213677,1,1,0,7,0,9
191213678,2,3,2,2,7,16
191213679,3,2,5,7,3,20
191213680,0,0,7,1,3,11
191213681,6,7,0,8,9,30
191213682,0,3,6,5,6,20
191213683,7,7,4,0,3,21
191213684,1,8,0,6,6,21
191213685,9,7,1,5,5,27
191213686,1,4,5,3,1,14
191213687,7,9,5,2,3,26
191213688,6,5,9,3,5,28
191213689,4,2,5,8,9,28
191213690,3,6,5,2,3,19
191213691,2,6,9,5,1,23
191213692,2,0,3,0,8,13
191213693,3,3,3,6,8,23
191213694,3,4,1,8,0,16
191213695,3,5,4,6,7,25
191213696,4,9,9,8,5,35
191213697,8,4,5,7,6,30
191213698,7,2,5,8,6,28
191213699,0,5,8,4,4,21
191213700,7,1,1,2,1,12
191213701,8,0,1,1,8,18
191213702,7,7,2,2,1,19
191213703,1,4,2,4,2,13
191213704,9,7,8,5,4,33
191213705,5,3,3,4,3,18
191213706,7,2,8,9,1,27
191213707,9,7,8,2,4,30
191213708,7,3,4,8,2,24
191213709,1,8,7,7,6,29
191213710,5,1,3,9,9,27
191213711,9,1,3,1,4,18
191213712,4,1,1,2,4,12
191213713,1,2,1,0,5,9
191213714,7,3,8,8,2,28
191213715,6,8,2,2,1,19
191213716,7,5,0,7,5,24
191213717,6,7,5,4,5,27
191213718,7,5,0,7,2,21
191213719,6,7,3,7,0,23
191213720,1,1,6,0,8,16
191213721,1,5,5,7,8,26
191213722,1,0,2,0,2,5
191213723,4,2,0,2,8,16
191213724,2,9,7,4,7,29
191213725,0,8,0,2,4,14
191213726,4,2,0,5,9,20
191213727,4,3,1,5,9,22
191213728,8,1,8,8,9,34
191213729,2,0,8,3,1,14
191213730,9,9,1,6,6,31
191213731,4,0,4,5,8,21
191213732,3,2,4,4,9,22
191213733,7,4,1,6,4,22
191213734,9,2,0,5,4,20
191213735,8,8,1,4,6,27
191213736,6,6,2,0,8,22
191213737,2,2,0,7,8,19
191213738,1,9,9,1,9,29
191213739,7,8,7,7,1,30
191213740,6,7,7,7,3,30
191213741,4,0,9,0,2,15
191213742,1,3,8,2,1,15
191213743,8,7,4,4,7,30
191213744,1,2,7,1,1,12
191213745,9,5,7,6,2,29
191213746,5,0,5,2,9,21
191213747,7,9,7,7,8,38
191213748,4,1,1,3,6,15
191213749,8,0,1,5,7,21
191213750,3,3,2,8,5,21
191213751,3,2,2,5,0,12
191213752,9,1,6,7,2,25
191213753,7,3,7,3,2,22
191213754,8,7,1,5,0,21
191213755,9,4,6,6,4,29
191213756,0,6,0,8,0,14
191213757,0,5,0,2,2,9
191213758,9,7,2,1,5,24
191213759,5,5,1,7,1,19
191213760,5,1,8,2,4,20
191213761,1,4,7,4,5,21
191213762,5,6,9,2,4,26
191213763,2,3,4,1,5,15
191213764,2,9,6,4,3,24
191213765,8,6,7,1,8,30
191213766,0,0,5,9,9,23
191213767,9,8,6,0,5,28
191213768,3,3,8,2,5,21
191213769,6,0,0,7,5,18
191213770,4,4,8,1,9,26
191213771,5,5,7,7,1,25
191213772,7,3,3,4,8,25
191213773,8,6,1,9,2,26
191213774,8,5,9,6,1,29
191213775,7,7,2,6,0,22
191213776,2,7,6,5,5,25
191213777,4,1,8,0,3,16
191213778,1,4,1,2,4,12
191213779,1,9,4,2,7,23
191213780,7,5,1,2,5,20
191213781,0,2,9,5,6,22
191213782,7,6,9,8,2,32
191213783,0,7,3,8,6,24
191213784,2,8,2,2,7,21
191213785,9,9,9,6,7,40
191213786,2,8,9,2,8,29
191213787,8,3,1,6,0,18
191213788,2,5,4,8,0,19
191213789,8,3,0,8,9,28
191213790,6,2,6,3,5,22
191213791,2,4,9,9,2,26
191213792,1,8,4,7,8,28
191213793,2,9,5,1,1,18
191213794,6,9,1,7,2,25
191213795,7,0,8,5,0,20
191213796,2,0,5,7,8,22
191213797,7,3,4,6,0,20
191213798,3,7,7,2,4,23
191213799,6,2,5,0,7,20
191213800,5,4,0,4,6,19
191213801,5,1,3,7,2,18
191213802,6,7,1,8,8,30
191213803,0,8,3,3,4,18
191213804,6,3,1,2,4,16
191213805,3,2,6,1,8,20
191213806,0,7,6,7,3,23
191213807,1,3,9,9,5,27
191213808,9,1,4,9,9,32
191213809,3,4,9,3,6,25
191213810,3,1,1,0,6,11
191213811,6,3,8,7,1,25
191213812,4,9,6,0,9,28
191213813,5,3,9,8,5,30
191213814,8,9,1,9,1,28
191213815,8,0,0,5,7,20
191213816,6,3,1,9,7,26
191213817,2,1,5,3,9,20
191213818,3,7,3,1,3,17
191213819,2,9,1,7,0,19
191213820,6,0,2,0,5,13
191213821,6,3,1,3,6,19
191213822,5,9,5,6,5,30
191213823,6,8,8,4,2,28
191213824,2,8,2,4,3,19
191213825,1,5,0,9,0,15
191213826,9,2,1,7,8,27
191213827,4,4,9,3,6,26
191213828,1,3,7,9,1,21
191213829,3,1,0,6,2,12
191213830,2,7,4,9,6,28
191213831,5,6,5,2,3,21
191213832,7,4,5,9,3,28
191213833,6,1,6,4,1,18
191213834,2,5,2,3,5,17
191213835,8,4,1,0,1,14
191213836,1,9,9,3,0,22
191213837,5,4,0,4,7,20
191213838,2,3,1,2,9,17
191213839,2,4,6,9,5,26
191213840,9,1,9,3,0,22
191213841,7,2,6,7,3,25
191213842,7,7,6,4,8,32
191213843,5,5,4,4,2,20
191213844,0,2,7,7,8,24
191213845,2,3,4,7,7,23
191213846,7,7,0,1,7,22
191213847,9,8,0,9,9,35
191213848,0,8,6,6,2,22
191213849,3,0,6,9,9,27
191213850,7,7,4,8,6,32
191213851,8,1,9,1,6,25
191213852,5,3,4,6,2,20
191213853,2,9,2,8,7,28
191213854,8,4,7,7,2,28
191213855,6,1,5,1,2,15
191213856,8,7,0,1,5,21
191213857,9,1,1,4,0,15
191213858,3,3,4,6,7,23
191213859,6,1,6,7,3,23
191213860,0,2,7,2,9,20
191213861,6,7,4,9,6,32
191213862,2,4,5,7,2,20
191213863,3,5,6,7,1,22
191213864,4,6,7,1,2,20
191213865,3,4,7,4,9,27
191213866,8,4,7,9,5,33
191213867,9,1,8,7,7,32
191213868,8,7,7,1,7,30
191213869,6,8,8,7,4,33
191213870,1,8,3,6,7,25
191213871,7,6,8,1,5,27
191213872,8,3,3,4,1,19
191213873,8,0,7,9,9,33
191213874,4,5,9,9,1,28
191213875,1,3,8,5,0,17
191213876,2,1,6,4,4,17
191213877,8,1,1,9,6,25
191213878,4,1,5,1,4,15
191213879,3,8,8,2,5,26
191213880,1,4,3,9,6,23
191213881,8,4,9,2,4,27
191213882,5,0,4,5,1,15
191213883,5,6,9,6,8,34
191213884,1,6,0,7,5,19
191213885,0,2,7,7,7,23
191213886,8,2,2,7,6,25
191213887,4,5,0,8,4,21
191213888,8,8,8,2,7,33
191213889,9,0,9,5,2,25
191213890,5,4,3,0,4,16
191213891,5,6,5,9,4,29
191213892,0,3,2,2,5,12
191213893,4,1,9,1,4,19
191213894,6,5,3,2,9,25
191213895,1,1,3,0,4,9
191213896,2,5,7,5,7,26
191213897,2,3,6,2,0,13
191213898,7,0,9,7,0,23
191213899,8,7,6,0,6,27
191213900,8,6,0,0,6,20
191213901,6,3,9,8,0,26
191213902,7,1,0,1,8,17
191213903,6,8,8,8,7,37
191213904,2,0,8,7,1,18
191213905,9,3,7,9,1,29
191213906,5,3,9,1,1,19
191213907,4,2,9,3,0,18
191213908,6,5,0,1,6,18
191213909,8,2,6,7,1,24
191213910,6,1,3,4,1,15
191213911,3,4,9,6,9,31
191213912,9,6,7,4,2,28
191213913,4,2,7,1,7,21
191213914,3,4,1,8,8,24
191213915,2,2,4,0,9,17
191213916,3,2,4,6,7,22
191213917,5,2,4,8,4,23
191213918,1,1,5,5,1,13
191213919,5,7,6,4,2,24
191213920,5,6,1,2,2,16
191213921,2,1,9,9,5,26
191213922,2,5,7,5,9,28
191213923,8,4,0,0,3,15
191213924,2,7,9,4,7,29
191213925,7,5,7,8,8,35
191213926,6,3,2,7,1,19
191213927,9,7,9,6,8,39
191213928,4,6,9,3,1,23
191213929,9,6,9,9,4,37
191213930,6,0,9,5,7,27
191213931,9,0,4,9,1,23
191213932,2,5,1,0,5,13
191213933,2,5,7,0,9,23
191213934,3,1,9,9,5,27
191213935,3,8,3,7,7,28
191213936,6,1,6,7,9,29
191213937,3,5,6,4,7,25
191213938,6,7,2,5,8,28
191213939,3,7,3,7,3,23
191213940,0,1,8,7,4,20
191213941,7,2,0,1,6,16
191213942,9,2,9,3,2,25
191213943,6,4,9,1,3,23
191213944,1,2,9,7,6,25
191213945,5,7,8,2,4,26
191213946,6,6,4,5,4,25
191213947,4,8,4,6,0,22
191213948,2,4,7,4,4,21
191213949,0,8,5,3,5,21
191213950,6,7,8,8,6,35
191213951,0,6,6,2,4,18
191213952,3,9,4,1,0,17
191213953,7,3,5,8,3,26
191213954,2,6,2,7,9,26
191213955,2,1,2,1,0,6
191213956,8,3,8,8,2,29
191213957,5,3,3,0,9,20
191213958,6,1,5,2,1,15
191213959,2,4,0,8,6,20
191213960,8,5,4,8,9,34
191213961,0,6,3,1,9,19
191213962,7,0,1,1,7,16
191213963,6,9,6,8,5,34
191213964,7,6,1,4,2,20
191213965,1,9,0,3,0,13
191213966,5,1,2,4,8,20
191213967,2,4,3,2,4,15
191213968,2,7,4,0,0,13
191213969,4,8,7,7,3,29
191213970,1,4,0,3,6,14
191213971,9,2,0,4,5,20
191213972,2,8,9,1,2,22
191213973,6,2,1,3,2,14
191213974,5,3,7,7,9,31
191213975,5,8,4,7,3,27
191213976,3,2,5,3,1,14
191213977,8,5,2,7,4,26
191213978,9,9,7,5,8,38
191213979,8,8,5,7,4,32
191213980,9,6,6,1,9,31
191213981,2,0,4,5,6,17
191213982,4,5,7,6,0,22
191213983,7,2,0,6,4,19
191213984,1,6,7,6,7,27
191213985,4,5,4,9,2,24
191213986,8,3,3,5,8,27
191213987,2,5,0,4,6,17
191213988,9,7,8,5,9,38
191213989,8,9,3,3,7,30
191213990,1,2,8,9,6,26
191213991,4,9,8,2,9,32
191213992,8,4,7,0,4,23
191213993,5,9,2,5,9,30
191213994,4,9,1,1,8,23
191213995,5,0,5,0,1,11
191213996,3,3,7,3,7,23
191213997,1,1,8,6,9,25
191213998,1,2,8,0,7,18
191213999,6,0,5,5,9,25
1912131000,9,1,5,8,7,30
1912131001,0,8,7,4,5,24
1912131002,2,7,8,4,5,26
1912131003,8,6,3,3,2,22
1912131004,5,3,8,6,9,31
1912131005,1,7,3,5,4,20
1912131006,0,3,9,3,8,23
1912131007,6,5,2,8,0,21
1912131008,1,0,7,6,5,19
1912131009,2,6,0,8,2,18
1912131010,1,7,4,2,8,22
1912131011,4,2,9,0,7,22
1912131012,4,5,4,7,5,25
1912131013,0,7,6,8,2,23
1912131014,7,9,2,7,3,28
1912131015,1,2,4,5,6,18
1912131016,0,1,4,0,9,14
1912131017,0,8,3,3,3,17
1912131018,9,6,4,0,5,24
1912131019,7,0,2,2,9,20
1912131020,6,2,0,0,9,17
1912131021,3,6,1,0,3,13
1912131022,9,9,3,0,2,23
1912131023,3,5,7,9,1,25
1912131024,0,0,6,9,9,24
1912131025,2,2,2,8,4,18
1912131026,0,0,6,6,8,20
1912131027,9,2,7,0,7,25
1912131028,6,6,9,5,7,33
1912131029,3,7,9,6,9,34
1912131030,9,9,8,8,2,36
1912131031,9,5,8,5,7,34
1912131032,2,1,6,1,3,13
1912131033,8,5,7,0,8,28
1912131034,9,6,0,4,9,28
1912131035,3,5,6,8,9,31
1912131036,2,0,9,3,8,22
1912131037,3,8,7,7,4,29
1912131038,3,9,7,6,8,33
1912131039,5,1,9,5,8,28
1912131040,0,7,1,8,4,20
1912131041,2,8,7,0,6,23
1912131042,2,9,0,0,4,15
1912131043,9,4,8,8,7,36
1912131044,4,2,4,0,9,19
1912131045,9,3,1,3,9,25
1912131046,3,7,7,8,3,28
1912131047,3,6,7,9,8,33
1912131048,2,6,4,2,7,21
1912131049,4,4,2,9,9,28
1912131050,4,3,4,6,7,24
1912131051,8,7,0,1,7,23
1912131052,1,1,7,2,9,20
1912131053,6,2,3,3,1,15
1912131054,5,1,6,5,3,20
1912131055,6,6,8,4,2,26
1912131056,9,4,9,3,0,25
1912131057,9,0,0,8,4,21
1912131058,2,0,6,5,9,22
1912131059,5,5,0,0,7,17
1912131060,2,9,3,4,7,25
1912131061,5,8,3,5,3,24
1912131062,6,4,5,3,3,21
1912131063,2,3,5,3,7,20
1912131064,2,7,1,8,1,19
1912131065,7,1,9,7,0,24
1912131066,6,8,8,5,0,27
1912131067,3,8,5,0,7,23
1912131068,5,7,3,7,0,22
1912131069,2,0,0,8,0,10
1912131070,2,5,6,1,4,18
1912131071,1,4,3,8,5,21
1912131072,4,4,6,1,3,18
1912131073,5,2,2,8,4,21
1912131074,2,7,0,9,1,19
1912131075,3,6,6,3,7,25
1912131076,5,2,3,8,7,25
1912131077,5,5,1,8,8,27
1912131078,1,7,5,2,3,18
1912131079,3,5,1,9,5,23
1912131080,0,8,5,1,1,15
1912131081,6,2,5,0,6,19
1912131082,9,3,1,9,7,29
1912131083,4,4,4,8,9,29
1912131084,4,4,1,2,1,12
1912131085,6,0,7,8,6,27
1912131086,6,6,0,6,7,25
1912131087,3,8,6,1,4,22
1912131088,0,2,3,8,4,17
1912131089,1,7,4,9,5,26
1912131090,4,2,2,6,9,23
1912131091,9,5,1,0,0,15
1912131092,9,3,1,1,6,20
1912131093,1,3,0,6,6,16
1912131094,0,0,7,9,7,23
1912131095,6,5,5,5,9,30
1912131096,2,3,4,6,8,23
1912131097,6,6,5,3,7,27
1912131098,7,0,5,6,1,19
1912131099,9,0,4,1,9,23
1912131100,6,2,9,5,0,22
1912131101,4,1,5,0,6,16
1912131102,3,8,6,9,9,35
1912131103,1,1,1,6,8,17
1912131104,4,0,1,2,3,10
1912131105,3,6,9,8,7,33
191214001,6,4,0,9,9,28
191214002,0,7,7,3,7,24
191214003,3,6,0,6,8,23
191214004,0,3,2,2,3,10
191214005,0,9,2,3,3,17
191214006,8,2,3,1,5,19
191214007,4,7,1,2,8,22
191214008,3,0,3,4,1,11
191214009,4,5,1,9,4,23
191214010,7,6,9,1,4,27
191214011,6,9,6,1,2,24
191214012,2,1,5,0,1,9
191214013,4,6,0,0,3,13
191214014,1,5,4,8,2,20
191214015,5,3,6,8,3,25
191214016,8,8,1,1,7,25
191214017,9,4,0,9,9,31
191214018,8,6,1,1,4,20
191214019,0,3,6,8,9,26
191214020,3,3,8,5,1,20
191214021,0,9,8,1,3,21
191214022,0,1,5,4,6,16
191214023,1,2,4,8,7,22
191214024,4,2,1,9,6,22
191214025,3,1,0,1,9,14
191214026,4,7,6,4,6,27
191214027,4,9,8,0,6,27
191214028,4,1,7,8,5,25
191214029,5,3,5,4,0,17
191214030,6,5,3,3,9,26
191214031,9,7,5,5,0,26
191214032,2,9,7,5,8,31
191214033,4,7,9,5,9,34
191214034,0,0,7,6,1,14
191214035,3,3,2,5,0,13
191214036,4,7,4,3,6,24
191214037,6,4,3,8,1,22
191214038,0,4,8,7,0,19
191214039,2,1,3,1,2,9
191214040,6,7,2,5,6,26
191214041,2,5,0,6,3,16
191214042,1,9,1,7,5,23
191214043,0,5,6,3,0,14
191214044,7,1,0,7,0,15
191214045,8,5,3,8,5,29
191214046,6,9,4,5,8,32
191214047,5,5,5,9,7,31
191214048,3,4,0,0,0,7
191214049,0,0,1,7,9,17
191214050,5,4,1,6,4,20
191214051,5,8,2,7,2,24
191214052,3,7,8,6,2,26
191214053,3,6,2,1,1,13
191214054,4,3,8,8,9,32
191214055,1,3,9,8,6,27
191214056,3,5,6,7,4,25
191214057,9,7,3,7,1,27
191214058,7,8,6,2,3,26
191214059,0,7,1,7,7,22
191214060,1,3,2,7,5,18
191214061,4,4,3,0,5,16
191214062,2,2,0,9,3,16
191214063,1,9,3,2,0,15
191214064,6,9,6,9,9,39
191214065,2,6,2,9,5,24
191214066,5,1,1,6,2,15
191214067,9,6,8,8,0,31
191214068,1,3,2,7,4,17
191214069,0,0,4,8,5,17
191214070,0,3,5,6,6,20
191214071,7,2,5,3,6,23
191214072,0,3,7,3,9,22
191214073,3,0,1,5,4,13
191214074,7,4,5,8,0,24
191214075,4,5,2,2,8,21
191214076,0,2,4,1,5,12
191214077,1,9,3,3,6,22
191214078,3,2,1,4,4,14
191214079,8,0,9,2,7,26
191214080,4,1,0,2,3,10
191214081,8,6,2,2,2,20
191214082,8,7,2,3,2,22
191214083,4,5,8,3,3,23
191214084,1,5,5,3,6,20
191214085,4,7,4,5,6,26
191214086,6,8,5,3,7,29
191214087,1,6,1,7,7,22
191214088,8,5,9,9,2,33
191214089,0,1,9,1,0,11
191214090,5,8,5,3,7,28
191214091,6,6,7,9,2,30
191214092,2,5,3,4,6,20
191214093,5,9,2,7,0,23
191214094,2,1,1,2,8,14
191214095,5,7,2,7,7,28
191214096,5,5,8,4,9,31
191214097,9,3,3,0,4,19
191214098,4,3,2,7,2,18
191214099,6,9,0,8,1,24
191214100,6,5,6,3,6,26
191214101,1,5,1,5,1,13
191214102,4,0,2,8,0,14
191214103,2,4,6,2,2,16
191214104,9,2,0,2,0,13
191214105,0,8,9,5,3,25
191214106,6,7,6,5,6,30
191214107,1,9,4,5,7,26
191214108,4,1,9,2,7,23
191214109,1,4,0,4,3,12
191214110,4,2,2,9,7,24
191214111,1,7,0,0,6,14
191214112,0,0,4,0,4,8
191214113,3,5,6,0,2,16
191214114,9,9,8,0,0,26
191214115,8,9,9,5,6,37
191214116,3,7,4,3,6,23
191214117,4,4,5,6,0,19
191214118,3,5,4,9,5,26
191214119,9,0,8,5,2,24
191214120,3,2,0,4,6,15
191214121,1,6,3,1,4,15
191214122,1,7,8,0,5,21
191214123,9,9,6,2,6,32
191214124,2,3,0,1,1,7
191214125,6,6,5,3,3,23
191214126,5,5,0,0,9,19
191214127,3,0,2,2,2,9
191214128,6,5,8,8,5,32
191214129,9,2,3,4,1,19
191214130,8,7,1,4,4,24
191214131,4,1,9,7,2,23
191214132,1,0,4,4,0,9
191214133,4,6,2,0,0,12
191214134,5,6,3,8,8,30
191214135,9,6,1,8,8,32
191214136,6,2,4,9,7,28
191214137,8,8,4,1,1,22
191214138,5,9,7,2,5,28
191214139,9,4,0,7,8,28
191214140,2,0,6,2,2,12
191214141,4,3,3,4,1,15
191214142,0,5,5,5,1,16
191214143,5,6,3,2,3,19
191214144,3,1,5,6,1,16
191214145,5,7,4,9,5,30
191214146,5,7,1,8,1,22
191214147,9,3,5,5,5,27
191214148,4,5,3,6,2,20
191214149,4,3,5,0,7,19
191214150,7,2,9,3,6,27
191214151,7,1,7,4,7,26
191214152,0,1,3,3,8,15
191214153,3,4,7,8,7,29
191214154,6,3,4,2,7,22
191214155,9,0,9,9,8,35
191214156,8,7,5,6,4,30
191214157,0,3,6,2,1,12
191214158,5,3,0,8,6,22
191214159,7,7,7,3,9,33
191214160,3,6,3,4,4,20
191214161,1,9,6,8,1,25
191214162,9,4,0,9,6,28
191214163,1,6,0,1,6,14
191214164,1,7,3,1,3,15
191214165,1,3,6,6,0,16
191214166,7,2,7,5,8,29
191214167,0,6,5,6,2,19
191214168,2,7,7,1,6,23
191214169,0,8,4,6,2,20
191214170,9,5,3,5,4,26
191214171,5,6,2,2,6,21
191214172,9,1,2,9,9,30
191214173,5,4,4,0,3,16
191214174,1,8,5,3,4,21
191214175,6,8,2,3,9,28
191214176,1,8,9,2,3,23
191214177,6,9,5,8,5,33
191214178,0,3,5,5,9,22
191214179,5,8,0,2,8,23
191214180,5,7,0,0,6,18
191214181,0,3,2,9,8,22
191214182,9,7,4,0,0,20
191214183,0,7,7,8,0,22
191214184,0,9,4,9,4,26
191214185,6,6,8,9,6,35
191214186,6,1,7,5,4,23
191214187,6,7,8,5,5,31
191214188,5,9,7,1,1,23
191214189,3,6,5,3,3,20
191214190,9,9,1,0,4,23
191214191,0,7,6,4,8,25
191214192,2,4,9,7,1,23
191214193,6,4,0,4,6,20
191214194,2,2,9,8,7,28
191214195,2,9,6,8,9,34
191214196,3,8,4,0,9,24
191214197,3,0,9,2,3,17
191214198,6,9,2,0,8,25
191214199,7,5,9,2,4,27
191214200,6,8,6,3,3,26
191214201,4,9,7,8,1,29
191214202,6,1,9,1,4,21
191214203,9,4,3,6,8,30
191214204,4,6,9,8,0,27
191214205,6,1,1,0,1,9
191214206,7,9,2,6,6,30
191214207,0,8,6,5,9,28
191214208,5,6,3,6,0,20
191214209,6,0,6,9,5,26
191214210,8,9,6,7,2,32
191214211,5,4,2,7,4,22
191214212,1,6,3,7,9,26
191214213,6,7,1,1,9,24
191214214,8,3,5,1,7,24
191214215,4,1,4,4,2,15
191214216,7,8,6,4,7,32
191214217,1,8,5,8,9,31
191214218,1,7,7,5,5,25
191214219,9,8,8,6,3,34
191214220,5,5,1,2,6,19
191214221,5,4,1,6,8,24
191214222,7,1,2,4,8,22
191214223,2,6,3,4,1,16
191214224,7,4,2,2,5,20
191214225,8,1,7,6,3,25
191214226,3,2,0,9,5,19
191214227,9,5,4,6,6,30
191214228,5,0,0,2,2,9
191214229,7,1,5,8,1,22
191214230,3,8,0,8,1,20
191214231,6,1,9,3,6,25
191214232,9,8,7,3,4,31
191214233,1,0,5,1,8,15
191214234,9,3,2,8,4,26
191214235,5,8,3,5,4,25
191214236,1,1,2,3,6,13
191214237,2,2,7,8,6,25
191214238,7,3,8,7,9,34
191214239,6,9,0,9,3,27
191214240,6,1,4,8,7,26
191214241,8,4,2,7,5,26
191214242,2,6,0,6,4,18
191214243,8,4,9,7,4,32
191214244,0,8,2,4,7,21
191214245,4,9,4,3,8,28
191214246,5,7,0,1,7,20
191214247,0,4,3,2,6,15
191214248,8,5,4,4,0,21
191214249,0,8,5,2,1,16
191214250,1,8,8,7,4,28
191214251,5,5,7,6,9,32
191214252,2,5,1,1,6,15
191214253,5,3,0,4,5,17
191214254,2,4,1,4,5,16
191214255,3,3,3,3,1,13
191214256,8,5,0,9,7,29
191214257,2,1,6,0,0,9
191214258,3,2,4,2,6,17
191214259,0,7,9,2,9,27
191214260,8,1,9,6,4,28
191214261,5,0,9,7,8,29
191214262,2,1,7,2,4,16
191214263,5,9,6,4,7,31
191214264,9,9,4,0,7,29
191214265,7,2,0,8,1,18
191214266,8,6,2,7,5,28
191214267,0,7,7,3,4,21
191214268,6,3,4,9,0,22
191214269,3,4,4,2,2,15
191214270,7,6,9,1,7,30
191214271,4,0,8,2,6,20
191214272,4,5,5,9,5,28
191214273,3,5,8,6,7,29
191214274,3,8,2,2,3,18
191214275,2,5,1,1,8,17
191214276,7,0,3,1,4,15
191214277,1,7,4,9,9,30
191214278,9,2,1,5,2,19
191214279,7,9,4,8,4,32
191214280,2,6,9,9,2,28
191214281,1,8,2,3,9,23
191214282,0,8,9,4,4,25
191214283,9,1,9,5,6,30
191214284,5,9,9,2,5,30
191214285,4,2,4,4,9,23
191214286,6,1,9,3,1,20
191214287,8,2,6,4,6,26
191214288,8,3,2,8,4,25
191214289,5,8,7,2,3,25
191214290,3,6,3,2,9,23
191214291,5,9,9,7,8,38
191214292,2,7,3,6,9,27
191214293,9,2,7,3,5,26
191214294,2,9,0,6,6,23
191214295,8,7,0,5,1,21
191214296,8,8,3,4,0,23
191214297,2,4,7,1,9,23
191214298,1,4,5,3,0,13
191214299,7,5,5,1,8,26
191214300,4,6,8,5,5,28
191214301,6,9,7,0,2,24
191214302,4,2,6,5,2,19
191214303,6,1,8,1,3,19
191214304,2,7,2,0,2,13
191214305,1,5,6,7,1,20
191214306,8,1,3,4,2,18
191214307,1,7,9,9,8,34
191214308,4,8,5,6,8,31
191214309,4,3,4,4,7,22
191214310,0,7,3,3,1,14
191214311,3,6,4,7,9,29
191214312,6,7,4,3,9,29
191214313,1,7,1,1,0,10
191214314,6,9,9,5,1,30
191214315,7,1,0,7,2,17
191214316,6,7,7,3,5,28
191214317,5,6,4,6,0,21
191214318,7,3,0,8,4,22
191214319,3,8,1,3,4,19
191214320,7,6,2,8,5,28
191214321,8,7,7,2,9,33
191214322,1,1,9,7,5,23
191214323,2,8,7,3,3,23
191214324,9,3,1,4,9,26
191214325,1,0,5,6,9,21
191214326,5,3,4,7,0,19
191214327,9,2,9,1,5,26
191214328,0,2,0,9,5,16
191214329,1,7,6,3,4,21
191214330,3,6,1,9,9,28
191214331,1,4,2,1,4,12
191214332,4,5,2,3,5,19
191214333,3,2,7,4,8,24
191214334,0,0,9,4,6,19
191214335,0,4,3,6,6,19
191214336,4,9,8,9,1,31
191214337,3,9,3,6,2,23
191214338,7,6,7,2,0,22
191214339,6,8,5,7,8,34
191214340,3,3,5,7,0,18
191214341,1,5,6,7,3,22
191214342,6,0,1,5,3,15
191214343,5,1,4,2,8,20
191214344,4,4,0,8,0,16
191214345,7,8,4,7,4,30
191214346,6,4,0,5,3,18
191214347,1,7,7,4,2,21
191214348,2,5,3,5,0,15
191214349,8,1,2,0,2,13
191214350,5,4,0,9,9,27
191214351,9,0,6,9,1,25
191214352,5,2,8,5,1,21
191214353,4,8,0,7,8,27
191214354,4,1,8,1,0,14
191214355,5,7,6,0,5,23
191214356,7,7,7,7,9,37
191214357,4,2,0,5,7,18
191214358,0,5,0,5,6,16
191214359,3,0,7,0,8,18
191214360,9,6,4,5,0,24
191214361,7,8,6,5,0,26
191214362,1,7,5,4,8,25
191214363,2,6,4,8,2,22
191214364,7,6,4,3,2,22
191214365,4,4,3,8,4,23
191214366,2,7,6,3,6,24
191214367,1,9,4,9,0,23
191214368,7,4,2,9,3,25
191214369,0,7,4,5,5,21
191214370,9,5,2,4,4,24
191214371,6,2,3,0,9,20
191214372,6,7,8,6,9,36
191214373,2,7,0,4,8,21
191214374,9,4,1,9,6,29
191214375,0,9,5,1,3,18
191214376,8,2,4,5,6,25
191214377,4,1,8,2,4,19
191214378,8,2,4,1,8,23
191214379,6,4,7,3,6,26
191214380,7,5,2,5,0,19
191214381,1,6,4,8,0,19
191214382,9,2,9,9,7,36
191214383,9,1,5,9,1,25
191214384,4,7,7,5,2,25
191214385,1,8,9,8,9,35
191214386,2,9,1,7,6,25
191214387,4,0,4,9,6,23
191214388,3,1,7,1,5,17
191214389,3,9,8,9,6,35
191214390,6,3,9,3,0,21
191214391,2,4,4,2,8,20
191214392,7,2,3,9,6,27
191214393,4,1,1,8,8,22
191214394,5,5,6,0,1,17
191214395,3,0,2,1,6,12
191214396,0,3,1,9,2,15
191214397,7,5,7,8,2,29
191214398,7,4,6,9,5,31
191214399,9,8,5,3,0,25
191214400,7,1,1,6,3,18
191214401,8,0,6,8,6,28
191214402,2,5,1,4,9,21
191214403,2,0,4,9,3,18
191214404,7,1,2,4,9,23
191214405,3,9,8,0,0,20
191214406,6,0,3,1,2,12
191214407,1,1,3,9,5,19
191214408,7,4,1,9,9,30
191214409,3,2,2,7,4,18
191214410,9,6,7,0,3,25
191214411,7,2,1,6,4,20
191214412,5,9,5,8,4,31
191214413,9,1,3,6,6,25
191214414,1,8,4,4,8,25
191214415,1,8,2,4,9,24
191214416,3,5,8,3,5,24
191214417,6,8,2,6,9,31
191214418,0,3,2,3,1,9
191214419,2,3,1,3,9,18
191214420,9,7,3,5,2,26
191214421,2,6,2,3,3,16
191214422,7,3,2,7,4,23
191214423,1,0,4,7,8,20
191214424,4,2,0,4,8,18
191214425,6,0,5,1,9,21
191214426,3,8,3,7,9,30
191214427,0,4,5,3,7,19
191214428,8,4,7,7,8,34
191214429,6,2,4,2,3,17
191214430,2,8,3,1,6,20
191214431,6,6,1,2,2,17
191214432,4,1,8,4,0,17
191214433,0,0,1,6,7,14
191214434,7,4,5,2,4,22
191214435,8,8,8,8,9,41
191214436,5,4,6,8,7,30
191214437,5,1,8,7,2,23
191214438,0,7,4,3,3,17
191214439,3,2,8,0,9,22
191214440,8,9,3,1,5,26
191214441,4,7,6,1,8,26
191214442,1,8,5,5,8,27
191214443,4,8,8,9,8,37
191214444,2,7,0,4,3,16
191214445,9,6,2,6,9,32
191214446,8,0,7,0,3,18
191214447,5,8,7,7,7,34
191214448,5,8,3,2,8,26
191214449,1,9,5,5,6,26
191214450,1,6,6,0,5,18
191214451,7,3,6,4,5,25
191214452,6,8,3,5,7,29
191214453,1,3,5,2,6,17
191214454,6,1,1,2,9,19
191214455,2,4,1,0,4,11
191214456,2,0,0,7,0,9
191214457,4,9,6,4,4,27
191214458,9,5,4,2,5,25
191214459,9,7,3,7,3,29
191214460,4,7,8,2,5,26
191214461,9,5,7,8,8,37
191214462,2,3,2,9,8,24
191214463,4,5,7,0,6,22
191214464,1,9,4,6,3,23
191214465,0,0,9,9,0,18
191214466,2,6,6,3,3,20
191214467,4,1,4,2,3,14
191214468,0,5,6,5,3,19
191214469,6,2,0,8,0,16
191214470,8,8,2,8,4,30
191214471,7,9,6,1,2,25
191214472,2,9,7,7,6,31
191214473,9,5,9,6,0,29
191214474,1,5,2,2,4,14
191214475,4,7,3,6,1,21
191214476,8,2,5,6,4,25
191214477,2,9,7,1,1,20
191214478,7,6,3,6,4,26
191214479,1,8,8,5,9,31
191214480,5,5,2,0,1,13
191214481,3,2,3,8,5,21
191214482,7,5,6,1,8,27
191214483,4,1,8,7,8,28
191214484,8,3,4,4,7,26
191214485,2,4,4,8,3,21
191214486,8,8,4,2,0,22
191214487,9,6,0,2,9,26
191214488,5,5,4,5,1,20
191214489,0,8,5,3,2,18
191214490,7,6,5,0,7,25
191214491,8,1,0,1,5,15
191214492,6,5,5,1,9,26
191214493,0,4,0,1,9,14
191214494,5,4,8,3,1,21
191214495,3,2,4,7,2,18
191214496,2,6,2,6,7,23
191214497,5,7,3,6,3,24
191214498,1,3,7,7,3,21
191214499,5,9,7,6,3,30
191214500,7,3,6,4,7,27
191214501,3,8,9,8,5,33
191214502,6,9,1,1,1,18
191214503,2,4,8,7,5,26
191214504,1,7,2,7,7,24
191214505,1,9,0,6,9,25
191214506,7,3,6,3,3,22
191214507,7,6,1,7,5,26
191214508,0,0,9,6,5,20
191214509,6,1,9,8,3,27
191214510,8,5,2,8,7,30
191214511,1,2,1,5,8,17
191214512,0,6,3,6,8,23
191214513,7,6,2,0,2,17
191214514,1,4,9,6,9,29
191214515,8,7,9,9,1,34
191214516,0,3,7,7,4,21
191214517,7,6,3,5,5,26
191214518,2,2,8,2,2,16
191214519,8,4,7,2,7,28
191214520,3,3,5,4,5,20
191214521,6,6,1,7,7,27
191214522,8,8,3,6,2,27
191214523,6,0,3,2,4,15
191214524,6,5,9,5,9,34
191214525,7,5,6,5,2,25
191214526,3,9,4,6,9,31
191214527,4,5,6,6,3,24
191214528,2,2,2,8,9,23
191214529,0,3,6,3,1,13
191214530,3,6,4,2,6,21
191214531,8,3,9,5,1,26
191214532,0,2,4,9,0,15
191214533,6,1,5,5,0,17
191214534,4,0,2,4,2,12
191214535,9,8,3,6,4,30
191214536,2,4,8,9,7,30
191214537,8,9,3,8,0,28
191214538,3,1,1,2,1,8
191214539,3,7,8,2,5,25
191214540,6,1,8,8,8,31
191214541,5,8,2,7,0,22
191214542,4,3,6,8,2,23
191214543,7,1,3,8,4,23
191214544,5,2,6,2,8,23
191214545,9,4,8,7,4,32
191214546,1,5,5,2,9,22
191214547,8,0,2,2,5,17
191214548,8,6,3,7,7,31
191214549,6,3,4,3,1,17
191214550,9,5,0,0,0,14
191214551,9,1,3,0,2,15
191214552,1,1,3,1,4,10
191214553,2,4,5,0,4,15
191214554,8,9,5,2,4,28
191214555,2,1,8,3,4,18
191214556,0,3,7,5,1,16
191214557,8,1,1,1,2,13
191214558,1,8,9,8,8,34
191214559,5,4,5,6,5,25
191214560,2,7,9,8,0,26
191214561,3,9,4,7,1,24
191214562,5,6,5,4,2,22
191214563,7,3,3,5,3,21
191214564,6,5,1,5,7,24
191214565,9,5,9,3,3,29
191214566,4,4,7,6,0,21
191214567,5,9,9,6,7,36
191214568,4,6,1,9,2,22
191214569,5,1,1,3,7,17
191214570,8,0,0,6,6,20
191214571,6,2,0,5,5,18
191214572,5,1,4,4,1,15
191214573,1,7,2,4,1,15
191214574,6,8,5,3,6,28
191214575,6,8,7,8,9,38
191214576,4,6,7,3,8,28
191214577,3,8,7,4,3,25
191214578,3,2,0,9,0,14
191214579,1,1,3,8,3,16
191214580,8,6,0,8,8,30
191214581,4,6,6,3,8,27
191214582,8,2,7,6,1,24
191214583,4,7,5,0,9,25
191214584,2,6,1,6,0,15
191214585,9,6,4,4,2,25
191214586,3,1,6,1,1,12
191214587,1,0,9,2,0,12
191214588,4,7,8,8,5,32
191214589,0,2,1,8,1,12
191214590,6,3,7,7,4,27
191214591,9,4,9,8,6,36
191214592,9,9,8,1,1,28
191214593,8,9,8,5,2,32
191214594,4,0,5,8,6,23
191214595,0,6,5,1,6,18
191214596,1,0,3,7,8,19
191214597,5,1,2,3,2,13
191214598,1,1,1,0,3,6
191214599,0,8,4,9,2,23
191214600,8,2,7,1,5,23
191214601,3,6,0,1,9,19
191214602,7,6,3,3,7,26
191214603,7,2,7,0,5,21
191214604,5,4,3,3,9,24
191214605,4,8,4,6,2,24
191214606,9,7,8,3,3,30
191214607,8,1,5,5,2,21
191214608,4,0,6,3,0,13
191214609,3,3,6,7,1,20
191214610,9,9,1,3,3,25
191214611,7,7,2,7,8,31
191214612,0,1,1,4,5,11
191214613,7,2,6,2,8,25
191214614,6,7,4,3,4,24
191214615,9,3,6,7,0,25
191214616,3,1,7,1,2,14
191214617,2,1,0,6,9,18
191214618,1,3,9,7,6,26
191214619,4,7,7,4,3,25
191214620,1,5,9,5,4,24
191214621,6,4,7,2,0,19
191214622,9,6,2,9,8,34
191214623,7,7,1,8,3,26
191214624,7,6,4,1,0,18
191214625,7,5,7,6,9,34
191214626,1,1,7,8,9,26
191214627,9,2,1,4,3,19
191214628,0,7,7,4,7,25
191214629,7,8,6,8,3,32
191214630,2,2,8,5,7,24
191214631,0,5,5,6,3,19
191214632,9,9,5,8,9,40
191214633,9,7,9,6,6,37
191214634,2,4,3,8,2,19
191214635,0,1,7,2,8,18
191214636,3,8,2,7,2,22
191214637,3,5,6,6,5,25
191214638,5,6,7,2,6,26
191214639,4,1,8,8,0,21
191214640,6,7,3,2,2,20
191214641,0,1,9,5,6,21
191214642,7,0,8,2,5,22
191214643,9,3,8,0,4,24
191214644,1,0,6,0,8,15
191214645,3,1,1,0,0,5
191214646,3,1,1,3,6,14
191214647,1,0,9,0,8,18
191214648,7,2,3,8,0,20
191214649,6,1,8,3,9,27
191214650,3,4,4,6,2,19
191214651,4,2,2,3,1,12
191214652,0,8,7,1,7,23
191214653,1,3,4,1,5,14
191214654,4,6,8,2,1,21
191214655,4,0,9,2,6,21
191214656,0,0,3,1,7,11
191214657,0,9,7,0,9,25
191214658,3,1,8,7,1,20
191214659,9,6,0,4,4,23
191214660,2,1,7,7,3,20
191214661,6,8,5,0,2,21
191214662,1,9,7,4,8,29
191214663,0,5,2,3,7,17
191214664,6,3,7,6,3,25
191214665,0,4,2,9,6,21
191214666,6,4,8,2,3,23
191214667,6,0,3,7,3,19
191214668,4,6,5,7,9,31
191214669,5,1,7,1,5,19
191214670,0,6,9,4,8,27
191214671,4,9,2,0,6,21
191214672,9,0,6,0,6,21
191214673,8,4,4,1,4,21
191214674,0,7,2,4,8,21
191214675,2,3,3,0,4,12
191214676,1,4,5,0,2,12
191214677,1,0,9,6,2,18
191214678,1,0,7,6,6,20
191214679,8,3,3,2,3,19
191214680,9,0,3,5,3,20
191214681,4,1,9,1,2,17
191214682,9,5,7,6,1,28
191214683,0,0,7,0,9,16
191214684,0,0,6,1,8,15
191214685,1,6,3,7,8,25
191214686,7,6,2,5,8,28
191214687,3,0,7,1,3,14
191214688,4,4,8,5,6,27
191214689,2,6,6,6,7,27
191214690,6,4,1,9,4,24
191214691,2,1,3,4,6,16
191214692,2,0,2,2,6,12
191214693,4,0,7,0,0,11
191214694,9,3,7,2,2,23
191214695,7,0,5,4,6,22
191214696,3,3,8,0,0,14
191214697,5,0,9,7,6,27
191214698,1,5,1,8,5,20
191214699,5,8,7,3,1,24
191214700,5,6,5,9,0,25
191214701,6,4,5,3,2,20
191214702,3,2,8,3,6,22
191214703,6,8,1,8,0,23
191214704,1,7,5,6,8,27
191214705,8,2,5,0,2,17
191214706,8,0,9,3,6,26
191214707,3,1,2,3,1,10
191214708,5,4,0,0,6,15
191214709,2,5,8,5,7,27
191214710,6,9,2,9,2,28
191214711,0,3,9,4,3,19
191214712,2,3,6,1,5,17
191214713,5,6,9,6,0,26
191214714,9,8,3,6,1,27
191214715,0,4,9,6,3,22
191214716,8,7,9,3,6,33
191214717,0,9,1,6,6,22
191214718,5,8,6,5,2,26
191214719,6,6,8,9,3,32
191214720,4,6,6,2,3,21
191214721,1,6,2,2,8,19
191214722,0,5,6,2,2,15
191214723,5,6,7,2,2,22
191214724,6,6,5,2,2,21
191214725,5,5,4,5,0,19
191214726,1,1,1,0,4,7
191214727,7,6,6,4,5,28
191214728,3,7,5,5,7,27
191214729,4,7,1,6,2,20
191214730,6,6,2,6,2,22
191214731,8,9,8,9,6,40
191214732,5,6,0,6,9,26
191214733,2,8,8,9,7,34
191214734,5,4,2,2,8,21
191214735,8,9,3,8,5,33
191214736,6,4,0,8,8,26
191214737,9,6,2,9,7,33
191214738,2,9,3,5,1,20
191214739,6,7,3,5,1,22
191214740,6,0,9,8,5,28
191214741,3,9,5,1,2,20
191214742,7,7,2,6,3,25
191214743,9,9,3,9,8,38
191214744,4,0,6,9,0,19
191214745,4,7,0,4,6,21
191214746,8,3,4,8,9,32
191214747,9,4,8,7,5,33
191214748,4,2,3,2,9,20
191214749,2,5,1,4,7,19
191214750,5,8,9,1,4,27
191214751,2,7,4,3,4,20
191214752,4,6,2,6,5,23
191214753,9,5,0,1,7,22
191214754,4,8,4,4,0,20
191214755,0,5,5,7,5,22
191214756,6,1,6,3,8,24
191214757,4,4,6,8,4,26
191214758,2,1,0,1,7,11
191214759,0,9,0,6,0,15
191214760,3,3,1,5,7,19
191214761,1,6,4,2,8,21
191214762,9,5,0,4,0,18
191214763,2,7,6,4,1,20
191214764,2,8,3,4,4,21
191214765,8,3,9,3,8,31
191214766,8,6,3,9,5,31
191214767,3,9,1,7,2,22
191214768,1,5,0,6,0,12
191214769,0,8,9,9,5,31
191214770,1,4,2,3,9,19
191214771,8,9,7,3,9,36
191214772,4,5,9,7,5,30
191214773,4,0,2,0,5,11
191214774,9,3,3,2,5,22
191214775,0,9,6,7,9,31
191214776,3,3,1,0,6,13
191214777,9,5,4,9,9,36
191214778,5,7,9,0,1,22
191214779,1,8,8,1,9,27
191214780,8,2,8,9,1,28
191214781,9,1,7,9,4,30
191214782,6,4,6,2,0,18
191214783,0,6,4,5,2,17
191214784,3,7,7,3,9,29
191214785,8,1,3,9,6,27
191214786,1,2,6,3,5,17
191214787,2,8,5,0,6,21
191214788,3,9,8,1,7,28
191214789,0,4,1,4,2,11
191214790,6,0,0,5,0,11
191214791,1,4,1,5,7,18
191214792,1,1,8,4,3,17
191214793,6,3,0,1,6,16
191214794,9,0,7,2,3,21
191214795,2,9,4,0,2,17
191214796,6,6,3,9,7,31
191214797,0,6,4,5,7,22
191214798,3,3,4,0,5,15
191214799,1,3,1,7,9,21
191214800,5,6,4,7,2,24
191214801,5,7,4,3,0,19
191214802,6,1,8,3,0,18
191214803,1,6,2,8,7,24
191214804,6,3,1,2,3,15
191214805,4,5,3,9,9,30
191214806,4,5,9,4,2,24
191214807,4,4,6,1,5,20
191214808,3,7,4,4,8,26
191214809,7,0,8,9,6,30
191214810,6,5,8,6,2,27
191214811,5,6,4,3,5,23
191214812,4,5,9,3,3,24
191214813,4,3,4,9,5,25
191214814,0,7,3,6,2,18
191214815,0,8,9,6,6,29
191214816,7,6,2,8,1,24
191214817,4,3,6,9,8,30
191214818,4,1,9,4,5,23
191214819,0,9,6,0,9,24
191214820,3,3,0,6,9,21
191214821,9,8,8,8,5,38
191214822,3,7,0,6,6,22
191214823,3,0,1,9,5,18
191214824,3,4,1,4,3,15
191214825,2,1,3,4,9,19
191214826,5,3,9,7,6,30
191214827,5,2,7,7,7,28
191214828,2,2,2,5,2,13
191214829,6,1,7,9,1,24
191214830,6,4,0,9,5,24
191214831,5,5,0,0,6,16
191214832,5,7,3,0,5,20
191214833,4,5,4,6,1,20
191214834,0,1,6,9,4,20
191214835,0,8,6,4,5,23
191214836,7,7,4,7,2,27
191214837,7,7,8,1,7,30
191214838,0,4,6,9,6,25
191214839,7,2,6,5,0,20
191214840,1,5,3,8,6,23
191214841,0,4,6,8,8,26
191214842,8,7,7,0,2,24
191214843,3,5,2,0,9,19
191214844,8,5,8,3,2,26
191214845,6,2,0,5,1,14
191214846,4,6,0,5,4,19
191214847,8,5,7,2,0,22
191214848,3,4,5,2,0,14
191214849,0,9,3,5,1,18
191214850,6,1,4,4,4,19
191214851,4,9,9,3,1,26
191214852,3,9,2,4,3,21
191214853,2,6,9,1,2,20
191214854,5,0,9,2,3,19
191214855,5,3,6,0,9,23
191214856,1,3,1,7,1,13
191214857,2,3,2,2,3,12
191214858,5,4,3,0,2,14
191214859,1,1,7,7,0,16
191214860,2,9,7,9,5,32
191214861,5,3,0,0,5,13
191214862,5,9,3,0,0,17
191214863,4,4,7,3,6,24
191214864,9,7,3,1,4,24
191214865,9,4,1,0,7,21
191214866,7,6,7,7,8,35
191214867,4,9,3,5,0,21
191214868,6,5,2,1,7,21
191214869,7,4,8,7,7,33
191214870,0,1,7,1,9,18
191214871,7,6,2,1,0,16
191214872,8,8,9,5,7,37
191214873,1,3,6,4,9,23
191214874,7,7,9,4,7,34
191214875,6,1,7,8,8,30
191214876,6,5,2,2,9,24
191214877,2,9,0,9,8,28
191214878,1,4,4,1,5,15
191214879,5,9,3,6,3,26
191214880,0,7,0,2,2,11
191214881,0,5,8,7,1,21
191214882,6,5,7,3,9,30
191214883,9,9,3,2,8,31
191214884,0,5,3,0,7,15
191214885,3,7,7,4,1,22
191214886,0,1,6,7,1,15
191214887,1,3,0,9,7,20
191214888,9,9,4,7,3,32
191214889,2,8,6,1,6,23
191214890,4,9,7,4,4,28
191214891,2,8,1,8,2,21
191214892,2,6,1,0,9,18
191214893,9,4,0,3,7,23
191214894,1,8,0,0,2,11
191214895,4,8,5,9,1,27
191214896,6,3,9,7,0,25
191214897,8,4,9,8,0,29
191214898,5,5,2,8,0,20
191214899,0,2,2,4,0,8
191214900,0,8,6,6,0,20
191214901,7,8,6,6,1,28
191214902,6,5,5,7,1,24
191214903,8,4,4,1,1,18
191214904,6,8,2,7,3,26
191214905,1,1,6,9,2,19
191214906,4,0,3,5,8,20
191214907,9,9,8,9,0,35
191214908,2,9,7,9,6,33
191214909,6,2,8,7,3,26
191214910,7,4,6,3,4,24
191214911,8,0,8,4,5,25
191214912,9,0,2,1,0,12
191214913,1,8,1,8,3,21
191214914,4,2,6,3,4,19
191214915,4,7,0,5,6,22
191214916,9,5,5,2,6,27
191214917,6,1,5,3,7,22
191214918,5,6,8,3,5,27
191214919,8,2,9,4,6,29
191214920,7,7,5,6,7,32
191214921,2,2,0,5,7,16
191214922,7,9,6,7,3,32
191214923,7,0,4,8,9,28
191214924,6,0,2,0,6,14
191214925,9,9,8,3,1,30
191214926,1,6,6,9,3,25
191214927,5,8,7,1,2,23
191214928,5,8,9,3,8,33
191214929,5,6,0,8,7,26
191214930,5,3,8,0,8,24
191214931,6,8,6,0,7,27
191214932,0,8,0,5,2,15
191214933,8,2,0,8,6,24
191214934,4,6,1,6,3,20
191214935,2,7,2,5,5,21
191214936,3,2,6,1,1,13
191214937,6,0,5,9,2,22
191214938,8,3,9,5,5,30
191214939,7,9,0,3,6,25
191214940,7,3,9,2,2,23
191214941,0,6,7,8,7,28
191214942,5,7,6,8,4,30
191214943,3,9,0,8,8,28
191214944,4,0,6,8,4,22
191214945,7,9,3,1,7,27
191214946,4,2,0,8,0,14
191214947,9,6,3,4,3,25
191214948,5,6,1,8,7,27
191214949,6,7,8,3,9,33
191214950,9,3,6,8,2,28
191214951,1,5,9,3,0,18
191214952,9,2,9,4,8,32
191214953,1,3,3,7,2,16
191214954,5,4,5,7,8,29
191214955,1,7,9,4,7,28
191214956,4,4,0,5,3,16
191214957,9,5,9,9,3,35
191214958,3,2,3,4,3,15
191214959,4,1,1,4,3,13
191214960,4,1,5,7,5,22
191214961,2,4,9,3,5,23
191214962,7,3,4,1,2,17
191214963,0,3,8,8,6,25
191214964,7,2,4,5,7,25
191214965,0,2,6,9,7,24
191214966,0,1,3,5,8,17
191214967,2,3,7,2,6,20
191214968,4,1,2,8,4,19
191214969,3,6,9,6,1,25
191214970,8,6,3,2,3,22
191214971,4,0,7,4,9,24
191214972,7,1,1,0,8,17
191214973,6,9,4,0,1,20
191214974,0,3,0,0,8,11
191214975,5,3,1,1,4,14
191214976,6,6,0,1,2,15
191214977,3,3,6,7,5,24
191214978,3,9,9,5,4,30
191214979,6,5,6,1,8,26
191214980,3,5,2,9,3,22
191214981,6,3,3,5,7,24
191214982,5,9,7,9,1,31
191214983,8,3,3,9,7,30
191214984,1,0,3,9,4,17
191214985,1,8,4,9,0,22
191214986,1,5,1,1,6,14
191214987,2,0,0,8,2,12
191214988,9,5,5,8,0,27
191214989,0,9,0,2,7,18
191214990,4,7,4,0,5,20
191214991,5,8,6,6,1,26
191214992,4,3,9,4,9,29
191214993,3,0,8,0,7,18
191214994,2,4,8,8,7,29
191214995,2,3,8,1,9,23
191214996,7,2,4,5,8,26
191214997,4,4,9,2,0,19
191214998,0,0,6,9,4,19
191214999,7,2,2,7,4,22
1912141000,1,3,9,0,1,14
1912141001,1,2,4,9,2,18
1912141002,8,8,5,3,4,28
1912141003,3,1,7,4,9,24
1912141004,7,2,8,0,1,18
1912141005,8,9,8,8,8,41
1912141006,3,9,6,1,2,21
1912141007,6,9,3,6,1,25
1912141008,8,1,0,0,9,18
1912141009,4,4,0,1,8,17
1912141010,2,5,6,4,2,19
1912141011,6,1,4,9,5,25
1912141012,3,1,8,4,4,20
1912141013,4,4,1,1,4,14
1912141014,8,5,5,1,3,22
1912141015,3,2,8,1,7,21
1912141016,8,1,4,9,4,26
1912141017,9,9,6,7,6,37
1912141018,8,2,0,5,1,16
1912141019,5,8,8,8,5,34
1912141020,4,3,8,3,6,24
1912141021,1,9,5,5,1,21
1912141022,3,6,4,8,0,21
1912141023,8,9,3,4,0,24
1912141024,5,2,3,8,4,22
1912141025,9,7,3,5,5,29
1912141026,1,8,7,6,1,23
1912141027,3,3,2,3,7,18
1912141028,4,9,4,7,9,33
1912141029,6,1,0,8,0,15
1912141030,9,3,9,5,7,33
1912141031,3,7,1,2,5,18
1912141032,4,0,0,0,7,11
1912141033,9,5,2,4,5,25
1912141034,0,9,7,6,2,24
1912141035,6,6,4,4,9,29
1912141036,9,4,5,2,7,27
1912141037,5,6,6,1,2,20
1912141038,4,9,2,1,2,18
1912141039,1,7,1,0,3,12
1912141040,2,1,7,1,7,18
1912141041,1,5,0,4,9,19
1912141042,1,3,4,4,2,14
1912141043,7,0,1,7,3,18
1912141044,7,1,6,7,4,25
1912141045,4,5,5,0,7,21
1912141046,9,0,7,2,1,19
1912141047,4,3,0,4,0,11
1912141048,5,4,3,9,9,30
1912141049,4,3,1,5,6,19
1912141050,9,1,9,2,6,27
1912141051,7,2,3,3,0,15
1912141052,0,3,9,6,8,26
1912141053,7,4,8,5,6,30
1912141054,3,2,3,2,3,13
1912141055,2,0,6,6,5,19
1912141056,7,5,3,7,8,30
1912141057,6,3,8,5,8,30
1912141058,6,4,8,7,8,33
1912141059,5,8,3,1,7,24
1912141060,6,2,1,0,1,10
1912141061,7,5,5,7,2,26
1912141062,0,2,9,0,3,14
1912141063,3,8,9,6,5,31
1912141064,8,3,3,1,2,17
1912141065,6,5,9,8,9,37
1912141066,8,2,9,3,5,27
1912141067,7,1,2,6,4,20
1912141068,4,5,2,7,1,19
1912141069,3,2,2,7,0,14
1912141070,3,9,0,9,1,22
1912141071,0,2,4,5,3,14
1912141072,0,2,3,9,5,19
1912141073,7,4,2,5,0,18
1912141074,8,7,7,1,1,24
1912141075,0,1,7,0,7,15
1912141076,6,1,6,1,8,22
1912141077,9,4,7,7,1,28
1912141078,0,8,6,3,9,26
1912141079,1,7,3,8,0,19
1912141080,7,9,3,2,5,26
1912141081,0,9,4,1,7,21
1912141082,6,7,2,6,6,27
1912141083,1,7,1,0,0,9
1912141084,3,8,7,9,9,36
1912141085,1,6,9,3,5,24
1912141086,2,6,8,0,1,17
1912141087,6,2,5,4,3,20
1912141088,5,7,3,8,4,27
1912141089,0,4,3,1,5,13
1912141090,6,5,0,0,1,12
1912141091,4,3,9,0,4,20
1912141092,0,5,9,5,6,25
1912141093,6,2,2,3,0,13
1912141094,6,2,4,3,9,24
1912141095,9,6,1,4,6,26
1912141096,6,4,5,2,8,25
1912141097,3,3,9,9,8,32
1912141098,0,9,7,6,4,26
1912141099,5,9,1,6,4,25
1912141100,0,6,1,2,5,14
1912141101,8,7,8,8,3,34
1912141102,7,6,6,7,3,29
1912141103,5,4,8,3,9,29
1912141104,2,0,5,2,1,10
1912141105,2,9,2,8,0,21
191215001,8,5,4,0,3,20
191215002,7,7,1,2,4,21
191215003,2,2,6,9,9,28
191215004,0,6,3,1,1,11
191215005,8,3,3,3,6,23
191215006,9,1,8,6,4,28
191215007,7,7,8,9,4,35
191215008,1,0,7,2,2,12
191215009,8,6,0,6,0,20
191215010,1,2,5,4,0,12
191215011,4,9,6,4,6,29
191215012,6,5,6,1,9,27
191215013,7,2,9,2,6,26
191215014,2,7,7,7,8,31
191215015,0,9,8,5,1,23
191215016,8,1,6,2,2,19
191215017,7,8,1,2,9,27
191215018,0,2,4,4,7,17
191215019,8,8,7,7,4,34
191215020,5,3,7,4,2,21
191215021,9,9,1,2,5,26
191215022,3,7,2,3,3,18
191215023,9,0,1,4,5,19
191215024,2,5,8,6,3,24
191215025,9,0,1,7,2,19
191215026,0,0,4,4,1,9
191215027,2,1,1,2,4,10
191215028,2,5,2,6,0,15
191215029,8,6,7,7,4,32
191215030,6,5,8,6,0,25
191215031,2,0,4,3,9,18
191215032,1,8,1,7,5,22
191215033,1,8,0,5,7,21
191215034,6,0,9,9,7,31
191215035,1,5,4,9,8,27
191215036,9,4,5,8,2,28
191215037,4,0,9,8,6,27
191215038,8,8,3,1,7,27
191215039,9,5,4,5,8,31
191215040,2,5,9,1,9,26
191215041,1,9,6,6,3,25
191215042,3,7,1,0,9,20
191215043,8,8,5,9,7,37
191215044,2,8,5,6,1,22
191215045,8,4,9,3,4,28
191215046,0,2,5,0,7,14
191215047,2,4,2,5,4,17
191215048,0,9,4,1,0,14
191215049,1,4,7,1,9,22
191215050,1,4,5,3,9,22
191215051,8,2,0,4,4,18
191215052,1,5,9,9,9,33
191215053,5,1,9,8,5,28
191215054,3,3,4,2,0,12
191215055,0,9,0,2,8,19
191215056,9,6,2,0,8,25
191215057,5,1,6,4,9,25
191215058,3,4,5,2,2,16
191215059,2,1,3,9,0,15
191215060,5,8,0,7,5,25
191215061,1,6,8,4,9,28
191215062,7,5,0,6,5,23
191215063,4,0,2,2,1,9
191215064,8,2,1,9,0,20
191215065,2,0,6,0,3,11
191215066,7,4,1,7,4,23
191215067,6,3,5,2,6,22
191215068,5,9,0,5,8,27
191215069,7,6,8,7,4,32
191215070,4,6,2,8,3,23
191215071,9,0,8,2,3,22
191215072,3,0,9,2,6,20
191215073,3,2,1,9,4,19
191215074,5,6,1,8,0,20
191215075,8,9,9,3,0,29
191215076,6,7,2,4,0,19
191215077,5,7,0,0,1,13
191215078,4,7,6,3,4,24
191215079,8,8,6,4,9,35
191215080,2,3,2,3,5,15
191215081,5,2,6,0,5,18
191215082,7,8,7,3,2,27
191215083,7,2,2,6,1,18
191215084,2,3,3,1,2,11
191215085,6,5,1,9,6,27
191215086,4,2,3,7,7,23
191215087,8,9,9,6,0,32
191215088,2,0,2,8,9,21
191215089,7,8,3,7,7,32
191215090,4,5,7,1,2,19
191215091,8,2,0,3,7,20
191215092,1,0,9,0,6,16
191215093,7,5,2,8,4,26
191215094,3,4,5,2,8,22
191215095,6,2,4,1,5,18
191215096,8,1,9,1,5,24
191215097,9,4,7,6,4,30
191215098,1,4,5,6,6,22
191215099,4,7,7,0,1,19
191215100,9,5,5,4,8,31
191215101,2,5,6,5,7,25
191215102,0,8,6,4,1,19
191215103,6,7,2,3,0,18
191215104,7,4,7,3,8,29
191215105,3,0,9,9,8,29
191215106,4,4,9,5,8,30
191215107,6,8,9,9,8,40
191215108,1,7,7,1,7,23
191215109,8,6,9,3,8,34
191215110,0,1,7,1,3,12
191215111,1,1,8,6,7,23
191215112,0,9,0,2,0,11
191215113,6,4,0,3,9,22
191215114,9,1,8,5,9,32
191215115,4,3,9,2,0,18
191215116,5,3,0,9,6,23
191215117,5,6,6,8,1,26
191215118,0,8,3,6,5,22
191215119,1,7,2,4,4,18
191215120,1,1,8,5,8,23
191215121,9,1,9,9,5,33
191215122,7,1,9,9,4,30
191215123,0,8,7,6,8,29
191215124,4,3,6,1,6,20
191215125,1,8,6,3,0,18
191215126,2,3,1,0,3,9
191215127,7,5,5,3,8,28
191215128,2,2,4,1,0,9
191215129,5,0,6,8,5,24
191215130,8,6,2,0,8,24
191215131,2,9,3,3,4,21
191215132,6,7,1,4,6,24
191215133,7,1,6,3,8,25
191215134,5,8,3,8,3,27
191215135,5,7,8,8,5,33
191215136,7,2,3,9,1,22
191215137,6,3,6,2,6,23
191215138,1,4,4,4,9,22
191215139,5,9,5,1,0,20
191215140,4,9,3,0,5,21
191215141,5,9,2,4,6,26
191215142,2,0,8,6,1,17
191215143,4,1,2,0,8,15
191215144,1,8,3,2,9,23
191215145,3,3,5,0,2,13
191215146,4,0,8,5,8,25
191215147,3,6,3,3,2,17
191215148,6,4,1,3,6,20
191215149,3,8,9,9,1,30
191215150,0,5,8,0,2,15
191215151,1,6,3,3,2,15
191215152,0,7,6,0,3,16
191215153,3,3,9,5,3,23
191215154,2,9,6,8,5,30
191215155,0,7,4,0,0,11
191215156,7,4,1,8,7,27
191215157,2,8,2,6,6,24
191215158,2,9,3,0,2,16
191215159,1,2,6,7,6,22
191215160,8,8,1,4,1,22
191215161,5,0,1,7,5,18
191215162,8,7,8,0,7,30
191215163,1,2,4,9,7,23
191215164,6,0,5,3,3,17
191215165,7,9,0,7,5,28
191215166,4,6,0,0,5,15
191215167,3,9,8,0,3,23
191215168,7,0,6,2,2,17
191215169,5,4,1,7,9,26
191215170,6,0,6,8,7,27
191215171,6,6,4,6,2,24
191215172,1,7,9,1,3,21
191215173,1,5,3,8,2,19
191215174,1,6,3,8,9,27
191215175,3,5,6,2,6,22
191215176,6,1,9,7,3,26
191215177,5,3,9,0,8,25
191215178,1,2,9,2,0,14
191215179,1,9,4,9,5,28
191215180,8,7,4,9,5,33
191215181,1,4,6,9,0,20
191215182,9,4,3,3,0,19
191215183,8,5,0,3,5,21
191215184,6,6,6,6,9,33
191215185,5,2,5,1,9,22
191215186,8,3,9,7,6,33
191215187,3,4,6,7,4,24
191215188,6,9,1,4,7,27
191215189,5,8,9,2,1,25
191215190,6,9,1,7,6,29
191215191,9,6,3,4,1,23
191215192,2,0,8,1,6,17
191215193,1,1,4,9,6,21
191215194,3,4,6,6,0,19
191215195,5,6,7,8,2,28
191215196,2,0,2,7,2,13
191215197,1,0,6,6,9,22
191215198,6,9,5,4,9,33
191215199,3,9,1,4,3,20
191215200,3,3,6,7,2,21
191215201,9,0,8,5,7,29
191215202,8,5,9,5,3,30
191215203,6,0,6,3,8,23
191215204,9,7,9,6,1,32
191215205,8,5,8,8,9,38
191215206,1,8,6,1,5,21
191215207,3,5,0,4,7,19
191215208,8,6,0,7,6,27
191215209,2,1,7,3,2,15
191215210,8,5,8,1,9,31
191215211,6,4,4,3,5,22
191215212,5,9,2,2,1,19
191215213,5,2,6,9,0,22
191215214,8,7,1,7,5,28
191215215,7,5,5,4,8,29
191215216,9,2,3,1,0,15
191215217,0,8,9,0,3,20
191215218,4,3,1,3,2,13
191215219,5,1,8,1,9,24
191215220,0,9,7,7,0,23
191215221,4,3,0,9,7,23
191215222,5,7,2,3,3,20
191215223,8,7,8,6,2,31
191215224,9,3,0,2,2,16
191215225,6,1,8,2,4,21
191215226,8,5,1,0,4,18
191215227,6,3,5,0,1,15
191215228,1,4,3,0,7,15
191215229,6,9,9,5,9,38
191215230,6,6,7,8,9,36
191215231,7,6,5,2,4,24
191215232,1,6,0,5,3,15
191215233,7,7,8,6,3,31
191215234,9,3,9,8,0,29
191215235,6,2,5,4,4,21
191215236,9,2,1,9,8,29
191215237,4,9,4,4,4,25
191215238,9,1,4,0,8,22
191215239,7,5,2,8,8,30
191215240,3,1,8,8,1,21
191215241,9,6,8,2,8,33
191215242,8,3,9,1,0,21
191215243,5,4,0,4,4,17
191215244,6,8,8,0,3,25
191215245,3,3,6,8,1,21
191215246,2,3,0,9,5,19
191215247,1,6,3,8,8,26
191215248,6,0,8,4,5,23
191215249,4,9,2,4,5,24
191215250,6,6,6,3,3,24
191215251,3,2,1,4,2,12
191215252,8,8,1,5,5,27
191215253,9,2,5,4,0,20
191215254,9,4,6,3,3,25
191215255,9,9,4,3,3,28
191215256,8,5,3,4,0,20
191215257,6,1,0,8,1,16
191215258,0,7,2,2,4,15
191215259,5,8,2,6,3,24
191215260,8,0,7,2,9,26
191215261,2,7,5,0,5,19
191215262,6,6,9,8,2,31
191215263,3,5,9,2,6,25
191215264,2,8,2,6,8,26
191215265,6,5,0,6,4,21
191215266,2,0,5,1,2,10
191215267,9,2,1,3,9,24
191215268,9,2,5,7,6,29
191215269,8,9,1,4,6,28
191215270,5,3,0,8,3,19
191215271,6,0,2,6,5,19
191215272,3,7,8,1,0,19
191215273,7,7,6,0,3,23
191215274,9,3,8,3,7,30
191215275,7,1,8,5,9,30
191215276,3,8,9,1,3,24
191215277,3,3,4,0,2,12
191215278,9,9,0,4,4,26
191215279,9,2,5,3,4,23
191215280,4,4,1,1,9,19
191215281,3,2,1,8,4,18
191215282,8,9,8,3,5,33
191215283,3,4,6,3,5,21
191215284,5,6,8,2,3,24
191215285,5,5,2,0,3,15
191215286,7,0,2,8,8,25
191215287,5,8,1,4,6,24
191215288,6,0,8,4,9,27
191215289,4,3,2,6,9,24
191215290,8,0,2,8,2,20
191215291,9,4,4,5,0,22
191215292,8,8,5,1,0,22
191215293,1,1,6,1,1,10
191215294,3,1,6,5,4,19
191215295,9,3,2,9,5,28
191215296,4,1,5,7,2,19
191215297,9,2,8,7,8,34
191215298,0,8,9,0,6,23
191215299,0,5,3,3,7,18
191215300,8,5,1,6,2,22
191215301,3,9,9,6,6,33
191215302,8,0,3,7,5,23
191215303,4,4,8,4,6,26
191215304,0,0,3,2,2,7
191215305,3,3,5,3,4,18
191215306,1,9,1,9,8,28
191215307,3,2,8,4,3,20
191215308,9,7,2,5,3,26
191215309,0,8,6,7,8,29
191215310,5,6,7,8,0,26
191215311,1,0,4,8,9,22
191215312,1,8,3,5,8,25
191215313,8,5,8,7,2,30
191215314,2,4,3,0,4,13
191215315,1,0,1,4,7,13
191215316,3,0,3,5,8,19
191215317,9,1,7,8,9,34
191215318,7,2,4,4,9,26
191215319,5,3,5,9,7,29
191215320,1,9,2,1,2,15
191215321,5,3,6,6,5,25
191215322,6,0,4,5,9,24
191215323,2,9,1,3,2,17
191215324,7,9,8,8,7,39
191215325,6,9,2,2,1,20
191215326,6,0,3,1,0,10
191215327,2,5,0,4,9,20
191215328,8,6,9,5,6,34
191215329,1,0,5,5,4,15
191215330,6,6,6,5,2,25
191215331,0,4,2,9,2,17
191215332,3,4,3,2,1,13
191215333,3,5,7,1,4,20
191215334,6,1,2,4,9,22
191215335,2,9,9,0,1,21
191215336,5,8,9,7,5,34
191215337,9,0,5,3,1,18
191215338,6,4,5,1,1,17
191215339,4,4,1,6,4,19
191215340,0,0,8,3,8,19
191215341,0,3,2,7,8,20
191215342,4,8,1,2,7,22
191215343,0,2,8,4,7,21
191215344,7,4,1,2,1,15
191215345,0,1,7,6,4,18
191215346,0,5,4,4,1,14
191215347,9,1,0,6,6,22
191215348,5,2,7,0,8,22
191215349,7,0,3,8,5,23
191215350,1,0,2,2,1,6
191215351,9,8,0,5,5,27
191215352,1,4,3,7,0,15
191215353,2,3,0,3,3,11
191215354,9,2,4,1,9,25
191215355,1,2,2,2,0,7
191215356,9,3,7,6,9,34
191215357,4,5,7,2,0,18
191215358,3,6,9,5,9,32
191215359,7,9,9,0,4,29
191215360,2,9,5,9,0,25
191215361,2,4,3,4,0,13
191215362,1,8,8,7,9,33
191215363,3,2,1,0,7,13
191215364,6,3,3,0,6,18
191215365,8,5,4,7,8,32
191215366,6,1,0,0,3,10
191215367,3,2,7,6,7,25
191215368,1,3,4,0,0,8
191215369,8,4,2,5,6,25
191215370,6,7,7,9,7,36
191215371,7,1,2,1,8,19
191215372,1,9,0,6,2,18
191215373,6,3,2,9,4,24
191215374,8,4,1,0,6,19
191215375,2,9,0,4,9,24
191215376,5,7,5,3,6,26
191215377,5,0,0,1,7,13
191215378,2,3,9,6,8,28
191215379,1,5,1,2,1,10
191215380,1,1,0,0,6,8
191215381,6,1,7,1,9,24
191215382,3,3,2,5,5,18
191215383,9,5,0,6,7,27
191215384,6,6,2,8,7,29
191215385,5,3,2,6,3,19
191215386,8,6,3,0,8,25
191215387,5,5,8,0,4,22
191215388,1,1,7,3,4,16
191215389,0,8,8,8,5,29
191215390,6,5,0,2,3,16
191215391,2,8,8,9,8,35
191215392,9,0,8,7,8,32
191215393,1,5,5,0,4,15
191215394,4,9,0,5,3,21
191215395,0,5,9,6,6,26
191215396,1,6,9,4,6,26
191215397,9,4,9,9,2,33
191215398,9,3,3,3,9,27
191215399,1,9,3,8,6,27
191215400,5,7,8,3,7,30
191215401,0,8,5,4,8,25
191215402,8,1,4,7,4,24
191215403,7,3,8,8,1,27
191215404,8,3,2,3,9,25
191215405,1,5,9,1,0,16
191215406,4,8,2,4,3,21
191215407,9,2,4,4,5,24
191215408,5,3,4,6,6,24
191215409,7,5,1,8,7,28
191215410,5,1,3,6,4,19
191215411,2,5,3,5,3,18
191215412,5,1,7,2,1,16
191215413,0,9,0,8,1,18
191215414,7,9,6,3,3,28
191215415,8,2,6,0,1,17
191215416,5,6,7,0,4,22
191215417,7,3,1,1,1,13
191215418,7,4,5,4,0,20
191215419,9,9,1,1,8,28
191215420,1,1,7,7,2,18
191215421,2,8,5,3,9,27
191215422,5,4,3,4,9,25
191215423,2,8,3,9,3,25
191215424,1,3,8,8,4,24
191215425,2,9,4,0,4,19
191215426,1,0,9,0,5,15
191215427,0,4,4,9,3,20
191215428,1,2,1,5,6,15
191215429,5,6,2,8,0,21
191215430,3,1,2,1,8,15
191215431,2,4,3,9,0,18
191215432,2,7,1,8,3,21
191215433,5,0,1,8,1,15
191215434,8,4,4,0,2,18
191215435,6,1,1,5,9,22
191215436,7,0,6,6,7,26
191215437,4,7,3,2,3,19
191215438,4,4,4,5,0,17
191215439,6,3,4,4,7,24
191215440,2,4,4,9,6,25
191215441,8,3,7,7,5,30
191215442,2,4,4,0,8,18
191215443,4,5,1,2,4,16
191215444,1,0,9,4,7,21
191215445,5,2,1,1,8,17
191215446,3,9,4,1,9,26
191215447,3,6,3,8,6,26
191215448,3,0,4,5,6,18
191215449,0,0,7,2,9,18
191215450,9,5,1,6,5,26
191215451,1,4,1,6,4,16
191215452,4,3,9,3,0,19
191215453,6,7,6,9,4,32
191215454,7,2,6,7,0,22
191215455,7,8,4,9,4,32
191215456,5,0,1,4,0,10
191215457,4,3,9,5,6,27
191215458,6,4,0,0,7,17
191215459,9,1,7,4,2,23
191215460,3,1,3,9,1,17
191215461,2,4,0,9,9,24
191215462,6,9,2,2,7,26
191215463,5,3,8,8,1,25
191215464,6,8,7,4,7,32
191215465,7,5,7,5,2,26
191215466,2,1,1,4,0,8
191215467,0,7,3,2,5,17
191215468,6,3,0,1,0,10
191215469,4,6,7,4,3,24
191215470,3,7,4,2,5,21
191215471,5,8,5,5,9,32
191215472,9,1,3,8,6,27
191215473,3,3,7,5,0,18
191215474,0,7,3,1,1,12
191215475,9,2,5,5,3,24
191215476,4,5,0,6,2,17
191215477,2,7,9,0,0,18
191215478,5,8,4,1,8,26
191215479,7,3,4,2,3,19
191215480,0,7,9,6,6,28
191215481,7,4,3,9,8,31
191215482,0,3,1,7,0,11
191215483,4,5,9,9,9,36
191215484,9,5,2,2,4,22
191215485,4,6,4,8,2,24
191215486,7,7,0,4,5,23
191215487,9,3,8,7,0,27
191215488,1,4,8,5,6,24
191215489,9,0,7,4,9,29
191215490,5,5,7,8,0,25
191215491,5,7,8,6,9,35
191215492,7,9,1,2,6,25
191215493,6,8,0,0,3,17
191215494,8,2,9,5,8,32
191215495,5,2,8,9,2,26
191215496,4,3,9,8,0,24
191215497,3,8,7,3,6,27
191215498,3,1,9,6,0,19
191215499,6,3,5,2,2,18
191215500,9,1,9,2,1,22
191215501,5,9,3,5,3,25
191215502,8,9,2,3,2,24
191215503,1,4,4,6,0,15
191215504,6,6,6,7,9,34
191215505,6,4,2,2,2,16
191215506,7,3,9,1,3,23
191215507,7,8,1,3,2,21
191215508,3,6,4,2,7,22
191215509,6,4,5,9,8,32
191215510,5,9,3,6,4,27
191215511,8,8,7,0,1,24
191215512,4,3,9,2,3,21
191215513,3,9,8,2,1,23
191215514,5,8,5,0,6,24
191215515,6,6,0,5,1,18
191215516,2,9,0,7,0,18
191215517,6,3,8,5,3,25
191215518,6,9,7,1,9,32
191215519,3,7,7,9,8,34
191215520,2,8,9,5,1,25
191215521,9,2,7,5,2,25
191215522,6,5,9,2,2,24
191215523,0,8,6,6,6,26
191215524,5,9,3,5,8,30
191215525,6,9,5,7,1,28
191215526,7,7,9,0,5,28
191215527,3,4,2,9,7,25
191215528,4,4,4,3,5,20
191215529,6,8,1,4,9,28
191215530,6,0,6,4,0,16
191215531,5,0,7,0,9,21
191215532,5,6,6,1,0,18
191215533,0,3,6,4,6,19
191215534,4,1,6,7,6,24
191215535,4,2,0,0,2,8
191215536,6,7,3,4,6,26
191215537,3,6,9,8,2,28
191215538,6,3,8,0,9,26
191215539,2,4,0,4,7,17
191215540,9,7,2,2,0,20
191215541,0,2,6,5,2,15
191215542,8,6,8,4,5,31
191215543,5,1,0,6,9,21
191215544,1,1,7,9,4,22
191215545,0,7,7,6,5,25
191215546,0,4,2,2,2,10
191215547,1,3,4,4,1,13
191215548,7,1,9,3,5,25
191215549,2,5,1,8,8,24
191215550,8,0,1,9,4,22
191215551,3,9,6,5,1,24
191215552,0,5,2,0,9,16
191215553,4,4,5,3,1,17
191215554,2,0,9,2,8,21
191215555,4,4,7,6,3,24
191215556,3,0,2,0,3,8
191215557,2,1,1,5,6,15
191215558,2,5,5,4,8,24
191215559,5,5,3,7,0,20
191215560,5,3,3,6,0,17
191215561,6,1,7,5,2,21
191215562,5,5,5,8,8,31
191215563,3,1,1,3,5,13
191215564,8,3,8,0,3,22
191215565,9,3,1,7,2,22
191215566,6,2,1,5,7,21
191215567,4,4,6,2,4,20
191215568,4,2,0,2,3,11
191215569,1,8,7,6,9,31
191215570,3,0,1,0,2,6
191215571,6,8,5,4,6,29
191215572,0,9,2,3,8,22
191215573,0,5,7,3,8,23
191215574,5,9,2,7,4,27
191215575,8,4,3,6,5,26
191215576,1,1,8,8,7,25
191215577,9,0,6,9,3,27
191215578,6,7,1,2,6,22
191215579,6,3,2,2,7,20
191215580,0,4,1,8,8,21
191215581,5,2,4,6,8,25
191215582,0,5,2,5,5,17
191215583,7,0,7,3,2,19
191215584,5,4,4,6,7,26
191215585,0,7,7,0,9,23
191215586,5,0,2,1,1,9
191215587,1,8,4,9,8,30
191215588,1,4,2,6,2,15
191215589,0,2,9,8,6,25
191215590,7,7,3,5,6,28
191215591,6,6,7,9,5,33
191215592,6,6,0,0,6,18
191215593,2,9,7,4,0,22
191215594,5,7,7,8,4,31
191215595,9,8,6,0,3,26
191215596,0,3,7,0,7,17
191215597,3,1,2,6,4,16
191215598,0,4,1,8,5,18
191215599,3,6,6,2,9,26
191215600,8,5,0,0,2,15
191215601,7,9,2,3,4,25
191215602,4,0,3,7,9,23
191215603,8,5,3,0,9,25
191215604,9,6,1,6,4,26
191215605,2,7,3,6,6,24
191215606,3,4,2,5,0,14
191215607,8,5,7,4,6,30
191215608,4,9,0,7,5,25
191215609,6,1,8,3,3,21
191215610,1,0,3,8,6,18
191215611,8,5,3,6,5,27
191215612,4,6,2,8,8,28
191215613,5,8,5,2,1,21
191215614,8,2,2,7,8,27
191215615,2,8,1,2,0,13
191215616,3,2,5,3,4,17
191215617,8,2,1,0,4,15
191215618,0,1,5,4,7,17
191215619,8,0,1,0,0,9
191215620,9,9,3,4,8,33
191215621,9,4,6,1,0,20
191215622,2,0,8,4,2,16
191215623,8,1,8,3,2,22
191215624,5,9,0,9,4,27
191215625,2,9,3,8,8,30
191215626,3,3,0,9,4,19
191215627,3,2,8,5,4,22
191215628,9,1,3,7,0,20
191215629,1,9,9,1,3,23
191215630,9,2,7,9,9,36
191215631,4,4,4,0,8,20
191215632,0,9,4,2,1,16
191215633,8,5,3,3,7,26
191215634,2,1,6,5,6,20
191215635,7,0,4,9,2,22
191215636,7,8,2,1,9,27
191215637,6,3,0,0,7,16
191215638,5,4,3,1,8,21
191215639,0,8,8,0,2,18
191215640,2,8,0,5,2,17
191215641,5,4,8,2,8,27
191215642,1,8,2,9,3,23
191215643,7,7,8,3,2,27
191215644,2,5,4,2,0,13
191215645,7,5,9,1,9,31
191215646,9,8,1,1,9,28
191215647,6,3,3,6,6,24
191215648,5,6,4,0,4,19
191215649,7,6,3,2,0,18
191215650,2,4,9,0,1,16
191215651,3,3,8,8,5,27
191215652,4,6,0,4,1,15
191215653,1,9,4,0,3,17
191215654,4,9,6,3,9,31
191215655,2,2,1,1,9,15
191215656,2,8,7,1,4,22
191215657,1,8,5,6,3,23
191215658,1,3,0,3,4,11
191215659,6,3,3,8,7,27
191215660,2,3,7,8,3,23
191215661,0,1,8,4,1,14
191215662,4,3,8,0,0,15
191215663,3,4,2,0,2,11
191215664,6,4,9,9,1,29
191215665,6,7,1,5,0,19
191215666,5,4,7,4,9,29
191215667,6,1,2,5,5,19
191215668,4,8,6,7,1,26
191215669,1,1,4,5,3,14
191215670,7,6,0,6,6,25
191215671,0,3,5,6,5,19
191215672,9,3,3,2,9,26
191215673,8,6,6,6,3,29
191215674,2,8,2,5,9,26
191215675,5,7,0,9,7,28
191215676,1,3,9,6,0,19
191215677,5,2,7,7,9,30
191215678,9,6,6,6,3,30
191215679,8,3,8,9,4,32
191215680,7,3,2,5,0,17
191215681,5,6,6,2,9,28
191215682,4,9,8,0,2,23
191215683,0,6,1,2,8,17
191215684,8,9,3,0,9,29
191215685,3,5,0,4,4,16
191215686,2,6,3,7,2,20
191215687,2,5,1,2,2,12
191215688,9,6,2,6,7,30
191215689,2,0,8,1,0,11
191215690,1,6,1,0,3,11
191215691,4,0,6,9,7,26
191215692,1,8,8,1,6,24
191215693,6,2,3,1,1,13
191215694,3,5,3,8,9,28
191215695,1,1,5,6,4,17
191215696,9,0,3,5,2,19
191215697,2,6,7,2,8,25
191215698,6,1,5,7,6,25
191215699,8,1,6,3,5,23
191215700,5,4,9,7,5,30
191215701,2,7,1,3,7,20
191215702,5,1,8,8,1,23
191215703,8,9,1,3,0,21
191215704,4,9,5,8,6,32
191215705,2,3,1,8,5,19
191215706,2,5,2,8,2,19
191215707,6,3,4,1,3,17
191215708,2,6,2,8,5,23
191215709,9,5,3,9,6,32
191215710,0,7,7,6,6,26
191215711,7,8,6,6,6,33
191215712,7,0,6,9,8,30
191215713,5,4,6,0,2,17
191215714,0,6,7,6,2,21
191215715,5,4,1,0,5,15
191215716,7,6,1,2,0,16
191215717,5,7,8,2,1,23
191215718,7,5,6,3,5,26
191215719,3,8,7,5,7,30
191215720,7,0,8,4,4,23
191215721,4,0,9,2,3,18
191215722,8,2,8,2,8,28
191215723,2,5,3,8,3,21
191215724,2,3,2,2,1,10
191215725,5,2,8,3,9,27
191215726,5,2,6,5,5,23
191215727,1,1,6,4,5,17
191215728,3,5,4,3,9,24
191215729,7,0,3,0,6,16
191215730,1,6,1,8,4,20
191215731,2,2,6,5,4,19
191215732,5,9,5,2,3,24
191215733,6,7,4,0,5,22
191215734,3,0,2,8,4,17
191215735,7,5,5,1,3,21
191215736,2,1,7,4,8,22
191215737,2,8,5,4,4,23
191215738,2,8,5,1,6,22
191215739,1,2,8,4,3,18
191215740,9,3,1,2,2,17
191215741,6,9,3,1,3,22
191215742,8,7,1,8,5,29
191215743,3,5,3,1,2,14
191215744,1,4,7,3,5,20
191215745,5,0,2,7,4,18
191215746,2,7,7,4,1,21
191215747,1,0,9,3,9,22
191215748,7,7,6,9,1,30
191215749,1,0,4,4,1,10
191215750,1,2,2,9,4,18
191215751,8,5,1,6,7,27
191215752,7,6,6,4,3,26
191215753,7,8,6,3,9,33
191215754,3,7,4,2,2,18
191215755,7,4,6,0,9,26
191215756,3,6,6,5,1,21
191215757,8,6,8,7,8,37
191215758,1,4,2,1,2,10
191215759,9,5,1,5,7,27
191215760,1,2,8,7,3,21
191215761,6,0,9,0,3,18
191215762,5,3,3,6,5,22
191215763,8,2,6,6,2,24
191215764,0,3,0,9,8,20
191215765,5,3,7,2,3,20
191215766,6,1,0,1,5,13
191215767,1,1,5,6,7,20
191215768,9,3,3,5,8,28
191215769,3,3,8,7,6,27
191215770,9,6,5,8,5,33
191215771,2,1,2,6,3,14
191215772,9,2,6,0,7,24
191215773,2,9,5,7,2,25
191215774,7,2,3,9,9,30
191215775,3,0,1,7,5,16
191215776,1,7,4,6,1,19
191215777,4,2,9,7,8,30
191215778,7,2,0,0,3,12
191215779,8,2,5,6,1,22
191215780,6,2,7,2,2,19
191215781,3,6,2,2,4,17
191215782,3,7,7,0,2,19
191215783,7,3,9,2,6,27
191215784,3,6,9,5,4,27
191215785,5,5,6,0,6,22
191215786,8,4,7,7,7,33
191215787,3,0,7,0,9,19
191215788,5,6,4,1,1,17
191215789,3,1,9,1,0,14
191215790,8,4,7,3,0,22
191215791,1,7,4,5,5,22
191215792,8,6,1,7,1,23
191215793,8,8,7,4,5,32
191215794,5,4,4,1,4,18
191215795,4,3,8,8,7,30
191215796,4,8,7,3,5,27
191215797,8,3,9,3,6,29
191215798,8,6,2,6,3,25
191215799,2,9,4,4,9,28
191215800,9,5,0,5,3,22
191215801,7,2,2,7,8,26
191215802,7,1,3,1,1,13
191215803,6,0,9,3,0,18
191215804,6,2,1,4,3,16
191215805,4,9,9,9,3,34
191215806,5,5,9,7,8,34
191215807,2,4,4,0,5,15
191215808,4,9,5,7,0,25
191215809,6,1,2,6,9,24
191215810,2,7,9,6,7,31
191215811,0,1,0,6,7,14
191215812,7,4,0,6,1,18
191215813,9,7,1,1,2,20
191215814,8,9,8,1,1,27
191215815,1,6,7,2,3,19
191215816,4,9,6,0,2,21
191215817,4,7,8,7,8,34
191215818,7,3,2,5,1,18
191215819,6,4,8,1,3,22
191215820,8,1,4,9,1,23
191215821,7,3,9,5,5,29
191215822,0,0,3,9,6,18
191215823,2,6,7,9,3,27
191215824,4,6,2,4,0,16
191215825,6,4,0,9,6,25
191215826,3,7,2,1,5,18
191215827,9,1,1,0,8,19
191215828,9,1,1,5,3,19
191215829,6,4,7,4,3,24
191215830,6,0,8,6,5,25
191215831,3,4,7,1,9,24
191215832,0,9,0,4,3,16
191215833,3,8,3,2,9,25
191215834,5,9,4,5,3,26
191215835,2,3,1,4,8,18
191215836,5,6,2,4,2,19
191215837,8,3,3,0,9,23
191215838,2,8,5,9,3,27
191215839,1,3,8,5,3,20
191215840,0,7,8,5,4,24
191215841,3,2,4,5,0,14
191215842,4,6,1,5,2,18
191215843,7,2,8,1,5,23
191215844,4,8,9,7,1,29
191215845,0,7,9,7,8,31
191215846,1,6,4,9,3,23
191215847,8,0,4,9,5,26
191215848,4,5,1,7,1,18
191215849,8,6,4,7,0,25
191215850,7,8,0,3,8,26
191215851,9,6,5,8,7,35
191215852,7,4,1,2,7,21
191215853,7,8,6,5,8,34
191215854,4,1,5,3,5,18
191215855,7,6,1,9,9,32
191215856,6,3,4,4,5,22
191215857,1,2,2,7,1,13
191215858,3,3,7,0,3,16
191215859,2,6,3,9,3,23
191215860,2,6,6,4,2,20
191215861,6,5,9,8,1,29
191215862,2,8,1,2,5,18
191215863,6,2,2,3,4,17
191215864,4,1,6,5,5,21
191215865,9,3,7,2,6,27
191215866,7,1,8,8,5,29
191215867,9,6,3,0,4,22
191215868,7,4,9,7,6,33
191215869,5,9,6,3,6,29
191215870,8,1,4,9,7,29
191215871,7,4,3,7,2,23
191215872,3,4,4,7,6,24
191215873,5,8,4,5,9,31
191215874,7,2,7,8,1,25
191215875,9,8,9,7,9,42
191215876,8,6,7,9,9,39
191215877,0,7,8,9,3,27
191215878,4,2,9,4,4,23
191215879,4,7,8,1,3,23
191215880,3,8,2,7,0,20
191215881,4,9,7,1,8,29
191215882,1,7,5,5,6,24
191215883,0,3,0,3,1,7
191215884,1,7,4,2,3,17
191215885,4,6,2,7,9,28
191215886,4,9,9,8,7,37
191215887,5,9,4,4,0,22
191215888,2,8,0,8,9,27
191215889,4,6,0,4,0,14
191215890,6,4,0,5,7,22
191215891,9,5,9,7,6,36
191215892,2,3,5,9,7,26
191215893,6,6,5,5,6,28
191215894,0,9,7,2,7,25
191215895,6,8,1,0,2,17
191215896,2,4,8,5,5,24
191215897,5,8,7,8,5,33
191215898,0,5,4,9,1,19
191215899,7,0,9,6,3,25
191215900,9,0,2,0,3,14
191215901,7,8,0,0,3,18
191215902,9,3,5,2,5,24
191215903,6,2,7,3,3,21
191215904,9,1,4,5,4,23
191215905,2,8,4,8,4,26
191215906,5,5,2,0,0,12
191215907,5,4,2,2,4,17
191215908,2,4,8,0,0,14
191215909,4,5,2,1,9,21
191215910,3,9,3,1,4,20
191215911,9,5,7,6,6,33
191215912,1,4,9,5,2,21
191215913,8,0,2,5,3,18
191215914,3,6,9,7,4,29
191215915,1,5,0,1,1,8
191215916,2,1,3,2,1,9
191215917,3,7,0,6,2,18
191215918,2,3,7,5,3,20
191215919,7,8,4,9,7,35
191215920,9,2,5,6,5,27
191215921,7,4,1,7,7,26
191215922,5,7,0,7,5,24
191215923,6,4,0,9,8,27
191215924,3,7,9,3,6,28
191215925,3,7,9,7,7,33
191215926,1,9,5,2,7,24
191215927,8,8,8,3,8,35
191215928,4,4,1,3,7,19
191215929,5,1,2,1,0,9
191215930,3,3,9,8,6,29
191215931,0,8,3,5,7,23
191215932,7,5,0,7,3,22
191215933,3,5,6,9,5,28
191215934,8,9,3,8,6,34
191215935,5,2,4,8,7,26
191215936,1,0,8,6,7,22
191215937,1,4,6,3,8,22
191215938,6,4,0,7,5,22
191215939,1,7,6,5,4,23
191215940,0,4,2,1,8,15
191215941,6,7,4,9,9,35
191215942,4,2,6,7,6,25
191215943,5,7,6,9,1,28
191215944,6,2,9,3,1,21
191215945,8,1,1,0,6,16
191215946,4,0,6,1,1,12
191215947,3,5,8,9,8,33
191215948,8,7,6,7,9,37
191215949,2,1,8,9,0,20
191215950,1,2,9,5,1,18
191215951,7,7,1,1,1,17
191215952,5,7,5,3,4,24
191215953,2,5,4,5,5,21
191215954,7,5,3,2,0,17
191215955,9,3,7,6,4,29
191215956,4,9,5,2,2,22
191215957,1,0,7,7,4,19
191215958,9,9,0,7,8,33
191215959,6,3,9,6,1,25
191215960,3,7,1,2,1,14
191215961,6,7,2,7,1,23
191215962,1,4,0,9,9,23
191215963,9,8,2,1,6,26
191215964,2,5,1,6,2,16
191215965,9,6,5,3,2,25
191215966,8,7,8,0,2,25
191215967,4,6,7,6,0,23
191215968,2,9,8,7,9,35
191215969,6,1,3,5,9,24
191215970,4,0,1,4,4,13
191215971,1,7,2,0,1,11
191215972,6,4,0,3,5,18
191215973,2,7,1,1,7,18
191215974,8,4,6,5,6,29
191215975,7,0,9,8,8,32
191215976,5,6,8,3,7,29
191215977,4,3,5,0,8,20
191215978,1,9,6,9,5,30
191215979,7,4,5,6,9,31
191215980,2,4,8,3,4,21
191215981,9,4,8,2,5,28
191215982,7,0,6,0,7,20
191215983,9,7,7,9,9,41
191215984,1,0,8,5,4,18
191215985,5,1,2,8,8,24
191215986,9,2,8,9,9,37
191215987,1,0,8,2,0,11
191215988,8,3,3,0,1,15
191215989,6,8,1,8,5,28
191215990,8,1,5,3,3,20
191215991,9,0,4,3,1,17
191215992,4,0,3,2,5,14
191215993,5,6,7,0,3,21
191215994,4,0,8,7,0,19
191215995,2,2,5,9,7,25
191215996,7,8,8,1,6,30
191215997,4,8,6,3,9,30
191215998,4,0,3,5,9,21
191215999,4,7,4,2,9,26
1912151000,6,7,8,3,1,25
1912151001,9,5,7,9,6,36
1912151002,3,8,8,8,3,30
1912151003,2,1,2,8,3,16
1912151004,8,7,5,7,6,33
1912151005,2,9,1,3,9,24
1912151006,8,0,1,4,4,17
1912151007,2,6,5,2,6,21
1912151008,3,5,8,1,1,18
1912151009,0,2,2,1,4,9
1912151010,5,7,3,6,4,25
1912151011,8,4,6,1,2,21
1912151012,0,7,1,0,0,8
1912151013,5,8,8,3,0,24
1912151014,8,0,1,7,4,20
1912151015,5,6,5,2,6,24
1912151016,9,4,4,6,0,23
1912151017,5,4,4,7,8,28
1912151018,1,0,2,9,1,13
1912151019,0,5,2,1,6,14
1912151020,8,8,1,8,2,27
1912151021,2,1,1,6,9,19
1912151022,8,8,7,2,6,31
1912151023,4,4,0,1,5,14
1912151024,7,6,9,0,2,24
1912151025,7,5,7,3,2,24
1912151026,9,3,8,0,0,20
1912151027,5,3,1,2,1,12
1912151028,4,6,7,8,8,33
1912151029,5,2,2,5,0,14
1912151030,1,0,3,2,4,10
1912151031,1,7,3,7,7,25
1912151032,1,1,9,0,3,14
1912151033,3,5,7,8,3,26
1912151034,3,3,0,3,8,17
1912151035,8,3,7,7,9,34
1912151036,0,7,8,0,6,21
1912151037,4,2,8,1,8,23
1912151038,1,9,5,7,2,24
1912151039,4,2,9,3,3,21
1912151040,0,9,2,8,6,25
1912151041,9,0,5,8,0,22
1912151042,0,8,1,3,3,15
1912151043,0,0,3,1,2,6
1912151044,2,9,4,2,4,21
1912151045,5,3,6,4,4,22
1912151046,5,4,7,5,1,22
1912151047,8,6,0,0,7,21
1912151048,9,7,5,7,4,32
1912151049,7,5,6,5,9,32
1912151050,9,8,9,1,3,30
1912151051,6,1,9,9,5,30
1912151052,2,2,1,6,8,19
1912151053,0,7,0,3,4,14
1912151054,9,2,0,6,9,26
1912151055,1,6,7,2,2,18
1912151056,9,8,1,2,5,25
1912151057,0,6,6,3,6,21
1912151058,9,4,7,1,2,23
1912151059,6,1,6,6,2,21
1912151060,3,2,3,3,5,16
1912151061,7,2,4,0,7,20
1912151062,9,3,3,7,8,30
1912151063,2,0,3,0,3,8
1912151064,9,7,1,8,8,33
1912151065,3,7,4,0,2,16
1912151066,4,9,3,7,9,32
1912151067,3,4,4,9,8,28
1912151068,5,6,2,0,2,15
1912151069,6,1,1,0,9,17
1912151070,5,0,6,9,5,25
1912151071,4,6,9,5,2,26
1912151072,3,6,9,8,8,34
1912151073,6,1,6,7,3,23
1912151074,3,2,9,9,3,26
1912151075,5,3,2,1,6,17
1912151076,1,2,1,9,9,22
1912151077,7,9,2,5,5,28
1912151078,1,2,6,1,6,16
1912151079,5,8,4,0,6,23
1912151080,0,9,1,2,9,21
1912151081,6,9,2,7,3,27
1912151082,2,4,7,5,5,23
1912151083,4,9,0,6,4,23
1912151084,4,5,1,8,8,26
1912151085,6,6,0,2,6,20
1912151086,6,9,7,3,7,32
1912151087,4,7,7,5,0,23
1912151088,6,1,9,0,5,21
1912151089,1,5,1,9,5,21
1912151090,5,7,2,1,0,15
1912151091,7,0,9,2,2,20
1912151092,6,2,4,5,5,22
1912151093,1,7,7,9,3,27
1912151094,8,5,1,7,3,24
1912151095,9,7,1,4,0,21
1912151096,8,9,2,3,9,31
1912151097,8,8,9,4,8,37
1912151098,4,0,5,3,4,16
1912151099,0,3,9,1,9,22
1912151100,8,8,6,0,2,24
1912151101,5,7,7,8,0,27
1912151102,3,5,2,5,4,19
1912151103,9,6,6,1,8,30
1912151104,7,0,8,6,1,22
1912151105,3,6,8,5,5,27
191216001,4,6,9,2,5,26
191216002,1,4,5,1,6,17
191216003,7,0,1,7,8,23
191216004,2,4,2,8,6,22
191216005,8,6,1,0,7,22
191216006,5,6,3,0,4,18
191216007,8,4,0,0,9,21
191216008,9,7,8,5,2,31
191216009,0,5,3,1,8,17
191216010,3,8,7,7,8,33
191216011,1,5,9,0,3,18
191216012,5,9,5,7,8,34
191216013,8,1,5,5,4,23
191216014,5,3,0,9,2,19
191216015,4,8,0,1,7,20
191216016,2,1,8,7,7,25
191216017,2,1,4,8,7,22
191216018,7,3,2,5,6,23
191216019,0,9,3,7,5,24
191216020,5,4,9,0,2,20
191216021,4,9,7,8,5,33
191216022,3,7,2,4,5,21
191216023,2,5,7,4,6,24
191216024,1,5,1,2,9,18
191216025,8,5,2,9,7,31
191216026,3,2,0,8,6,19
191216027,2,8,7,7,5,29
191216028,3,4,1,6,0,14
191216029,5,1,1,8,2,17
191216030,9,6,0,3,0,18
191216031,5,2,3,4,2,16
191216032,1,8,4,8,9,30
191216033,6,4,3,7,6,26
191216034,9,4,6,3,0,22
191216035,9,0,0,1,0,10
191216036,5,3,3,1,4,16
191216037,0,5,4,6,3,18
191216038,4,5,8,8,2,27
191216039,1,8,0,5,2,16
191216040,4,4,1,7,9,25
191216041,6,4,4,5,3,22
191216042,4,3,3,0,9,19
191216043,1,8,0,3,7,19
191216044,7,7,8,7,3,32
191216045,2,7,5,8,0,22
191216046,7,1,9,0,3,20
191216047,8,1,4,8,7,28
191216048,1,3,3,8,4,19
191216049,6,1,3,9,6,25
191216050,3,2,3,3,3,14
191216051,9,3,2,8,9,31
191216052,7,1,5,2,7,22
191216053,9,5,3,7,6,30
191216054,5,0,0,1,2,8
191216055,2,0,0,6,5,13
191216056,2,8,1,7,5,23
191216057,9,1,3,6,8,27
191216058,4,3,2,2,2,13
191216059,1,5,2,7,7,22
191216060,0,1,1,7,1,10
191216061,9,5,2,6,1,23
191216062,1,9,6,6,4,26
191216063,9,2,8,0,0,19
191216064,8,8,7,4,2,29
191216065,7,3,5,4,9,28
191216066,0,2,2,5,7,16
191216067,3,8,4,8,4,27
191216068,1,5,8,3,1,18
191216069,1,0,2,5,5,13
191216070,4,3,1,7,9,24
191216071,3,0,7,5,3,18
191216072,8,0,7,4,5,24
191216073,3,6,4,8,4,25
191216074,7,6,1,2,8,24
191216075,4,9,1,4,5,23
191216076,0,0,9,6,3,18
191216077,2,1,0,1,8,12
191216078,5,6,7,3,6,27
191216079,3,4,6,0,2,15
191216080,0,7,5,9,6,27
191216081,0,3,7,3,5,18
191216082,7,0,5,6,7,25
191216083,5,4,5,1,7,22
191216084,4,9,2,6,4,25
191216085,4,5,4,5,3,21
191216086,1,5,4,0,3,13
191216087,1,2,1,3,8,15
191216088,8,7,1,1,0,17
191216089,8,4,3,8,6,29
191216090,6,6,7,5,0,24
191216091,3,0,1,3,3,10
191216092,3,9,9,7,2,30
191216093,3,8,3,4,9,27
191216094,4,6,9,7,3,29
191216095,3,0,1,5,1,10
191216096,1,8,7,3,0,19
191216097,4,6,7,4,7,28
191216098,4,0,7,8,7,26
191216099,7,8,3,1,2,21
191216100,8,4,6,2,6,26
191216101,3,7,2,1,1,14
191216102,9,7,6,5,9,36
191216103,2,0,1,9,7,19
191216104,5,0,3,2,6,16
191216105,4,9,6,1,4,24
191216106,4,0,3,9,9,25
191216107,4,8,1,0,1,14
191216108,6,4,4,5,9,28
191216109,2,4,5,8,2,21
191216110,4,8,9,6,3,30
191216111,5,6,9,5,6,31
191216112,3,0,1,7,9,20
191216113,5,0,7,6,1,19
191216114,9,1,1,3,9,23
191216115,4,2,0,3,9,18
191216116,8,5,9,9,5,36
191216117,3,2,9,7,3,24
191216118,9,8,9,2,7,35
191216119,1,8,2,9,4,24
191216120,0,6,3,9,3,21
191216121,0,9,9,5,3,26
191216122,8,7,5,3,7,30
191216123,5,4,2,6,8,25
191216124,9,1,8,1,4,23
191216125,3,0,6,4,9,22
191216126,2,8,0,5,6,21
191216127,3,8,3,5,2,21
191216128,6,6,8,6,9,35
191216129,6,9,7,2,9,33
191216130,2,9,8,8,8,35
191216131,7,2,7,7,0,23
191216132,1,2,7,6,7,23
191216133,3,0,2,4,3,12
191216134,4,6,9,5,9,33
191216135,9,0,1,4,3,17
191216136,6,9,0,8,2,25
191216137,6,1,7,4,9,27
191216138,0,2,5,3,9,19
191216139,9,6,7,1,7,30
191216140,3,1,0,1,0,5
191216141,2,2,1,9,8,22
191216142,7,8,5,2,7,29
191216143,5,0,7,1,9,22
191216144,9,4,0,7,2,22
191216145,9,6,7,2,9,33
191216146,6,2,1,3,3,15
191216147,5,6,7,8,6,32
191216148,0,2,6,8,1,17
191216149,0,6,3,0,9,18
191216150,5,1,9,7,1,23
191216151,4,7,8,6,1,26
191216152,8,6,5,6,8,33
191216153,5,1,2,6,2,16
191216154,3,9,2,6,6,26
191216155,4,3,5,1,0,13
191216156,2,2,0,1,4,9
191216157,5,6,5,3,5,24
191216158,4,2,8,5,2,21
191216159,6,8,8,7,7,36
191216160,6,3,7,2,6,24
191216161,4,2,2,6,6,20
191216162,0,5,7,8,4,24
191216163,2,4,8,3,6,23
191216164,5,4,6,7,4,26
191216165,3,2,3,5,4,17
191216166,6,2,7,2,8,25
191216167,4,9,8,9,8,38
191216168,5,5,2,0,6,18
191216169,0,5,5,5,7,22
191216170,7,6,8,4,0,25
191216171,9,6,8,3,4,30
191216172,5,2,7,1,1,16
191216173,5,8,0,6,0,19
191216174,0,0,4,3,0,7
191216175,7,1,0,0,4,12
191216176,7,4,8,0,0,19
191216177,6,6,5,6,8,31
191216178,8,4,1,0,2,15
191216179,5,7,6,8,6,32
191216180,7,4,3,3,4,21
191216181,7,6,3,2,5,23
191216182,0,6,9,8,6,29
191216183,2,5,2,0,5,14
191216184,9,6,1,7,7,30
191216185,1,4,7,7,5,24
191216186,1,2,7,8,8,26
191216187,3,6,1,0,0,10
191216188,5,4,3,0,4,16
191216189,5,1,3,2,9,20
191216190,5,8,2,6,0,21
191216191,3,8,4,7,1,23
191216192,8,6,5,4,9,32
191216193,7,4,2,6,2,21
191216194,4,7,9,3,4,27
191216195,1,8,3,3,6,21
191216196,0,5,3,2,6,16
191216197,1,7,2,9,7,26
191216198,2,7,5,3,8,25
191216199,6,4,6,5,3,24
191216200,4,5,9,7,2,27
191216201,4,0,6,0,8,18
191216202,1,5,5,6,5,22
191216203,0,8,0,6,9,23
191216204,1,4,3,6,9,23
191216205,5,5,9,8,4,31
191216206,1,9,1,7,7,25
191216207,7,4,0,6,8,25
191216208,4,2,9,2,3,20
191216209,5,6,1,5,2,19
191216210,3,5,9,3,4,24
191216211,3,1,2,6,8,20
191216212,9,2,5,9,2,27
191216213,5,8,7,7,0,27
191216214,2,9,6,9,9,35
191216215,8,3,6,0,2,19
191216216,0,2,5,4,8,19
191216217,0,3,8,0,8,19
191216218,6,1,3,3,3,16
191216219,1,5,5,3,3,17
191216220,9,9,8,9,7,42
191216221,1,9,7,1,7,25
191216222,2,3,0,1,2,8
191216223,0,7,1,1,7,16
191216224,4,5,5,0,3,17
191216225,6,5,4,9,8,32
191216226,1,5,9,4,6,25
191216227,0,5,1,6,4,16
191216228,5,9,5,3,2,24
191216229,8,8,9,9,4,38
191216230,9,6,7,1,4,27
191216231,4,4,3,0,1,12
191216232,1,3,5,5,2,16
191216233,3,1,1,0,2,7
191216234,4,9,8,4,2,27
191216235,7,9,6,5,9,36
191216236,4,3,1,4,1,13
191216237,6,7,1,6,4,24
191216238,7,0,4,6,8,25
191216239,6,7,7,4,3,27
191216240,8,1,5,9,6,29
191216241,2,1,2,1,6,12
191216242,9,3,2,6,5,25
191216243,2,7,7,9,9,34
191216244,3,1,1,1,1,7
191216245,5,2,8,2,5,22
191216246,5,2,8,9,0,24
191216247,0,3,9,0,9,21
191216248,2,5,8,8,8,31
191216249,5,6,5,5,7,28
191216250,6,5,4,9,3,27
191216251,8,7,1,5,2,23
191216252,4,9,2,1,9,25
191216253,0,8,2,4,3,17
191216254,3,1,1,0,5,10
191216255,0,8,0,1,7,16
191216256,7,2,8,5,2,24
191216257,7,2,3,1,0,13
191216258,5,1,7,4,6,23
191216259,0,6,2,9,6,23
191216260,8,9,8,5,0,30
191216261,9,8,4,5,5,31
191216262,7,2,0,1,3,13
191216263,3,7,7,2,5,24
191216264,9,8,5,6,8,36
191216265,2,7,6,6,8,29
191216266,3,5,6,3,5,22
191216267,2,4,0,6,9,21
191216268,5,1,2,4,8,20
191216269,6,8,5,5,6,30
191216270,1,4,6,8,9,28
191216271,6,0,5,6,9,26
191216272,2,9,9,3,9,32
191216273,7,6,5,7,1,26
191216274,7,3,1,0,5,16
191216275,0,7,2,0,7,16
191216276,8,3,7,2,7,27
191216277,5,1,9,5,1,21
191216278,7,3,2,6,4,22
191216279,5,8,4,4,9,30
191216280,3,8,2,8,1,22
191216281,9,7,9,7,8,40
191216282,2,2,7,5,0,16
191216283,1,0,3,7,6,17
191216284,2,8,5,7,1,23
191216285,6,9,2,8,8,33
191216286,1,7,3,6,5,22
191216287,4,0,5,2,3,14
191216288,2,6,1,4,5,18
191216289,8,3,1,1,2,15
191216290,7,6,4,0,1,18
191216291,0,9,1,4,6,20
191216292,5,0,8,8,1,22
191216293,8,4,1,7,6,26
191216294,1,8,4,2,3,18
191216295,4,3,6,8,5,26
191216296,6,8,8,7,5,34
191216297,9,7,1,6,0,23
191216298,6,7,7,6,0,26
191216299,3,1,4,5,0,13
191216300,7,4,7,7,5,30
191216301,7,5,8,7,6,33
191216302,7,3,1,8,4,23
191216303,8,4,3,1,1,17
191216304,6,2,1,3,4,16
191216305,9,0,8,7,4,28
191216306,0,2,1,9,4,16
191216307,6,8,7,5,5,31
191216308,4,2,9,0,2,17
191216309,6,9,6,1,3,25
191216310,8,7,7,7,0,29
191216311,2,9,7,6,8,32
191216312,4,9,0,1,0,14
191216313,1,0,5,0,9,15
191216314,4,6,2,5,5,22
191216315,7,4,2,2,8,23
191216316,7,4,7,2,1,21
191216317,5,4,7,8,4,28
191216318,1,7,4,8,2,22
191216319,2,2,7,2,8,21
191216320,3,5,2,9,5,24
191216321,8,0,6,2,5,21
191216322,6,2,2,7,3,20
191216323,9,4,5,3,6,27
191216324,0,4,4,2,9,19
191216325,7,4,8,3,5,27
191216326,3,5,3,3,5,19
191216327,0,8,1,1,5,15
191216328,1,3,7,1,4,16
191216329,7,8,4,6,9,34
191216330,1,7,8,5,3,24
191216331,8,3,4,8,2,25
191216332,7,6,9,6,6,34
191216333,8,8,8,3,0,27
191216334,8,4,7,8,1,28
191216335,4,8,3,9,4,28
191216336,5,1,9,4,8,27
191216337,4,4,5,7,6,26
191216338,8,5,2,8,8,31
191216339,5,5,9,8,7,34
191216340,2,1,9,2,7,21
191216341,0,9,6,9,7,31
191216342,4,3,2,2,1,12
191216343,7,6,2,0,7,22
191216344,3,3,8,0,5,19
191216345,7,3,9,3,2,24
191216346,5,0,2,6,4,17
191216347,4,6,8,8,3,29
191216348,7,2,4,4,5,22
191216349,9,7,7,9,7,39
191216350,9,1,8,5,5,28
191216351,6,7,5,4,3,25
191216352,9,5,6,4,0,24
191216353,5,9,9,7,3,33
191216354,7,2,8,4,3,24
191216355,9,9,7,7,4,36
191216356,2,2,2,4,6,16
191216357,3,5,1,8,8,25
191216358,2,2,4,2,4,14
191216359,3,7,8,9,5,32
191216360,2,9,0,0,9,20
191216361,8,8,2,1,3,22
191216362,8,0,8,0,3,19
191216363,8,4,0,1,0,13
191216364,0,9,5,1,4,19
191216365,8,2,4,1,9,24
191216366,1,5,0,2,8,16
191216367,0,6,9,9,2,26
191216368,0,3,5,9,7,24
191216369,7,1,1,4,3,16
191216370,5,1,9,6,5,26
191216371,1,3,6,2,5,17
191216372,9,4,0,5,8,26
191216373,3,7,7,8,5,30
191216374,1,5,3,8,1,18
191216375,8,0,6,3,8,25
191216376,3,7,1,4,3,18
191216377,8,5,6,9,2,30
191216378,8,6,7,0,1,22
191216379,4,7,1,4,0,16
191216380,7,0,7,3,1,18
191216381,2,3,7,6,3,21
191216382,9,1,5,7,9,31
191216383,2,3,1,1,0,7
191216384,0,5,3,2,1,11
191216385,0,5,7,4,4,20
191216386,7,1,7,2,9,26
191216387,7,3,1,6,3,20
191216388,6,5,9,9,9,38
191216389,5,4,2,4,3,18
191216390,0,6,6,0,6,18
191216391,7,3,8,2,7,27
191216392,0,1,4,8,5,18
191216393,3,9,1,4,6,23
191216394,2,8,2,8,4,24
191216395,5,0,2,3,9,19
191216396,2,6,9,9,4,30
191216397,2,9,8,1,5,25
191216398,9,7,5,3,7,31
191216399,7,1,9,9,3,29
191216400,6,2,6,3,8,25
191216401,7,0,5,2,9,23
191216402,0,8,5,0,7,20
191216403,7,9,1,5,3,25
191216404,8,8,9,1,2,28
191216405,5,4,5,9,7,30
191216406,6,5,0,2,8,21
191216407,7,0,3,7,4,21
191216408,8,2,4,8,0,22
191216409,3,8,5,4,4,24
191216410,9,6,3,3,8,29
191216411,8,9,1,4,8,30
191216412,3,5,4,6,9,27
191216413,5,7,4,9,7,32
191216414,3,0,1,0,6,10
191216415,9,7,5,5,4,30
191216416,8,5,8,3,0,24
191216417,3,4,2,5,9,23
191216418,0,0,8,6,6,20
191216419,1,3,6,4,2,16
191216420,1,4,5,2,8,20
191216421,1,7,2,4,7,21
191216422,8,9,3,2,6,28
191216423,8,3,7,6,1,25
191216424,7,7,3,2,3,22
191216425,3,4,9,2,7,25
191216426,9,8,4,4,0,25
191216427,3,2,5,6,7,23
191216428,0,6,1,7,4,18
191216429,3,5,3,6,1,18
191216430,2,0,3,4,9,18
191216431,5,7,7,4,7,30
191216432,0,3,1,5,5,14
191216433,9,8,9,0,0,26
191216434,9,3,6,3,3,24
191216435,8,4,6,7,2,27
191216436,6,0,6,8,0,20
191216437,2,2,5,9,6,24
191216438,3,1,1,0,6,11
191216439,0,6,0,6,6,18
191216440,6,4,7,5,3,25
191216441,1,4,6,5,2,18
191216442,8,7,7,1,4,27
191216443,2,9,5,4,1,21
191216444,5,7,5,5,6,28
191216445,7,9,1,3,3,23
191216446,0,5,7,7,2,21
191216447,5,2,7,6,5,25
191216448,6,8,7,4,8,33
191216449,4,5,6,3,5,23
191216450,9,2,4,6,0,21
191216451,6,9,9,0,7,31
191216452,0,6,8,6,7,27
191216453,9,8,2,8,3,30
191216454,6,0,4,7,4,21
191216455,3,0,1,7,0,11
191216456,6,8,5,0,4,23
191216457,8,6,9,8,0,31
191216458,5,7,1,3,3,19
191216459,8,0,6,9,7,30
191216460,5,2,3,7,8,25
191216461,4,0,0,1,4,9
191216462,3,6,4,0,2,15
191216463,8,3,1,2,7,21
191216464,2,0,9,7,6,24
191216465,8,9,9,8,0,34
191216466,2,8,1,9,1,21
191216467,0,0,1,4,3,8
191216468,2,6,2,0,3,13
191216469,9,2,3,3,8,25
191216470,6,3,3,0,1,13
191216471,3,4,1,5,9,22
191216472,3,4,8,6,5,26
191216473,4,3,0,7,6,20
191216474,7,0,9,2,5,23
191216475,5,0,7,1,4,17
191216476,4,1,7,9,9,30
191216477,8,8,0,7,4,27
191216478,2,5,8,8,1,24
191216479,2,4,9,0,2,17
191216480,6,0,7,3,7,23
191216481,6,1,4,8,3,22
191216482,3,2,4,6,7,22
191216483,1,1,2,8,2,14
191216484,4,8,0,6,4,22
191216485,5,1,1,4,2,13
191216486,7,8,6,8,4,33
191216487,1,1,4,7,2,15
191216488,0,1,4,6,5,16
191216489,4,2,6,6,6,24
191216490,3,3,1,1,7,15
191216491,6,8,2,9,1,26
191216492,3,1,9,0,7,20
191216493,4,8,0,9,3,24
191216494,0,1,8,7,4,20
191216495,2,6,4,9,3,24
191216496,3,7,8,6,7,31
191216497,6,4,5,8,9,32
191216498,8,1,7,4,1,21
191216499,0,2,2,4,3,11
191216500,4,5,6,4,9,28
191216501,7,7,3,4,7,28
191216502,0,8,6,0,6,20
191216503,5,4,0,8,5,22
191216504,7,4,8,2,0,21
191216505,3,9,2,0,0,14
191216506,5,3,1,5,3,17
191216507,8,6,2,8,0,24
191216508,1,4,0,2,4,11
191216509,4,3,2,0,1,10
191216510,5,2,8,0,0,15
191216511,9,4,4,7,4,28
191216512,9,4,9,1,5,28
191216513,7,2,8,2,3,22
191216514,7,8,5,7,2,29
191216515,6,2,3,5,2,18
191216516,9,7,7,0,0,23
191216517,5,9,1,7,0,22
191216518,1,0,5,5,0,11
191216519,5,8,7,2,4,26
191216520,0,2,3,6,4,15
191216521,2,6,4,1,8,21
191216522,3,1,2,8,0,14
191216523,0,3,5,4,3,15
191216524,5,0,8,9,7,29
191216525,9,8,9,2,3,31
191216526,6,7,8,4,4,29
191216527,5,8,4,0,0,17
191216528,1,5,5,0,9,20
191216529,3,4,4,8,3,22
191216530,7,6,1,6,8,28
191216531,0,9,2,7,7,25
191216532,6,2,7,1,8,24
191216533,7,3,1,6,2,19
191216534,3,7,5,1,1,17
191216535,4,0,9,2,1,16
191216536,5,7,4,1,7,24
191216537,2,0,5,6,9,22
191216538,9,8,0,0,0,17
191216539,3,6,1,7,4,21
191216540,2,7,6,4,2,21
191216541,7,4,1,6,7,25
191216542,5,1,4,2,8,20
191216543,1,6,8,1,0,16
191216544,2,2,0,1,8,13
191216545,0,3,7,1,0,11
191216546,6,1,5,3,9,24
191216547,8,6,5,4,6,29
191216548,3,4,8,4,4,23
191216549,1,6,1,7,3,18
191216550,2,9,6,5,8,30
191216551,5,3,8,5,0,21
191216552,4,6,6,5,9,30
191216553,1,0,2,9,9,21
191216554,0,3,9,9,6,27
191216555,2,6,9,5,6,28
191216556,8,2,2,5,0,17
191216557,6,9,5,9,5,34
191216558,3,6,1,5,8,23
191216559,5,4,4,0,2,15
191216560,6,7,1,7,8,29
191216561,5,9,0,6,8,28
191216562,0,6,3,8,6,23
191216563,0,7,4,6,9,26
191216564,5,7,0,2,9,23
191216565,7,0,4,2,3,16
191216566,5,0,0,1,8,14
191216567,9,6,6,8,4,33
191216568,3,2,7,8,2,22
191216569,4,8,1,4,0,17
191216570,6,7,6,0,2,21
191216571,1,0,6,1,0,8
191216572,1,2,4,2,4,13
191216573,8,9,6,9,1,33
191216574,5,5,2,2,1,15
191216575,3,8,6,2,6,25
191216576,6,3,5,6,4,24
191216577,2,9,0,2,1,14
191216578,4,1,3,0,8,16
191216579,6,7,6,0,7,26
191216580,5,5,2,0,1,13
191216581,7,5,8,2,5,27
191216582,7,7,0,2,0,16
191216583,9,3,3,4,7,26
191216584,1,2,4,9,4,20
191216585,8,4,5,0,9,26
191216586,8,9,1,8,6,32
191216587,5,6,0,7,4,22
191216588,2,4,0,7,3,16
191216589,3,8,3,8,5,27
191216590,7,5,8,3,1,24
191216591,0,2,6,0,8,16
191216592,9,9,5,3,3,29
191216593,9,0,0,4,4,17
191216594,8,8,4,0,1,21
191216595,4,6,8,7,4,29
191216596,2,4,5,4,0,15
191216597,5,7,9,3,2,26
191216598,5,7,1,8,1,22
191216599,2,9,3,2,1,17
191216600,1,6,3,6,6,22
191216601,3,4,9,0,9,25
191216602,2,7,3,9,4,25
191216603,0,2,7,1,3,13
191216604,2,4,1,1,3,11
191216605,7,5,7,8,0,27
191216606,2,0,4,5,7,18
191216607,7,5,6,1,1,20
191216608,1,2,0,4,6,13
191216609,1,0,5,9,9,24
191216610,9,4,7,7,3,30
191216611,0,0,1,2,7,10
191216612,7,5,5,3,7,27
191216613,6,4,1,2,2,15
191216614,6,3,7,7,8,31
191216615,5,2,1,7,7,22
191216616,8,0,1,3,7,19
191216617,5,1,3,0,0,9
191216618,3,1,0,5,0,9
191216619,6,9,1,4,6,26
191216620,7,7,2,1,6,23
191216621,7,0,9,6,0,22
191216622,3,7,9,6,5,30
191216623,5,3,5,4,5,22
191216624,3,4,8,7,4,26
191216625,4,5,1,3,0,13
191216626,1,8,7,4,9,29
191216627,5,4,5,5,1,20
191216628,2,0,1,2,3,8
191216629,9,2,3,7,6,27
191216630,1,6,9,7,9,32
191216631,3,0,5,5,6,19
191216632,4,3,8,2,7,24
191216633,9,9,9,9,8,44
191216634,5,3,4,9,2,23
191216635,9,3,5,6,2,25
191216636,8,1,4,7,1,21
191216637,5,6,1,6,3,21
191216638,2,5,4,5,7,23
191216639,7,4,6,5,0,22
191216640,0,1,2,8,3,14
191216641,3,4,8,8,1,24
191216642,1,3,6,4,7,21
191216643,0,3,9,8,7,27
191216644,0,8,9,6,9,32
191216645,4,4,1,8,5,22
191216646,9,7,2,9,2,29
191216647,0,9,5,3,4,21
191216648,6,3,7,5,5,26
191216649,8,4,3,0,1,16
191216650,4,2,5,0,4,15
191216651,2,8,8,3,3,24
191216652,8,6,3,1,4,22
191216653,1,2,9,4,5,21
191216654,9,0,7,7,2,25
191216655,4,4,2,0,1,11
191216656,3,9,6,9,7,34
191216657,1,0,6,9,2,18
191216658,6,4,7,3,9,29
191216659,4,7,4,1,2,18
191216660,3,1,2,4,1,11
191216661,1,9,9,8,7,34
191216662,4,6,2,8,5,25
191216663,7,3,5,6,0,21
191216664,6,5,4,7,9,31
191216665,3,3,3,6,0,15
191216666,1,2,8,5,3,19
191216667,2,1,6,7,9,25
191216668,9,0,2,3,9,23
191216669,8,0,3,4,1,16
191216670,9,8,3,4,4,28
191216671,6,4,5,3,3,21
191216672,6,8,0,9,8,31
191216673,3,8,3,2,8,24
191216674,2,2,3,5,2,14
191216675,2,6,8,2,3,21
191216676,7,6,2,0,2,17
191216677,3,8,7,0,5,23
191216678,6,9,9,4,3,31
191216679,8,9,0,7,1,25
191216680,9,5,3,6,8,31
191216681,2,1,3,7,3,16
191216682,3,1,6,9,0,19
191216683,7,8,5,6,6,32
191216684,9,4,5,7,7,32
191216685,4,3,1,1,6,15
191216686,4,8,8,2,6,28
191216687,5,2,4,7,3,21
191216688,7,4,0,6,3,20
191216689,6,7,3,8,8,32
191216690,2,3,3,3,7,18
191216691,6,0,1,7,8,22
191216692,7,7,3,0,0,17
191216693,7,3,4,0,9,23
191216694,0,3,9,0,7,19
191216695,6,9,5,0,2,22
191216696,7,0,1,8,5,21
191216697,6,5,5,0,5,21
191216698,6,4,8,5,5,28
191216699,8,2,8,3,1,22
191216700,2,6,3,4,7,22
191216701,6,0,4,3,4,17
191216702,9,2,6,1,9,27
191216703,4,3,4,9,6,26
191216704,9,2,0,3,5,19
191216705,8,4,7,5,1,25
191216706,8,3,2,0,3,16
191216707,7,6,4,9,2,28
191216708,1,0,0,9,3,13
191216709,8,4,5,3,0,20
191216710,2,1,6,0,7,16
191216711,4,1,2,6,5,18
191216712,8,0,5,0,3,16
191216713,6,7,5,9,7,34
191216714,6,8,9,4,2,29
191216715,3,7,6,9,6,31
191216716,0,1,9,6,6,22
191216717,9,6,9,7,1,32
191216718,9,6,0,2,0,17
191216719,5,7,2,7,2,23
191216720,5,9,7,7,6,34
191216721,4,1,1,0,9,15
191216722,2,2,6,6,5,21
191216723,6,6,9,1,2,24
191216724,6,0,4,2,6,18
191216725,9,1,6,9,6,31
191216726,7,3,4,3,3,20
191216727,0,7,7,8,7,29
191216728,4,9,3,4,2,22
191216729,5,6,4,2,1,18
191216730,9,8,0,6,9,32
191216731,0,0,0,2,5,7
191216732,9,8,5,9,2,33
191216733,0,3,1,6,3,13
191216734,3,1,0,3,5,12
191216735,2,0,4,0,4,10
191216736,9,5,1,4,5,24
191216737,3,6,9,2,4,24
191216738,5,7,2,1,5,20
191216739,4,8,5,1,1,19
191216740,1,7,9,7,2,26
191216741,1,5,0,3,8,17
191216742,5,8,5,1,1,20
191216743,2,5,4,4,6,21
191216744,6,2,0,4,0,12
191216745,7,6,5,2,5,25
191216746,4,2,9,1,4,20
191216747,3,2,6,2,4,17
191216748,7,1,2,7,4,21
191216749,1,3,0,5,0,9
191216750,2,2,7,3,7,21
191216751,2,1,1,8,2,14
191216752,5,0,4,0,0,9
191216753,8,1,2,8,4,23
191216754,0,5,9,5,8,27
191216755,9,8,4,7,4,32
191216756,0,1,1,4,6,12
191216757,9,2,0,8,0,19
191216758,1,2,3,9,4,19
191216759,5,3,0,2,4,14
191216760,8,0,6,3,5,22
191216761,4,7,7,2,0,20
191216762,2,6,1,2,8,19
191216763,2,1,2,2,5,12
191216764,2,9,9,8,2,30
191216765,0,1,0,6,6,13
191216766,9,5,3,3,5,25
191216767,7,4,6,9,3,29
191216768,0,9,0,4,6,19
191216769,1,9,5,8,4,27
191216770,0,7,0,0,3,10
191216771,1,3,1,4,4,13
191216772,2,2,5,8,9,26
191216773,5,6,7,7,5,30
191216774,6,5,1,3,3,18
191216775,7,1,5,4,9,26
191216776,6,1,6,2,8,23
191216777,9,6,7,1,1,24
191216778,2,6,7,6,7,28
191216779,2,9,1,5,5,22
191216780,1,0,0,3,1,5
191216781,8,6,7,9,7,37
191216782,6,1,1,9,2,19
191216783,2,4,7,4,2,19
191216784,4,6,3,6,6,25
191216785,7,6,3,2,8,26
191216786,0,5,2,1,2,10
191216787,6,0,3,5,1,15
191216788,1,1,7,4,3,16
191216789,5,6,9,0,4,24
191216790,8,6,1,6,7,28
191216791,8,4,7,9,4,32
191216792,8,1,1,0,2,12
191216793,0,7,1,4,0,12
191216794,3,3,7,2,5,20
191216795,8,3,8,5,3,27
191216796,7,0,1,1,1,10
191216797,8,9,7,5,3,32
191216798,3,6,1,8,0,18
191216799,8,5,5,2,7,27
191216800,7,7,0,4,1,19
191216801,5,6,9,6,9,35
191216802,1,7,6,9,4,27
191216803,4,1,0,1,2,8
191216804,7,9,3,9,1,29
191216805,9,5,5,1,4,24
191216806,6,7,3,9,9,34
191216807,3,2,7,2,5,19
191216808,3,4,4,4,7,22
191216809,2,3,5,4,6,20
191216810,8,6,3,7,8,32
191216811,5,1,7,7,3,23
191216812,1,4,5,9,6,25
191216813,0,7,5,1,9,22
191216814,9,9,0,9,9,36
191216815,9,6,6,2,1,24
191216816,6,2,7,1,3,19
191216817,0,8,1,8,0,17
191216818,2,4,6,8,1,21
191216819,1,8,2,2,5,18
191216820,0,5,1,2,1,9
191216821,3,9,6,6,2,26
191216822,0,3,2,6,1,12
191216823,7,2,1,1,7,18
191216824,7,7,9,6,3,32
191216825,0,3,1,7,1,12
191216826,3,0,1,6,6,16
191216827,4,0,9,3,1,17
191216828,1,4,7,6,4,22
191216829,4,1,7,8,5,25
191216830,4,6,9,8,3,30
191216831,3,1,7,3,9,23
191216832,8,3,9,0,1,21
191216833,6,7,8,6,8,35
191216834,6,6,1,4,5,22
191216835,3,0,3,0,6,12
191216836,7,0,0,0,4,11
191216837,9,5,1,1,2,18
191216838,5,8,4,6,3,26
191216839,2,4,4,1,5,16
191216840,2,7,6,7,2,24
191216841,2,8,3,0,0,13
191216842,5,4,5,4,0,18
191216843,4,4,4,7,3,22
191216844,4,1,4,2,1,12
191216845,0,2,2,7,3,14
191216846,9,6,0,6,0,21
191216847,3,9,9,3,1,25
191216848,7,4,9,8,2,30
191216849,4,5,1,5,5,20
191216850,8,8,2,0,4,22
191216851,3,3,0,9,5,20
191216852,6,8,1,5,0,20
191216853,5,6,9,8,5,33
191216854,7,4,1,6,9,27
191216855,2,2,8,2,2,16
191216856,0,2,1,3,9,15
191216857,7,9,4,2,1,23
191216858,2,2,8,5,8,25
191216859,5,0,1,5,1,12
191216860,2,9,6,6,7,30
191216861,7,3,1,7,5,23
191216862,4,9,1,6,5,25
191216863,9,3,7,3,6,28
191216864,8,3,1,3,6,21
191216865,6,6,1,9,5,27
191216866,9,3,9,7,5,33
191216867,1,3,2,1,8,15
191216868,2,3,3,1,9,18
191216869,4,9,1,8,8,30
191216870,8,6,8,2,6,30
191216871,9,4,6,1,7,27
191216872,3,8,8,3,7,29
191216873,0,7,9,0,0,16
191216874,1,2,5,2,4,14
191216875,7,1,6,1,6,21
191216876,3,7,5,8,2,25
191216877,7,5,2,5,3,22
191216878,6,6,0,3,3,18
191216879,0,2,0,0,2,4
191216880,9,5,7,9,8,38
191216881,9,6,9,0,9,33
191216882,2,5,2,1,9,19
191216883,9,9,2,9,7,36
191216884,0,2,4,6,9,21
191216885,6,8,3,6,7,30
191216886,1,1,5,0,0,7
191216887,3,7,6,5,4,25
191216888,9,6,2,2,2,21
191216889,5,1,2,8,0,16
191216890,9,6,2,1,6,24
191216891,3,7,4,8,7,29
191216892,2,6,1,5,9,23
191216893,1,2,4,7,1,15
191216894,9,4,2,7,5,27
191216895,8,1,6,2,0,17
191216896,1,1,8,4,7,21
191216897,4,3,6,0,5,18
191216898,3,4,0,3,8,18
191216899,4,2,2,2,8,18
191216900,1,3,2,8,0,14
191216901,3,3,1,6,9,22
191216902,6,7,3,8,2,26
191216903,0,8,4,9,4,25
191216904,4,1,4,0,0,9
191216905,2,0,8,4,4,18
191216906,9,5,9,7,7,37
191216907,4,5,5,1,6,21
191216908,0,1,7,7,6,21
191216909,6,5,2,7,6,26
191216910,6,6,4,4,5,25
191216911,2,1,6,5,5,19
191216912,1,6,4,9,0,20
191216913,1,6,9,3,0,19
191216914,5,9,5,1,6,26
191216915,8,7,7,8,0,30
191216916,3,6,7,9,0,25
191216917,0,0,6,6,7,19
191216918,3,0,2,8,7,20
191216919,3,4,0,7,6,20
191216920,0,7,5,9,5,26
191216921,8,9,5,3,3,28
191216922,2,5,2,6,7,22
191216923,4,4,2,0,8,18
191216924,6,4,0,8,3,21
191216925,7,2,7,4,8,28
191216926,8,1,3,8,9,29
191216927,6,6,5,8,1,26
191216928,3,9,2,0,7,21
191216929,0,7,3,5,9,24
191216930,9,9,5,7,2,32
191216931,8,5,4,0,9,26
191216932,3,7,9,9,0,28
191216933,2,7,7,8,4,28
191216934,2,6,3,3,5,19
191216935,2,2,6,3,4,17
191216936,8,0,4,0,5,17
191216937,7,2,3,8,0,20
191216938,2,0,1,5,1,9
191216939,8,9,1,9,7,34
191216940,8,4,4,6,8,30
191216941,0,6,1,8,0,15
191216942,7,2,2,2,4,17
191216943,4,9,0,5,5,23
191216944,0,5,2,5,1,13
191216945,6,7,0,2,1,16
191216946,6,5,2,2,0,15
191216947,8,2,7,6,9,32
191216948,1,7,5,4,9,26
191216949,4,2,9,8,8,31
191216950,8,7,5,3,6,29
191216951,4,0,4,3,8,19
191216952,0,7,5,5,8,25
191216953,0,9,1,7,8,25
191216954,8,7,2,5,6,28
191216955,9,5,9,5,2,30
191216956,9,2,5,1,1,18
191216957,8,2,2,0,8,20
191216958,3,4,2,9,9,27
191216959,4,7,9,4,8,32
191216960,9,4,8,7,0,28
191216961,5,3,0,1,4,13
191216962,9,8,3,2,8,30
191216963,9,5,9,5,6,34
191216964,1,7,4,2,2,16
191216965,1,4,8,0,4,17
191216966,3,6,0,8,2,19
191216967,4,0,1,4,2,11
191216968,9,8,2,7,2,28
191216969,8,6,8,8,9,39
191216970,0,3,5,6,2,16
191216971,3,9,3,2,9,26
191216972,2,6,7,6,6,27
191216973,7,4,8,9,1,29
191216974,9,7,7,8,6,37
191216975,6,2,7,8,5,28
191216976,5,0,2,6,1,14
191216977,4,9,3,5,4,25
191216978,4,0,3,7,3,17
191216979,8,6,0,9,5,28
191216980,3,5,2,8,5,23
191216981,2,7,2,4,4,19
191216982,2,7,5,2,6,22
191216983,0,3,6,6,3,18
191216984,4,8,2,0,7,21
191216985,0,2,0,1,0,3
191216986,2,1,5,3,8,19
191216987,3,9,4,9,8,33
191216988,0,6,8,0,9,23
191216989,0,3,8,9,8,28
191216990,5,8,3,2,4,22
191216991,0,6,4,2,1,13
191216992,0,5,3,8,0,16
191216993,6,7,6,0,4,23
191216994,6,0,9,4,8,27
191216995,9,3,1,2,9,24
191216996,2,9,5,3,5,24
191216997,5,2,6,8,2,23
191216998,9,6,4,7,4,30
191216999,6,4,7,3,2,22
1912161000,0,6,7,7,5,25
1912161001,7,1,3,8,7,26
1912161002,2,6,6,8,8,30
1912161003,1,5,0,3,5,14
1912161004,0,5,0,3,5,13
1912161005,1,8,0,4,9,22
1912161006,3,4,9,4,2,22
1912161007,1,9,0,3,7,20
1912161008,2,9,3,7,8,29
1912161009,3,2,6,0,7,18
1912161010,3,4,7,4,3,21
1912161011,3,0,7,9,4,23
1912161012,7,5,5,9,3,29
1912161013,1,7,1,9,4,22
1912161014,7,7,8,4,6,32
1912161015,2,5,7,9,0,23
1912161016,2,5,1,9,9,26
1912161017,3,8,7,0,8,26
1912161018,8,0,8,8,2,26
1912161019,8,9,6,6,5,34
1912161020,1,4,4,6,9,24
1912161021,1,9,3,8,8,29
1912161022,7,6,9,5,3,30
1912161023,5,9,9,6,4,33
1912161024,3,5,7,4,1,20
1912161025,3,2,7,7,7,26
1912161026,4,1,3,3,5,16
1912161027,5,9,8,9,3,34
1912161028,5,9,5,9,4,32
1912161029,3,0,9,5,9,26
1912161030,8,5,2,5,5,25
1912161031,1,2,5,0,1,9
1912161032,6,0,2,4,7,19
1912161033,4,3,1,2,2,12
1912161034,5,0,9,2,0,16
1912161035,9,5,6,4,9,33
1912161036,5,0,3,3,1,12
1912161037,2,3,7,5,4,21
1912161038,8,7,8,6,8,37
1912161039,9,2,2,4,0,17
1912161040,1,6,7,0,4,18
1912161041,9,9,3,2,0,23
1912161042,8,1,2,2,4,17
1912161043,5,2,8,6,6,27
1912161044,5,5,6,6,6,28
1912161045,9,0,6,0,0,15
1912161046,7,6,0,2,2,17
1912161047,8,6,9,2,8,33
1912161048,1,6,4,8,9,28
1912161049,4,1,4,3,5,17
1912161050,9,9,7,9,5,39
1912161051,6,7,0,4,3,20
1912161052,2,8,5,1,3,19
1912161053,6,1,8,5,5,25
1912161054,6,6,3,5,0,20
1912161055,0,3,5,3,2,13
1912161056,8,5,3,9,0,25
1912161057,8,5,0,8,1,22
1912161058,2,6,0,9,6,23
1912161059,3,2,2,2,6,15
1912161060,4,3,4,6,0,17
1912161061,7,6,4,0,8,25
1912161062,2,4,8,5,6,25
1912161063,1,4,6,1,0,12
1912161064,7,2,5,4,1,19
1912161065,1,1,0,8,2,12
1912161066,3,6,1,4,7,21
1912161067,5,7,7,9,8,36
1912161068,4,4,8,6,9,31
1912161069,2,5,2,5,9,23
1912161070,0,4,8,5,7,24
1912161071,3,1,4,5,5,18
1912161072,2,6,8,0,0,16
1912161073,7,4,9,1,9,30
1912161074,9,4,3,8,8,32
1912161075,6,2,9,7,8,32
1912161076,5,2,7,6,4,24
1912161077,2,8,4,8,6,28
1912161078,1,7,1,8,4,21
1912161079,9,6,9,2,7,33
1912161080,9,8,9,4,9,39
1912161081,6,7,5,1,9,28
1912161082,6,3,5,5,8,27
1912161083,6,0,6,7,1,20
1912161084,4,1,2,4,5,16
1912161085,1,5,0,8,8,22
1912161086,1,3,0,2,1,7
1912161087,1,9,1,2,2,15
1912161088,2,8,9,4,6,29
1912161089,6,8,3,4,4,25
1912161090,4,1,0,0,5,10
1912161091,0,0,4,5,0,9
1912161092,2,9,3,4,0,18
1912161093,3,1,3,1,5,13
1912161094,2,6,2,1,4,15
1912161095,4,9,7,9,3,32
1912161096,7,9,1,2,3,22
1912161097,7,2,7,7,9,32
1912161098,6,1,0,3,6,16
1912161099,8,2,3,6,4,23
1912161100,9,2,1,4,8,24
1912161101,4,4,4,0,9,21
1912161102,1,8,0,8,1,18
1912161103,0,8,8,6,5,27
1912161104,0,4,5,4,7,20
1912161105,6,0,8,4,4,22
191217001,2,8,5,8,9,32
191217002,8,7,1,9,4,29
191217003,7,3,0,2,3,15
191217004,6,4,5,9,3,27
191217005,9,4,8,3,9,33
191217006,4,7,2,4,3,20
191217007,7,2,5,8,1,23
191217008,6,4,4,9,3,26
191217009,7,3,7,8,7,32
191217010,5,7,5,0,8,25
191217011,5,2,0,8,8,23
191217012,3,7,0,8,8,26
191217013,8,3,2,4,0,17
191217014,0,6,6,7,6,25
191217015,2,9,6,4,6,27
191217016,3,1,5,1,0,10
191217017,8,3,3,9,6,29
191217018,9,9,4,4,4,30
191217019,2,1,8,0,7,18
191217020,8,1,2,1,3,15
191217021,7,1,6,7,1,22
191217022,7,8,2,3,8,28
191217023,6,2,5,8,9,30
191217024,8,4,3,1,6,22
191217025,3,2,2,6,3,16
191217026,0,3,5,7,9,24
191217027,9,8,5,1,3,26
191217028,8,5,5,9,5,32
191217029,0,1,6,1,0,8
191217030,2,2,2,7,9,22
191217031,6,7,2,2,8,25
191217032,8,0,9,9,0,26
191217033,6,5,5,9,3,28
191217034,1,7,7,7,7,29
191217035,5,0,0,7,6,18
191217036,2,5,8,1,1,17
191217037,2,0,6,6,5,19
191217038,3,8,3,8,6,28
191217039,9,6,3,4,8,30
191217040,2,7,1,0,2,12
191217041,1,9,8,8,2,28
191217042,1,0,8,0,3,12
191217043,5,9,1,7,6,28
191217044,1,8,8,6,0,23
191217045,9,1,7,9,6,32
191217046,7,6,2,7,4,26
191217047,3,2,6,0,3,14
191217048,7,8,1,1,0,17
191217049,6,8,9,7,9,39
191217050,7,9,2,3,5,26
191217051,9,1,3,1,2,16
191217052,3,2,4,0,8,17
191217053,6,0,0,2,4,12
191217054,1,8,1,4,1,15
191217055,1,0,7,6,5,19
191217056,5,5,0,1,0,11
191217057,8,4,1,5,3,21
191217058,5,3,4,1,2,15
191217059,3,7,6,3,1,20
191217060,9,0,1,9,1,20
191217061,8,1,7,4,2,22
191217062,4,5,4,2,7,22
191217063,5,8,7,4,1,25
191217064,3,1,8,2,2,16
191217065,0,4,7,8,3,22
191217066,3,0,0,6,3,12
191217067,0,2,3,0,9,14
191217068,2,7,1,7,4,21
191217069,2,5,3,0,4,14
191217070,4,5,0,2,8,19
191217071,8,5,3,1,9,26
191217072,6,1,9,1,6,23
191217073,0,2,1,2,9,14
191217074,6,3,5,8,8,30
191217075,7,5,2,1,7,22
191217076,1,0,5,8,5,19
191217077,9,1,6,8,5,29
191217078,6,6,3,0,9,24
191217079,1,5,2,8,0,16
191217080,2,0,9,0,8,19
191217081,0,1,0,6,5,12
191217082,8,5,5,5,2,25
191217083,5,4,5,4,2,20
191217084,4,5,8,4,9,30
191217085,1,7,1,5,5,19
191217086,4,4,7,2,6,23
191217087,2,2,0,6,3,13
191217088,3,5,1,8,5,22
191217089,7,9,5,1,3,25
191217090,6,7,0,1,1,15
191217091,6,1,0,9,0,16
191217092,7,9,0,8,3,27
191217093,1,6,9,8,7,31
191217094,5,0,9,1,4,19
191217095,4,1,8,6,9,28
191217096,9,2,0,0,7,18
191217097,1,4,2,7,8,22
191217098,4,4,6,2,3,19
191217099,0,2,3,7,7,19
191217100,0,2,4,9,5,20
191217101,3,0,3,3,2,11
191217102,5,7,2,0,0,14
191217103,4,4,2,3,1,14
191217104,6,8,1,4,4,23
191217105,3,4,7,4,8,26
191217106,1,7,0,0,5,13
191217107,0,2,1,6,5,14
191217108,9,7,1,3,0,20
191217109,1,1,3,4,9,18
191217110,5,8,0,5,6,24
191217111,2,6,3,7,5,23
191217112,6,3,3,3,5,20
191217113,2,3,3,9,8,25
191217114,8,9,5,9,5,36
191217115,4,2,7,0,4,17
191217116,1,7,6,0,8,22
191217117,0,9,0,6,1,16
191217118,8,6,9,4,3,30
191217119,6,6,9,3,1,25
191217120,7,5,4,8,2,26
191217121,4,8,9,7,9,37
191217122,2,8,4,9,9,32
191217123,3,9,0,6,4,22
191217124,5,8,3,8,0,24
191217125,4,2,4,9,5,24
191217126,7,6,8,1,8,30
191217127,4,7,3,8,2,24
191217128,1,2,8,7,9,27
191217129,4,2,0,0,9,15
191217130,3,1,0,0,8,12
191217131,4,2,0,6,3,15
191217132,6,8,6,9,4,33
191217133,1,8,1,8,9,27
191217134,1,8,0,6,7,22
191217135,3,4,7,0,4,18
191217136,3,9,4,6,7,29
191217137,1,9,5,0,9,24
191217138,3,5,0,3,9,20
191217139,6,1,9,2,1,19
191217140,5,3,2,9,2,21
191217141,9,5,5,9,4,32
191217142,9,3,6,8,4,30
191217143,9,5,8,5,8,35
191217144,7,6,2,3,7,25
191217145,8,8,5,9,8,38
191217146,0,6,4,1,1,12
191217147,6,2,1,8,9,26
191217148,0,6,3,4,0,13
191217149,1,8,4,9,4,26
191217150,9,5,7,2,6,29
191217151,7,5,3,2,9,26
191217152,9,8,2,4,7,30
191217153,0,8,3,8,1,20
191217154,3,3,0,5,7,18
191217155,0,5,1,1,1,8
191217156,6,5,4,4,9,28
191217157,1,5,4,5,6,21
191217158,9,1,1,0,9,20
191217159,3,9,7,5,9,33
191217160,0,2,7,6,0,15
191217161,3,1,6,0,4,14
191217162,6,8,0,7,5,26
191217163,9,2,0,7,9,27
191217164,2,6,3,5,9,25
191217165,0,8,4,1,8,21
191217166,1,6,5,9,7,28
191217167,9,8,7,2,8,34
191217168,9,5,5,3,3,25
191217169,0,2,4,9,9,24
191217170,4,2,8,6,8,28
191217171,7,4,8,7,6,32
191217172,3,2,3,5,5,18
191217173,2,8,3,5,6,24
191217174,9,9,5,4,7,34
191217175,8,7,3,3,7,28
191217176,9,4,0,3,4,20
191217177,2,8,3,6,5,24
191217178,7,0,1,1,2,11
191217179,4,9,9,2,4,28
191217180,8,6,9,3,8,34
191217181,0,4,7,7,3,21
191217182,9,7,2,4,5,27
191217183,6,8,5,9,3,31
191217184,7,5,3,6,1,22
191217185,0,7,6,1,0,14
191217186,9,6,9,9,4,37
191217187,9,2,3,0,0,14
191217188,2,7,2,4,5,20
191217189,4,9,5,5,7,30
191217190,0,5,2,0,5,12
191217191,5,2,3,9,7,26
191217192,3,5,7,2,6,23
191217193,6,6,4,5,7,28
191217194,8,4,8,9,6,35
191217195,1,4,9,7,9,30
191217196,6,4,2,0,4,16
191217197,6,3,3,8,6,26
191217198,1,1,0,0,2,4
191217199,3,9,1,6,3,22
191217200,7,2,4,4,6,23
191217201,6,5,0,7,2,20
191217202,0,6,8,6,6,26
191217203,1,1,1,5,0,8
191217204,1,6,9,9,7,32
191217205,3,7,3,3,7,23
191217206,7,9,0,3,3,22
191217207,0,6,1,6,8,21
191217208,2,1,0,3,0,6
191217209,4,5,9,3,4,25
191217210,6,2,3,6,1,18
191217211,2,4,4,5,9,24
191217212,6,6,6,4,5,27
191217213,9,9,3,6,1,28
191217214,6,6,9,1,9,31
191217215,9,8,4,4,9,34
191217216,9,1,0,7,2,19
191217217,9,0,4,7,2,22
191217218,0,2,2,2,3,9
191217219,7,1,6,7,2,23
191217220,6,0,4,9,4,23
191217221,8,7,8,9,2,34
191217222,9,8,1,6,9,33
191217223,3,5,0,0,5,13
191217224,2,1,2,8,7,20
191217225,5,7,1,3,0,16
191217226,2,1,5,9,3,20
191217227,3,9,3,4,9,28
191217228,1,9,6,0,8,24
191217229,6,9,3,4,5,27
191217230,0,7,5,8,7,27
191217231,6,6,4,8,5,29
191217232,7,3,5,6,7,28
191217233,6,1,8,4,9,28
191217234,3,9,9,4,0,25
191217235,6,7,7,1,9,30
191217236,0,5,6,2,7,20
191217237,5,3,4,5,8,25
191217238,4,3,0,1,0,8
191217239,5,4,8,4,4,25
191217240,3,6,0,9,5,23
191217241,7,6,1,6,4,24
191217242,7,4,5,6,4,26
191217243,6,3,2,5,2,18
191217244,5,8,1,6,3,23
191217245,0,4,3,5,3,15
191217246,7,9,4,6,9,35
191217247,4,3,7,9,2,25
191217248,9,2,5,7,9,32
191217249,2,4,8,8,2,24
191217250,2,9,7,3,5,26
191217251,0,9,6,5,2,22
191217252,8,4,4,7,5,28
191217253,2,6,9,1,2,20
191217254,0,5,4,5,7,21
191217255,3,0,2,3,8,16
191217256,9,1,8,0,0,18
191217257,3,0,4,8,1,16
191217258,7,0,9,1,0,17
191217259,4,7,0,0,7,18
191217260,5,1,9,2,0,17
191217261,7,0,3,9,5,24
191217262,6,2,1,3,7,19
191217263,1,7,5,8,6,27
191217264,4,6,2,0,5,17
191217265,4,5,1,5,4,19
191217266,6,0,1,3,8,18
191217267,1,3,5,3,7,19
191217268,5,2,6,5,1,19
191217269,1,1,2,3,4,11
191217270,2,4,7,2,0,15
191217271,5,6,4,8,2,25
191217272,3,6,7,9,5,30
191217273,2,2,9,4,5,22
191217274,6,3,6,2,6,23
191217275,2,7,7,3,5,24
191217276,1,9,1,0,1,12
191217277,5,5,0,3,9,22
191217278,8,2,0,2,1,13
191217279,2,2,1,0,1,6
191217280,0,1,3,5,7,16
191217281,9,9,1,3,4,26
191217282,8,5,8,0,2,23
191217283,4,8,7,0,7,26
191217284,7,6,3,7,8,31
191217285,8,9,6,8,7,38
191217286,4,6,9,4,6,29
191217287,1,7,7,0,4,19
191217288,7,9,5,0,8,29
191217289,7,9,5,9,8,38
191217290,9,4,6,4,0,23
191217291,0,4,8,7,7,26
191217292,0,6,4,6,9,25
191217293,1,7,4,6,6,24
191217294,6,3,0,3,0,12
191217295,0,0,5,5,3,13
191217296,4,0,1,5,6,16
191217297,4,1,1,1,0,7
191217298,0,8,3,6,3,20
191217299,3,1,6,5,0,15
191217300,6,7,9,7,8,37
191217301,9,9,5,2,3,28
191217302,7,5,4,4,5,25
191217303,5,0,1,3,4,13
191217304,4,0,9,8,8,29
191217305,8,8,6,1,9,32
191217306,0,4,0,8,3,15
191217307,1,0,8,7,6,22
191217308,4,4,3,5,7,23
191217309,4,1,1,7,7,20
191217310,2,9,4,8,7,30
191217311,7,5,5,7,6,30
191217312,1,2,9,1,0,13
191217313,9,5,9,0,3,26
191217314,7,2,4,5,6,24
191217315,3,4,1,7,9,24
191217316,5,7,1,6,8,27
191217317,8,4,8,5,7,32
191217318,8,7,0,9,3,27
191217319,9,2,2,5,3,21
191217320,5,5,1,9,8,28
191217321,6,2,1,8,3,20
191217322,1,4,1,9,4,19
191217323,4,2,2,0,1,9
191217324,5,8,3,7,4,27
191217325,0,8,9,9,6,32
191217326,7,9,6,0,7,29
191217327,4,5,1,9,2,21
191217328,0,1,5,9,8,23
191217329,6,5,3,2,8,24
191217330,1,1,0,6,6,14
191217331,8,7,5,6,1,27
191217332,1,0,3,6,4,14
191217333,8,0,5,7,9,29
191217334,7,4,6,3,8,28
191217335,2,8,2,6,1,19
191217336,7,6,7,7,7,34
191217337,1,9,5,4,8,27
191217338,7,0,3,0,5,15
191217339,5,0,4,8,6,23
191217340,4,7,6,2,3,22
191217341,4,9,1,3,4,21
191217342,8,7,9,8,2,34
191217343,9,7,2,8,1,27
191217344,7,1,7,5,1,21
191217345,4,5,9,5,1,24
191217346,6,6,6,8,3,29
191217347,3,4,6,8,8,29
191217348,2,6,3,1,0,12
191217349,8,1,4,1,5,19
191217350,2,0,5,3,3,13
191217351,7,1,3,6,0,17
191217352,2,7,9,7,6,31
191217353,6,0,8,9,5,28
191217354,1,3,8,8,9,29
191217355,4,4,5,3,3,19
191217356,7,6,3,3,8,27
191217357,3,7,0,4,4,18
191217358,4,6,2,5,7,24
191217359,9,1,5,3,4,22
191217360,0,5,5,6,4,20
191217361,4,7,0,1,1,13
191217362,2,8,1,6,7,24
191217363,6,1,6,7,8,28
191217364,4,2,7,8,9,30
191217365,6,6,9,5,9,35
191217366,5,1,6,0,2,14
191217367,3,7,5,8,1,24
191217368,3,6,1,4,2,16
191217369,1,2,9,4,9,25
191217370,6,2,8,6,7,29
191217371,5,1,0,8,9,23
191217372,9,7,3,6,7,32
191217373,0,5,4,0,0,9
191217374,3,1,3,3,8,18
191217375,3,5,1,4,3,16
191217376,0,4,8,9,3,24
191217377,8,7,9,0,2,26
191217378,2,0,6,3,2,13
191217379,6,7,5,7,0,25
191217380,8,8,1,6,5,28
191217381,1,8,2,8,6,25
191217382,0,8,5,8,6,27
191217383,8,4,6,6,4,28
191217384,4,5,1,8,2,20
191217385,1,2,0,3,1,7
191217386,9,3,6,4,0,22
191217387,7,0,7,5,5,24
191217388,8,4,9,9,0,30
191217389,2,4,4,0,4,14
191217390,3,9,3,7,2,24
191217391,5,5,7,5,8,30
191217392,5,3,3,5,0,16
191217393,8,5,2,7,9,31
191217394,5,8,3,7,7,30
191217395,3,9,5,2,5,24
191217396,1,8,8,7,5,29
191217397,7,1,0,8,9,25
191217398,6,5,4,6,1,22
191217399,2,8,9,4,5,28
191217400,0,9,7,8,7,31
191217401,4,5,0,4,7,20
191217402,8,4,9,2,2,25
191217403,8,7,4,7,2,28
191217404,7,2,2,0,9,20
191217405,6,6,5,9,4,30
191217406,1,7,4,6,3,21
191217407,7,3,2,4,3,19
191217408,8,9,6,0,7,30
191217409,9,8,8,9,6,40
191217410,0,4,5,1,9,19
191217411,9,2,1,5,2,19
191217412,1,3,9,0,1,14
191217413,3,2,2,0,1,8
191217414,6,9,2,9,7,33
191217415,4,1,1,6,3,15
191217416,0,2,6,1,9,18
191217417,8,4,8,9,2,31
191217418,2,4,8,2,6,22
191217419,8,8,7,5,6,34
191217420,3,7,0,3,4,17
191217421,1,2,7,4,3,17
191217422,2,5,6,5,3,21
191217423,6,4,6,2,5,23
191217424,6,5,9,9,3,32
191217425,0,3,8,7,4,22
191217426,7,3,8,0,9,27
191217427,8,6,5,8,2,29
191217428,3,3,5,3,8,22
191217429,1,1,9,8,2,21
191217430,5,3,1,6,3,18
191217431,9,9,6,4,5,33
191217432,1,5,1,7,6,20
191217433,2,8,9,0,4,23
191217434,7,5,9,8,8,37
191217435,1,9,0,9,8,27
191217436,5,0,5,5,0,15
191217437,5,2,6,0,5,18
191217438,9,9,9,8,5,40
191217439,7,3,0,2,0,12
191217440,4,5,6,1,9,25
191217441,3,6,4,6,4,23
191217442,7,0,8,8,1,24
191217443,2,9,3,5,0,19
191217444,4,3,8,6,2,23
191217445,6,4,3,7,4,24
191217446,5,5,9,1,5,25
191217447,4,3,1,2,3,13
191217448,6,1,7,9,1,24
191217449,6,4,1,6,3,20
191217450,7,2,2,7,3,21
191217451,5,9,2,3,2,21
191217452,3,9,9,4,2,27
191217453,5,0,3,1,5,14
191217454,5,7,5,6,3,26
191217455,0,9,8,0,9,26
191217456,4,4,8,1,6,23
191217457,2,8,2,7,4,23
191217458,9,8,4,9,7,37
191217459,2,7,9,5,5,28
191217460,6,6,0,7,0,19
191217461,9,8,8,5,7,37
191217462,0,1,2,0,5,8
191217463,2,5,9,0,1,17
191217464,7,8,4,2,3,24
191217465,3,9,5,2,3,22
191217466,2,4,7,1,1,15
191217467,1,4,0,2,2,9
191217468,3,8,3,7,8,29
191217469,1,2,7,7,6,23
191217470,2,7,8,1,7,25
191217471,4,9,2,3,0,18
191217472,7,9,1,6,6,29
191217473,0,7,5,9,0,21
191217474,5,5,8,6,0,24
191217475,7,8,6,1,9,31
191217476,4,8,2,5,5,24
191217477,0,9,5,6,3,23
191217478,5,2,8,7,2,24
191217479,5,7,4,7,8,31
191217480,4,4,2,5,7,22
191217481,7,0,3,3,2,15
191217482,0,4,9,5,7,25
191217483,8,9,2,5,6,30
191217484,4,9,6,9,9,37
191217485,6,4,8,4,5,27
191217486,6,5,8,5,5,29
191217487,1,6,1,2,4,14
191217488,9,9,8,2,3,31
191217489,1,9,0,6,7,23
191217490,4,5,0,6,2,17
191217491,5,6,7,2,7,27
191217492,4,2,2,4,5,17
191217493,9,0,7,8,3,27
191217494,2,8,4,0,4,18
191217495,3,8,6,7,8,32
191217496,3,1,8,6,8,26
191217497,4,1,3,2,3,13
191217498,6,8,4,7,8,33
191217499,8,1,0,3,9,21
191217500,9,7,6,3,2,27
191217501,7,5,3,7,0,22
191217502,7,3,3,2,8,23
191217503,3,3,1,2,5,14
191217504,6,3,0,7,4,20
191217505,4,4,2,1,8,19
191217506,1,3,7,7,0,18
191217507,1,8,1,4,8,22
191217508,6,8,1,2,7,24
191217509,1,5,7,2,5,20
191217510,3,8,2,5,5,23
191217511,7,1,1,5,9,23
191217512,0,3,3,7,6,19
191217513,4,8,7,9,7,35
191217514,6,8,1,6,3,24
191217515,3,6,9,4,5,27
191217516,5,9,8,8,7,37
191217517,8,4,4,6,3,25
191217518,0,2,0,5,5,12
191217519,3,7,9,9,6,34
191217520,8,4,3,9,2,26
191217521,7,0,6,2,8,23
191217522,6,5,3,2,0,16
191217523,5,9,5,0,7,26
191217524,9,3,2,9,9,32
191217525,8,6,1,6,0,21
191217526,6,7,4,7,4,28
191217527,2,5,6,8,5,26
191217528,2,5,7,1,6,21
191217529,3,4,5,2,6,20
191217530,6,4,1,3,0,14
191217531,5,5,1,8,8,27
191217532,5,5,3,8,0,21
191217533,4,8,6,0,7,25
191217534,8,4,2,5,3,22
191217535,9,4,9,8,5,35
191217536,1,1,2,3,7,14
191217537,2,4,2,6,6,20
191217538,9,9,6,9,0,33
191217539,4,1,1,4,5,15
191217540,4,6,1,4,1,16
191217541,0,1,0,5,7,13
191217542,8,9,0,7,5,29
191217543,2,8,9,1,6,26
191217544,5,4,6,5,1,21
191217545,1,4,7,6,3,21
191217546,3,3,9,8,7,30
191217547,4,4,1,3,8,20
191217548,9,9,6,8,7,39
191217549,4,1,5,7,8,25
191217550,5,5,7,4,3,24
191217551,9,8,7,4,8,36
191217552,2,2,0,5,3,12
191217553,5,1,8,5,0,19
191217554,5,0,4,9,8,26
191217555,5,1,0,4,4,14
191217556,7,5,5,5,4,26
191217557,5,3,0,3,9,20
191217558,0,7,2,1,9,19
191217559,7,3,9,3,9,31
191217560,4,8,6,8,9,35
191217561,3,3,5,1,2,14
191217562,8,5,9,1,6,29
191217563,3,7,4,8,9,31
191217564,8,6,2,8,8,32
191217565,5,2,3,4,8,22
191217566,5,3,2,5,7,22
191217567,9,9,3,2,8,31
191217568,4,1,5,2,8,20
191217569,0,2,1,1,7,11
191217570,0,5,4,0,5,14
191217571,5,1,1,5,5,17
191217572,5,8,2,9,7,31
191217573,3,3,2,0,8,16
191217574,2,0,4,1,1,8
191217575,5,6,2,0,5,18
191217576,8,7,5,7,7,34
191217577,0,3,3,7,8,21
191217578,3,5,6,3,3,20
191217579,0,3,2,7,1,13
191217580,9,9,4,3,5,30
191217581,4,5,4,6,5,24
191217582,5,5,6,4,4,24
191217583,3,6,3,4,6,22
191217584,0,9,2,5,5,21
191217585,9,4,8,3,4,28
191217586,1,4,9,0,2,16
191217587,9,2,5,7,0,23
191217588,3,7,1,4,1,16
191217589,4,1,5,0,1,11
191217590,9,9,7,2,1,28
191217591,3,2,8,7,0,20
191217592,0,3,6,5,9,23
191217593,2,0,5,2,6,15
191217594,5,1,3,7,1,17
191217595,6,2,2,1,7,18
191217596,2,6,0,1,9,18
191217597,6,6,3,2,4,21
191217598,7,1,8,3,7,26
191217599,4,3,5,2,6,20
191217600,1,1,7,3,5,17
191217601,9,1,9,7,0,26
191217602,5,0,1,5,2,13
191217603,9,7,7,1,5,29
191217604,5,4,6,0,6,21
191217605,7,6,2,8,1,24
191217606,1,8,7,8,7,31
191217607,3,5,4,1,3,16
191217608,5,6,5,5,9,30
191217609,7,6,2,6,9,30
191217610,0,4,5,8,4,21
191217611,2,5,7,6,1,21
191217612,4,8,0,4,4,20
191217613,4,7,5,5,1,22
191217614,9,2,9,0,4,24
191217615,1,4,6,5,8,24
191217616,8,8,2,8,3,29
191217617,7,3,6,9,1,26
191217618,5,8,4,4,7,28
191217619,5,7,0,0,6,18
191217620,9,3,7,0,9,28
191217621,5,8,4,4,5,26
191217622,4,9,8,0,0,21
191217623,7,3,8,5,2,25
191217624,7,1,2,4,2,16
191217625,5,3,0,8,1,17
191217626,5,6,2,0,7,20
191217627,7,5,3,9,0,24
191217628,1,2,8,0,1,12
191217629,5,9,4,4,7,29
191217630,2,2,0,3,1,8
191217631,1,4,3,2,9,19
191217632,9,5,3,2,5,24
191217633,0,3,3,8,2,16
191217634,6,2,5,7,8,28
191217635,1,5,5,9,7,27
191217636,2,9,8,7,0,26
191217637,1,1,9,5,2,18
191217638,5,0,3,1,8,17
191217639,8,3,9,1,2,23
191217640,8,2,8,3,4,25
191217641,1,8,2,5,4,20
191217642,5,5,8,1,3,22
191217643,5,1,6,8,6,26
191217644,2,8,6,8,9,33
191217645,2,3,0,6,4,15
191217646,1,7,6,3,1,18
191217647,2,4,2,2,9,19
191217648,8,2,4,8,8,30
191217649,8,1,3,3,4,19
191217650,1,8,7,4,8,28
191217651,9,5,1,8,7,30
191217652,3,3,0,0,8,14
191217653,6,8,7,6,5,32
191217654,2,5,2,7,4,20
191217655,8,0,1,5,6,20
191217656,6,0,1,0,1,8
191217657,9,0,9,6,8,32
191217658,3,5,8,0,1,17
191217659,9,3,5,6,0,23
191217660,1,4,4,1,2,12
191217661,6,3,3,0,8,20
191217662,2,7,9,8,0,26
191217663,8,6,2,2,8,26
191217664,5,8,5,4,4,26
191217665,9,6,3,5,8,31
191217666,8,6,6,8,2,30
191217667,7,4,5,2,0,18
191217668,6,8,0,7,6,27
191217669,6,1,9,6,6,28
191217670,2,5,9,2,0,18
191217671,2,3,1,1,7,14
191217672,4,1,1,4,6,16
191217673,2,5,3,0,8,18
191217674,3,6,7,3,7,26
191217675,0,7,5,8,4,24
191217676,2,2,6,8,6,24
191217677,3,0,6,7,2,18
191217678,9,4,5,3,5,26
191217679,2,3,0,4,6,15
191217680,4,1,3,2,4,14
191217681,9,7,5,5,8,34
191217682,1,6,7,9,7,30
191217683,2,6,5,9,9,31
191217684,6,6,6,6,5,29
191217685,0,1,8,0,4,13
191217686,9,6,5,1,8,29
191217687,8,5,1,2,2,18
191217688,6,7,6,5,7,31
191217689,5,8,0,9,0,22
191217690,0,0,2,7,9,18
191217691,2,6,7,6,4,25
191217692,8,1,3,9,2,23
191217693,2,8,6,0,7,23
191217694,1,0,6,9,3,19
191217695,3,7,3,8,0,21
191217696,1,7,7,5,0,20
191217697,5,5,3,2,3,18
191217698,8,9,9,0,4,30
191217699,8,4,6,3,9,30
191217700,8,7,1,2,4,22
191217701,5,5,6,6,9,31
191217702,6,6,6,2,3,23
191217703,4,0,5,6,5,20
191217704,5,4,1,1,7,18
191217705,0,4,3,5,4,16
191217706,9,6,8,1,6,30
191217707,8,8,1,1,9,27
191217708,0,4,9,9,1,23
191217709,5,4,1,5,1,16
191217710,3,7,9,8,7,34
191217711,7,5,8,1,6,27
191217712,6,2,2,8,3,21
191217713,1,6,0,5,3,15
191217714,7,9,8,2,2,28
191217715,6,5,8,4,4,27
191217716,9,7,8,3,9,36
191217717,3,0,2,0,5,10
191217718,5,6,5,0,8,24
191217719,4,3,6,4,2,19
191217720,4,5,9,9,6,33
191217721,1,7,3,1,5,17
191217722,2,1,4,7,9,23
191217723,1,8,1,3,0,13
191217724,6,7,1,5,0,19
191217725,3,0,0,4,0,7
191217726,6,1,0,5,2,14
191217727,6,0,3,4,5,18
191217728,6,4,0,9,5,24
191217729,6,1,1,2,4,14
191217730,3,2,1,9,5,20
191217731,1,6,0,2,4,13
191217732,2,9,2,6,3,22
191217733,5,2,3,2,7,19
191217734,4,0,1,5,1,11
191217735,6,3,4,4,6,23
191217736,5,2,2,2,9,20
191217737,2,0,3,2,1,8
191217738,4,0,0,3,0,7
191217739,2,1,3,1,7,14
191217740,1,9,2,7,8,27
191217741,5,2,0,7,4,18
191217742,0,2,3,4,6,15
191217743,0,8,4,4,9,25
191217744,2,0,5,3,7,17
191217745,7,5,7,6,8,33
191217746,5,6,1,4,4,20
191217747,6,6,2,4,2,20
191217748,3,5,0,3,2,13
191217749,4,6,6,2,6,24
191217750,0,4,8,0,7,19
191217751,3,2,3,3,1,12
191217752,9,8,0,9,7,33
191217753,4,9,6,1,7,27
191217754,4,2,2,1,8,17
191217755,0,0,9,2,4,15
191217756,6,7,8,2,0,23
191217757,1,5,9,8,5,28
191217758,0,0,9,7,9,25
191217759,1,3,9,2,6,21
191217760,7,3,6,8,6,30
191217761,2,0,7,0,9,18
191217762,9,2,0,6,4,21
191217763,8,4,0,4,3,19
191217764,8,7,4,5,3,27
191217765,5,7,9,9,6,36
191217766,2,0,1,9,0,12
191217767,9,4,9,0,0,22
191217768,6,9,4,6,2,27
191217769,1,7,5,2,6,21
191217770,8,4,6,7,1,26
191217771,8,3,2,9,9,31
191217772,4,4,1,0,6,15
191217773,0,2,0,5,3,10
191217774,9,4,7,2,2,24
191217775,1,2,9,5,6,23
191217776,2,7,5,5,8,27
191217777,2,1,6,9,1,19
191217778,1,3,6,4,1,15
191217779,1,7,9,6,7,30
191217780,9,9,8,7,6,39
191217781,2,5,5,8,3,23
191217782,4,0,1,7,9,21
191217783,2,9,9,2,9,31
191217784,7,7,7,5,2,28
191217785,0,3,1,6,7,17
191217786,1,2,6,1,3,13
191217787,0,3,0,5,1,9
191217788,5,0,8,6,3,22
191217789,5,1,9,3,9,27
191217790,7,8,0,9,9,33
191217791,8,7,6,7,3,31
191217792,6,6,7,3,0,22
191217793,3,8,9,7,7,34
191217794,3,0,0,2,3,8
191217795,6,5,6,3,6,26
191217796,0,5,6,7,3,21
191217797,6,7,4,6,2,25
191217798,1,5,7,7,2,22
191217799,1,5,2,2,2,12
191217800,2,2,5,8,8,25
191217801,6,1,5,4,8,24
191217802,5,9,8,0,5,27
191217803,5,1,7,1,7,21
191217804,5,2,5,2,2,16
191217805,6,6,1,9,6,28
191217806,5,4,1,3,5,18
191217807,4,1,9,7,7,28
191217808,5,9,4,7,6,31
191217809,0,3,1,9,0,13
191217810,7,4,9,6,3,29
191217811,7,3,0,1,7,18
191217812,4,4,7,1,8,24
191217813,0,0,8,8,0,16
191217814,6,7,8,3,6,30
191217815,1,2,0,8,6,17
191217816,9,1,8,5,3,26
191217817,0,6,9,6,8,29
191217818,0,4,7,2,0,13
191217819,5,4,6,3,4,22
191217820,6,9,4,5,8,32
191217821,5,6,5,4,7,27
191217822,0,9,8,6,0,23
191217823,7,5,4,0,0,16
191217824,4,8,6,7,4,29
191217825,1,7,7,8,0,23
191217826,2,2,9,0,5,18
191217827,6,6,3,7,0,22
191217828,7,2,9,4,4,26
191217829,8,1,5,4,1,19
191217830,5,8,1,5,6,25
191217831,0,0,6,1,3,10
191217832,8,4,8,4,4,28
191217833,5,7,2,6,0,20
191217834,9,6,1,0,9,25
191217835,4,5,0,0,8,17
191217836,5,2,9,7,4,27
191217837,0,0,5,9,8,22
191217838,7,5,7,5,9,33
191217839,7,7,7,4,1,26
191217840,3,2,6,1,9,21
191217841,9,3,7,9,8,36
191217842,8,8,4,4,7,31
191217843,5,2,7,8,9,31
191217844,0,2,8,8,3,21
191217845,7,2,9,6,4,28
191217846,0,6,6,1,1,14
191217847,8,7,6,2,2,25
191217848,6,8,5,9,0,28
191217849,9,9,3,9,5,35
191217850,1,2,8,2,8,21
191217851,8,4,7,6,9,34
191217852,4,8,8,7,7,34
191217853,4,4,0,4,0,12
191217854,7,4,4,5,2,22
191217855,8,0,1,4,2,15
191217856,1,8,8,2,9,28
191217857,5,8,2,5,9,29
191217858,9,2,0,8,2,21
191217859,9,8,7,4,0,28
191217860,0,2,3,0,7,12
191217861,4,1,8,4,3,20
191217862,2,3,4,4,8,21
191217863,7,9,3,8,2,29
191217864,0,2,0,9,4,15
191217865,8,4,3,1,3,19
191217866,9,6,4,6,0,25
191217867,2,1,8,6,4,21
191217868,3,7,3,6,1,20
191217869,6,1,0,4,3,14
191217870,1,4,6,7,4,22
191217871,4,6,7,6,9,32
191217872,3,0,3,2,9,17
191217873,3,4,7,8,8,30
191217874,5,7,1,0,7,20
191217875,7,3,6,9,4,29
191217876,0,1,5,5,1,12
191217877,9,7,6,5,1,28
191217878,8,2,4,8,3,25
191217879,6,7,3,7,1,24
191217880,3,5,2,8,8,26
191217881,1,5,1,7,0,14
191217882,0,5,7,0,0,12
191217883,4,9,3,4,3,23
191217884,0,8,0,0,8,16
191217885,3,1,4,7,8,23
191217886,6,3,4,7,5,25
191217887,5,0,9,7,9,30
191217888,4,5,7,7,9,32
191217889,2,8,0,6,8,24
191217890,7,7,3,7,0,24
191217891,3,3,9,5,3,23
191217892,7,9,2,7,3,28
191217893,2,6,8,6,2,24
191217894,8,7,7,6,9,37
191217895,7,3,3,9,4,26
191217896,3,9,5,6,9,32
191217897,2,9,1,1,2,15
191217898,4,5,5,4,1,19
191217899,3,6,8,6,1,24
191217900,2,0,6,5,8,21
191217901,3,1,2,6,6,18
191217902,7,8,0,5,8,28
191217903,1,2,7,3,6,19
191217904,0,5,0,9,8,22
191217905,1,5,6,5,7,24
191217906,9,8,3,0,2,22
191217907,2,0,5,7,4,18
191217908,5,0,3,9,5,22
191217909,1,5,5,4,6,21
191217910,1,9,0,8,3,21
191217911,8,4,9,2,1,24
191217912,7,7,2,9,1,26
191217913,3,3,6,4,5,21
191217914,9,2,5,3,4,23
191217915,1,0,4,3,6,14
191217916,6,6,5,8,2,27
191217917,4,6,2,7,6,25
191217918,7,8,6,7,2,30
191217919,8,7,5,7,9,36
191217920,1,4,4,9,4,22
191217921,9,0,1,8,2,20
191217922,4,5,7,7,1,24
191217923,8,7,7,6,1,29
191217924,9,1,5,2,4,21
191217925,8,5,7,8,5,33
191217926,4,8,9,3,3,27
191217927,3,9,9,8,9,38
191217928,1,0,6,2,4,13
191217929,8,8,9,0,2,27
191217930,0,1,2,4,8,15
191217931,7,5,2,5,2,21
191217932,5,0,5,5,5,20
191217933,3,2,3,6,6,20
191217934,1,8,5,3,7,24
191217935,0,9,7,2,5,23
191217936,6,6,8,7,5,32
191217937,5,7,4,4,1,21
191217938,3,2,8,0,0,13
191217939,8,5,5,5,1,24
191217940,4,8,9,9,8,38
191217941,0,5,6,7,6,24
191217942,4,8,3,6,0,21
191217943,0,1,9,7,6,23
191217944,3,8,4,4,1,20
191217945,3,0,4,5,0,12
191217946,4,6,2,6,3,21
191217947,2,6,5,9,5,27
191217948,0,5,1,9,7,22
191217949,5,2,5,1,4,17
191217950,3,7,0,9,6,25
191217951,8,8,4,1,5,26
191217952,8,0,7,4,9,28
191217953,6,5,6,0,8,25
191217954,3,0,4,2,3,12
191217955,7,5,0,2,1,15
191217956,3,5,5,8,7,28
191217957,5,9,6,4,8,32
191217958,4,4,9,6,8,31
191217959,9,4,8,1,4,26
191217960,0,3,2,5,1,11
191217961,9,6,7,9,8,39
191217962,5,8,4,5,3,25
191217963,0,8,1,7,5,21
191217964,5,1,0,0,7,13
191217965,9,3,8,7,2,29
191217966,8,7,9,2,6,32
191217967,1,5,6,8,1,21
191217968,3,5,6,1,8,23
191217969,9,7,3,0,8,27
191217970,8,3,5,9,0,25
191217971,2,1,6,4,7,20
191217972,1,5,6,3,2,17
191217973,2,2,0,6,5,15
191217974,1,6,4,1,4,16
191217975,6,4,2,2,3,17
191217976,6,7,7,0,6,26
191217977,0,0,2,7,7,16
191217978,4,4,4,2,2,16
191217979,6,4,3,2,7,22
191217980,7,7,9,9,2,34
191217981,8,7,1,8,9,33
191217982,1,3,2,0,1,7
191217983,8,4,9,8,0,29
191217984,6,3,6,2,8,25
191217985,7,1,0,6,0,14
191217986,0,9,5,2,2,18
191217987,0,0,1,0,9,10
191217988,7,8,8,8,0,31
191217989,9,5,8,8,1,31
191217990,8,6,6,3,0,23
191217991,2,6,3,7,0,18
191217992,8,8,4,8,4,32
191217993,7,4,2,4,6,23
191217994,7,8,1,2,6,24
191217995,6,0,2,3,0,11
191217996,5,6,0,9,0,20
191217997,5,7,3,5,8,28
191217998,3,8,2,2,1,16
191217999,6,0,5,2,3,16
1912171000,6,6,7,8,1,28
1912171001,5,1,7,0,4,17
1912171002,5,0,1,1,9,16
1912171003,9,4,3,4,1,21
1912171004,2,6,6,9,2,25
1912171005,1,8,2,7,9,27
1912171006,7,2,9,0,7,25
1912171007,8,3,7,2,6,26
1912171008,9,1,0,7,7,24
1912171009,4,4,4,2,0,14
1912171010,8,6,8,4,9,35
1912171011,2,2,3,0,4,11
1912171012,7,7,6,9,1,30
1912171013,5,0,0,3,4,12
1912171014,6,1,4,1,2,14
1912171015,4,3,9,5,6,27
1912171016,4,0,6,1,9,20
1912171017,7,9,4,4,4,28
1912171018,0,7,5,7,6,25
1912171019,9,3,6,2,5,25
1912171020,0,8,4,9,5,26
1912171021,9,0,5,0,5,19
1912171022,2,6,7,7,2,24
1912171023,1,1,3,8,5,18
1912171024,2,1,1,6,4,14
1912171025,1,8,4,8,3,24
1912171026,4,7,1,4,8,24
1912171027,7,0,3,7,6,23
1912171028,4,1,5,1,3,14
1912171029,2,7,6,7,5,27
1912171030,2,9,2,5,0,18
1912171031,4,1,7,2,3,17
1912171032,9,7,0,7,7,30
1912171033,0,8,4,0,9,21
1912171034,7,2,9,8,4,30
1912171035,7,1,3,6,4,21
1912171036,3,9,5,5,0,22
1912171037,1,1,7,9,6,24
1912171038,6,9,2,8,4,29
1912171039,2,5,7,7,6,27
1912171040,5,4,8,0,8,25
1912171041,1,0,1,8,6,16
1912171042,5,2,6,6,2,21
1912171043,7,1,1,8,5,22
1912171044,4,8,8,3,0,23
1912171045,3,6,5,0,3,17
1912171046,9,1,4,9,1,24
1912171047,9,6,2,0,6,23
1912171048,6,7,0,7,0,20
1912171049,6,8,5,3,1,23
1912171050,7,9,2,8,8,34
1912171051,4,2,2,9,0,17
1912171052,5,7,5,3,3,23
1912171053,9,5,7,3,0,24
1912171054,8,7,2,7,3,27
1912171055,1,5,6,4,7,23
1912171056,9,7,6,9,4,35
1912171057,0,1,4,5,5,15
1912171058,2,8,7,3,8,28
1912171059,7,5,1,7,7,27
1912171060,2,9,0,9,7,27
1912171061,1,5,9,0,1,16
1912171062,0,0,1,1,3,5
1912171063,7,7,3,1,9,27
1912171064,5,7,7,7,4,30
1912171065,5,8,8,3,4,28
1912171066,3,3,3,0,0,9
1912171067,6,3,8,5,4,26
1912171068,7,2,5,3,6,23
1912171069,2,8,6,1,7,24
1912171070,0,3,3,5,7,18
1912171071,2,6,4,8,5,25
1912171072,5,2,8,7,3,25
1912171073,8,9,0,8,7,32
1912171074,8,3,6,5,5,27
1912171075,2,7,7,9,1,26
1912171076,0,5,8,4,4,21
1912171077,6,2,8,1,4,21
1912171078,8,6,1,6,5,26
1912171079,4,3,0,7,2,16
1912171080,2,8,0,9,0,19
1912171081,8,3,7,1,0,19
1912171082,0,4,6,8,3,21
1912171083,0,6,6,6,6,24
1912171084,4,2,8,4,4,22
1912171085,0,9,3,2,4,18
1912171086,4,6,5,4,5,24
1912171087,8,4,9,7,9,37
1912171088,5,4,8,5,5,27
1912171089,9,7,4,7,2,29
1912171090,4,9,7,5,5,30
1912171091,5,5,5,5,9,29
1912171092,2,0,2,6,1,11
1912171093,5,1,1,1,1,9
1912171094,7,0,1,6,2,16
1912171095,8,9,9,4,1,31
1912171096,4,2,5,9,3,23
1912171097,2,2,4,2,3,13
1912171098,9,0,8,7,2,26
1912171099,9,5,7,3,9,33
1912171100,0,7,5,7,4,23
1912171101,0,8,6,0,0,14
1912171102,8,6,0,0,4,18
1912171103,8,4,4,4,1,21
1912171104,9,2,3,3,3,20
1912171105,9,0,6,1,6,22
191218001,5,6,7,0,4,22
191218002,3,8,3,7,4,25
191218003,5,8,6,0,9,28
191218004,5,6,1,8,7,27
191218005,0,5,5,5,6,21
191218006,0,8,5,2,2,17
191218007,0,0,7,1,6,14
191218008,6,3,6,2,4,21
191218009,6,1,9,8,2,26
191218010,1,5,3,7,1,17
191218011,0,2,1,4,1,8
191218012,4,7,7,7,8,33
191218013,6,7,9,9,6,37
191218014,2,6,9,0,8,25
191218015,2,9,5,1,9,26
191218016,8,9,7,9,0,33
191218017,9,3,2,8,6,28
191218018,4,6,7,7,9,33
191218019,4,1,4,7,1,17
191218020,3,6,7,0,0,16
191218021,3,6,4,0,1,14
191218022,5,8,2,0,6,21
191218023,4,7,0,5,4,20
191218024,9,4,2,4,1,20
191218025,3,1,5,4,6,19
191218026,0,3,8,6,7,24
191218027,0,4,1,4,0,9
191218028,2,8,0,0,1,11
191218029,5,9,0,2,8,24
191218030,3,8,1,7,2,21
191218031,5,9,4,6,1,25
191218032,3,2,9,9,6,29
191218033,0,9,3,1,7,20
191218034,7,3,3,3,7,23
191218035,5,9,7,4,4,29
191218036,3,7,2,0,5,17
191218037,8,8,2,5,2,25
191218038,4,8,7,2,5,26
191218039,0,6,2,0,8,16
191218040,0,0,9,2,1,12
191218041,9,5,8,9,3,34
191218042,2,4,6,5,5,22
191218043,1,9,3,0,3,16
191218044,5,8,1,7,6,27
191218045,2,8,2,5,7,24
191218046,2,5,9,3,1,20
191218047,1,0,6,7,4,18
191218048,4,5,2,2,5,18
191218049,9,8,7,4,4,32
191218050,9,2,5,0,3,19
191218051,5,9,4,5,0,23
191218052,8,8,4,0,8,28
191218053,7,6,3,2,1,19
191218054,2,3,3,6,0,14
191218055,8,5,4,5,2,24
191218056,0,7,9,8,8,32
191218057,1,7,6,8,9,31
191218058,3,2,8,5,3,21
191218059,1,2,8,5,8,24
191218060,5,3,0,7,7,22
191218061,3,2,9,8,4,26
191218062,1,7,5,1,8,22
191218063,8,8,1,0,6,23
191218064,9,2,4,6,9,30
191218065,6,7,4,1,3,21
191218066,8,5,6,4,6,29
191218067,2,2,8,0,9,21
191218068,7,7,1,7,1,23
191218069,6,3,9,1,8,27
191218070,4,0,4,5,9,22
191218071,4,1,3,3,1,12
191218072,0,2,1,3,5,11
191218073,6,3,5,9,2,25
191218074,1,8,0,8,5,22
191218075,8,6,8,5,2,29
191218076,2,3,2,2,7,16
191218077,3,5,5,5,1,19
191218078,3,7,0,5,1,16
191218079,0,1,3,6,5,15
191218080,7,6,3,3,7,26
191218081,2,2,6,1,4,15
191218082,6,5,8,6,2,27
191218083,4,9,6,0,4,23
191218084,9,1,1,7,0,18
191218085,6,1,8,7,9,31
191218086,4,4,0,1,0,9
191218087,1,5,2,9,9,26
191218088,5,7,9,0,4,25
191218089,9,5,2,3,1,20
191218090,5,9,9,0,1,24
191218091,9,8,1,7,1,26
191218092,9,7,3,7,5,31
191218093,9,2,5,5,8,29
191218094,8,1,9,3,6,27
191218095,8,4,4,3,3,22
191218096,6,7,9,4,7,33
191218097,3,2,2,9,6,22
191218098,0,5,2,1,6,14
191218099,1,1,0,9,0,11
191218100,3,4,4,5,7,23
191218101,1,3,6,2,3,15
191218102,9,6,5,2,9,31
191218103,4,1,2,8,6,21
191218104,5,2,9,3,9,28
191218105,7,5,6,7,4,29
191218106,7,6,0,8,8,29
191218107,2,7,5,7,8,29
191218108,4,8,1,3,0,16
191218109,3,7,2,2,6,20
191218110,2,0,2,7,9,20
191218111,3,9,8,0,0,20
191218112,9,5,4,5,8,31
191218113,2,1,1,2,1,7
191218114,0,5,9,0,1,15
191218115,9,0,2,4,0,15
191218116,8,2,7,9,0,26
191218117,8,5,3,9,1,26
191218118,6,8,1,8,1,24
191218119,1,9,6,4,5,25
191218120,8,7,4,0,3,22
191218121,7,6,3,3,4,23
191218122,3,8,7,7,5,30
191218123,8,2,8,4,7,29
191218124,3,1,2,8,3,17
191218125,3,9,2,4,5,23
191218126,7,1,3,3,6,20
191218127,2,8,1,2,3,16
191218128,4,0,4,8,2,18
191218129,6,0,0,7,9,22
191218130,1,9,6,8,0,24
191218131,6,8,8,2,7,31
191218132,6,0,2,8,1,17
191218133,9,2,6,8,2,27
191218134,3,7,4,1,0,15
191218135,6,7,1,3,2,19
191218136,8,1,4,2,7,22
191218137,8,5,1,6,4,24
191218138,6,6,9,6,8,35
191218139,4,2,8,3,8,25
191218140,0,4,6,5,4,19
191218141,7,5,2,7,2,23
191218142,7,6,9,5,7,34
191218143,8,7,4,2,0,21
191218144,2,9,2,0,5,18
191218145,1,3,7,4,3,18
191218146,8,2,5,1,0,16
191218147,2,4,8,7,1,22
191218148,9,4,6,7,9,35
191218149,5,5,8,0,5,23
191218150,5,3,7,0,9,24
191218151,6,1,1,4,5,17
191218152,1,9,4,2,8,24
191218153,3,3,4,9,4,23
191218154,7,2,6,3,9,27
191218155,9,6,0,2,3,20
191218156,5,9,1,1,2,18
191218157,1,8,6,5,2,22
191218158,8,9,4,6,4,31
191218159,0,6,1,3,0,10
191218160,8,0,4,7,4,23
191218161,2,8,2,8,9,29
191218162,1,3,8,4,5,21
191218163,2,1,2,9,4,18
191218164,3,1,5,4,4,17
191218165,8,5,3,3,2,21
191218166,9,1,2,1,1,14
191218167,7,1,5,3,6,22
191218168,4,5,2,5,6,22
191218169,4,9,9,8,6,36
191218170,7,3,5,1,0,16
191218171,6,6,9,8,4,33
191218172,4,3,2,7,3,19
191218173,9,6,7,3,1,26
191218174,6,2,0,3,4,15
191218175,6,0,2,9,0,17
191218176,8,0,5,8,4,25
191218177,8,4,0,6,8,26
191218178,9,6,5,5,3,28
191218179,8,5,8,2,9,32
191218180,3,5,3,9,2,22
191218181,0,0,7,5,6,18
191218182,4,9,5,7,9,34
191218183,5,4,2,4,8,23
191218184,8,0,6,9,1,24
191218185,0,7,1,3,8,19
191218186,2,2,3,1,6,14
191218187,9,9,1,8,6,33
191218188,3,0,3,9,9,24
191218189,2,7,8,2,6,25
191218190,7,0,9,8,9,33
191218191,8,3,3,7,0,21
191218192,3,0,0,8,3,14
191218193,1,6,4,5,8,24
191218194,2,6,1,4,3,16
191218195,5,4,6,1,3,19
191218196,4,4,9,9,4,30
191218197,4,0,0,5,2,11
191218198,4,4,4,9,9,30
191218199,7,1,5,1,4,18
191218200,8,5,4,5,3,25
191218201,2,6,8,3,6,25
191218202,7,0,7,3,3,20
191218203,8,0,9,8,5,30
191218204,2,7,2,3,7,21
191218205,7,0,3,8,7,25
191218206,7,6,6,9,5,33
191218207,9,6,0,1,2,18
191218208,0,2,0,5,6,13
191218209,8,5,5,7,2,27
191218210,1,8,7,5,0,21
191218211,1,3,3,9,5,21
191218212,8,3,0,1,7,19
191218213,7,5,5,9,7,33
191218214,6,7,3,1,4,21
191218215,8,6,1,7,6,28
191218216,2,4,8,9,5,28
191218217,7,4,4,2,5,22
191218218,4,3,1,9,1,18
191218219,3,0,0,3,5,11
191218220,0,7,5,7,7,26
191218221,2,1,6,1,2,12
191218222,3,2,4,4,5,18
191218223,1,0,1,9,4,15
191218224,2,3,1,1,8,15
191218225,2,2,8,0,8,20
191218226,9,5,3,6,4,27
191218227,0,7,0,6,9,22
191218228,3,9,8,2,6,28
191218229,1,1,6,0,0,8
191218230,6,7,3,6,5,27
191218231,9,6,1,0,4,20
191218232,6,3,4,4,0,17
191218233,1,4,2,1,6,14
191218234,6,9,7,1,1,24
191218235,0,9,7,8,0,24
191218236,9,6,7,0,4,26
191218237,9,8,2,8,9,36
191218238,0,6,6,6,1,19
191218239,9,5,8,2,0,24
191218240,9,0,3,6,3,21
191218241,5,4,5,5,4,23
191218242,2,7,2,8,2,21
191218243,2,0,5,7,2,16
191218244,5,6,4,5,4,24
191218245,7,6,3,0,2,18
191218246,9,3,9,6,7,34
191218247,7,1,5,7,3,23
191218248,5,4,7,8,2,26
191218249,7,6,7,6,8,34
191218250,7,0,3,8,3,21
191218251,3,1,9,7,8,28
191218252,7,6,4,5,8,30
191218253,2,0,6,0,6,14
191218254,3,9,4,7,4,27
191218255,9,8,3,8,1,29
191218256,5,8,7,8,9,37
191218257,9,0,4,9,0,22
191218258,9,3,8,8,7,35
191218259,3,0,0,0,6,9
191218260,7,5,1,3,2,18
191218261,2,2,4,0,1,9
191218262,4,9,1,0,9,23
191218263,4,9,2,8,1,24
191218264,8,3,2,5,1,19
191218265,0,8,6,2,4,20
191218266,5,5,5,2,5,22
191218267,5,3,1,6,2,17
191218268,2,5,1,6,4,18
191218269,1,9,4,3,9,26
191218270,8,2,1,4,6,21
191218271,2,5,7,4,1,19
191218272,4,3,4,1,4,16
191218273,1,5,3,0,7,16
191218274,5,4,7,7,3,26
191218275,4,2,1,9,1,17
191218276,9,9,0,2,8,28
191218277,3,1,7,9,9,29
191218278,4,7,2,7,2,22
191218279,1,3,4,6,9,23
191218280,7,2,6,5,5,25
191218281,2,6,1,2,7,18
191218282,2,8,7,7,2,26
191218283,8,2,5,5,0,20
191218284,0,3,0,2,0,5
191218285,2,3,1,2,8,16
191218286,1,6,5,8,8,28
191218287,3,6,3,8,4,24
191218288,0,7,8,3,5,23
191218289,4,0,5,0,8,17
191218290,8,8,0,4,6,26
191218291,3,1,6,1,5,16
191218292,9,3,5,5,4,26
191218293,4,6,3,8,9,30
191218294,3,5,2,2,4,16
191218295,0,6,0,5,8,19
191218296,1,9,5,1,8,24
191218297,5,9,1,5,2,22
191218298,8,7,1,1,1,18
191218299,9,6,6,3,9,33
191218300,6,9,3,7,0,25
191218301,5,8,7,0,0,20
191218302,9,0,1,6,5,21
191218303,2,0,6,5,7,20
191218304,0,8,4,2,6,20
191218305,9,2,4,0,5,20
191218306,2,2,9,2,6,21
191218307,9,8,8,7,6,38
191218308,1,9,0,7,5,22
191218309,3,2,5,3,7,20
191218310,7,4,8,3,2,24
191218311,2,5,7,0,1,15
191218312,8,7,8,2,2,27
191218313,6,8,7,9,0,30
191218314,6,7,2,3,7,25
191218315,1,8,7,6,7,29
191218316,0,5,7,0,2,14
191218317,7,9,0,0,9,25
191218318,1,6,4,8,5,24
191218319,9,0,2,3,8,22
191218320,2,9,1,3,7,22
191218321,5,1,1,0,4,11
191218322,6,8,9,1,9,33
191218323,3,8,8,3,1,23
191218324,6,2,9,9,5,31
191218325,4,4,6,9,5,28
191218326,9,6,5,8,2,30
191218327,2,7,0,9,6,24
191218328,9,3,3,5,8,28
191218329,9,0,1,0,8,18
191218330,5,2,7,2,6,22
191218331,2,7,4,8,9,30
191218332,9,9,9,4,3,34
191218333,0,4,5,6,1,16
191218334,6,8,3,1,6,24
191218335,1,5,7,5,2,20
191218336,5,4,5,5,8,27
191218337,7,0,6,7,4,24
191218338,9,1,0,4,7,21
191218339,7,2,7,8,7,31
191218340,2,9,3,7,1,22
191218341,6,1,6,4,6,23
191218342,2,0,1,0,6,9
191218343,6,8,9,5,4,32
191218344,0,7,0,6,3,16
191218345,7,6,9,7,1,30
191218346,8,8,7,8,3,34
191218347,2,8,6,9,6,31
191218348,4,8,7,1,2,22
191218349,4,9,6,7,0,26
191218350,2,9,8,2,1,22
191218351,0,0,3,1,8,12
191218352,2,1,5,8,4,20
191218353,2,8,5,6,9,30
191218354,4,9,3,6,8,30
191218355,7,0,6,0,9,22
191218356,0,5,0,7,0,12
191218357,1,8,9,2,2,22
191218358,6,8,5,7,1,27
191218359,8,9,6,3,2,28
191218360,9,7,2,7,7,32
191218361,1,2,2,0,1,6
191218362,5,4,6,1,7,23
191218363,8,9,0,8,4,29
191218364,3,0,3,3,9,18
191218365,6,9,1,9,2,27
191218366,5,2,3,6,1,17
191218367,2,3,3,5,2,15
191218368,5,6,5,8,4,28
191218369,1,4,1,4,3,13
191218370,2,6,3,6,2,19
191218371,2,7,0,5,7,21
191218372,3,8,2,5,9,27
191218373,1,7,7,5,2,22
191218374,8,5,8,7,7,35
191218375,1,1,4,0,3,9
191218376,0,2,5,5,0,12
191218377,6,2,9,5,7,29
191218378,2,9,2,1,7,21
191218379,5,5,2,4,7,23
191218380,1,2,4,1,9,17
191218381,9,9,9,5,4,36
191218382,0,2,5,0,9,16
191218383,9,7,6,6,1,29
191218384,8,3,3,1,5,20
191218385,0,0,3,1,1,5
191218386,0,2,3,8,6,19
191218387,8,0,0,1,5,14
191218388,5,1,9,2,4,21
191218389,0,5,4,8,7,24
191218390,4,3,9,9,8,33
191218391,0,0,3,8,4,15
191218392,9,6,2,9,5,31
191218393,2,6,3,7,6,24
191218394,0,9,5,0,6,20
191218395,8,8,0,2,7,25
191218396,3,3,7,7,5,25
191218397,8,5,2,8,4,27
191218398,2,9,9,9,4,33
191218399,9,9,1,6,9,34
191218400,3,7,9,3,2,24
191218401,0,4,1,1,3,9
191218402,9,2,6,8,1,26
191218403,4,1,1,7,5,18
191218404,8,8,3,4,8,31
191218405,4,9,0,6,8,27
191218406,6,1,6,3,8,24
191218407,3,8,6,3,1,21
191218408,4,0,2,3,0,9
191218409,1,1,5,1,2,10
191218410,3,7,0,1,5,16
191218411,4,7,8,8,1,28
191218412,4,2,3,9,8,26
191218413,3,1,2,5,6,17
191218414,7,2,0,1,2,12
191218415,5,8,0,6,2,21
191218416,1,6,0,8,5,20
191218417,0,1,1,6,6,14
191218418,8,6,0,3,4,21
191218419,3,0,4,8,8,23
191218420,8,6,4,5,9,32
191218421,0,1,2,5,5,13
191218422,6,7,6,4,3,26
191218423,2,1,8,5,3,19
191218424,0,3,5,2,7,17
191218425,3,0,4,5,8,20
191218426,7,8,9,5,6,35
191218427,2,8,3,2,9,24
191218428,4,1,8,1,6,20
191218429,7,7,6,9,2,31
191218430,7,5,8,9,0,29
191218431,0,7,9,2,2,20
191218432,0,4,5,7,2,18
191218433,6,8,8,6,7,35
191218434,1,8,5,6,0,20
191218435,9,2,5,9,5,30
191218436,0,8,9,7,0,24
191218437,7,2,3,4,7,23
191218438,2,8,0,3,9,22
191218439,5,2,8,5,1,21
191218440,2,1,8,7,6,24
191218441,6,1,5,7,7,26
191218442,5,1,4,8,9,27
191218443,6,6,1,8,7,28
191218444,5,7,6,7,4,29
191218445,0,7,8,3,3,21
191218446,7,3,4,2,3,19
191218447,5,0,9,9,2,25
191218448,3,2,2,1,3,11
191218449,5,1,1,0,8,15
191218450,6,1,7,7,6,27
191218451,1,2,7,2,4,16
191218452,3,3,3,5,1,15
191218453,2,1,5,5,9,22
191218454,6,9,7,3,4,29
191218455,2,1,1,2,7,13
191218456,7,5,6,4,2,24
191218457,9,3,9,9,0,30
191218458,4,8,7,3,0,22
191218459,2,1,6,7,6,22
191218460,4,7,8,3,9,31
191218461,8,4,9,2,0,23
191218462,3,8,8,0,4,23
191218463,8,0,2,3,8,21
191218464,5,3,8,9,6,31
191218465,3,6,3,8,0,20
191218466,1,2,0,8,7,18
191218467,6,1,6,0,9,22
191218468,1,6,2,4,4,17
191218469,7,4,4,2,1,18
191218470,7,6,4,3,2,22
191218471,8,0,0,1,1,10
191218472,0,3,3,6,5,17
191218473,9,1,9,8,7,34
191218474,3,4,4,2,8,21
191218475,3,8,8,9,0,28
191218476,3,0,3,6,0,12
191218477,0,1,1,3,3,8
191218478,0,2,4,1,4,11
191218479,6,9,8,3,0,26
191218480,2,0,3,4,8,17
191218481,3,2,6,3,3,17
191218482,5,9,9,2,0,25
191218483,9,4,8,7,1,29
191218484,0,1,5,3,1,10
191218485,3,3,9,3,0,18
191218486,2,0,1,2,0,5
191218487,0,6,2,0,7,15
191218488,7,2,5,5,7,26
191218489,9,3,5,6,3,26
191218490,9,4,0,5,8,26
191218491,6,1,9,6,2,24
191218492,0,8,7,2,4,21
191218493,3,5,8,9,1,26
191218494,2,6,3,5,7,23
191218495,6,5,0,4,2,17
191218496,1,9,5,9,0,24
191218497,3,1,0,4,2,10
191218498,6,4,6,6,4,26
191218499,4,0,3,8,2,17
191218500,5,3,6,1,4,19
191218501,8,4,8,3,7,30
191218502,4,0,2,5,1,12
191218503,1,6,1,4,7,19
191218504,7,3,3,4,7,24
191218505,0,7,7,6,4,24
191218506,6,6,7,6,0,25
191218507,0,0,2,2,0,4
191218508,4,5,0,5,5,19
191218509,8,4,2,3,5,22
191218510,5,6,2,4,8,25
191218511,9,3,4,3,3,22
191218512,1,3,7,2,3,16
191218513,5,2,1,7,3,18
191218514,2,7,7,3,9,28
191218515,7,9,1,7,6,30
191218516,3,5,0,8,3,19
191218517,2,1,7,5,4,19
191218518,5,2,2,4,3,16
191218519,8,5,2,1,5,21
191218520,5,0,0,2,6,13
191218521,4,3,0,0,1,8
191218522,7,0,0,2,5,14
191218523,3,4,6,8,4,25
191218524,6,1,3,7,4,21
191218525,9,9,8,6,5,37
191218526,3,1,5,1,3,13
191218527,9,1,4,3,5,22
191218528,4,4,0,0,4,12
191218529,2,5,7,8,3,25
191218530,1,3,8,0,2,14
191218531,8,8,5,3,3,27
191218532,1,4,9,0,7,21
191218533,9,0,8,9,7,33
191218534,2,0,5,1,9,17
191218535,4,7,6,9,5,31
191218536,6,4,8,9,7,34
191218537,3,9,6,8,2,28
191218538,9,0,8,9,5,31
191218539,1,3,5,4,8,21
191218540,0,3,2,8,2,15
191218541,1,2,6,8,0,17
191218542,7,3,4,0,5,19
191218543,8,8,7,2,2,27
191218544,8,2,4,8,9,31
191218545,8,7,3,7,8,33
191218546,7,9,8,0,6,30
191218547,8,1,4,6,1,20
191218548,7,9,8,4,2,30
191218549,9,5,2,3,9,28
191218550,2,1,4,2,6,15
191218551,4,2,5,6,0,17
191218552,4,4,5,5,4,22
191218553,6,8,9,0,0,23
191218554,6,1,8,9,9,33
191218555,6,5,0,6,3,20
191218556,4,1,5,2,2,14
191218557,6,4,9,3,2,24
191218558,8,9,3,3,4,27
191218559,9,7,3,0,4,23
191218560,9,0,3,6,2,20
191218561,0,6,1,5,2,14
191218562,3,1,8,1,8,21
191218563,7,7,8,5,9,36
191218564,2,3,0,0,0,5
191218565,1,3,9,7,6,26
191218566,9,0,0,7,3,19
191218567,5,8,7,1,1,22
191218568,0,4,4,0,7,15
191218569,9,8,9,3,0,29
191218570,8,3,7,3,0,21
191218571,3,7,4,7,0,21
191218572,2,1,8,3,4,18
191218573,4,6,5,0,5,20
191218574,0,4,6,9,4,23
191218575,5,4,7,0,1,17
191218576,7,3,6,1,5,22
191218577,3,3,2,8,4,20
191218578,0,9,8,2,2,21
191218579,7,7,1,3,6,24
191218580,3,2,8,4,0,17
191218581,8,4,7,7,1,27
191218582,4,1,6,9,1,21
191218583,4,1,1,2,4,12
191218584,1,7,5,3,0,16
191218585,6,8,0,3,5,22
191218586,4,2,1,4,9,20
191218587,5,2,6,7,0,20
191218588,4,0,4,4,9,21
191218589,7,2,0,9,8,26
191218590,9,2,2,1,7,21
191218591,6,2,5,1,5,19
191218592,8,9,9,5,9,40
191218593,6,6,1,4,2,19
191218594,0,8,3,6,9,26
191218595,9,3,9,4,5,30
191218596,0,6,5,6,7,24
191218597,4,3,9,5,4,25
191218598,6,8,9,4,9,36
191218599,2,6,6,2,1,17
191218600,1,3,5,2,8,19
191218601,0,8,0,7,9,24
191218602,4,1,1,1,3,10
191218603,0,1,4,3,3,11
191218604,3,5,8,6,0,22
191218605,9,7,4,6,7,33
191218606,2,0,8,9,0,19
191218607,8,2,0,4,3,17
191218608,4,0,4,6,1,15
191218609,2,0,8,2,0,12
191218610,2,5,3,5,8,23
191218611,5,9,7,1,1,23
191218612,1,5,8,4,2,20
191218613,2,5,0,1,6,14
191218614,4,7,8,0,9,28
191218615,9,1,8,7,1,26
191218616,0,5,8,5,9,27
191218617,2,0,0,7,6,15
191218618,2,2,0,6,9,19
191218619,8,5,3,7,1,24
191218620,8,5,5,5,5,28
191218621,7,9,3,7,4,30
191218622,5,3,4,7,9,28
191218623,6,3,9,2,5,25
191218624,3,3,5,1,1,13
191218625,2,6,8,3,4,23
191218626,3,5,3,6,3,20
191218627,8,8,9,6,9,40
191218628,3,7,9,2,6,27
191218629,6,1,1,5,4,17
191218630,5,2,9,8,4,28
191218631,2,0,4,9,4,19
191218632,8,5,9,7,0,29
191218633,0,1,5,8,4,18
191218634,8,4,6,1,9,28
191218635,6,0,5,1,5,17
191218636,6,5,6,7,0,24
191218637,5,3,5,5,7,25
191218638,8,9,1,8,2,28
191218639,7,6,0,4,7,24
191218640,9,0,4,3,9,25
191218641,4,3,0,3,3,13
191218642,3,5,3,7,7,25
191218643,7,6,7,9,3,32
191218644,8,9,7,8,7,39
191218645,2,1,7,7,6,23
191218646,6,5,0,5,5,21
191218647,6,5,4,7,4,26
191218648,4,7,8,4,7,30
191218649,6,8,2,9,8,33
191218650,6,3,9,7,1,26
191218651,8,0,3,8,4,23
191218652,4,0,0,4,0,8
191218653,5,8,8,4,4,29
191218654,2,7,5,2,5,21
191218655,3,9,4,7,6,29
191218656,2,3,0,5,3,13
191218657,9,6,5,3,6,29
191218658,1,8,3,9,4,25
191218659,0,0,1,3,6,10
191218660,0,0,8,5,2,15
191218661,3,2,8,5,1,19
191218662,7,7,8,0,7,29
191218663,6,0,4,5,7,22
191218664,6,2,9,3,6,26
191218665,0,8,6,5,7,26
191218666,4,4,1,8,6,23
191218667,7,3,4,8,3,25
191218668,7,7,2,6,1,23
191218669,6,4,8,6,6,30
191218670,1,0,7,5,1,14
191218671,6,0,3,7,6,22
191218672,4,4,7,7,6,28
191218673,7,3,1,8,0,19
191218674,9,5,6,0,2,22
191218675,5,0,2,3,3,13
191218676,2,2,7,4,6,21
191218677,6,8,5,7,6,32
191218678,6,3,5,5,0,19
191218679,7,1,7,2,2,19
191218680,0,6,7,8,4,25
191218681,0,4,8,7,3,22
191218682,6,4,8,9,6,33
191218683,8,6,6,5,7,32
191218684,0,5,1,0,4,10
191218685,5,3,0,2,0,10
191218686,8,2,1,6,5,22
191218687,7,0,2,7,1,17
191218688,0,6,7,6,3,22
191218689,6,5,2,6,7,26
191218690,5,7,2,4,7,25
191218691,4,3,4,5,4,20
191218692,7,7,9,8,9,40
191218693,2,9,1,6,1,19
191218694,9,5,5,1,7,27
191218695,3,0,4,7,4,18
191218696,1,7,2,4,8,22
191218697,9,6,5,0,2,22
191218698,0,5,1,0,8,14
191218699,8,0,9,5,4,26
191218700,1,6,8,8,1,24
191218701,1,9,3,7,0,20
191218702,7,0,9,8,5,29
191218703,0,3,9,9,1,22
191218704,0,0,8,3,3,14
191218705,4,0,1,2,1,8
191218706,5,9,1,1,8,24
191218707,0,6,1,7,7,21
191218708,7,6,2,3,5,23
191218709,0,7,0,2,6,15
191218710,3,8,1,5,8,25
191218711,4,8,5,0,1,18
191218712,2,9,0,1,0,12
191218713,0,5,7,4,1,17
191218714,2,1,2,8,8,21
191218715,5,6,9,0,9,29
191218716,2,8,4,4,2,20
191218717,0,3,6,3,6,18
191218718,5,6,2,2,1,16
191218719,5,6,7,5,2,25
191218720,2,8,5,5,9,29
191218721,8,2,0,1,0,11
191218722,2,4,3,4,6,19
191218723,6,3,7,4,8,28
191218724,6,8,5,2,4,25
191218725,9,1,0,6,6,22
191218726,8,9,8,5,4,34
191218727,0,7,9,9,7,32
191218728,8,7,7,9,5,36
191218729,6,0,8,9,4,27
191218730,4,3,7,8,0,22
191218731,7,4,4,6,3,24
191218732,3,4,4,1,2,14
191218733,7,3,6,7,2,25
191218734,0,8,4,0,6,18
191218735,8,3,6,2,3,22
191218736,3,4,2,2,6,17
191218737,7,4,5,3,3,22
191218738,8,0,7,5,3,23
191218739,4,1,5,7,3,20
191218740,3,3,1,5,2,14
191218741,7,4,7,9,5,32
191218742,4,0,3,5,4,16
191218743,0,6,9,8,9,32
191218744,1,4,0,8,2,15
191218745,5,3,7,2,7,24
191218746,9,9,1,7,6,32
191218747,6,2,8,4,3,23
191218748,7,0,4,2,6,19
191218749,0,3,7,1,5,16
191218750,6,2,2,5,0,15
191218751,4,8,7,4,2,25
191218752,8,2,6,5,8,29
191218753,9,6,9,4,9,37
191218754,8,1,5,2,4,20
191218755,5,3,5,0,6,19
191218756,0,2,3,9,7,21
191218757,3,6,3,2,0,14
191218758,6,9,9,0,0,24
191218759,9,1,7,5,5,27
191218760,2,9,1,4,7,23
191218761,9,4,4,3,9,29
191218762,3,7,7,6,6,29
191218763,5,3,6,7,5,26
191218764,1,7,0,8,6,22
191218765,9,7,3,3,7,29
191218766,3,8,6,7,9,33
191218767,8,4,7,7,5,31
191218768,6,5,6,7,4,28
191218769,3,7,0,6,0,16
191218770,4,3,3,9,7,26
191218771,4,0,0,5,1,10
191218772,0,9,5,5,5,24
191218773,2,9,5,4,9,29
191218774,8,0,6,0,3,17
191218775,9,1,0,7,5,22
191218776,9,3,6,0,3,21
191218777,6,6,2,6,5,25
191218778,3,7,2,2,4,18
191218779,8,3,3,5,2,21
191218780,5,5,8,3,7,28
191218781,2,9,4,7,4,26
191218782,3,9,3,1,6,22
191218783,3,0,7,4,9,23
191218784,1,7,9,4,8,29
191218785,6,2,5,9,8,30
191218786,4,6,3,0,1,14
191218787,2,4,6,1,3,16
191218788,2,1,4,3,0,10
191218789,3,6,7,6,8,30
191218790,7,5,1,2,4,19
191218791,6,8,5,3,8,30
191218792,0,3,5,8,5,21
191218793,5,8,6,2,3,24
191218794,0,4,9,7,3,23
191218795,4,0,4,0,5,13
191218796,7,9,5,2,2,25
191218797,6,5,6,3,4,24
191218798,4,0,2,3,8,17
191218799,1,9,4,7,4,25
191218800,3,3,6,9,7,28
191218801,7,2,0,9,3,21
191218802,9,9,0,0,6,24
191218803,1,4,8,1,5,19
191218804,2,1,0,9,1,13
191218805,3,3,3,0,6,15
191218806,0,9,3,2,5,19
191218807,7,6,0,5,6,24
191218808,9,1,2,0,5,17
191218809,1,1,7,3,0,12
191218810,6,0,7,5,8,26
191218811,7,0,0,1,8,16
191218812,7,6,2,9,9,33
191218813,2,4,9,5,1,21
191218814,1,7,2,9,8,27
191218815,2,9,4,4,9,28
191218816,7,3,3,5,8,26
191218817,4,4,1,9,2,20
191218818,7,2,4,9,9,31
191218819,9,2,8,9,1,29
191218820,5,4,4,1,7,21
191218821,9,7,8,7,2,33
191218822,3,6,3,6,8,26
191218823,4,0,7,6,0,17
191218824,2,5,1,0,3,11
191218825,6,2,5,3,2,18
191218826,4,4,3,3,9,23
191218827,0,9,3,1,6,19
191218828,8,0,1,2,5,16
191218829,1,4,8,4,1,18
191218830,6,3,9,9,7,34
191218831,2,3,2,4,1,12
191218832,5,3,2,4,1,15
191218833,6,6,8,8,0,28
191218834,8,4,6,7,8,33
191218835,2,6,4,9,5,26
191218836,8,2,6,2,8,26
191218837,2,7,3,2,2,16
191218838,0,4,9,4,7,24
191218839,3,9,4,5,5,26
191218840,8,1,7,6,1,23
191218841,8,2,1,4,5,20
191218842,4,6,6,1,4,21
191218843,3,3,6,1,3,16
191218844,8,2,9,1,4,24
191218845,4,7,6,4,1,22
191218846,9,9,2,8,8,36
191218847,7,0,7,9,3,26
191218848,7,3,7,5,4,26
191218849,6,4,2,2,9,23
191218850,3,4,7,7,7,28
191218851,2,3,7,9,2,23
191218852,4,3,6,3,0,16
191218853,8,6,9,2,9,34
191218854,5,3,9,7,2,26
191218855,4,2,0,7,8,21
191218856,5,9,3,4,0,21
191218857,3,0,2,0,1,6
191218858,3,2,3,6,3,17
191218859,1,3,2,3,8,17
191218860,4,5,7,7,4,27
191218861,5,0,7,0,4,16
191218862,8,3,2,6,6,25
191218863,6,1,5,1,0,13
191218864,6,4,2,5,6,23
191218865,9,3,5,7,0,24
191218866,1,1,3,8,9,22
191218867,1,5,9,7,8,30
191218868,0,9,5,9,1,24
191218869,9,9,8,8,7,41
191218870,1,9,0,6,3,19
191218871,8,4,1,3,3,19
191218872,3,7,4,2,9,25
191218873,4,8,5,1,2,20
191218874,5,0,8,8,1,22
191218875,2,7,9,0,0,18
191218876,2,6,4,7,3,22
191218877,7,0,5,7,2,21
191218878,5,2,1,4,0,12
191218879,9,3,2,5,7,26
191218880,7,7,4,6,0,24
191218881,2,8,8,5,6,29
191218882,7,1,4,1,5,18
191218883,2,0,7,9,6,24
191218884,1,7,8,1,7,24
191218885,5,5,8,5,5,28
191218886,0,9,2,5,3,19
191218887,1,4,5,9,4,23
191218888,5,3,3,2,7,20
191218889,2,2,8,4,3,19
191218890,2,8,8,7,8,33
191218891,9,9,5,2,9,34
191218892,5,9,6,7,0,27
191218893,7,2,8,5,2,24
191218894,1,1,1,6,9,18
191218895,7,2,6,7,5,27
191218896,0,2,0,6,5,13
191218897,8,0,5,1,4,18
191218898,9,9,1,0,9,28
191218899,4,4,3,6,0,17
191218900,4,7,1,9,7,28
191218901,3,2,6,3,7,21
191218902,7,2,3,5,0,17
191218903,6,4,3,4,8,25
191218904,8,0,4,2,0,14
191218905,1,1,6,6,0,14
191218906,0,5,6,8,1,20
191218907,7,7,5,6,3,28
191218908,8,4,8,4,2,26
191218909,6,4,2,6,7,25
191218910,5,0,7,1,0,13
191218911,7,9,3,8,5,32
191218912,1,4,4,6,2,17
191218913,5,3,7,7,8,30
191218914,1,1,7,7,7,23
191218915,5,6,0,7,5,23
191218916,7,2,3,2,1,15
191218917,9,1,3,0,5,18
191218918,2,5,1,1,0,9
191218919,1,7,1,6,7,22
191218920,6,4,2,3,7,22
191218921,9,6,7,4,3,29
191218922,2,1,7,3,5,18
191218923,2,3,6,4,0,15
191218924,2,2,2,1,0,7
191218925,1,3,0,1,4,9
191218926,3,8,7,6,5,29
191218927,4,5,1,8,6,24
191218928,5,1,1,0,5,12
191218929,1,9,1,5,7,23
191218930,0,7,8,0,1,16
191218931,3,4,2,0,8,17
191218932,7,2,5,4,5,23
191218933,9,6,3,1,5,24
191218934,4,5,5,1,1,16
191218935,8,8,1,5,8,30
191218936,1,8,2,5,8,24
191218937,1,3,6,2,0,12
191218938,4,5,4,7,2,22
191218939,2,3,6,4,3,18
191218940,2,7,2,8,1,20
191218941,1,0,0,3,8,12
191218942,9,6,1,3,5,24
191218943,2,3,2,4,4,15
191218944,5,4,8,5,8,30
191218945,2,7,2,1,0,12
191218946,7,6,8,3,3,27
191218947,3,2,9,4,4,22
191218948,0,9,9,6,3,27
191218949,6,7,0,9,0,22
191218950,4,9,0,3,9,25
191218951,4,7,9,0,8,28
191218952,1,4,0,5,3,13
191218953,4,5,5,4,7,25
191218954,1,1,1,6,2,11
191218955,0,2,7,1,8,18
191218956,9,3,9,2,1,24
191218957,5,1,8,1,6,21
191218958,4,6,8,5,8,31
191218959,2,5,3,3,1,14
191218960,6,7,4,8,3,28
191218961,3,0,0,1,9,13
191218962,8,3,8,2,1,22
191218963,4,7,7,7,7,32
191218964,3,6,1,0,9,19
191218965,4,6,3,4,2,19
191218966,2,4,2,1,0,9
191218967,6,9,4,8,5,32
191218968,5,0,5,0,7,17
191218969,1,8,1,1,1,12
191218970,0,6,6,2,0,14
191218971,7,1,1,1,1,11
191218972,7,6,4,1,7,25
191218973,6,6,3,7,5,27
191218974,2,9,9,2,0,22
191218975,7,0,3,1,7,18
191218976,4,3,6,3,2,18
191218977,3,5,0,5,7,20
191218978,5,5,9,0,7,26
191218979,4,1,5,3,5,18
191218980,5,6,7,2,4,24
191218981,8,9,2,1,6,26
191218982,1,4,3,8,8,24
191218983,7,4,0,9,6,26
191218984,1,2,8,6,9,26
191218985,5,4,7,9,7,32
191218986,2,9,0,8,9,28
191218987,0,3,3,6,6,18
191218988,6,9,5,6,7,33
191218989,9,6,7,8,5,35
191218990,3,0,8,0,1,12
191218991,1,1,5,6,2,15
191218992,5,6,6,0,0,17
191218993,1,3,4,7,1,16
191218994,4,3,4,1,9,21
191218995,1,7,8,2,3,21
191218996,0,7,3,4,6,20
191218997,9,2,0,1,1,13
191218998,5,5,0,3,7,20
191218999,1,4,4,8,1,18
1912181000,1,0,4,7,5,17
1912181001,9,9,6,7,0,31
1912181002,2,1,9,9,2,23
1912181003,3,3,9,9,9,33
1912181004,5,2,1,0,6,14
1912181005,3,3,8,9,2,25
1912181006,4,8,6,7,8,33
1912181007,2,4,4,1,4,15
1912181008,4,9,5,1,4,23
1912181009,0,8,2,1,3,14
1912181010,5,5,0,9,2,21
1912181011,4,0,4,5,7,20
1912181012,4,5,1,5,3,18
1912181013,3,5,0,8,2,18
1912181014,3,1,3,0,7,14
1912181015,4,1,6,6,9,26
1912181016,2,3,4,9,0,18
1912181017,9,2,4,6,7,28
1912181018,6,2,1,3,0,12
1912181019,4,6,7,4,4,25
1912181020,4,6,4,1,0,15
1912181021,1,8,9,9,6,33
1912181022,9,2,3,7,5,26
1912181023,4,4,4,5,4,21
1912181024,2,7,9,9,4,31
1912181025,9,5,1,9,4,28
1912181026,2,0,3,1,8,14
1912181027,6,9,9,7,3,34
1912181028,9,6,8,9,3,35
1912181029,1,6,7,9,4,27
1912181030,6,5,3,8,2,24
1912181031,0,1,7,7,0,15
1912181032,3,1,5,2,7,18
1912181033,3,8,0,6,3,20
1912181034,8,1,0,5,1,15
1912181035,2,6,7,0,4,19
1912181036,9,5,4,0,1,19
1912181037,2,7,7,1,4,21
1912181038,6,8,4,3,8,29
1912181039,2,5,5,6,1,19
1912181040,5,1,6,0,3,15
1912181041,7,6,6,9,8,36
1912181042,4,9,4,3,9,29
1912181043,1,8,8,9,2,28
1912181044,5,6,2,7,1,21
1912181045,7,2,6,5,3,23
1912181046,2,3,6,0,4,15
1912181047,5,7,8,3,6,29
1912181048,6,2,4,3,6,21
1912181049,7,0,3,9,9,28
1912181050,6,2,8,9,8,33
1912181051,6,3,5,3,3,20
1912181052,2,3,7,0,8,20
1912181053,6,6,6,4,7,29
1912181054,1,7,1,5,9,23
1912181055,6,0,0,8,5,19
1912181056,6,3,9,3,5,26
1912181057,6,7,7,6,3,29
1912181058,9,7,7,4,8,35
1912181059,3,2,8,9,6,28
1912181060,9,3,8,2,5,27
1912181061,3,7,6,8,6,30
1912181062,6,3,8,6,4,27
1912181063,2,0,7,0,3,12
1912181064,4,2,6,0,4,16
1912181065,1,2,2,7,2,14
1912181066,2,4,2,9,7,24
1912181067,0,7,2,1,6,16
1912181068,7,9,9,4,4,33
1912181069,8,1,5,0,3,17
1912181070,7,2,8,1,3,21
1912181071,1,4,3,7,1,16
1912181072,6,1,7,1,4,19
1912181073,1,4,5,6,4,20
1912181074,1,3,7,0,5,16
1912181075,5,1,5,5,1,17
1912181076,2,4,9,9,9,33
1912181077,1,0,9,5,0,15
1912181078,8,3,8,1,1,21
1912181079,2,4,2,4,5,17
1912181080,3,6,1,9,9,28
1912181081,3,2,2,4,9,20
1912181082,7,6,7,3,7,30
1912181083,2,1,8,2,5,18
1912181084,9,7,4,1,4,25
1912181085,5,5,0,8,7,25
1912181086,6,7,6,7,9,35
1912181087,6,0,2,9,3,20
1912181088,6,2,5,6,2,21
1912181089,8,4,1,4,7,24
1912181090,7,1,5,0,8,21
1912181091,1,1,9,4,7,22
1912181092,0,6,3,1,5,15
1912181093,1,8,8,3,7,27
1912181094,9,7,9,7,2,34
1912181095,4,8,0,8,8,28
1912181096,9,0,0,7,7,23
1912181097,8,7,6,5,5,31
1912181098,6,2,2,6,5,21
1912181099,6,9,1,1,0,17
1912181100,7,7,9,4,3,30
1912181101,7,3,3,5,0,18
1912181102,7,0,8,4,1,20
1912181103,6,4,4,4,6,24
1912181104,0,3,8,3,7,21
1912181105,1,3,8,4,2,18
191219001,5,3,4,2,1,15
191219002,4,7,2,2,1,16
191219003,2,1,6,2,0,11
191219004,4,6,1,7,6,24
191219005,1,5,5,3,3,17
191219006,7,1,9,8,4,29
191219007,3,5,8,7,0,23
191219008,5,9,1,2,1,18
191219009,7,7,5,8,6,33
191219010,9,8,1,4,8,30
191219011,4,9,7,3,0,23
191219012,5,6,7,4,0,22
191219013,9,8,3,0,9,29
191219014,4,7,7,0,7,25
191219015,7,8,3,3,5,26
191219016,6,5,9,8,1,29
191219017,3,0,0,0,0,3
191219018,8,1,7,6,4,26
191219019,9,2,8,9,3,31
191219020,0,4,9,1,5,19
191219021,6,3,7,4,3,23
191219022,5,9,1,9,3,27
191219023,5,1,6,7,1,20
191219024,5,5,5,5,8,28
191219025,4,8,4,3,3,22
191219026,8,5,0,9,0,22
191219027,9,6,5,7,2,29
191219028,6,8,1,5,4,24
191219029,4,1,6,2,3,16
191219030,0,7,8,0,5,20
191219031,5,3,7,3,0,18
191219032,4,1,5,7,9,26
191219033,4,0,4,6,5,19
191219034,1,5,6,6,5,23
191219035,7,8,5,4,4,28
191219036,5,8,2,0,8,23
191219037,2,7,1,4,5,19
191219038,6,5,5,2,7,25
191219039,8,8,9,0,1,26
191219040,6,1,0,2,7,16
191219041,4,9,0,1,4,18
191219042,4,0,2,6,7,19
191219043,4,0,7,5,7,23
191219044,3,6,6,0,5,20
191219045,8,6,1,9,5,29
191219046,3,1,9,4,8,25
191219047,9,7,0,2,1,19
191219048,9,0,0,1,0,10
191219049,4,5,1,9,9,28
191219050,0,7,9,7,0,23
191219051,6,9,5,6,2,28
191219052,7,4,8,4,9,32
191219053,3,8,3,6,4,24
191219054,7,8,1,5,9,30
191219055,0,6,7,5,3,21
191219056,2,6,6,2,9,25
191219057,2,8,9,8,8,35
191219058,3,8,2,1,9,23
191219059,7,7,2,1,9,26
191219060,8,4,9,3,8,32
191219061,2,7,0,9,7,25
191219062,2,4,7,1,4,18
191219063,7,2,4,3,0,16
191219064,7,0,0,7,5,19
191219065,7,7,5,0,6,25
191219066,2,4,2,9,6,23
191219067,0,2,2,5,3,12
191219068,9,5,2,1,3,20
191219069,2,3,0,1,2,8
191219070,3,2,4,9,3,21
191219071,1,6,0,3,3,13
191219072,2,2,2,6,8,20
191219073,0,6,2,3,2,13
191219074,8,3,7,5,6,29
191219075,6,4,9,6,5,30
191219076,9,7,6,1,5,28
191219077,8,8,3,4,5,28
191219078,0,5,1,1,4,11
191219079,7,6,0,2,9,24
191219080,7,2,4,5,1,19
191219081,8,9,1,3,5,26
191219082,4,4,6,3,1,18
191219083,1,7,1,2,7,18
191219084,8,5,0,2,8,23
191219085,1,9,5,5,4,24
191219086,0,6,3,8,7,24
191219087,9,7,9,7,1,33
191219088,9,2,7,8,9,35
191219089,1,7,6,8,8,30
191219090,8,4,7,1,0,20
191219091,8,6,6,5,6,31
191219092,4,8,5,0,3,20
191219093,3,8,1,3,8,23
191219094,9,5,5,6,8,33
191219095,7,7,8,6,9,37
191219096,7,7,3,7,9,33
191219097,3,1,5,2,2,13
191219098,8,8,2,6,3,27
191219099,9,9,8,0,5,31
191219100,1,7,8,9,7,32
191219101,1,3,1,6,9,20
191219102,3,7,0,8,2,20
191219103,6,0,2,7,4,19
191219104,3,8,4,9,2,26
191219105,7,2,8,6,6,29
191219106,2,1,1,0,3,7
191219107,7,4,3,0,5,19
191219108,7,6,9,0,7,29
191219109,6,2,3,0,5,16
191219110,9,5,2,9,3,28
191219111,6,3,2,7,7,25
191219112,7,1,6,7,4,25
191219113,3,4,9,7,9,32
191219114,7,0,0,6,9,22
191219115,4,4,1,1,2,12
191219116,6,5,4,9,1,25
191219117,1,8,8,6,9,32
191219118,5,5,5,8,5,28
191219119,9,3,7,8,3,30
191219120,6,4,7,6,0,23
191219121,2,1,8,1,1,13
191219122,9,9,3,0,7,28
191219123,2,9,9,4,0,24
191219124,6,0,9,6,1,22
191219125,5,5,9,7,5,31
191219126,3,9,0,2,1,15
191219127,6,9,6,6,0,27
191219128,7,0,5,8,8,28
191219129,0,6,8,2,7,23
191219130,8,7,9,8,0,32
191219131,1,0,1,9,0,11
191219132,2,3,4,9,2,20
191219133,2,3,0,3,9,17
191219134,2,6,9,8,8,33
191219135,8,5,0,1,0,14
191219136,8,7,7,1,8,31
191219137,7,7,0,0,4,18
191219138,9,5,3,1,4,22
191219139,7,5,8,1,4,25
191219140,3,1,1,5,0,10
191219141,2,7,6,4,2,21
191219142,9,0,6,0,5,20
191219143,3,3,4,2,3,15
191219144,2,5,8,1,2,18
191219145,0,1,0,0,3,4
191219146,9,7,5,3,5,29
191219147,6,3,0,5,6,20
191219148,9,7,3,8,1,28
191219149,8,9,2,5,5,29
191219150,8,1,7,1,6,23
191219151,7,8,3,3,8,29
191219152,8,7,2,4,6,27
191219153,2,1,1,6,9,19
191219154,7,1,5,6,2,21
191219155,5,6,1,6,8,26
191219156,6,9,2,2,2,21
191219157,7,1,9,4,9,30
191219158,3,3,9,8,9,32
191219159,8,8,3,9,3,31
191219160,5,3,0,2,3,13
191219161,7,2,9,6,6,30
191219162,9,2,5,6,0,22
191219163,8,9,0,6,4,27
191219164,0,2,2,6,9,19
191219165,2,1,3,6,8,20
191219166,7,5,3,3,7,25
191219167,3,5,6,8,9,31
191219168,3,4,6,5,1,19
191219169,7,8,8,4,8,35
191219170,1,7,7,3,4,22
191219171,2,6,3,9,5,25
191219172,4,8,2,0,2,16
191219173,5,6,1,7,7,26
191219174,7,7,8,9,1,32
191219175,2,8,1,0,1,12
191219176,3,7,7,4,4,25
191219177,6,8,3,3,4,24
191219178,3,7,4,2,3,19
191219179,4,6,9,1,5,25
191219180,3,3,8,9,6,29
191219181,3,1,4,7,5,20
191219182,4,8,7,7,9,35
191219183,7,1,0,0,1,9
191219184,8,0,7,4,8,27
191219185,5,4,8,9,2,28
191219186,4,2,1,2,7,16
191219187,7,4,1,6,2,20
191219188,0,7,2,8,9,26
191219189,0,7,4,6,0,17
191219190,6,6,5,5,5,27
191219191,6,1,7,5,7,26
191219192,3,6,1,2,6,18
191219193,6,0,7,8,8,29
191219194,0,7,7,7,4,25
191219195,3,3,3,4,8,21
191219196,9,9,4,5,5,32
191219197,3,0,9,3,4,19
191219198,2,8,2,1,6,19
191219199,5,6,4,7,8,30
191219200,5,3,6,2,5,21
191219201,3,7,4,7,6,27
191219202,4,6,2,4,4,20
191219203,0,5,5,7,3,20
191219204,0,7,0,3,1,11
191219205,0,4,0,6,9,19
191219206,8,8,3,6,9,34
191219207,6,7,9,0,4,26
191219208,6,5,7,4,7,29
191219209,1,0,8,7,8,24
191219210,5,8,7,7,2,29
191219211,9,0,8,1,4,22
191219212,7,7,3,5,4,26
191219213,1,5,0,8,5,19
191219214,2,6,8,7,1,24
191219215,0,9,1,8,8,26
191219216,1,2,8,0,9,20
191219217,9,6,4,1,6,26
191219218,3,0,6,3,2,14
191219219,3,0,2,4,7,16
191219220,0,5,7,2,4,18
191219221,6,9,6,7,9,37
191219222,9,6,2,2,5,24
191219223,4,7,8,8,0,27
191219224,6,3,8,2,2,21
191219225,6,9,9,7,6,37
191219226,9,1,0,4,8,22
191219227,1,4,8,4,2,19
191219228,5,3,8,5,8,29
191219229,2,0,3,7,6,18
191219230,0,4,2,0,4,10
191219231,7,2,1,2,5,17
191219232,5,0,4,9,9,27
191219233,0,3,1,0,5,9
191219234,3,1,7,2,2,15
191219235,1,7,0,6,4,18
191219236,4,1,4,8,7,24
191219237,3,0,1,6,0,10
191219238,2,9,4,0,3,18
191219239,9,9,2,1,8,29
191219240,7,3,4,1,1,16
191219241,0,9,2,6,9,26
191219242,1,0,4,9,9,23
191219243,2,9,6,8,9,34
191219244,5,2,8,0,4,19
191219245,2,3,9,0,5,19
191219246,9,4,9,2,2,26
191219247,4,4,0,6,0,14
191219248,1,0,5,9,6,21
191219249,8,1,7,7,8,31
191219250,0,3,2,2,6,13
191219251,0,4,7,8,5,24
191219252,0,2,2,0,2,6
191219253,4,3,5,4,2,18
191219254,7,8,2,1,3,21
191219255,6,8,8,8,9,39
191219256,4,2,7,3,7,23
191219257,2,5,1,7,3,18
191219258,4,0,5,5,3,17
191219259,4,2,1,3,6,16
191219260,3,6,6,3,7,25
191219261,4,4,4,2,7,21
191219262,9,9,7,0,3,28
191219263,8,6,4,8,7,33
191219264,3,3,9,7,0,22
191219265,7,7,9,0,4,27
191219266,3,8,9,5,7,32
191219267,1,9,0,6,6,22
191219268,2,3,3,6,2,16
191219269,7,0,6,9,9,31
191219270,9,4,1,2,2,18
191219271,7,6,6,7,6,32
191219272,2,3,7,3,2,17
191219273,7,0,8,1,4,20
191219274,8,7,5,0,4,24
191219275,0,9,7,3,1,20
191219276,2,5,4,8,2,21
191219277,1,3,6,1,2,13
191219278,8,0,0,6,0,14
191219279,9,5,9,1,1,25
191219280,8,9,2,8,6,33
191219281,5,8,0,9,1,23
191219282,6,7,4,4,6,27
191219283,8,1,5,9,6,29
191219284,6,7,5,7,1,26
191219285,4,5,2,8,4,23
191219286,7,2,8,3,8,28
191219287,9,7,9,9,2,36
191219288,1,2,2,0,6,11
191219289,6,2,9,0,5,22
191219290,6,8,7,8,1,30
191219291,7,5,7,7,8,34
191219292,3,2,0,6,3,14
191219293,9,2,9,1,0,21
191219294,5,8,0,6,3,22
191219295,7,3,6,8,7,31
191219296,9,2,5,1,2,19
191219297,3,0,0,6,7,16
191219298,7,9,0,3,1,20
191219299,8,6,8,0,8,30
191219300,2,3,3,1,1,10
191219301,8,6,7,0,0,21
191219302,1,6,8,4,5,24
191219303,1,7,6,8,5,27
191219304,9,3,8,5,4,29
191219305,6,3,2,3,1,15
191219306,7,2,8,5,6,28
191219307,2,4,1,2,4,13
191219308,2,3,2,7,3,17
191219309,7,8,0,7,6,28
191219310,6,9,7,5,1,28
191219311,5,9,4,6,4,28
191219312,3,8,1,7,1,20
191219313,8,2,5,0,0,15
191219314,9,2,0,1,3,15
191219315,8,5,1,6,6,26
191219316,0,0,2,2,7,11
191219317,6,1,7,4,9,27
191219318,5,9,2,7,7,30
191219319,9,9,2,4,6,30
191219320,7,3,4,0,9,23
191219321,5,2,9,3,6,25
191219322,7,5,8,0,1,21
191219323,2,7,6,5,4,24
191219324,9,0,6,6,2,23
191219325,5,4,4,9,5,27
191219326,5,6,2,3,0,16
191219327,5,1,6,7,5,24
191219328,0,0,1,7,8,16
191219329,9,3,6,6,8,32
191219330,1,7,9,8,7,32
191219331,3,0,7,4,3,17
191219332,0,5,2,1,0,8
191219333,0,9,1,0,9,19
191219334,6,8,3,9,8,34
191219335,2,5,5,3,7,22
191219336,4,7,5,6,2,24
191219337,9,9,3,9,8,38
191219338,0,7,6,0,3,16
191219339,4,5,9,2,7,27
191219340,4,7,2,2,7,22
191219341,1,8,7,3,8,27
191219342,5,8,5,5,9,32
191219343,9,2,6,1,8,26
191219344,6,5,4,0,1,16
191219345,2,2,4,1,1,10
191219346,6,7,8,9,3,33
191219347,7,9,1,4,3,24
191219348,3,8,8,1,6,26
191219349,9,9,7,0,0,25
191219350,1,2,8,3,8,22
191219351,0,9,8,1,4,22
191219352,7,4,7,6,5,29
191219353,5,0,3,0,7,15
191219354,1,7,5,1,1,15
191219355,4,7,8,4,2,25
191219356,8,9,3,6,0,26
191219357,3,1,9,5,3,21
191219358,0,3,7,4,6,20
191219359,2,9,1,2,7,21
191219360,4,5,4,4,9,26
191219361,8,9,3,4,4,28
191219362,5,1,9,5,6,26
191219363,6,9,2,2,1,20
191219364,2,9,3,7,9,30
191219365,5,9,3,2,9,28
191219366,0,0,3,9,9,21
191219367,2,6,4,1,0,13
191219368,5,8,8,7,3,31
191219369,1,7,4,4,7,23
191219370,8,2,3,5,6,24
191219371,7,2,1,2,6,18
191219372,5,7,9,8,5,34
191219373,3,8,0,2,1,14
191219374,9,1,9,7,5,31
191219375,8,5,7,1,2,23
191219376,4,5,3,0,4,16
191219377,1,6,7,0,7,21
191219378,9,0,1,6,4,20
191219379,2,8,3,8,3,24
191219380,2,9,9,3,9,32
191219381,4,5,3,9,9,30
191219382,7,6,0,0,8,21
191219383,8,5,4,0,9,26
191219384,3,2,4,0,4,13
191219385,3,0,7,5,5,20
191219386,0,9,6,7,8,30
191219387,9,9,6,1,4,29
191219388,4,1,9,6,6,26
191219389,8,9,5,7,4,33
191219390,8,7,4,6,4,29
191219391,0,8,1,5,9,23
191219392,6,5,2,5,0,18
191219393,9,0,3,3,3,18
191219394,1,9,1,8,1,20
191219395,7,7,4,4,3,25
191219396,1,0,3,8,0,12
191219397,0,2,7,2,9,20
191219398,0,8,3,2,2,15
191219399,9,5,2,0,2,18
191219400,7,1,1,2,1,12
191219401,7,2,6,3,6,24
191219402,1,7,9,3,1,21
191219403,6,8,1,9,5,29
191219404,4,1,5,9,5,24
191219405,4,4,9,6,6,29
191219406,6,1,0,9,9,25
191219407,2,6,2,8,7,25
191219408,6,4,4,0,3,17
191219409,5,8,0,1,3,17
191219410,4,6,2,1,2,15
191219411,8,8,4,1,1,22
191219412,3,7,5,1,8,24
191219413,2,6,7,1,8,24
191219414,7,8,2,9,6,32
191219415,9,4,2,2,4,21
191219416,9,6,2,3,6,26
191219417,7,2,2,3,0,14
191219418,9,5,5,6,9,34
191219419,0,8,4,2,2,16
191219420,4,4,8,4,4,24
191219421,5,6,8,8,7,34
191219422,3,5,7,5,5,25
191219423,2,7,0,3,6,18
191219424,8,6,9,0,3,26
191219425,1,5,5,8,5,24
191219426,5,6,2,9,0,22
191219427,2,9,6,1,0,18
191219428,7,6,9,9,8,39
191219429,3,0,9,6,4,22
191219430,8,4,8,5,5,30
191219431,1,5,4,6,6,22
191219432,6,8,3,1,5,23
191219433,3,6,6,7,6,28
191219434,2,7,3,0,6,18
191219435,6,8,1,6,7,28
191219436,5,5,5,9,9,33
191219437,8,5,4,4,0,21
191219438,4,9,9,9,6,37
191219439,9,4,7,8,3,31
191219440,1,7,9,9,8,34
191219441,6,7,7,9,1,30
191219442,8,7,5,9,5,34
191219443,6,6,2,2,9,25
191219444,3,8,4,6,4,25
191219445,6,9,4,8,7,34
191219446,1,9,0,2,0,12
191219447,6,8,1,7,5,27
191219448,6,1,5,4,6,22
191219449,9,7,3,6,0,25
191219450,9,5,0,2,5,21
191219451,1,8,7,9,1,26
191219452,3,9,1,0,7,20
191219453,0,9,4,6,5,24
191219454,6,4,2,4,1,17
191219455,3,3,8,5,3,22
191219456,1,1,1,6,7,16
191219457,0,7,1,7,6,21
191219458,0,5,9,8,5,27
191219459,4,2,8,7,6,27
191219460,2,3,6,0,8,19
191219461,9,0,1,8,6,24
191219462,4,2,8,3,9,26
191219463,6,5,4,6,6,27
191219464,2,6,2,4,9,23
191219465,8,0,9,8,2,27
191219466,7,2,1,6,6,22
191219467,2,7,1,2,0,12
191219468,6,2,7,1,2,18
191219469,1,5,9,0,9,24
191219470,0,7,5,4,9,25
191219471,1,0,5,6,6,18
191219472,9,6,3,1,9,28
191219473,3,6,6,5,5,25
191219474,9,8,7,8,0,32
191219475,8,9,8,6,4,35
191219476,7,7,0,8,3,25
191219477,5,3,6,2,9,25
191219478,9,1,2,1,0,13
191219479,0,4,8,4,9,25
191219480,4,2,6,5,5,22
191219481,3,7,5,7,0,22
191219482,8,3,5,5,6,27
191219483,2,7,5,3,1,18
191219484,7,7,6,7,7,34
191219485,3,9,5,5,2,24
191219486,4,9,8,4,2,27
191219487,6,9,3,8,1,27
191219488,7,9,8,0,0,24
191219489,5,8,7,4,7,31
191219490,2,4,3,5,7,21
191219491,2,8,0,1,1,12
191219492,8,6,7,2,6,29
191219493,0,0,2,5,8,15
191219494,3,7,3,1,0,14
191219495,8,7,7,2,6,30
191219496,4,5,6,5,0,20
191219497,9,4,3,1,6,23
191219498,5,5,7,6,7,30
191219499,2,7,9,5,5,28
191219500,4,7,1,5,9,26
191219501,5,3,8,4,1,21
191219502,9,8,9,3,6,35
191219503,1,6,0,7,8,22
191219504,9,6,0,2,7,24
191219505,6,3,7,6,5,27
191219506,5,6,2,7,9,29
191219507,8,9,0,6,5,28
191219508,1,8,4,8,0,21
191219509,2,3,0,4,9,18
191219510,5,3,0,3,4,15
191219511,6,1,1,5,6,19
191219512,4,2,9,9,7,31
191219513,4,4,4,6,2,20
191219514,5,2,8,7,2,24
191219515,6,4,4,9,3,26
191219516,8,5,2,0,2,17
191219517,4,4,1,3,6,18
191219518,1,1,2,2,8,14
191219519,2,9,3,1,9,24
191219520,1,5,1,4,4,15
191219521,9,5,1,7,2,24
191219522,3,7,5,2,8,25
191219523,5,2,7,1,6,21
191219524,2,6,5,6,9,28
191219525,1,9,9,0,8,27
191219526,5,5,6,7,0,23
191219527,5,6,6,8,4,29
191219528,8,0,3,0,2,13
191219529,4,9,9,6,6,34
191219530,6,0,3,0,6,15
191219531,3,5,8,8,8,32
191219532,2,7,9,0,3,21
191219533,8,6,0,7,6,27
191219534,0,8,5,8,4,25
191219535,2,0,6,4,8,20
191219536,2,3,6,2,5,18
191219537,6,6,3,9,9,33
191219538,1,8,4,4,2,19
191219539,1,6,4,6,2,19
191219540,8,6,0,8,7,29
191219541,8,9,7,2,6,32
191219542,8,6,1,4,3,22
191219543,1,3,0,8,8,20
191219544,4,2,5,8,3,22
191219545,7,3,2,0,0,12
191219546,2,4,5,8,9,28
191219547,4,4,7,8,8,31
191219548,3,0,1,5,5,14
191219549,4,3,7,9,4,27
191219550,1,1,0,9,2,13
191219551,2,2,4,7,7,22
191219552,2,4,0,9,2,17
191219553,4,0,4,5,8,21
191219554,5,1,3,9,9,27
191219555,3,8,2,0,7,20
191219556,0,1,8,9,5,23
191219557,5,1,7,6,5,24
191219558,6,7,2,0,3,18
191219559,1,6,2,0,9,18
191219560,1,5,4,2,2,14
191219561,8,1,0,7,3,19
191219562,4,8,2,9,5,28
191219563,2,6,9,4,0,21
191219564,7,7,1,9,2,26
191219565,5,5,9,2,1,22
191219566,7,7,7,7,0,28
191219567,1,4,1,5,7,18
191219568,5,0,9,3,4,21
191219569,3,4,6,5,2,20
191219570,8,7,6,3,2,26
191219571,7,4,2,9,4,26
191219572,4,5,0,8,7,24
191219573,6,7,0,5,1,19
191219574,9,1,6,7,4,27
191219575,8,6,2,9,5,30
191219576,7,7,8,9,0,31
191219577,1,2,5,0,3,11
191219578,7,3,1,7,4,22
191219579,9,8,0,2,5,24
191219580,0,4,1,1,1,7
191219581,3,2,8,6,6,25
191219582,5,4,5,2,8,24
191219583,2,6,3,5,4,20
191219584,8,5,3,9,7,32
191219585,3,8,4,5,7,27
191219586,4,4,1,6,7,22
191219587,6,6,4,6,3,25
191219588,7,1,2,1,5,16
191219589,9,1,3,4,1,18
191219590,0,6,8,4,7,25
191219591,1,8,6,6,4,25
191219592,3,5,2,2,7,19
191219593,1,3,9,4,8,25
191219594,0,6,6,3,7,22
191219595,4,0,0,7,3,14
191219596,1,6,0,9,8,24
191219597,1,3,0,3,3,10
191219598,9,6,5,8,6,34
191219599,3,6,9,6,9,33
191219600,8,0,1,2,1,12
191219601,4,3,6,4,9,26
191219602,4,0,7,5,3,19
191219603,9,0,8,4,8,29
191219604,9,2,1,0,9,21
191219605,5,6,3,6,6,26
191219606,8,6,5,8,6,33
191219607,2,7,7,4,6,26
191219608,1,9,0,7,6,23
191219609,7,0,4,0,0,11
191219610,1,6,2,6,2,17
191219611,8,5,5,8,1,27
191219612,6,8,1,0,4,19
191219613,3,9,4,0,5,21
191219614,9,6,2,4,6,27
191219615,8,7,1,5,3,24
191219616,0,0,8,5,0,13
191219617,8,9,1,0,7,25
191219618,9,7,9,1,7,33
191219619,1,3,6,9,5,24
191219620,1,8,2,3,2,16
191219621,0,5,5,8,3,21
191219622,4,5,8,2,2,21
191219623,6,7,1,8,4,26
191219624,0,3,8,1,8,20
191219625,8,7,4,2,9,30
191219626,8,4,3,7,0,22
191219627,3,3,4,4,7,21
191219628,2,2,5,1,6,16
191219629,0,3,1,1,4,9
191219630,1,9,3,2,5,20
191219631,5,4,1,1,0,11
191219632,7,9,6,3,4,29
191219633,0,1,4,5,4,14
191219634,9,8,7,5,5,34
191219635,5,8,1,8,8,30
191219636,5,5,5,3,1,19
191219637,0,7,8,5,1,21
191219638,3,8,1,5,2,19
191219639,2,2,6,7,2,19
191219640,4,2,3,8,2,19
191219641,6,6,0,5,5,22
191219642,8,0,5,1,3,17
191219643,2,9,2,9,8,30
191219644,5,3,2,4,2,16
191219645,2,8,8,5,8,31
191219646,1,7,4,5,8,25
191219647,7,4,3,9,9,32
191219648,7,2,1,1,6,17
191219649,6,9,8,6,1,30
191219650,6,5,6,9,0,26
191219651,3,7,9,6,5,30
191219652,6,5,5,5,1,22
191219653,4,4,6,0,5,19
191219654,0,6,6,5,3,20
191219655,3,1,6,8,5,23
191219656,8,6,1,5,1,21
191219657,6,1,2,0,9,18
191219658,5,8,4,0,4,21
191219659,7,4,6,2,9,28
191219660,2,6,0,0,5,13
191219661,1,1,8,8,1,19
191219662,4,7,6,6,9,32
191219663,1,3,5,9,3,21
191219664,5,4,5,6,4,24
191219665,7,9,8,9,4,37
191219666,6,2,6,6,4,24
191219667,0,0,6,4,6,16
191219668,5,2,6,7,2,22
191219669,2,1,2,1,6,12
191219670,4,2,1,3,9,19
191219671,8,5,0,5,4,22
191219672,3,8,9,4,3,27
191219673,2,8,4,0,9,23
191219674,5,6,5,1,2,19
191219675,6,7,9,2,2,26
191219676,2,9,5,6,6,28
191219677,1,3,4,4,5,17
191219678,8,4,7,7,0,26
191219679,8,1,9,2,5,25
191219680,6,4,8,3,5,26
191219681,8,3,0,9,1,21
191219682,3,5,3,8,4,23
191219683,5,0,0,1,7,13
191219684,7,6,9,3,3,28
191219685,2,3,5,4,7,21
191219686,6,9,4,1,2,22
191219687,0,9,6,9,9,33
191219688,4,0,7,0,7,18
191219689,6,4,0,5,9,24
191219690,7,6,1,7,6,27
191219691,5,9,9,6,6,35
191219692,1,5,3,6,0,15
191219693,3,9,4,9,0,25
191219694,1,8,0,8,6,23
191219695,0,1,6,5,6,18
191219696,5,6,7,4,2,24
191219697,3,7,7,4,9,30
191219698,9,7,8,8,3,35
191219699,7,8,0,5,9,29
191219700,2,7,6,9,3,27
191219701,9,7,0,8,3,27
191219702,1,2,4,8,1,16
191219703,3,1,9,1,4,18
191219704,3,5,8,2,1,19
191219705,7,6,6,2,6,27
191219706,2,2,8,8,0,20
191219707,6,2,0,0,3,11
191219708,3,2,0,4,5,14
191219709,4,9,1,0,4,18
191219710,6,3,7,4,4,24
191219711,0,9,6,3,4,22
191219712,5,4,5,8,8,30
191219713,0,1,8,2,9,20
191219714,4,0,6,2,0,12
191219715,1,6,9,6,4,26
191219716,6,3,4,8,5,26
191219717,6,2,2,2,5,17
191219718,9,4,3,1,8,25
191219719,9,4,4,6,9,32
191219720,7,9,4,7,3,30
191219721,2,8,5,4,1,20
191219722,9,5,4,8,6,32
191219723,4,0,0,3,7,14
191219724,6,3,3,4,2,18
191219725,3,9,4,0,0,16
191219726,2,9,0,3,3,17
191219727,4,5,4,0,1,14
191219728,7,5,4,5,1,22
191219729,2,5,9,6,2,24
191219730,1,0,2,6,9,18
191219731,9,9,1,8,4,31
191219732,9,9,3,7,8,36
191219733,1,5,5,3,9,23
191219734,4,1,7,6,5,23
191219735,2,1,6,2,3,14
191219736,9,9,6,4,0,28
191219737,6,0,3,0,8,17
191219738,7,1,2,7,1,18
191219739,6,5,3,0,9,23
191219740,7,1,7,5,8,28
191219741,6,9,4,1,5,25
191219742,1,7,4,2,3,17
191219743,1,2,4,5,6,18
191219744,4,1,4,7,2,18
191219745,3,0,5,7,2,17
191219746,1,0,5,2,2,10
191219747,7,1,9,7,5,29
191219748,8,2,8,4,9,31
191219749,3,1,4,3,6,17
191219750,7,0,1,9,8,25
191219751,7,9,9,0,5,30
191219752,2,3,2,5,7,19
191219753,6,4,7,8,6,31
191219754,5,3,3,1,0,12
191219755,7,6,3,9,3,28
191219756,6,3,5,8,9,31
191219757,7,5,3,1,2,18
191219758,4,8,5,4,7,28
191219759,5,7,2,9,5,28
191219760,5,1,5,9,8,28
191219761,1,0,7,4,5,17
191219762,4,5,1,3,4,17
191219763,1,6,4,9,5,25
191219764,3,9,0,3,9,24
191219765,5,9,7,5,0,26
191219766,9,6,3,1,6,25
191219767,5,2,6,2,6,21
191219768,5,6,9,9,6,35
191219769,2,5,0,7,8,22
191219770,9,3,9,0,6,27
191219771,1,3,5,0,5,14
191219772,0,7,7,8,6,28
191219773,6,4,2,8,0,20
191219774,9,9,7,8,6,39
191219775,7,9,4,7,1,28
191219776,8,4,4,0,9,25
191219777,6,6,6,4,1,23
191219778,6,8,0,6,0,20
191219779,9,4,0,1,2,16
191219780,1,7,7,6,2,23
191219781,2,4,1,3,0,10
191219782,1,2,5,9,7,24
191219783,6,5,1,5,4,21
191219784,6,3,3,5,6,23
191219785,4,1,4,8,3,20
191219786,5,4,3,4,9,25
191219787,7,3,9,6,9,34
191219788,6,0,5,1,1,13
191219789,3,6,8,3,3,23
191219790,8,6,2,6,5,27
191219791,9,0,5,3,4,21
191219792,9,4,4,4,7,28
191219793,2,1,5,4,0,12
191219794,3,8,0,0,1,12
191219795,8,0,7,2,9,26
191219796,3,6,0,9,3,21
191219797,8,1,8,0,7,24
191219798,5,1,4,2,5,17
191219799,4,0,2,2,1,9
191219800,7,4,1,9,2,23
191219801,0,9,7,5,0,21
191219802,5,6,5,7,0,23
191219803,2,0,9,7,1,19
191219804,6,6,0,7,6,25
191219805,3,1,8,3,2,17
191219806,9,8,3,2,4,26
191219807,1,1,9,7,4,22
191219808,3,4,8,9,0,24
191219809,8,1,7,0,9,25
191219810,5,6,8,0,4,23
191219811,5,7,0,1,3,16
191219812,1,4,5,6,5,21
191219813,3,2,7,3,0,15
191219814,1,3,4,7,2,17
191219815,0,9,5,0,7,21
191219816,2,3,7,0,2,14
191219817,9,1,1,1,0,12
191219818,8,1,7,6,6,28
191219819,9,7,2,6,6,30
191219820,1,2,6,3,7,19
191219821,0,9,4,2,8,23
191219822,4,5,2,8,2,21
191219823,8,6,3,2,6,25
191219824,8,8,2,2,4,24
191219825,0,6,9,1,2,18
191219826,0,3,2,6,5,16
191219827,2,9,8,1,3,23
191219828,2,2,6,4,3,17
191219829,5,2,4,0,9,20
191219830,2,6,2,5,1,16
191219831,3,6,5,3,9,26
191219832,1,7,9,1,3,21
191219833,7,1,2,4,2,16
191219834,5,7,1,1,3,17
191219835,9,4,9,9,1,32
191219836,2,2,6,3,2,15
191219837,8,5,3,9,2,27
191219838,3,0,2,7,1,13
191219839,7,9,6,1,6,29
191219840,7,4,9,1,6,27
191219841,8,3,3,9,8,31
191219842,7,5,0,5,4,21
191219843,4,0,5,9,8,26
191219844,8,9,8,5,9,39
191219845,2,1,6,7,9,25
191219846,4,3,3,5,1,16
191219847,8,4,1,2,2,17
191219848,5,9,7,3,4,28
191219849,9,9,3,2,7,30
191219850,9,0,3,6,4,22
191219851,0,7,2,0,1,10
191219852,2,2,5,2,0,11
191219853,5,0,3,2,3,13
191219854,5,5,7,7,7,31
191219855,9,0,5,9,6,29
191219856,5,8,3,4,4,24
191219857,7,5,2,5,7,26
191219858,7,4,8,8,0,27
191219859,9,0,9,5,4,27
191219860,9,5,0,9,6,29
191219861,4,5,3,1,3,16
191219862,7,4,0,5,9,25
191219863,2,7,3,1,1,14
191219864,6,5,5,4,7,27
191219865,1,7,4,7,1,20
191219866,7,9,4,8,8,36
191219867,4,8,8,4,9,33
191219868,8,0,1,9,1,19
191219869,1,2,6,5,7,21
191219870,6,1,1,2,2,12
191219871,6,7,0,2,9,24
191219872,1,0,1,2,3,7
191219873,9,5,2,1,5,22
191219874,8,1,2,5,0,16
191219875,1,8,2,3,4,18
191219876,1,9,3,1,2,16
191219877,3,9,9,9,1,31
191219878,7,6,4,9,7,33
191219879,2,4,4,4,0,14
191219880,0,5,9,5,5,24
191219881,3,9,8,1,2,23
191219882,9,4,6,1,0,20
191219883,6,0,4,9,6,25
191219884,7,0,8,1,0,16
191219885,2,8,1,0,4,15
191219886,8,2,3,2,9,24
191219887,6,8,0,2,4,20
191219888,6,4,7,8,3,28
191219889,0,0,6,7,0,13
191219890,4,8,4,5,8,29
191219891,7,9,8,8,6,38
191219892,7,4,5,9,9,34
191219893,1,6,1,0,1,9
191219894,7,6,3,2,7,25
191219895,7,0,8,1,1,17
191219896,8,1,9,4,1,23
191219897,2,9,1,2,8,22
191219898,1,6,1,6,2,16
191219899,6,9,2,6,1,24
191219900,5,4,8,3,1,21
191219901,2,4,0,7,1,14
191219902,9,1,5,8,8,31
191219903,9,2,4,1,3,19
191219904,1,5,5,7,2,20
191219905,2,0,8,3,6,19
191219906,9,0,9,5,7,30
191219907,8,0,7,0,0,15
191219908,6,2,1,4,7,20
191219909,7,6,3,5,5,26
191219910,0,6,0,9,5,20
191219911,0,3,6,8,7,24
191219912,9,3,9,9,2,32
191219913,5,7,9,3,3,27
191219914,7,4,1,4,7,23
191219915,5,0,1,2,8,16
191219916,5,0,8,9,2,24
191219917,8,8,4,4,7,31
191219918,4,6,0,2,4,16
191219919,0,1,5,1,0,7
191219920,9,1,1,7,7,25
191219921,8,4,3,6,0,21
191219922,3,5,0,6,1,15
191219923,5,9,3,4,4,25
191219924,5,2,9,9,8,33
191219925,9,9,5,0,8,31
191219926,5,8,5,1,7,26
191219927,2,7,4,4,1,18
191219928,0,4,2,2,7,15
191219929,0,3,4,9,2,18
191219930,5,0,5,7,5,22
191219931,7,3,4,4,5,23
191219932,0,6,6,9,0,21
191219933,2,6,4,9,8,29
191219934,9,6,1,9,6,31
191219935,7,8,1,3,3,22
191219936,0,6,5,9,7,27
191219937,9,6,6,9,1,31
191219938,8,8,1,5,5,27
191219939,9,1,4,5,9,28
191219940,1,3,9,9,2,24
191219941,5,6,3,3,0,17
191219942,5,0,1,4,4,14
191219943,0,4,4,4,7,19
191219944,7,2,2,9,0,20
191219945,5,8,7,5,7,32
191219946,3,2,3,0,2,10
191219947,7,4,6,5,9,31
191219948,7,7,7,0,5,26
191219949,9,4,1,8,9,31
191219950,0,6,9,3,1,19
191219951,9,1,7,3,8,28
191219952,7,0,3,1,2,13
191219953,6,9,5,0,2,22
191219954,4,2,4,9,5,24
191219955,1,3,2,6,3,15
191219956,0,1,7,8,9,25
191219957,4,3,1,6,3,17
191219958,4,2,8,6,3,23
191219959,9,8,0,6,7,30
191219960,8,1,9,3,4,25
191219961,6,1,6,2,8,23
191219962,5,0,3,7,9,24
191219963,7,5,4,7,3,26
191219964,4,3,7,6,3,23
191219965,8,9,6,0,9,32
191219966,3,1,4,5,7,20
191219967,0,8,5,8,8,29
191219968,2,6,2,6,5,21
191219969,2,9,5,5,6,27
191219970,2,0,6,6,9,23
191219971,9,8,0,5,0,22
191219972,6,4,4,3,8,25
191219973,9,8,6,2,1,26
191219974,2,5,2,3,3,15
191219975,6,6,2,2,4,20
191219976,4,1,2,6,8,21
191219977,3,8,4,8,5,28
191219978,1,8,0,7,8,24
191219979,2,5,3,6,9,25
191219980,7,6,0,8,3,24
191219981,1,3,7,1,6,18
191219982,2,4,1,2,9,18
191219983,9,2,5,1,1,18
191219984,1,7,8,1,9,26
191219985,2,4,6,7,3,22
191219986,3,0,4,0,1,8
191219987,9,5,7,4,8,33
191219988,4,8,9,1,7,29
191219989,4,3,7,0,3,17
191219990,6,7,7,8,0,28
191219991,5,5,4,2,6,22
191219992,7,5,4,0,7,23
191219993,9,2,9,2,9,31
191219994,5,3,5,5,8,26
191219995,9,0,3,8,3,23
191219996,3,0,7,3,3,16
191219997,6,7,2,4,0,19
191219998,3,8,8,5,6,30
191219999,0,4,0,4,8,16
1912191000,9,8,1,3,2,23
1912191001,7,9,2,5,6,29
1912191002,7,9,4,9,5,34
1912191003,0,0,3,0,7,10
1912191004,5,6,7,9,3,30
1912191005,9,1,6,3,1,20
1912191006,6,2,2,1,4,15
1912191007,2,9,7,1,5,24
1912191008,0,3,4,4,8,19
1912191009,0,6,7,0,0,13
1912191010,0,0,8,3,5,16
1912191011,1,7,6,9,3,26
1912191012,2,7,1,2,4,16
1912191013,0,5,5,9,8,27
1912191014,4,1,3,4,1,13
1912191015,7,8,8,0,5,28
1912191016,1,2,0,4,4,11
1912191017,8,6,5,3,1,23
1912191018,5,9,4,0,4,22
1912191019,8,1,9,4,2,24
1912191020,2,4,2,7,9,24
1912191021,0,6,9,8,0,23
1912191022,3,3,1,6,1,14
1912191023,6,0,1,0,8,15
1912191024,3,1,4,8,2,18
1912191025,5,4,8,1,6,24
1912191026,5,3,7,2,8,25
1912191027,3,0,3,4,5,15
1912191028,8,9,6,5,1,29
1912191029,3,7,7,1,6,24
1912191030,1,4,4,0,5,14
1912191031,4,6,8,1,7,26
1912191032,5,4,0,2,5,16
1912191033,1,3,0,9,7,20
1912191034,7,4,4,9,9,33
1912191035,0,6,2,8,3,19
1912191036,3,7,8,1,9,28
1912191037,5,0,5,3,6,19
1912191038,9,6,8,3,2,28
1912191039,0,4,9,2,8,23
1912191040,5,6,2,9,1,23
1912191041,1,9,1,7,8,26
1912191042,9,8,2,0,5,24
1912191043,6,3,1,3,9,22
1912191044,8,6,9,1,3,27
1912191045,5,4,0,5,4,18
1912191046,5,6,3,8,2,24
1912191047,5,5,5,1,0,16
1912191048,5,8,4,7,9,33
1912191049,9,3,2,5,2,21
1912191050,5,6,5,3,7,26
1912191051,7,5,9,1,9,31
1912191052,4,9,7,6,6,32
1912191053,6,3,1,8,9,27
1912191054,0,7,6,3,4,20
1912191055,4,0,6,6,7,23
1912191056,6,7,9,1,3,26
1912191057,1,2,0,5,5,13
1912191058,2,3,2,3,3,13
1912191059,5,0,7,6,4,22
1912191060,7,9,2,6,2,26
1912191061,2,6,7,9,9,33
1912191062,0,2,6,9,7,24
1912191063,5,3,3,9,4,24
1912191064,3,7,2,5,9,26
1912191065,5,5,7,2,7,26
1912191066,4,7,7,5,3,26
1912191067,9,3,6,0,0,18
1912191068,5,3,9,7,8,32
1912191069,4,1,0,9,7,21
1912191070,7,5,7,0,9,28
1912191071,4,0,2,5,3,14
1912191072,8,6,5,4,3,26
1912191073,9,6,8,7,5,35
1912191074,8,5,4,7,6,30
1912191075,6,4,4,1,7,22
1912191076,1,8,3,6,6,24
1912191077,8,6,0,2,5,21
1912191078,9,8,4,9,1,31
1912191079,6,6,7,5,8,32
1912191080,5,1,8,1,9,24
1912191081,9,1,2,6,9,27
1912191082,4,2,3,6,9,24
1912191083,5,3,4,0,8,20
1912191084,9,0,7,5,7,28
1912191085,7,7,6,2,7,29
1912191086,1,5,6,5,5,22
1912191087,1,6,8,0,1,16
1912191088,9,0,0,7,6,22
1912191089,3,6,4,6,8,27
1912191090,8,5,3,0,7,23
1912191091,6,9,3,2,9,29
1912191092,7,2,2,7,5,23
1912191093,7,7,1,0,5,20
1912191094,4,7,6,0,1,18
1912191095,2,3,2,6,9,22
1912191096,7,4,7,3,3,24
1912191097,3,5,5,6,5,24
1912191098,7,5,9,6,3,30
1912191099,1,6,3,2,1,13
1912191100,3,8,0,3,1,15
1912191101,1,8,0,2,9,20
1912191102,5,8,9,8,0,30
1912191103,3,5,8,5,2,23
1912191104,3,8,1,1,1,14
1912191105,7,4,6,7,9,33
191220001,0,6,0,1,4,11
191220002,7,0,5,7,8,27
191220003,8,3,6,3,9,29
191220004,2,9,3,0,9,23
191220005,5,9,8,2,5,29
191220006,2,6,4,0,5,17
191220007,5,6,6,0,6,23
191220008,3,8,2,8,5,26
191220009,8,1,4,9,3,25
191220010,8,4,8,8,0,28
191220011,1,8,2,8,2,21
191220012,9,3,7,5,4,28
191220013,8,6,8,7,9,38
191220014,1,5,1,1,4,12
191220015,5,7,7,4,2,25
191220016,7,1,1,9,7,25
191220017,4,1,2,1,5,13
191220018,7,2,8,2,2,21
191220019,4,8,0,7,3,22
191220020,3,7,5,3,5,23
191220021,7,1,1,0,5,14
191220022,1,2,0,5,8,16
191220023,7,6,7,4,7,31
191220024,9,5,9,8,9,40
191220025,9,0,5,1,2,17
191220026,1,5,4,0,3,13
191220027,6,9,2,3,6,26
191220028,4,3,8,2,0,17
191220029,6,9,5,3,3,26
191220030,2,9,1,1,7,20
191220031,3,9,2,7,0,21
191220032,0,0,7,8,0,15
191220033,4,8,6,8,5,31
191220034,0,3,7,2,1,13
191220035,2,6,4,3,2,17
191220036,3,4,9,0,3,19
191220037,7,5,7,1,7,27
191220038,1,7,8,2,1,19
191220039,9,4,5,2,5,25
191220040,0,0,2,2,9,13
191220041,3,7,5,9,6,30
191220042,1,4,3,1,0,9
191220043,7,6,3,4,4,24
191220044,4,8,3,3,4,22
191220045,6,4,1,5,0,16
191220046,0,0,8,9,8,25
191220047,5,1,4,2,2,14
191220048,0,3,5,6,0,14
191220049,4,7,2,5,8,26
191220050,6,7,9,8,8,38
191220051,2,5,5,6,6,24
191220052,6,1,8,3,9,27
191220053,4,7,1,1,7,20
191220054,1,9,0,2,3,15
191220055,7,4,5,5,0,21
191220056,8,2,5,7,9,31
191220057,1,6,8,5,8,28
191220058,4,9,9,2,1,25
191220059,5,6,7,0,1,19
191220060,8,0,0,7,4,19
191220061,1,5,1,7,5,19
191220062,2,8,8,0,6,24
191220063,6,9,0,1,1,17
191220064,7,2,9,0,7,25
191220065,2,3,2,6,7,20
191220066,4,4,3,3,0,14
191220067,7,0,3,8,1,19
191220068,7,7,9,2,8,33
191220069,7,8,5,3,7,30
191220070,7,4,0,8,5,24
191220071,3,0,7,7,1,18
191220072,4,6,8,3,3,24
191220073,0,2,8,7,9,26
191220074,7,0,0,8,0,15
191220075,1,8,9,8,8,34
191220076,2,3,1,8,8,22
191220077,9,8,5,0,0,22
191220078,2,2,6,8,2,20
191220079,7,8,9,7,8,39
191220080,4,0,7,7,2,20
191220081,2,3,8,4,7,24
191220082,4,7,1,7,3,22
191220083,4,9,6,3,0,22
191220084,5,7,3,8,7,30
191220085,2,5,6,1,2,16
191220086,9,6,1,5,1,22
191220087,3,0,1,4,8,16
191220088,6,5,7,3,8,29
191220089,0,1,4,7,0,12
191220090,0,4,8,3,2,17
191220091,0,7,6,3,2,18
191220092,7,3,9,3,1,23
191220093,6,9,8,6,0,29
191220094,4,6,7,5,1,23
191220095,5,5,8,1,1,20
191220096,0,7,8,2,5,22
191220097,7,2,7,7,2,25
191220098,3,6,1,0,7,17
191220099,8,3,7,8,4,30
191220100,3,3,8,6,6,26
191220101,3,1,0,9,3,16
191220102,5,8,9,2,9,33
191220103,4,4,3,7,4,22
191220104,8,2,1,5,4,20
191220105,3,6,0,1,0,10
191220106,8,6,4,4,1,23
191220107,6,3,5,3,5,22
191220108,3,4,3,0,6,16
191220109,8,8,3,0,4,23
191220110,3,4,1,8,2,18
191220111,0,0,7,4,3,14
191220112,6,3,3,6,1,19
191220113,9,4,4,3,3,23
191220114,8,2,9,4,0,23
191220115,6,2,1,6,9,24
191220116,9,3,9,2,8,31
191220117,7,3,9,4,2,25
191220118,2,3,5,8,7,25
191220119,6,4,5,2,7,24
191220120,2,0,9,2,6,19
191220121,4,1,2,4,6,17
191220122,1,8,9,1,8,27
191220123,4,3,9,2,5,23
191220124,2,9,7,1,9,28
191220125,9,1,3,8,9,30
191220126,8,1,5,9,5,28
191220127,4,0,1,7,0,12
191220128,0,4,7,1,1,13
191220129,1,2,4,8,3,18
191220130,0,8,9,5,5,27
191220131,6,2,5,6,1,20
191220132,1,1,8,3,8,21
191220133,9,2,5,3,1,20
191220134,0,0,5,6,0,11
191220135,6,7,5,2,3,23
191220136,1,6,4,3,0,14
191220137,1,0,8,4,5,18
191220138,3,9,0,5,4,21
191220139,6,5,5,2,2,20
191220140,1,8,6,6,6,27
191220141,8,2,1,0,9,20
191220142,5,8,9,4,6,32
191220143,8,7,8,3,8,34
191220144,0,1,6,8,6,21
191220145,0,6,8,2,0,16
191220146,7,9,8,9,3,36
191220147,7,0,2,6,1,16
191220148,2,8,1,1,1,13
191220149,0,4,0,3,7,14
191220150,3,1,6,8,4,22
191220151,1,0,4,3,5,13
191220152,8,3,8,7,3,29
191220153,1,4,9,4,7,25
191220154,7,7,4,6,6,30
191220155,6,7,1,1,4,19
191220156,0,5,9,9,5,28
191220157,4,1,5,1,7,18
191220158,4,6,4,4,9,27
191220159,9,9,7,7,3,35
191220160,5,7,9,7,4,32
191220161,6,1,0,8,2,17
191220162,9,1,6,2,8,26
191220163,1,1,6,4,4,16
191220164,4,6,3,2,8,23
191220165,5,7,6,3,8,29
191220166,5,9,3,7,5,29
191220167,5,3,7,4,8,27
191220168,5,4,2,8,3,22
191220169,7,8,8,9,8,40
191220170,5,4,3,9,3,24
191220171,7,1,6,6,6,26
191220172,9,3,6,4,6,28
191220173,9,8,1,0,3,21
191220174,4,1,4,1,4,14
191220175,8,0,7,6,7,28
191220176,0,8,8,0,1,17
191220177,4,6,2,6,4,22
191220178,3,8,9,4,2,26
191220179,9,7,5,0,4,25
191220180,3,9,6,8,4,30
191220181,6,5,8,9,9,37
191220182,6,9,2,7,4,28
191220183,0,7,2,5,9,23
191220184,3,3,8,8,0,22
191220185,7,6,4,4,6,27
191220186,0,4,0,8,9,21
191220187,1,7,8,0,4,20
191220188,5,2,2,7,6,22
191220189,0,5,4,6,9,24
191220190,0,2,0,8,7,17
191220191,0,8,4,6,1,19
191220192,3,0,1,5,4,13
191220193,0,8,7,7,0,22
191220194,1,4,0,5,1,11
191220195,1,6,9,9,4,29
191220196,4,6,6,4,6,26
191220197,0,2,9,4,2,17
191220198,3,7,4,6,5,25
191220199,1,9,2,6,6,24
191220200,9,1,6,0,5,21
191220201,9,4,5,8,9,35
191220202,2,4,8,3,1,18
191220203,0,3,4,6,6,19
191220204,5,4,4,9,4,26
191220205,5,5,7,8,5,30
191220206,5,1,0,8,1,15
191220207,7,9,0,5,0,21
191220208,0,6,1,1,8,16
191220209,2,2,1,8,7,20
191220210,0,2,1,1,3,7
191220211,0,9,6,6,4,25
191220212,6,8,1,9,0,24
191220213,6,7,5,0,9,27
191220214,9,2,3,6,1,21
191220215,6,2,8,0,4,20
191220216,7,9,3,2,7,28
191220217,8,2,7,2,3,22
191220218,6,5,8,8,6,33
191220219,0,8,0,2,8,18
191220220,4,8,4,5,9,30
191220221,1,8,8,2,4,23
191220222,9,6,0,0,8,23
191220223,3,2,5,7,2,19
191220224,7,6,4,5,3,25
191220225,1,2,8,9,2,22
191220226,4,4,5,2,6,21
191220227,6,8,6,1,2,23
191220228,6,9,4,1,1,21
191220229,7,4,1,0,3,15
191220230,0,1,4,1,6,12
191220231,4,4,8,8,3,27
191220232,8,2,9,4,1,24
191220233,1,3,1,1,4,10
191220234,8,7,2,8,1,26
191220235,9,9,5,6,8,37
191220236,1,9,2,6,9,27
191220237,0,4,4,6,7,21
191220238,0,0,1,3,8,12
191220239,3,3,6,4,0,16
191220240,1,9,8,4,6,28
191220241,3,3,2,4,3,15
191220242,6,4,3,4,4,21
191220243,3,1,4,4,1,13
191220244,7,6,9,4,8,34
191220245,1,1,2,1,7,12
191220246,8,6,5,2,8,29
191220247,1,4,2,5,8,20
191220248,0,9,8,6,7,30
191220249,1,9,5,8,0,23
191220250,3,7,7,7,3,27
191220251,2,5,7,7,8,29
191220252,6,5,9,8,4,32
191220253,3,1,6,6,1,17
191220254,1,0,0,7,8,16
191220255,8,7,0,1,7,23
191220256,4,7,0,1,8,20
191220257,8,6,1,2,2,19
191220258,7,8,6,5,6,32
191220259,2,4,9,7,9,31
191220260,8,6,4,6,9,33
191220261,1,4,2,6,3,16
191220262,4,6,1,6,4,21
191220263,8,9,6,2,7,32
191220264,6,5,5,7,0,23
191220265,5,5,7,5,9,31
191220266,9,4,1,9,9,32
191220267,4,2,2,0,1,9
191220268,6,0,7,7,5,25
191220269,3,5,2,5,9,24
191220270,9,2,0,5,5,21
191220271,6,6,3,5,4,24
191220272,7,4,1,7,5,24
191220273,6,6,1,7,6,26
191220274,0,1,5,4,3,13
191220275,0,8,3,3,8,22
191220276,1,6,0,2,1,10
191220277,1,3,2,9,7,22
191220278,5,1,0,1,3,10
191220279,8,5,0,8,6,27
191220280,3,1,2,1,3,10
191220281,9,1,5,7,0,22
191220282,5,4,7,9,2,27
191220283,7,4,5,1,1,18
191220284,6,3,2,8,8,27
191220285,7,8,8,8,7,38
191220286,2,6,7,2,8,25
191220287,1,8,3,4,6,22
191220288,3,9,4,3,3,22
191220289,7,8,2,9,9,35
191220290,8,3,8,1,5,25
191220291,1,7,1,3,8,20
191220292,1,4,5,8,9,27
191220293,1,3,4,8,2,18
191220294,5,7,8,9,4,33
191220295,3,9,2,3,5,22
191220296,9,8,2,6,1,26
191220297,6,3,8,9,0,26
191220298,3,9,8,9,1,30
191220299,2,9,2,6,3,22
191220300,3,3,6,6,3,21
191220301,0,4,3,7,6,20
191220302,4,9,0,1,9,23
191220303,0,3,1,4,7,15
191220304,3,5,7,1,3,19
191220305,1,5,5,1,3,15
191220306,1,9,8,7,9,34
191220307,0,0,8,1,2,11
191220308,8,4,0,6,3,21
191220309,2,3,6,6,4,21
191220310,3,1,5,7,0,16
191220311,1,0,3,7,6,17
191220312,3,6,9,0,9,27
191220313,6,4,6,8,7,31
191220314,9,5,5,3,1,23
191220315,0,9,3,6,6,24
191220316,6,9,3,2,4,24
191220317,6,8,8,8,6,36
191220318,2,0,7,4,1,14
191220319,3,8,1,4,7,23
191220320,1,7,1,8,8,25
191220321,0,7,2,2,7,18
191220322,2,4,8,8,9,31
191220323,3,6,3,4,4,20
191220324,5,0,4,2,2,13
191220325,1,6,2,8,2,19
191220326,9,1,1,4,9,24
191220327,4,4,6,5,1,20
191220328,5,5,4,5,2,21
191220329,4,2,5,7,0,18
191220330,0,1,4,3,9,17
191220331,5,1,4,0,8,18
191220332,8,8,6,4,5,31
191220333,5,8,5,6,5,29
191220334,5,1,2,6,8,22
191220335,3,9,2,0,2,16
191220336,0,5,1,3,0,9
191220337,9,4,7,7,4,31
191220338,7,7,6,9,9,38
191220339,5,2,2,1,5,15
191220340,7,8,0,1,5,21
191220341,0,4,8,0,6,18
191220342,4,6,9,5,0,24
191220343,2,7,4,9,9,31
191220344,4,4,0,2,3,13
191220345,8,1,7,2,4,22
191220346,3,1,9,2,0,15
191220347,7,9,9,8,2,35
191220348,4,4,0,5,9,22
191220349,7,7,0,0,8,22
191220350,8,8,5,8,8,37
191220351,2,0,3,7,4,16
191220352,1,3,4,4,4,16
191220353,8,8,9,4,5,34
191220354,9,0,2,7,1,19
191220355,5,0,2,7,5,19
191220356,4,8,9,4,1,26
191220357,9,2,4,4,7,26
191220358,1,1,5,7,4,18
191220359,1,3,7,9,0,20
191220360,8,5,4,7,2,26
191220361,2,6,1,6,5,20
191220362,1,4,1,5,9,20
191220363,3,4,2,1,9,19
191220364,0,9,9,4,5,27
191220365,0,4,3,1,8,16
191220366,2,5,2,7,6,22
191220367,5,6,4,4,6,25
191220368,0,3,8,7,4,22
191220369,2,2,3,7,9,23
191220370,7,1,5,5,8,26
191220371,3,5,6,8,4,26
191220372,0,6,7,3,6,22
191220373,8,3,0,2,6,19
191220374,9,0,6,6,4,25
191220375,1,1,8,4,0,14
191220376,3,5,1,5,4,18
191220377,4,7,1,8,9,29
191220378,3,4,0,4,3,14
191220379,2,2,0,1,5,10
191220380,2,0,2,4,8,16
191220381,3,5,8,4,0,20
191220382,0,8,9,8,7,32
191220383,1,6,1,3,8,19
191220384,8,5,2,0,6,21
191220385,2,5,4,9,1,21
191220386,9,1,8,3,2,23
191220387,1,8,1,8,8,26
191220388,5,4,2,7,7,25
191220389,8,8,5,9,7,37
191220390,4,8,5,7,3,27
191220391,8,2,6,4,9,29
191220392,5,1,1,4,1,12
191220393,7,7,5,9,2,30
191220394,3,9,6,3,6,27
191220395,0,9,8,5,0,22
191220396,0,8,0,8,2,18
191220397,4,8,1,2,3,18
191220398,0,1,4,8,1,14
191220399,4,0,1,9,6,20
191220400,6,8,5,8,9,36
191220401,0,5,2,4,8,19
191220402,6,3,0,8,6,23
191220403,1,0,3,4,0,8
191220404,7,1,5,5,5,23
191220405,1,5,0,6,2,14
191220406,0,1,3,6,6,16
191220407,2,5,3,6,4,20
191220408,6,3,1,1,9,20
191220409,5,5,1,0,7,18
191220410,1,2,3,7,0,13
191220411,1,9,8,9,5,32
191220412,5,2,0,3,1,11
191220413,8,4,6,4,3,25
191220414,7,5,6,2,6,26
191220415,3,3,7,0,6,19
191220416,9,8,1,6,9,33
191220417,8,1,0,0,9,18
191220418,1,8,6,8,2,25
191220419,9,5,5,3,2,24
191220420,2,8,5,1,4,20
191220421,1,8,9,9,0,27
191220422,3,9,1,5,1,19
191220423,7,3,3,0,0,13
191220424,5,7,6,5,8,31
191220425,1,8,9,2,9,29
191220426,5,4,8,1,2,20
191220427,7,4,3,9,6,29
191220428,3,1,7,3,2,16
191220429,0,8,6,5,5,24
191220430,2,2,9,8,7,28
191220431,5,4,1,6,1,17
191220432,5,5,9,2,9,30
191220433,8,3,3,1,1,16
191220434,3,8,0,7,1,19
191220435,0,8,5,0,7,20
191220436,4,8,8,2,5,27
191220437,0,8,6,2,4,20
191220438,1,3,3,2,8,17
191220439,7,0,5,4,4,20
191220440,3,5,0,0,3,11
191220441,5,1,9,2,8,25
191220442,0,0,4,9,7,20
191220443,0,0,7,4,6,17
191220444,5,1,3,8,3,20
191220445,5,1,3,8,4,21
191220446,6,1,3,3,4,17
191220447,5,6,8,5,1,25
191220448,9,0,4,7,3,23
191220449,7,6,2,3,2,20
191220450,0,6,1,6,9,22
191220451,9,9,1,7,8,34
191220452,3,4,0,1,5,13
191220453,9,1,9,1,1,21
191220454,3,2,5,8,7,25
191220455,4,8,8,4,5,29
191220456,0,4,1,0,5,10
191220457,5,2,3,7,9,26
191220458,7,9,6,0,9,31
191220459,5,0,2,8,9,24
191220460,5,0,3,4,1,13
191220461,2,7,7,0,1,17
191220462,4,9,7,7,4,31
191220463,2,1,4,1,6,14
191220464,6,1,3,6,9,25
191220465,1,6,0,1,4,12
191220466,7,7,2,9,5,30
191220467,5,1,5,0,7,18
191220468,2,5,9,8,5,29
191220469,8,9,0,1,9,27
191220470,0,8,9,1,4,22
191220471,5,6,3,6,8,28
191220472,5,5,6,3,9,28
191220473,8,1,1,8,1,19
191220474,1,1,3,0,4,9
191220475,1,3,9,9,4,26
191220476,3,9,3,3,9,27
191220477,4,1,0,5,5,15
191220478,5,7,5,6,7,30
191220479,7,6,7,5,8,33
191220480,2,3,5,6,0,16
191220481,6,3,0,3,9,21
191220482,5,9,4,0,6,24
191220483,3,8,5,6,6,28
191220484,8,2,2,4,4,20
191220485,8,3,5,7,9,32
191220486,2,0,8,2,9,21
191220487,6,7,5,9,3,30
191220488,0,4,5,6,9,24
191220489,3,7,3,0,3,16
191220490,5,7,8,5,9,34
191220491,0,2,0,7,7,16
191220492,9,0,8,7,5,29
191220493,6,6,6,3,8,29
191220494,0,4,5,4,0,13
191220495,8,1,1,3,4,17
191220496,1,5,3,5,7,21
191220497,0,5,5,1,7,18
191220498,5,3,9,5,5,27
191220499,1,5,5,4,0,15
191220500,0,5,2,3,8,18
191220501,0,0,5,9,9,23
191220502,3,8,2,1,7,21
191220503,8,3,5,1,9,26
191220504,9,9,2,5,7,32
191220505,5,3,5,1,4,18
191220506,5,9,9,8,5,36
191220507,5,0,7,8,7,27
191220508,1,3,6,6,4,20
191220509,1,1,4,2,5,13
191220510,0,0,8,6,3,17
191220511,7,5,1,0,0,13
191220512,1,3,0,4,7,15
191220513,7,3,2,4,6,22
191220514,7,6,9,7,1,30
191220515,0,4,8,7,9,28
191220516,4,2,1,6,1,14
191220517,7,1,0,1,3,12
191220518,2,1,7,7,8,25
191220519,0,9,1,8,0,18
191220520,2,5,0,9,4,20
191220521,5,7,1,9,1,23
191220522,7,0,6,8,5,26
191220523,2,2,1,6,8,19
191220524,6,8,3,5,2,24
191220525,0,5,2,2,2,11
191220526,2,9,4,7,8,30
191220527,4,1,6,3,8,22
191220528,6,2,4,5,7,24
191220529,8,9,4,0,0,21
191220530,2,3,0,8,7,20
191220531,4,7,8,3,1,23
191220532,9,7,5,5,5,31
191220533,9,5,6,4,0,24
191220534,6,3,9,5,3,26
191220535,5,8,8,4,8,33
191220536,1,3,4,0,3,11
191220537,9,8,0,2,7,26
191220538,8,9,6,0,4,27
191220539,9,9,5,6,9,38
191220540,0,1,3,4,2,10
191220541,3,4,1,8,1,17
191220542,0,2,9,3,2,16
191220543,3,0,4,9,0,16
191220544,1,9,9,7,0,26
191220545,2,1,6,1,8,18
191220546,2,4,0,3,1,10
191220547,7,5,5,4,2,23
191220548,8,2,4,7,4,25
191220549,7,6,2,0,3,18
191220550,7,8,1,8,0,24
191220551,1,7,4,7,3,22
191220552,6,0,0,6,4,16
191220553,1,5,7,5,0,18
191220554,4,4,5,6,4,23
191220555,8,8,3,3,6,28
191220556,8,7,2,8,3,28
191220557,6,8,6,1,9,30
191220558,4,9,3,1,3,20
191220559,2,3,1,3,8,17
191220560,2,3,8,8,5,26
191220561,5,7,9,1,3,25
191220562,1,9,4,4,0,18
191220563,6,9,1,4,6,26
191220564,8,6,3,2,2,21
191220565,2,2,7,3,0,14
191220566,0,3,6,3,4,16
191220567,6,3,5,2,9,25
191220568,5,6,8,6,4,29
191220569,5,4,2,0,7,18
191220570,3,2,4,9,5,23
191220571,6,6,0,2,8,22
191220572,3,9,6,1,9,28
191220573,7,8,0,3,8,26
191220574,0,7,2,8,1,18
191220575,3,7,0,8,5,23
191220576,4,9,5,7,0,25
191220577,5,3,3,6,5,22
191220578,9,5,0,1,3,18
191220579,7,6,9,5,2,29
191220580,8,7,4,7,2,28
191220581,3,3,8,6,9,29
191220582,5,2,6,9,4,26
191220583,1,6,6,0,0,13
191220584,3,7,3,9,8,30
191220585,0,2,2,8,2,14
191220586,1,9,0,9,3,22
191220587,8,7,1,1,1,18
191220588,4,9,4,3,0,20
191220589,6,9,1,8,1,25
191220590,2,4,4,1,1,12
191220591,2,0,5,4,9,20
191220592,6,9,0,9,2,26
191220593,2,4,9,6,2,23
191220594,9,0,9,3,4,25
191220595,9,3,0,7,7,26
191220596,2,6,6,0,5,19
191220597,1,9,6,4,5,25
191220598,8,4,7,4,3,26
191220599,7,8,8,1,9,33
191220600,9,2,1,0,2,14
191220601,4,6,8,1,3,22
191220602,1,2,1,7,7,18
191220603,3,9,3,7,2,24
191220604,3,4,3,9,0,19
191220605,1,9,7,5,2,24
191220606,0,7,9,9,1,26
191220607,8,3,6,3,6,26
191220608,4,4,5,2,3,18
191220609,3,6,5,7,5,26
191220610,2,1,0,0,3,6
191220611,4,7,2,2,6,21
191220612,8,7,7,0,6,28
191220613,1,3,5,0,7,16
191220614,2,7,2,6,9,26
191220615,0,7,9,4,5,25
191220616,8,1,3,6,6,24
191220617,8,9,4,1,8,30
191220618,2,1,2,0,2,7
191220619,6,7,1,3,2,19
191220620,9,6,8,3,5,31
191220621,3,3,5,8,8,27
191220622,8,6,7,2,9,32
191220623,2,6,4,4,9,25
191220624,6,7,9,6,4,32
191220625,6,4,6,7,0,23
191220626,4,0,9,5,3,21
191220627,6,6,2,2,0,16
191220628,0,0,2,8,4,14
191220629,3,1,6,4,5,19
191220630,6,8,8,8,8,38
191220631,6,0,4,4,9,23
191220632,6,0,8,2,2,18
191220633,3,4,3,6,0,16
191220634,0,1,8,1,2,12
191220635,3,5,8,8,2,26
191220636,1,0,0,8,0,9
191220637,6,0,8,7,3,24
191220638,3,9,0,4,8,24
191220639,1,6,5,8,3,23
191220640,3,8,7,8,9,35
191220641,9,1,4,5,8,27
191220642,9,5,3,7,7,31
191220643,3,6,7,8,1,25
191220644,4,3,9,6,1,23
191220645,0,1,0,2,2,5
191220646,5,5,8,9,4,31
191220647,3,5,1,8,2,19
191220648,8,2,4,1,7,22
191220649,9,6,6,9,3,33
191220650,3,1,6,7,9,26
191220651,2,2,6,9,3,22
191220652,7,7,2,2,6,24
191220653,7,5,5,1,9,27
191220654,1,1,5,9,9,25
191220655,3,7,3,9,1,23
191220656,6,3,2,7,0,18
191220657,6,1,4,2,5,18
191220658,2,6,2,2,6,18
191220659,3,7,6,2,8,26
191220660,1,3,3,5,3,15
191220661,0,5,9,3,3,20
191220662,8,2,6,1,6,23
191220663,2,2,5,3,2,14
191220664,0,2,1,9,7,19
191220665,1,4,8,1,6,20
191220666,4,5,4,0,5,18
191220667,3,0,9,1,0,13
191220668,5,8,5,4,5,27
191220669,9,0,8,8,5,30
191220670,9,5,2,6,8,30
191220671,2,6,5,5,0,18
191220672,7,8,4,0,4,23
191220673,6,7,1,5,8,27
191220674,2,2,4,3,8,19
191220675,8,0,5,0,7,20
191220676,6,6,9,8,5,34
191220677,7,5,8,4,7,31
191220678,4,8,3,6,9,30
191220679,4,0,4,8,6,22
191220680,2,6,2,7,2,19
191220681,5,2,5,2,5,19
191220682,0,9,5,9,4,27
191220683,0,2,7,3,1,13
191220684,3,1,3,1,4,12
191220685,8,9,9,6,5,37
191220686,5,5,7,4,7,28
191220687,2,9,2,3,2,18
191220688,0,0,9,7,5,21
191220689,9,7,8,6,9,39
191220690,3,3,6,1,1,14
191220691,1,2,3,8,1,15
191220692,9,2,7,9,7,34
191220693,6,4,7,9,4,30
191220694,8,5,3,7,1,24
191220695,8,5,9,5,8,35
191220696,7,6,5,7,8,33
191220697,8,2,9,8,8,35
191220698,1,3,9,9,8,30
191220699,7,3,3,1,3,17
191220700,9,4,6,9,9,37
191220701,8,4,4,2,4,22
191220702,4,1,3,7,3,18
191220703,4,3,5,1,9,22
191220704,2,4,9,9,5,29
191220705,9,6,8,9,6,38
191220706,2,6,1,5,2,16
191220707,1,4,3,8,9,25
191220708,4,6,5,6,2,23
191220709,9,5,2,4,1,21
191220710,9,2,0,0,2,13
191220711,4,6,2,7,6,25
191220712,8,3,2,0,9,22
191220713,8,0,4,3,0,15
191220714,6,0,6,2,4,18
191220715,8,0,1,3,2,14
191220716,8,7,6,7,0,28
191220717,6,6,0,9,1,22
191220718,8,1,8,6,3,26
191220719,8,7,8,1,6,30
191220720,2,5,7,1,0,15
191220721,1,0,3,8,1,13
191220722,2,7,5,2,0,16
191220723,4,9,2,0,6,21
191220724,8,8,4,8,5,33
191220725,6,1,9,0,2,18
191220726,0,4,8,5,9,26
191220727,4,9,9,5,3,30
191220728,2,8,3,8,9,30
191220729,9,0,9,3,9,30
191220730,8,9,6,6,8,37
191220731,2,0,4,4,2,12
191220732,5,8,2,2,3,20
191220733,2,9,5,0,8,24
191220734,2,0,7,4,2,15
191220735,5,2,4,8,5,24
191220736,0,2,1,2,5,10
191220737,7,3,7,6,5,28
191220738,3,0,4,7,0,14
191220739,9,2,8,0,0,19
191220740,6,8,5,8,3,30
191220741,1,1,5,7,5,19
191220742,7,4,0,4,7,22
191220743,9,3,3,3,8,26
191220744,5,8,8,0,4,25
191220745,4,5,9,1,3,22
191220746,9,3,9,3,8,32
191220747,8,8,4,7,9,36
191220748,5,3,3,3,4,18
191220749,7,9,2,1,2,21
191220750,4,0,9,8,4,25
191220751,6,5,7,5,7,30
191220752,3,5,7,5,8,28
191220753,4,5,0,7,2,18
191220754,1,0,8,5,5,19
191220755,7,8,0,1,9,25
191220756,8,8,8,5,9,38
191220757,2,4,6,7,7,26
191220758,2,5,3,2,1,13
191220759,8,4,5,4,1,22
191220760,7,6,5,8,2,28
191220761,1,7,9,0,5,22
191220762,7,7,0,9,0,23
191220763,6,5,3,2,9,25
191220764,5,5,7,5,5,27
191220765,7,1,2,5,1,16
191220766,3,3,6,8,4,24
191220767,4,6,5,3,7,25
191220768,4,4,4,9,8,29
191220769,7,1,3,7,7,25
191220770,3,3,5,5,5,21
191220771,2,8,4,4,2,20
191220772,2,3,7,5,5,22
191220773,8,0,5,7,8,28
191220774,8,5,8,8,4,33
191220775,7,1,8,8,6,30
191220776,9,4,8,8,1,30
191220777,4,3,8,7,1,23
191220778,3,5,1,9,0,18
191220779,8,3,2,1,0,14
191220780,1,6,0,7,7,21
191220781,3,6,6,8,2,25
191220782,9,9,5,5,7,35
191220783,3,5,1,0,0,9
191220784,8,5,5,4,2,24
191220785,8,3,3,7,1,22
191220786,1,2,6,3,9,21
191220787,6,8,2,5,2,23
191220788,0,4,2,7,2,15
191220789,8,2,4,8,3,25
191220790,5,0,4,7,9,25
191220791,0,4,3,2,7,16
191220792,3,7,2,8,6,26
191220793,2,2,0,4,5,13
191220794,8,4,9,9,6,36
191220795,0,8,8,8,8,32
191220796,3,7,9,8,2,29
191220797,9,7,0,1,4,21
191220798,6,5,6,0,4,21
191220799,0,0,9,3,9,21
191220800,1,1,5,3,4,14
191220801,4,0,8,8,9,29
191220802,0,7,4,3,8,22
191220803,2,2,9,9,7,29
191220804,4,6,7,4,8,29
191220805,6,0,2,7,7,22
191220806,3,6,7,4,6,26
191220807,1,1,3,4,7,16
191220808,5,2,6,2,0,15
191220809,2,8,8,4,9,31
191220810,2,3,3,9,4,21
191220811,6,0,9,8,7,30
191220812,2,4,9,2,7,24
191220813,5,8,8,5,1,27
191220814,6,5,4,2,5,22
191220815,2,7,9,6,7,31
191220816,8,4,3,3,3,21
191220817,4,0,9,9,4,26
191220818,2,0,0,0,9,11
191220819,9,5,3,6,4,27
191220820,1,9,3,4,1,18
191220821,9,6,8,1,5,29
191220822,4,7,5,6,1,23
191220823,2,2,1,6,9,20
191220824,3,8,2,8,7,28
191220825,0,1,6,8,1,16
191220826,3,2,8,5,5,23
191220827,8,3,2,9,1,23
191220828,8,2,5,8,9,32
191220829,8,9,3,3,6,29
191220830,7,2,0,4,9,22
191220831,2,0,7,8,8,25
191220832,6,2,7,1,1,17
191220833,5,0,6,2,8,21
191220834,7,9,7,8,9,40
191220835,1,2,2,3,9,17
191220836,3,4,2,2,5,16
191220837,2,8,7,9,9,35
191220838,0,1,0,1,6,8
191220839,3,1,9,7,4,24
191220840,3,4,5,7,4,23
191220841,1,9,2,1,6,19
191220842,0,2,7,5,1,15
191220843,6,6,2,0,6,20
191220844,0,3,3,1,7,14
191220845,7,0,5,3,2,17
191220846,2,5,9,0,4,20
191220847,1,3,7,5,0,16
191220848,2,2,8,7,1,20
191220849,3,1,3,9,4,20
191220850,0,7,1,6,7,21
191220851,3,7,7,2,8,27
191220852,1,1,8,9,6,25
191220853,4,0,2,2,0,8
191220854,3,7,5,6,8,29
191220855,5,2,2,1,9,19
191220856,4,1,9,4,4,22
191220857,5,8,5,2,9,29
191220858,1,9,3,8,9,30
191220859,6,7,8,7,3,31
191220860,9,2,3,8,2,24
191220861,2,2,7,3,6,20
191220862,4,4,1,8,8,25
191220863,1,6,1,2,4,14
191220864,9,5,6,8,3,31
191220865,0,6,0,4,8,18
191220866,0,4,2,4,9,19
191220867,8,8,3,1,3,23
191220868,7,2,8,0,5,22
191220869,8,4,1,2,3,18
191220870,1,4,2,6,9,22
191220871,3,4,4,8,7,26
191220872,1,9,6,1,5,22
191220873,7,8,5,7,3,30
191220874,9,4,6,9,1,29
191220875,2,7,4,9,5,27
191220876,9,5,1,5,5,25
191220877,6,2,2,4,5,19
191220878,1,5,9,3,3,21
191220879,9,2,3,4,2,20
191220880,0,1,6,7,6,20
191220881,9,8,2,0,7,26
191220882,4,1,8,0,1,14
191220883,9,6,1,8,7,31
191220884,2,2,5,0,6,15
191220885,0,2,9,1,2,14
191220886,5,5,9,0,5,24
191220887,3,2,2,1,1,9
191220888,5,2,8,4,1,20
191220889,9,4,0,7,3,23
191220890,4,3,7,6,7,27
191220891,7,9,2,2,9,29
191220892,6,6,3,9,7,31
191220893,2,1,9,4,8,24
191220894,7,4,3,6,4,24
191220895,9,4,1,0,0,14
191220896,0,6,9,1,1,17
191220897,8,7,0,9,9,33
191220898,1,6,3,3,1,14
191220899,6,7,7,3,1,24
191220900,4,0,0,1,4,9
191220901,3,2,6,5,1,17
191220902,2,9,4,6,3,24
191220903,1,7,6,1,2,17
191220904,0,4,0,8,6,18
191220905,4,2,9,7,2,24
191220906,7,3,4,3,6,23
191220907,0,4,8,2,5,19
191220908,7,7,8,1,0,23
191220909,6,6,9,5,9,35
191220910,0,3,2,3,3,11
191220911,8,2,1,9,6,26
191220912,1,1,3,8,0,13
191220913,5,5,6,3,4,23
191220914,1,4,6,8,2,21
191220915,8,6,0,5,9,28
191220916,0,5,7,6,4,22
191220917,7,8,1,2,2,20
191220918,2,6,4,6,5,23
191220919,6,1,2,9,3,21
191220920,3,8,1,6,1,19
191220921,2,3,8,7,9,29
191220922,9,9,6,7,9,40
191220923,0,4,2,3,4,13
191220924,1,5,0,2,1,9
191220925,1,9,6,1,2,19
191220926,2,2,7,7,5,23
191220927,7,8,9,7,3,34
191220928,4,6,3,2,3,18
191220929,3,5,0,7,5,20
191220930,6,2,9,1,8,26
191220931,1,1,2,1,6,11
191220932,6,0,4,4,5,19
191220933,5,1,6,4,3,19
191220934,2,7,7,5,7,28
191220935,9,0,1,0,0,10
191220936,2,3,0,1,0,6
191220937,1,2,2,0,1,6
191220938,5,5,8,6,6,30
191220939,2,4,4,7,4,21
191220940,2,6,7,8,6,29
191220941,9,6,5,6,3,29
191220942,9,7,4,3,0,23
191220943,5,6,9,7,0,27
191220944,5,5,3,5,1,19
191220945,5,4,3,2,1,15
191220946,1,0,4,8,3,16
191220947,2,1,1,0,1,5
191220948,2,6,0,5,8,21
191220949,9,1,5,3,7,25
191220950,5,9,5,3,7,29
191220951,9,9,9,4,6,37
191220952,4,5,2,7,9,27
191220953,1,5,3,9,6,24
191220954,6,7,5,7,3,28
191220955,8,8,8,7,4,35
191220956,1,7,4,6,4,22
191220957,9,6,0,4,3,22
191220958,7,0,2,9,6,24
191220959,3,1,3,8,9,24
191220960,0,1,6,8,5,20
191220961,1,7,5,0,2,15
191220962,9,1,5,8,7,30
191220963,2,8,5,3,8,26
191220964,1,8,1,9,2,21
191220965,3,6,0,6,9,24
191220966,2,6,9,3,2,22
191220967,3,6,7,2,5,23
191220968,6,5,0,4,2,17
191220969,1,4,1,4,1,11
191220970,7,3,8,3,3,24
191220971,8,2,3,4,3,20
191220972,1,2,0,9,5,17
191220973,8,8,3,8,8,35
191220974,1,1,7,3,2,14
191220975,5,5,4,7,6,27
191220976,1,8,8,7,3,27
191220977,6,1,3,3,8,21
191220978,1,2,6,9,3,21
191220979,9,3,7,5,5,29
191220980,7,9,7,8,2,33
191220981,1,8,0,4,0,13
191220982,3,2,0,5,5,15
191220983,3,9,6,5,5,28
191220984,9,1,2,6,2,20
191220985,3,5,7,1,5,21
191220986,0,9,4,1,6,20
191220987,5,0,3,6,5,19
191220988,4,2,1,1,7,15
191220989,2,3,6,9,7,27
191220990,5,2,8,2,4,21
191220991,6,2,9,4,9,30
191220992,9,0,5,6,8,28
191220993,2,2,9,6,8,27
191220994,0,2,1,6,2,11
191220995,5,3,3,5,6,22
191220996,6,4,0,9,3,22
191220997,1,6,5,9,2,23
191220998,9,2,3,7,3,24
191220999,7,9,3,8,3,30
1912201000,6,8,1,2,0,17
1912201001,7,7,0,5,1,20
1912201002,1,7,9,8,1,26
1912201003,2,6,0,5,1,14
1912201004,1,5,4,3,2,15
1912201005,0,6,8,7,3,24
1912201006,1,9,6,7,6,29
1912201007,4,6,8,6,2,26
1912201008,6,5,0,1,4,16
1912201009,4,3,0,8,2,17
1912201010,8,5,6,6,1,26
1912201011,9,4,7,2,9,31
1912201012,8,0,7,6,2,23
1912201013,7,5,6,9,4,31
1912201014,1,2,8,2,1,14
1912201015,1,0,9,3,9,22
1912201016,6,9,7,2,5,29
1912201017,4,4,2,6,9,25
1912201018,8,0,4,9,5,26
1912201019,8,1,8,2,7,26
1912201020,0,9,7,5,5,26
1912201021,3,1,5,7,7,23
1912201022,7,8,0,0,7,22
1912201023,4,8,0,8,6,26
1912201024,9,9,9,5,6,38
1912201025,2,7,6,2,2,19
1912201026,4,0,5,4,6,19
1912201027,6,3,3,8,7,27
1912201028,3,4,6,2,1,16
1912201029,0,8,2,1,5,16
1912201030,2,0,2,0,2,6
1912201031,3,9,9,4,9,34
1912201032,5,9,8,4,7,33
1912201033,9,7,5,7,1,29
1912201034,1,8,3,6,0,18
1912201035,5,9,7,4,1,26
1912201036,8,7,5,6,2,28
1912201037,1,3,1,1,1,7
1912201038,4,4,4,6,8,26
1912201039,7,0,9,1,5,22
1912201040,2,9,8,0,9,28
1912201041,7,4,3,7,0,21
1912201042,6,7,5,2,6,26
1912201043,0,5,0,4,3,12
1912201044,5,9,4,7,4,29
1912201045,3,0,1,5,2,11
1912201046,5,0,4,3,7,19
1912201047,3,5,3,5,9,25
1912201048,7,8,4,8,3,30
1912201049,5,4,9,8,4,30
1912201050,3,9,3,5,6,26
1912201051,6,9,6,2,0,23
1912201052,7,4,2,9,6,28
1912201053,4,7,4,7,8,30
1912201054,6,4,6,8,0,24
1912201055,6,7,4,5,6,28
1912201056,4,1,1,5,9,20
1912201057,4,3,0,3,5,15
1912201058,2,7,9,5,3,26
1912201059,6,6,0,9,3,24
1912201060,4,2,9,5,7,27
1912201061,5,9,3,6,2,25
1912201062,8,2,2,0,1,13
1912201063,8,2,5,2,4,21
1912201064,7,7,4,2,7,27
1912201065,5,2,6,9,3,25
1912201066,0,2,8,1,0,11
1912201067,0,7,4,1,8,20
1912201068,0,1,3,5,2,11
1912201069,3,3,4,7,6,23
1912201070,6,5,1,8,4,24
1912201071,3,4,5,4,8,24
1912201072,7,0,1,5,4,17
1912201073,2,8,9,1,2,22
1912201074,2,0,5,7,3,17
1912201075,3,2,8,8,9,30
1912201076,5,8,7,4,2,26
1912201077,5,2,8,3,1,19
1912201078,8,9,8,7,5,37
1912201079,0,8,1,2,9,20
1912201080,2,9,7,2,6,26
1912201081,4,1,7,1,5,18
1912201082,6,8,8,3,0,25
1912201083,1,3,4,5,5,18
1912201084,5,8,8,3,3,27
1912201085,5,7,8,4,5,29
1912201086,1,5,6,9,1,22
1912201087,6,1,9,8,6,30
1912201088,2,9,9,6,3,29
1912201089,2,2,1,3,4,12
1912201090,5,5,2,1,2,15
1912201091,0,2,3,5,7,17
1912201092,5,9,4,0,5,23
1912201093,8,6,8,3,9,34
1912201094,9,3,4,5,3,24
1912201095,9,6,8,8,4,35
1912201096,0,5,2,2,9,18
1912201097,5,4,2,8,5,24
1912201098,8,5,1,2,4,20
1912201099,6,4,2,3,3,18
1912201100,6,2,6,4,9,27
1912201101,6,7,4,3,1,21
1912201102,3,1,2,1,1,8
1912201103,0,0,8,2,6,16
1912201104,1,1,8,1,3,14
1912201105,8,5,9,8,6,36
191221001,0,5,2,1,9,17
191221002,7,2,0,9,2,20
191221003,2,6,3,5,2,18
191221004,8,2,7,6,2,25
191221005,4,5,9,8,9,35
191221006,9,8,4,6,9,36
191221007,2,2,5,7,8,24
191221008,4,2,4,4,7,21
191221009,9,6,9,3,0,27
191221010,9,7,6,7,4,33
191221011,9,7,6,2,8,32
191221012,2,4,7,9,6,28
191221013,9,1,6,7,7,30
191221014,8,6,8,4,6,32
191221015,6,6,3,9,4,28
191221016,5,0,1,9,0,15
191221017,1,2,6,0,0,9
191221018,4,4,0,2,1,11
191221019,5,8,6,7,9,35
191221020,3,0,9,7,3,22
191221021,3,6,4,3,6,22
191221022,6,5,9,9,4,33
191221023,9,8,3,1,9,30
191221024,4,8,0,1,8,21
191221025,7,0,8,0,1,16
191221026,0,9,6,9,2,26
191221027,9,5,8,5,0,27
191221028,9,4,5,7,2,27
191221029,1,0,7,4,3,15
191221030,3,9,9,0,1,22
191221031,7,2,7,1,7,24
191221032,4,1,5,2,6,18
191221033,6,8,1,5,6,26
191221034,0,0,4,2,3,9
191221035,7,7,1,9,6,30
191221036,1,8,1,6,9,25
191221037,2,7,2,5,9,25
191221038,9,4,6,2,2,23
191221039,7,6,0,8,6,27
191221040,9,8,1,9,7,34
191221041,5,0,7,7,6,25
191221042,1,6,0,8,6,21
191221043,7,9,2,5,2,25
191221044,1,2,7,3,9,22
191221045,2,2,8,5,9,26
191221046,0,2,6,8,9,25
191221047,2,1,2,9,9,23
191221048,6,0,4,3,7,20
191221049,2,2,6,4,2,16
191221050,0,0,5,7,1,13
191221051,8,6,9,7,9,39
191221052,9,8,4,4,2,27
191221053,7,7,0,9,6,29
191221054,0,3,3,4,0,10
191221055,3,1,4,9,9,26
191221056,3,8,2,6,2,21
191221057,2,8,2,7,6,25
191221058,6,2,9,3,7,27
191221059,5,0,2,5,3,15
191221060,2,5,6,8,2,23
191221061,8,4,8,4,8,32
191221062,4,4,2,4,6,20
191221063,0,0,1,5,2,8
191221064,8,3,9,4,9,33
191221065,1,4,3,4,0,12
191221066,7,0,8,1,7,23
191221067,2,7,4,5,8,26
191221068,7,3,3,7,5,25
191221069,2,4,2,8,5,21
191221070,5,8,5,0,3,21
191221071,2,6,7,2,0,17
191221072,4,7,6,4,7,28
191221073,6,1,7,0,5,19
191221074,0,8,3,3,3,17
191221075,9,2,6,7,5,29
191221076,6,7,9,6,0,28
191221077,8,0,8,9,9,34
191221078,7,0,9,7,1,24
191221079,1,7,7,6,6,27
191221080,0,8,2,7,5,22
191221081,0,3,8,6,2,19
191221082,6,8,9,3,7,33
191221083,0,2,2,3,2,9
191221084,8,0,3,7,9,27
191221085,0,9,8,1,9,27
191221086,6,8,1,0,8,23
191221087,6,5,2,4,0,17
191221088,0,1,5,0,8,14
191221089,6,4,3,7,4,24
191221090,3,9,0,6,5,23
191221091,9,8,8,2,4,31
191221092,7,6,5,3,9,30
191221093,7,8,4,9,6,34
191221094,9,7,2,4,0,22
191221095,4,8,6,8,8,34
191221096,9,7,7,5,4,32
191221097,8,9,2,9,7,35
191221098,1,2,4,3,0,10
191221099,0,9,9,1,2,21
191221100,0,5,2,4,6,17
191221101,2,8,7,2,8,27
191221102,1,3,3,5,9,21
191221103,9,0,6,9,4,28
191221104,9,2,2,4,3,20
191221105,9,3,0,2,3,17
191221106,5,1,7,1,5,19
191221107,6,2,8,9,2,27
191221108,7,9,4,3,1,24
191221109,4,2,3,2,7,18
191221110,6,9,8,7,0,30
191221111,4,2,0,3,9,18
191221112,6,8,2,9,9,34
191221113,4,0,6,3,1,14
191221114,3,3,3,4,6,19
191221115,6,5,4,9,0,24
191221116,8,3,7,2,2,22
191221117,7,9,7,3,5,31
191221118,0,2,6,5,2,15
191221119,5,3,1,3,5,17
191221120,5,1,0,6,9,21
191221121,3,7,1,6,1,18
191221122,3,8,7,6,2,26
191221123,6,0,5,1,3,15
191221124,0,1,5,4,8,18
191221125,4,4,7,7,9,31
191221126,5,9,9,1,1,25
191221127,3,6,7,3,4,23
191221128,9,2,4,4,2,21
191221129,3,1,3,8,8,23
191221130,9,7,4,4,3,27
191221131,3,0,0,4,2,9
191221132,9,2,6,9,1,27
191221133,5,6,6,5,6,28
191221134,7,7,8,6,1,29
191221135,6,9,9,2,4,30
191221136,3,2,9,4,9,27
191221137,5,3,9,1,5,23
191221138,8,3,4,5,9,29
191221139,0,7,5,4,5,21
191221140,1,9,9,6,0,25
191221141,6,6,8,7,9,36
191221142,9,4,1,5,8,27
191221143,0,7,2,7,2,18
191221144,0,9,6,2,4,21
191221145,6,3,2,5,1,17
191221146,2,5,3,2,8,20
191221147,7,0,0,7,9,23
191221148,6,1,2,2,4,15
191221149,6,1,5,3,2,17
191221150,7,5,6,4,3,25
191221151,5,5,7,5,6,28
191221152,4,6,8,5,4,27
191221153,0,1,1,5,5,12
191221154,0,9,4,3,1,17
191221155,4,6,2,8,4,24
191221156,1,1,8,1,8,19
191221157,2,7,3,5,1,18
191221158,8,8,1,4,1,22
191221159,5,2,3,6,1,17
191221160,2,5,5,7,8,27
191221161,4,6,6,7,9,32
191221162,6,6,5,8,1,26
191221163,8,2,6,2,1,19
191221164,8,7,6,2,1,24
191221165,5,4,6,5,8,28
191221166,2,4,7,9,0,22
191221167,9,1,0,3,7,20
191221168,4,5,1,5,1,16
191221169,9,6,5,2,7,29
191221170,2,0,3,7,5,17
191221171,8,8,8,8,7,39
191221172,3,0,5,3,2,13
191221173,6,2,3,1,5,17
191221174,2,3,4,6,8,23
191221175,3,4,4,4,6,21
191221176,7,5,6,2,5,25
191221177,6,2,2,3,8,21
191221178,2,6,5,8,6,27
191221179,2,8,9,0,3,22
191221180,2,2,1,7,3,15
191221181,6,6,7,9,7,35
191221182,0,9,3,6,8,26
191221183,2,2,1,9,5,19
191221184,5,2,2,5,6,20
191221185,2,4,1,9,7,23
191221186,1,7,0,8,2,18
191221187,1,1,7,7,8,24
191221188,2,4,8,4,5,23
191221189,1,9,0,8,0,18
191221190,6,9,4,4,5,28
191221191,9,6,1,6,5,27
191221192,1,7,0,2,6,16
191221193,0,8,6,3,2,19
191221194,8,4,8,4,1,25
191221195,9,1,8,8,0,26
191221196,7,3,2,2,7,21
191221197,5,6,6,7,1,25
191221198,1,2,6,8,6,23
191221199,8,6,8,3,6,31
191221200,6,1,8,5,4,24
191221201,4,4,1,2,1,12
191221202,5,8,2,3,8,26
191221203,2,2,6,8,1,19
191221204,4,2,2,2,2,12
191221205,2,6,9,3,5,25
191221206,7,7,5,3,3,25
191221207,8,2,2,7,9,28
191221208,7,0,2,5,9,23
191221209,1,7,2,3,8,21
191221210,0,8,5,5,4,22
191221211,2,5,0,1,2,10
191221212,2,1,7,5,7,22
191221213,0,1,3,2,0,6
191221214,2,2,2,5,5,16
191221215,6,1,9,8,9,33
191221216,5,7,4,3,6,25
191221217,6,5,7,6,8,32
191221218,2,9,0,4,4,19
191221219,1,9,5,8,2,25
191221220,0,7,8,6,6,27
191221221,8,0,7,4,9,28
191221222,3,1,6,6,6,22
191221223,5,0,2,8,6,21
191221224,7,7,9,5,1,29
191221225,9,4,8,0,9,30
191221226,7,9,9,0,8,33
191221227,1,5,4,3,7,20
191221228,0,4,1,2,5,12
191221229,9,5,0,1,4,19
191221230,7,4,8,4,9,32
191221231,3,1,6,6,2,18
191221232,4,3,4,8,7,26
191221233,6,0,0,6,5,17
191221234,4,1,6,4,2,17
191221235,2,7,3,5,5,22
191221236,6,2,2,0,9,19
191221237,3,1,0,5,7,16
191221238,3,7,7,3,2,22
191221239,7,7,0,0,6,20
191221240,1,6,3,9,1,20
191221241,6,5,6,4,5,26
191221242,4,0,8,7,1,20
191221243,6,4,7,5,5,27
191221244,4,3,5,0,7,19
191221245,8,5,3,0,3,19
191221246,0,2,0,6,0,8
191221247,0,7,6,6,3,22
191221248,7,6,7,7,7,34
191221249,1,6,1,1,1,10
191221250,8,6,3,4,3,24
191221251,4,8,5,4,9,30
191221252,0,6,3,7,1,17
191221253,2,9,5,8,0,24
191221254,4,1,5,7,1,18
191221255,9,1,5,9,2,26
191221256,5,2,2,6,4,19
191221257,5,7,6,0,2,20
191221258,1,0,5,9,3,18
191221259,6,5,5,3,3,22
191221260,0,9,0,7,3,19
191221261,0,9,9,9,4,31
191221262,9,8,8,2,3,30
191221263,8,1,4,4,6,23
191221264,3,2,1,0,0,6
191221265,4,6,5,1,1,17
191221266,1,5,2,4,2,14
191221267,3,9,8,1,4,25
191221268,8,1,7,7,3,26
191221269,0,4,9,3,5,21
191221270,6,3,5,4,4,22
191221271,5,8,9,9,3,34
191221272,9,9,9,1,8,36
191221273,7,9,4,0,5,25
191221274,9,2,6,5,0,22
191221275,9,8,6,7,8,38
191221276,2,9,3,6,9,29
191221277,5,6,7,4,5,27
191221278,2,5,3,5,1,16
191221279,0,0,6,0,7,13
191221280,8,9,9,2,7,35
191221281,6,6,8,0,1,21
191221282,5,9,0,7,3,24
191221283,9,6,9,6,9,39
191221284,9,5,6,6,0,26
191221285,6,6,1,2,6,21
191221286,9,0,1,3,6,19
191221287,4,3,6,1,7,21
191221288,5,2,7,2,9,25
191221289,5,0,7,3,9,24
191221290,0,2,7,4,8,21
191221291,1,7,5,7,8,28
191221292,9,0,7,7,2,25
191221293,9,6,6,3,4,28
191221294,9,8,7,4,9,37
191221295,6,0,8,6,1,21
191221296,2,2,6,4,6,20
191221297,8,1,0,6,4,19
191221298,1,9,3,3,1,17
191221299,1,5,2,7,9,24
191221300,2,7,0,3,8,20
191221301,3,5,0,1,3,12
191221302,1,1,1,5,8,16
191221303,8,6,7,0,6,27
191221304,0,3,0,6,6,15
191221305,7,3,7,2,5,24
191221306,5,0,9,6,3,23
191221307,8,7,9,8,5,37
191221308,7,0,0,9,6,22
191221309,1,8,2,1,3,15
191221310,4,1,7,0,0,12
191221311,8,4,2,7,6,27
191221312,4,9,4,2,9,28
191221313,4,6,4,2,2,18
191221314,2,3,6,6,1,18
191221315,1,3,3,1,9,17
191221316,2,0,8,4,3,17
191221317,3,8,3,8,4,26
191221318,1,4,2,6,5,18
191221319,1,6,5,3,5,20
191221320,7,3,2,6,4,22
191221321,3,6,0,9,7,25
191221322,7,2,5,7,6,27
191221323,0,2,4,4,6,16
191221324,8,6,9,7,6,36
191221325,3,8,9,3,7,30
191221326,1,6,7,3,0,17
191221327,7,3,7,6,2,25
191221328,0,5,4,6,2,17
191221329,9,5,4,3,1,22
191221330,0,2,8,0,0,10
191221331,4,2,4,3,9,22
191221332,4,2,8,5,0,19
191221333,1,1,9,9,0,20
191221334,8,1,4,3,6,22
191221335,2,0,9,2,0,13
191221336,6,3,9,9,0,27
191221337,0,3,6,1,9,19
191221338,6,4,8,2,1,21
191221339,2,7,1,7,4,21
191221340,7,9,1,5,0,22
191221341,9,3,7,7,6,32
191221342,6,3,2,5,4,20
191221343,6,3,4,1,7,21
191221344,1,8,5,4,1,19
191221345,7,3,7,7,5,29
191221346,0,8,8,2,3,21
191221347,0,1,1,1,4,7
191221348,9,8,8,2,1,28
191221349,5,0,4,9,4,22
191221350,7,4,3,6,2,22
191221351,5,6,3,8,6,28
191221352,5,7,4,0,7,23
191221353,3,3,2,2,8,18
191221354,3,9,7,9,4,32
191221355,7,7,6,4,2,26
191221356,3,9,1,5,9,27
191221357,6,3,1,5,7,22
191221358,1,3,8,0,3,15
191221359,6,1,6,9,0,22
191221360,4,6,0,4,5,19
191221361,3,4,5,0,4,16
191221362,5,7,1,4,1,18
191221363,8,6,1,4,2,21
191221364,1,4,5,2,1,13
191221365,9,9,0,8,4,30
191221366,6,1,3,2,9,21
191221367,1,7,0,6,8,22
191221368,2,2,3,9,7,23
191221369,0,1,2,5,8,16
191221370,7,8,1,0,7,23
191221371,4,8,6,2,8,28
191221372,5,3,5,9,5,27
191221373,8,9,7,9,6,39
191221374,3,3,8,4,9,27
191221375,1,2,4,0,8,15
191221376,3,3,5,9,4,24
191221377,0,5,6,1,8,20
191221378,2,1,6,1,0,10
191221379,4,0,2,0,0,6
191221380,0,4,2,9,2,17
191221381,5,1,3,1,8,18
191221382,5,5,3,9,6,28
191221383,8,1,1,6,1,17
191221384,3,6,4,6,6,25
191221385,8,7,0,6,3,24
191221386,7,7,7,0,8,29
191221387,3,6,8,5,7,29
191221388,3,9,6,8,3,29
191221389,9,2,3,4,7,25
191221390,9,1,6,6,7,29
191221391,0,9,3,9,9,30
191221392,8,3,2,3,8,24
191221393,6,0,0,2,0,8
191221394,1,7,6,6,9,29
191221395,3,5,1,6,6,21
191221396,7,4,1,0,0,12
191221397,2,7,6,3,6,24
191221398,7,0,3,8,9,27
191221399,9,2,1,5,8,25
191221400,9,6,9,3,1,28
191221401,1,3,8,2,8,22
191221402,1,7,1,5,7,21
191221403,4,0,0,3,3,10
191221404,7,8,9,0,7,31
191221405,0,0,3,5,8,16
191221406,2,6,9,8,3,28
191221407,8,1,9,1,9,28
191221408,3,2,5,5,0,15
191221409,2,1,8,0,7,18
191221410,4,0,9,5,5,23
191221411,7,2,2,1,4,16
191221412,2,3,4,2,6,17
191221413,7,9,9,5,3,33
191221414,6,5,7,4,9,31
191221415,3,4,9,8,2,26
191221416,4,0,1,2,5,12
191221417,5,8,9,5,0,27
191221418,6,9,3,9,5,32
191221419,5,7,0,2,5,19
191221420,7,3,1,0,1,12
191221421,9,8,5,3,5,30
191221422,5,6,0,8,2,21
191221423,6,9,2,6,6,29
191221424,3,6,1,6,7,23
191221425,0,4,6,1,7,18
191221426,1,9,5,2,7,24
191221427,6,3,7,4,3,23
191221428,4,8,8,0,5,25
191221429,5,7,8,6,3,29
191221430,8,6,0,4,9,27
191221431,7,9,7,0,1,24
191221432,8,6,0,5,8,27
191221433,0,1,1,1,9,12
191221434,2,0,5,4,0,11
191221435,6,5,8,5,3,27
191221436,0,6,0,1,9,16
191221437,8,3,1,8,3,23
191221438,0,7,4,3,4,18
191221439,2,9,9,9,9,38
191221440,7,5,5,1,6,24
191221441,9,9,2,0,9,29
191221442,2,1,7,0,6,16
191221443,8,8,0,0,6,22
191221444,5,4,2,7,1,19
191221445,8,9,5,8,4,34
191221446,7,4,3,0,4,18
191221447,7,7,3,5,8,30
191221448,1,1,4,9,7,22
191221449,2,9,6,7,7,31
191221450,8,4,5,9,2,28
191221451,2,9,2,1,9,23
191221452,1,3,2,7,8,21
191221453,0,5,8,5,8,26
191221454,2,0,8,6,8,24
191221455,6,3,7,8,8,32
191221456,2,4,4,2,7,19
191221457,2,5,9,7,5,28
191221458,8,5,9,7,2,31
191221459,9,4,9,2,2,26
191221460,8,4,1,0,4,17
191221461,5,2,4,4,9,24
191221462,8,9,8,1,8,34
191221463,6,7,1,6,0,20
191221464,8,2,1,0,6,17
191221465,9,9,2,0,5,25
191221466,9,4,6,9,5,33
191221467,8,4,7,8,4,31
191221468,6,4,2,0,9,21
191221469,4,0,2,8,4,18
191221470,0,5,0,5,2,12
191221471,5,0,8,0,3,16
191221472,6,8,1,4,5,24
191221473,9,9,2,5,2,27
191221474,3,6,7,9,4,29
191221475,1,7,3,7,0,18
191221476,2,5,9,5,5,26
191221477,3,5,7,7,4,26
191221478,8,8,5,7,2,30
191221479,0,8,3,2,8,21
191221480,6,1,7,8,6,28
191221481,9,0,2,5,0,16
191221482,9,8,4,8,1,30
191221483,9,1,5,3,5,23
191221484,5,0,6,0,0,11
191221485,4,4,9,3,5,25
191221486,9,4,5,3,9,30
191221487,1,1,1,8,7,18
191221488,9,4,0,1,3,17
191221489,3,9,0,6,7,25
191221490,2,6,3,4,8,23
191221491,8,3,0,1,2,14
191221492,9,2,8,4,5,28
191221493,3,9,7,9,1,29
191221494,2,7,0,9,2,20
191221495,8,5,3,3,6,25
191221496,0,7,9,3,5,24
191221497,5,8,1,6,2,22
191221498,8,7,8,5,3,31
191221499,1,8,1,8,3,21
191221500,5,4,1,8,5,23
191221501,0,7,4,0,9,20
191221502,4,0,8,5,4,21
191221503,9,0,2,0,8,19
191221504,6,1,6,3,5,21
191221505,3,6,7,6,3,25
191221506,5,9,2,4,5,25
191221507,3,4,6,2,8,23
191221508,9,9,1,9,3,31
191221509,2,4,1,8,6,21
191221510,2,2,6,4,5,19
191221511,8,5,4,5,7,29
191221512,1,7,2,6,5,21
191221513,4,8,4,1,2,19
191221514,8,4,1,6,5,24
191221515,8,4,3,0,6,21
191221516,7,4,6,4,6,27
191221517,6,2,4,0,3,15
191221518,6,3,9,7,7,32
191221519,1,1,8,0,5,15
191221520,5,1,5,0,5,16
191221521,1,3,6,4,2,16
191221522,6,1,4,3,1,15
191221523,2,9,9,7,6,33
191221524,7,1,7,2,9,26
191221525,8,4,0,3,5,20
191221526,9,8,9,3,7,36
191221527,2,9,2,8,4,25
191221528,7,2,5,3,9,26
191221529,2,2,1,3,2,10
191221530,0,8,6,5,0,19
191221531,7,9,8,6,4,34
191221532,5,4,6,0,7,22
191221533,2,4,6,1,0,13
191221534,2,1,7,8,3,21
191221535,2,1,7,1,0,11
191221536,6,4,4,7,6,27
191221537,1,4,3,9,2,19
191221538,4,9,7,5,0,25
191221539,0,7,1,7,9,24
191221540,4,6,1,7,2,20
191221541,8,5,2,1,9,25
191221542,3,3,0,1,7,14
191221543,7,8,6,2,1,24
191221544,5,1,6,6,5,23
191221545,3,2,7,4,8,24
191221546,6,3,4,0,6,19
191221547,6,3,9,9,7,34
191221548,2,4,1,5,4,16
191221549,1,7,6,2,4,20
191221550,0,8,2,1,3,14
191221551,7,7,6,4,4,28
191221552,7,9,4,0,9,29
191221553,0,0,5,1,5,11
191221554,7,1,3,7,8,26
191221555,4,2,1,0,3,10
191221556,7,1,2,8,1,19
191221557,7,3,8,6,8,32
191221558,1,2,8,1,1,13
191221559,9,4,5,9,3,30
191221560,3,0,5,8,2,18
191221561,5,9,9,7,0,30
191221562,8,6,7,9,7,37
191221563,6,2,8,8,4,28
191221564,7,6,4,1,3,21
191221565,0,4,1,7,1,13
191221566,4,4,5,5,8,26
191221567,6,8,2,0,4,20
191221568,0,1,8,0,6,15
191221569,3,4,7,8,0,22
191221570,3,7,8,1,4,23
191221571,9,4,5,4,6,28
191221572,0,5,2,6,7,20
191221573,8,1,9,9,6,33
191221574,6,7,1,2,0,16
191221575,7,3,6,2,2,20
191221576,1,1,8,8,6,24
191221577,4,6,7,6,6,29
191221578,7,6,7,6,2,28
191221579,4,6,8,2,1,21
191221580,2,8,8,0,1,19
191221581,3,9,0,3,7,22
191221582,1,4,6,1,1,13
191221583,6,4,6,7,3,26
191221584,6,0,7,4,9,26
191221585,0,2,7,1,4,14
191221586,6,0,7,0,5,18
191221587,8,1,7,3,1,20
191221588,4,6,3,6,0,19
191221589,8,5,6,1,6,26
191221590,6,1,4,0,5,16
191221591,7,6,7,5,3,28
191221592,1,5,0,1,0,7
191221593,6,2,0,2,2,12
191221594,1,3,7,1,5,17
191221595,9,2,7,4,6,28
191221596,9,0,4,8,5,26
191221597,3,4,3,5,6,21
191221598,7,8,6,5,3,29
191221599,1,1,6,7,9,24
191221600,0,3,7,9,4,23
191221601,6,0,8,2,9,25
191221602,6,3,9,8,6,32
191221603,6,0,1,1,3,11
191221604,8,6,7,2,5,28
191221605,8,3,2,2,0,15
191221606,3,6,0,7,3,19
191221607,4,0,5,2,9,20
191221608,5,4,8,8,9,34
191221609,6,4,2,1,5,18
191221610,7,1,4,9,2,23
191221611,2,1,2,7,8,20
191221612,9,0,7,8,1,25
191221613,3,1,2,2,0,8
191221614,8,8,5,8,3,32
191221615,7,8,1,5,5,26
191221616,1,2,2,6,6,17
191221617,5,8,3,7,7,30
191221618,3,5,4,8,0,20
191221619,3,3,2,1,5,14
191221620,9,6,9,0,8,32
191221621,6,0,0,8,9,23
191221622,6,7,4,5,3,25
191221623,2,5,3,0,4,14
191221624,6,8,3,0,4,21
191221625,0,1,3,4,7,15
191221626,3,6,1,5,3,18
191221627,0,5,5,5,1,16
191221628,5,0,6,8,2,21
191221629,1,9,6,8,4,28
191221630,7,1,7,4,7,26
191221631,6,5,2,0,0,13
191221632,1,4,4,6,2,17
191221633,0,5,6,8,3,22
191221634,6,5,9,7,7,34
191221635,6,2,6,8,3,25
191221636,6,6,2,9,9,32
191221637,4,4,1,1,3,13
191221638,6,1,0,4,4,15
191221639,4,0,9,1,1,15
191221640,3,1,0,3,5,12
191221641,6,7,9,4,7,33
191221642,3,9,1,4,3,20
191221643,0,3,7,3,0,13
191221644,2,8,9,7,2,28
191221645,2,6,7,2,3,20
191221646,9,3,0,5,9,26
191221647,6,0,7,8,7,28
191221648,9,3,4,1,5,22
191221649,2,6,0,3,0,11
191221650,8,2,8,6,5,29
191221651,2,6,5,4,7,24
191221652,1,3,3,6,1,14
191221653,9,5,2,6,4,26
191221654,8,8,8,9,4,37
191221655,2,3,6,9,1,21
191221656,5,5,2,0,4,16
191221657,2,4,2,6,1,15
191221658,6,7,4,4,7,28
191221659,6,9,6,3,5,29
191221660,9,3,3,6,8,29
191221661,9,9,5,8,3,34
191221662,2,3,7,0,1,13
191221663,0,0,1,3,5,9
191221664,4,4,7,5,7,27
191221665,3,6,0,3,1,13
191221666,8,1,1,8,5,23
191221667,6,4,0,1,9,20
191221668,7,2,1,9,3,22
191221669,5,3,6,1,4,19
191221670,5,0,8,8,2,23
191221671,5,8,3,7,2,25
191221672,1,5,0,6,7,19
191221673,8,2,5,8,4,27
191221674,5,5,5,8,8,31
191221675,7,8,4,1,0,20
191221676,8,9,9,0,8,34
191221677,0,3,4,5,3,15
191221678,7,6,9,3,8,33
191221679,2,9,2,4,7,24
191221680,0,9,8,2,2,21
191221681,6,2,9,3,6,26
191221682,7,7,5,3,1,23
191221683,0,7,6,4,4,21
191221684,1,8,3,6,9,27
191221685,2,1,6,0,2,11
191221686,6,5,6,5,8,30
191221687,1,2,9,5,8,25
191221688,4,0,4,6,2,16
191221689,3,3,6,1,6,19
191221690,9,4,9,6,9,37
191221691,6,1,0,6,5,18
191221692,7,6,1,1,2,17
191221693,5,1,0,2,0,8
191221694,8,1,6,3,1,19
191221695,1,8,0,5,5,19
191221696,2,8,9,6,2,27
191221697,8,1,4,4,9,26
191221698,4,1,8,1,3,17
191221699,6,9,7,8,4,34
191221700,3,1,0,4,2,10
191221701,9,3,4,7,0,23
191221702,2,8,0,7,7,24
191221703,5,4,5,8,0,22
191221704,0,0,6,2,2,10
191221705,6,2,4,3,5,20
191221706,5,5,9,5,4,28
191221707,4,4,0,1,3,12
191221708,4,6,0,9,3,22
191221709,4,1,4,3,8,20
191221710,4,5,1,0,7,17
191221711,0,8,4,5,0,17
191221712,8,2,5,7,1,23
191221713,1,3,8,8,9,29
191221714,7,6,2,9,6,30
191221715,1,6,7,8,6,28
191221716,1,1,3,5,0,10
191221717,0,5,7,2,2,16
191221718,3,9,1,2,0,15
191221719,6,9,5,7,9,36
191221720,2,5,9,5,0,21
191221721,5,9,1,0,4,19
191221722,5,1,7,4,2,19
191221723,2,1,5,9,9,26
191221724,2,5,4,9,6,26
191221725,9,4,3,0,8,24
191221726,5,8,5,7,9,34
191221727,1,6,2,7,7,23
191221728,7,2,8,0,9,26
191221729,9,0,4,7,9,29
191221730,6,3,6,6,9,30
191221731,2,7,7,3,2,21
191221732,0,0,3,7,4,14
191221733,5,0,2,9,5,21
191221734,1,4,4,8,5,22
191221735,3,1,4,1,0,9
191221736,1,5,9,0,8,23
191221737,2,0,5,7,9,23
191221738,9,7,9,1,9,35
191221739,2,6,1,4,5,18
191221740,5,5,2,6,2,20
191221741,6,7,9,3,6,31
191221742,0,3,0,6,2,11
191221743,0,3,0,4,2,9
191221744,9,0,8,4,7,28
191221745,2,1,4,3,2,12
191221746,1,3,5,8,5,22
191221747,3,9,3,4,7,26
191221748,3,0,9,2,2,16
191221749,5,0,8,9,3,25
191221750,7,6,1,4,6,24
191221751,9,6,1,3,9,28
191221752,5,6,7,5,4,27
191221753,4,6,9,8,1,28
191221754,4,0,6,5,5,20
191221755,3,8,7,9,5,32
191221756,2,6,7,5,9,29
191221757,6,2,3,6,2,19
191221758,9,9,3,6,4,31
191221759,5,4,0,7,0,16
191221760,4,6,2,1,8,21
191221761,1,5,0,5,3,14
191221762,3,0,6,6,7,22
191221763,5,8,0,7,3,23
191221764,7,0,7,3,9,26
191221765,6,6,9,7,0,28
191221766,1,0,3,0,6,10
191221767,8,2,1,7,9,27
191221768,3,4,0,6,8,21
191221769,5,9,8,6,2,30
191221770,7,8,1,6,2,24
191221771,6,9,3,9,8,35
191221772,4,7,2,2,7,22
191221773,7,5,0,7,0,19
191221774,3,8,8,9,8,36
191221775,0,5,9,0,9,23
191221776,5,2,9,7,8,31
191221777,1,2,1,0,6,10
191221778,2,0,1,1,4,8
191221779,8,7,9,0,0,24
191221780,0,4,3,8,5,20
191221781,1,5,4,9,9,28
191221782,7,2,3,7,6,25
191221783,0,2,1,8,2,13
191221784,2,5,4,2,9,22
191221785,4,6,2,6,8,26
191221786,3,8,0,6,8,25
191221787,9,7,4,7,2,29
191221788,6,1,5,1,5,18
191221789,7,1,8,9,8,33
191221790,6,8,7,9,6,36
191221791,3,1,8,9,9,30
191221792,0,9,8,5,9,31
191221793,9,6,1,1,0,17
191221794,1,7,7,4,0,19
191221795,3,8,4,6,8,29
191221796,0,0,5,4,5,14
191221797,0,2,4,7,7,20
191221798,7,7,7,1,4,26
191221799,3,5,8,7,5,28
191221800,0,3,4,8,5,20
191221801,3,6,5,6,6,26
191221802,5,5,4,2,4,20
191221803,4,8,8,8,8,36
191221804,4,5,8,7,3,27
191221805,9,5,6,8,4,32
191221806,1,2,9,5,3,20
191221807,9,8,4,7,7,35
191221808,8,0,2,2,9,21
191221809,3,6,7,6,7,29
191221810,7,1,2,5,2,17
191221811,6,6,3,0,5,20
191221812,7,5,9,8,8,37
191221813,4,6,1,4,6,21
191221814,6,9,3,7,3,28
191221815,3,7,4,3,0,17
191221816,0,3,8,6,1,18
191221817,4,2,5,4,7,22
191221818,7,6,8,1,1,23
191221819,3,3,4,9,5,24
191221820,0,2,1,4,0,7
191221821,1,7,7,2,1,18
191221822,3,7,2,7,9,28
191221823,5,5,2,2,7,21
191221824,6,7,4,0,2,19
191221825,0,1,3,2,2,8
191221826,5,8,4,7,6,30
191221827,3,5,2,4,2,16
191221828,6,2,0,1,3,12
191221829,8,9,5,6,1,29
191221830,1,6,2,6,4,19
191221831,4,0,0,2,4,10
191221832,1,0,3,9,1,14
191221833,1,9,4,4,8,26
191221834,2,6,8,7,8,31
191221835,6,7,5,1,7,26
191221836,9,3,4,9,2,27
191221837,6,0,2,3,4,15
191221838,3,7,2,1,0,13
191221839,8,9,1,1,3,22
191221840,9,2,1,8,2,22
191221841,4,9,6,1,9,29
191221842,4,0,0,3,9,16
191221843,0,0,5,5,7,17
191221844,7,6,0,3,6,22
191221845,7,4,2,1,2,16
191221846,9,0,8,1,5,23
191221847,7,9,0,5,3,24
191221848,3,6,3,6,5,23
191221849,6,4,1,4,0,15
191221850,2,3,1,9,4,19
191221851,4,9,4,6,0,23
191221852,7,5,8,4,4,28
191221853,3,9,3,7,9,31
191221854,8,2,0,7,2,19
191221855,5,7,1,4,3,20
191221856,0,9,2,5,9,25
191221857,0,5,5,9,9,28
191221858,7,3,3,5,3,21
191221859,8,5,7,8,0,28
191221860,3,8,9,9,7,36
191221861,2,6,9,0,6,23
191221862,2,3,6,4,8,23
191221863,3,4,7,2,1,17
191221864,9,0,1,4,9,23
191221865,2,7,4,3,5,21
191221866,2,5,2,6,2,17
191221867,1,3,9,5,7,25
191221868,0,4,7,5,5,21
191221869,9,4,9,0,4,26
191221870,6,7,0,5,9,27
191221871,3,7,4,7,8,29
191221872,2,9,4,8,9,32
191221873,3,4,6,8,1,22
191221874,3,6,0,0,7,16
191221875,4,4,6,5,8,27
191221876,0,0,3,2,1,6
191221877,7,9,1,5,9,31
191221878,5,3,9,4,0,21
191221879,2,5,1,0,0,8
191221880,9,9,9,8,9,44
191221881,3,4,8,1,4,20
191221882,0,7,6,1,0,14
191221883,2,2,9,9,1,23
191221884,7,1,5,8,2,23
191221885,9,1,8,4,6,28
191221886,5,5,7,1,7,25
191221887,4,8,7,5,1,25
191221888,1,4,5,6,2,18
191221889,8,3,7,8,2,28
191221890,1,8,6,3,1,19
191221891,3,1,1,4,9,18
191221892,2,9,3,2,5,21
191221893,0,2,2,6,6,16
191221894,3,1,1,6,5,16
191221895,3,7,5,7,7,29
191221896,1,6,7,8,2,24
191221897,0,7,9,7,4,27
191221898,2,8,2,5,3,20
191221899,7,2,7,9,7,32
191221900,1,6,9,5,0,21
191221901,2,7,0,7,9,25
191221902,0,7,9,3,0,19
191221903,6,3,3,3,3,18
191221904,1,9,2,3,2,17
191221905,1,0,8,6,9,24
191221906,1,5,5,8,2,21
191221907,5,8,0,8,5,26
191221908,2,3,6,7,1,19
191221909,7,2,9,7,5,30
191221910,9,8,6,7,0,30
191221911,2,5,6,6,6,25
191221912,0,4,1,8,1,14
191221913,3,5,9,4,1,22
191221914,6,2,3,1,2,14
191221915,9,7,4,9,0,29
191221916,3,9,8,5,5,30
191221917,8,7,5,6,3,29
191221918,0,1,8,5,6,20
191221919,0,7,5,0,7,19
191221920,3,3,3,8,4,21
191221921,7,6,1,2,7,23
191221922,9,2,8,4,0,23
191221923,1,8,8,3,0,20
191221924,0,7,7,5,7,26
191221925,8,4,1,6,2,21
191221926,4,1,6,3,9,23
191221927,8,5,6,8,4,31
191221928,8,7,4,6,0,25
191221929,9,9,1,0,3,22
191221930,1,1,9,0,4,15
191221931,9,8,1,8,1,27
191221932,4,8,1,4,4,21
191221933,8,4,9,5,7,33
191221934,9,2,3,5,4,23
191221935,2,7,2,8,5,24
191221936,8,2,7,7,0,24
191221937,1,8,1,2,9,21
191221938,1,1,2,9,1,14
191221939,3,0,5,5,3,16
191221940,9,6,6,9,4,34
191221941,2,0,8,7,7,24
191221942,4,3,6,3,8,24
191221943,1,0,0,7,1,9
191221944,4,5,4,7,0,20
191221945,4,7,2,5,5,23
191221946,7,4,2,5,4,22
191221947,2,3,8,9,8,30
191221948,6,2,7,0,4,19
191221949,7,2,0,5,7,21
191221950,7,1,2,1,5,16
191221951,5,2,0,0,5,12
191221952,2,7,0,2,0,11
191221953,1,3,2,8,5,19
191221954,0,0,7,8,3,18
191221955,2,7,2,5,8,24
191221956,1,2,8,0,8,19
191221957,3,9,0,5,0,17
191221958,4,8,4,5,6,27
191221959,8,7,3,5,0,23
191221960,3,5,7,2,6,23
191221961,6,8,9,0,5,28
191221962,6,7,3,2,0,18
191221963,7,1,4,7,1,20
191221964,4,4,3,8,0,19
191221965,9,3,0,7,8,27
191221966,2,2,0,1,6,11
191221967,0,2,6,4,9,21
191221968,9,8,6,4,3,30
191221969,6,3,7,4,8,28
191221970,9,3,7,4,8,31
191221971,1,8,9,3,4,25
191221972,0,7,3,7,8,25
191221973,1,2,6,0,7,16
191221974,2,0,9,1,6,18
191221975,9,8,2,1,3,23
191221976,6,1,4,9,3,23
191221977,4,0,2,8,2,16
191221978,2,1,9,7,7,26
191221979,7,1,5,9,0,22
191221980,4,4,4,8,5,25
191221981,1,5,2,0,7,15
191221982,6,4,8,4,7,29
191221983,2,2,7,8,5,24
191221984,8,1,3,4,9,25
191221985,3,8,5,6,7,29
191221986,3,3,2,1,8,17
191221987,7,7,6,9,4,33
191221988,3,4,8,2,4,21
191221989,6,3,7,2,5,23
191221990,8,3,2,2,8,23
191221991,6,6,0,2,7,21
191221992,4,5,3,3,5,20
191221993,2,0,5,1,7,15
191221994,3,3,9,1,2,18
191221995,2,7,7,8,9,33
191221996,2,2,4,8,5,21
191221997,8,4,7,5,0,24
191221998,4,5,7,4,1,21
191221999,3,4,6,4,7,24
1912211000,0,3,2,3,9,17
1912211001,4,2,7,3,8,24
1912211002,5,7,0,7,5,24
1912211003,4,7,2,0,0,13
1912211004,8,4,5,1,9,27
1912211005,7,6,5,7,1,26
1912211006,6,1,5,0,3,15
1912211007,6,7,4,2,3,22
1912211008,0,7,0,5,8,20
1912211009,8,4,6,0,9,27
1912211010,3,0,0,4,4,11
1912211011,6,4,5,4,1,20
1912211012,7,3,8,5,8,31
1912211013,9,6,7,4,6,32
1912211014,2,7,4,0,7,20
1912211015,6,2,7,7,1,23
1912211016,0,9,6,9,6,30
1912211017,7,8,6,3,9,33
1912211018,5,6,6,6,0,23
1912211019,2,3,0,7,2,14
1912211020,2,5,4,1,9,21
1912211021,0,8,9,9,7,33
1912211022,5,9,1,5,0,20
1912211023,2,5,6,1,0,14
1912211024,2,8,8,7,4,29
1912211025,7,3,9,3,6,28
1912211026,3,6,5,1,6,21
1912211027,5,3,1,2,2,13
1912211028,4,2,4,9,0,19
1912211029,7,4,8,6,3,28
1912211030,1,4,4,9,5,23
1912211031,4,2,0,9,2,17
1912211032,3,6,8,9,4,30
1912211033,2,4,5,9,0,20
1912211034,3,3,9,8,5,28
1912211035,0,3,2,4,2,11
1912211036,5,3,0,2,4,14
1912211037,7,8,1,2,9,27
1912211038,6,6,7,0,8,27
1912211039,6,9,1,0,7,23
1912211040,1,2,4,7,7,21
1912211041,2,5,7,5,7,26
1912211042,7,8,9,4,5,33
1912211043,3,6,3,9,5,26
1912211044,9,2,5,0,2,18
1912211045,7,7,5,0,2,21
1912211046,2,9,2,3,0,16
1912211047,4,8,3,2,1,18
1912211048,8,6,1,6,7,28
1912211049,9,1,3,1,5,19
1912211050,8,6,2,6,5,27
1912211051,3,1,4,0,4,12
1912211052,4,3,6,3,3,19
1912211053,1,8,2,6,0,17
1912211054,4,1,3,3,9,20
1912211055,1,7,7,3,6,24
1912211056,6,5,5,2,7,25
1912211057,0,7,4,0,3,14
1912211058,5,8,6,9,6,34
1912211059,8,6,7,6,6,33
1912211060,5,2,6,1,5,19
1912211061,7,7,2,2,4,22
1912211062,7,7,5,5,0,24
1912211063,0,5,7,7,9,28
1912211064,1,5,6,8,0,20
1912211065,5,0,3,2,7,17
1912211066,0,3,0,8,2,13
1912211067,5,0,6,6,8,25
1912211068,5,3,7,0,8,23
1912211069,4,2,4,4,5,19
1912211070,8,3,3,4,3,21
1912211071,0,8,7,1,3,19
1912211072,1,1,9,5,9,25
1912211073,0,0,7,3,8,18
1912211074,5,8,8,3,7,31
1912211075,1,6,8,2,4,21
1912211076,8,3,1,8,0,20
1912211077,2,5,9,7,4,27
1912211078,1,8,4,0,4,17
1912211079,3,5,6,4,3,21
1912211080,2,6,0,4,0,12
1912211081,9,5,9,0,2,25
1912211082,7,0,2,1,0,10
1912211083,6,3,9,7,0,25
1912211084,9,0,8,7,4,28
1912211085,2,2,3,6,3,16
1912211086,4,4,6,6,7,27
1912211087,5,0,9,9,6,29
1912211088,8,4,8,2,7,29
1912211089,1,4,6,9,4,24
1912211090,2,6,8,6,6,28
1912211091,6,5,2,9,0,22
1912211092,4,5,2,8,9,28
1912211093,2,9,5,8,1,25
1912211094,6,4,1,7,9,27
1912211095,1,0,3,1,1,6
1912211096,5,0,1,0,5,11
1912211097,5,9,4,4,6,28
1912211098,4,4,7,6,8,29
1912211099,0,1,4,9,5,19
1912211100,0,4,5,9,0,18
1912211101,1,0,9,8,4,22
1912211102,7,1,6,9,2,25
1912211103,7,6,5,5,7,30
1912211104,8,6,6,9,7,36
1912211105,5,4,4,0,8,21
191222001,8,6,5,1,4,24
191222002,1,3,0,8,3,15
191222003,5,4,3,2,0,14
191222004,5,7,5,9,0,26
191222005,9,5,3,8,1,26
191222006,0,1,5,8,2,16
191222007,8,7,6,3,4,28
191222008,3,3,5,9,6,26
191222009,5,4,3,2,7,21
191222010,3,8,1,4,0,16
191222011,1,3,3,4,1,12
191222012,7,4,2,3,9,25
191222013,7,6,1,3,0,17
191222014,6,5,6,1,5,23
191222015,0,4,7,5,6,22
191222016,0,2,7,8,0,17
191222017,6,6,4,4,4,24
191222018,8,4,3,6,3,24
191222019,3,7,5,2,2,19
191222020,4,8,3,2,8,25
191222021,9,8,8,1,3,29
191222022,8,0,4,1,0,13
191222023,5,9,9,0,6,29
191222024,5,7,4,8,2,26
191222025,4,5,1,5,5,20
191222026,8,9,7,4,1,29
191222027,6,6,9,7,8,36
191222028,1,7,6,6,7,27
191222029,5,8,3,5,1,22
191222030,3,9,4,0,2,18
191222031,3,5,7,9,9,33
191222032,2,2,8,6,4,22
191222033,6,5,7,1,8,27
191222034,1,1,7,7,1,17
191222035,4,5,9,1,4,23
191222036,0,4,5,3,2,14
191222037,9,0,5,8,7,29
191222038,6,0,4,7,3,20
191222039,8,9,3,7,8,35
191222040,3,3,9,7,4,26
191222041,8,1,4,9,2,24
191222042,6,1,2,8,1,18
191222043,0,0,7,5,1,13
191222044,7,5,7,9,0,28
191222045,5,5,6,3,8,27
191222046,7,1,4,0,4,16
191222047,5,3,9,3,5,25
191222048,4,4,3,9,1,21
191222049,4,2,1,6,9,22
191222050,5,7,9,3,7,31
191222051,3,4,6,1,1,15
191222052,3,4,6,0,2,15
191222053,5,4,0,5,7,21
191222054,7,2,6,4,1,20
191222055,9,5,5,1,3,23
191222056,1,1,0,9,0,11
191222057,5,4,2,3,4,18
191222058,5,4,6,6,5,26
191222059,6,2,9,6,9,32
191222060,1,4,7,7,3,22
191222061,3,9,5,5,7,29
191222062,7,0,1,6,2,16
191222063,5,4,4,9,8,30
191222064,7,7,8,8,1,31
191222065,6,2,4,7,6,25
191222066,0,5,4,7,7,23
191222067,9,9,0,1,2,21
191222068,0,4,3,2,8,17
191222069,5,8,9,1,3,26
191222070,3,3,9,0,8,23
191222071,8,3,4,5,2,22
191222072,7,2,4,4,3,20
191222073,5,5,1,1,9,21
191222074,0,5,4,6,4,19
191222075,4,7,5,0,5,21
191222076,8,6,2,0,7,23
191222077,8,9,3,2,7,29
191222078,3,1,5,2,1,12
191222079,8,9,3,0,9,29
191222080,5,0,2,9,8,24
191222081,5,9,5,4,5,28
191222082,7,8,2,8,7,32
191222083,1,5,8,3,4,21
191222084,8,9,0,6,6,29
191222085,2,5,1,2,6,16
191222086,0,8,5,0,8,21
191222087,4,4,8,8,6,30
191222088,1,4,4,8,0,17
191222089,0,8,0,9,9,26
191222090,2,9,8,0,8,27
191222091,2,1,3,0,2,8
191222092,7,3,1,3,3,17
191222093,3,1,5,2,4,15
191222094,0,5,3,8,2,18
191222095,9,0,2,7,3,21
191222096,8,9,3,4,8,32
191222097,4,5,8,9,1,27
191222098,6,0,8,0,9,23
191222099,4,9,2,3,6,24
191222100,2,9,3,4,7,25
191222101,0,9,8,6,1,24
191222102,8,8,0,6,5,27
191222103,8,8,5,0,2,23
191222104,8,4,9,9,9,39
191222105,4,8,2,6,4,24
191222106,0,8,2,4,4,18
191222107,8,0,4,4,4,20
191222108,2,2,3,5,2,14
191222109,8,6,6,0,3,23
191222110,0,6,5,3,4,18
191222111,8,9,0,3,6,26
191222112,9,5,3,4,6,27
191222113,1,5,2,1,3,12
191222114,0,4,9,7,8,28
191222115,9,8,2,6,2,27
191222116,3,2,7,7,1,20
191222117,0,4,2,0,3,9
191222118,9,7,9,1,0,26
191222119,1,2,2,1,4,10
191222120,1,7,2,6,4,20
191222121,2,6,3,6,0,17
191222122,4,1,4,8,1,18
191222123,8,3,8,2,6,27
191222124,7,8,0,0,2,17
191222125,9,9,5,4,3,30
191222126,5,4,4,0,6,19
191222127,1,0,5,2,3,11
191222128,0,3,1,5,4,13
191222129,8,9,0,5,2,24
191222130,3,7,5,9,9,33
191222131,0,1,1,6,2,10
191222132,6,6,9,1,6,28
191222133,5,7,0,5,2,19
191222134,6,3,6,1,7,23
191222135,5,6,5,6,7,29
191222136,6,6,2,6,7,27
191222137,2,8,3,8,0,21
191222138,4,3,6,4,2,19
191222139,4,3,0,7,3,17
191222140,6,4,2,2,4,18
191222141,6,1,6,0,0,13
191222142,3,5,3,0,5,16
191222143,2,0,8,5,7,22
191222144,3,3,4,5,1,16
191222145,0,3,2,8,2,15
191222146,8,8,1,3,9,29
191222147,4,2,0,2,1,9
191222148,4,3,4,9,0,20
191222149,9,7,4,0,3,23
191222150,1,1,9,4,1,16
191222151,1,7,1,1,2,12
191222152,5,3,8,0,4,20
191222153,8,1,6,4,4,23
191222154,3,6,3,0,9,21
191222155,0,8,1,6,4,19
191222156,3,0,4,3,6,16
191222157,3,4,2,6,2,17
191222158,1,2,9,2,2,16
191222159,7,9,3,8,2,29
191222160,1,5,0,9,0,15
191222161,6,7,2,0,1,16
191222162,4,1,3,2,1,11
191222163,4,0,7,8,2,21
191222164,5,2,6,9,0,22
191222165,4,1,5,0,3,13
191222166,0,5,8,1,3,17
191222167,8,5,4,3,1,21
191222168,8,9,7,3,6,33
191222169,9,5,2,7,9,32
191222170,3,4,9,3,4,23
191222171,5,6,0,8,8,27
191222172,2,0,5,8,3,18
191222173,7,3,0,7,9,26
191222174,4,7,4,7,1,23
191222175,9,6,7,3,3,28
191222176,7,1,3,9,5,25
191222177,8,7,0,6,9,30
191222178,5,6,4,5,7,27
191222179,6,6,4,6,2,24
191222180,8,4,3,0,3,18
191222181,6,2,3,5,2,18
191222182,5,3,1,0,2,11
191222183,0,3,6,4,6,19
191222184,9,8,8,6,4,35
191222185,9,5,5,6,1,26
191222186,4,1,6,2,9,22
191222187,2,1,7,3,9,22
191222188,7,0,0,3,5,15
191222189,3,1,9,7,3,23
191222190,1,4,7,3,9,24
191222191,6,5,9,2,5,27
191222192,9,0,9,2,0,20
191222193,2,8,8,7,5,30
191222194,6,2,4,9,3,24
191222195,6,8,2,2,6,24
191222196,5,9,3,2,1,20
191222197,4,1,9,2,8,24
191222198,1,7,2,8,0,18
191222199,3,4,8,4,9,28
191222200,5,5,5,2,3,20
191222201,6,0,0,2,2,10
191222202,8,3,2,4,2,19
191222203,1,3,3,1,4,12
191222204,8,1,8,0,3,20
191222205,3,8,0,8,6,25
191222206,3,3,5,2,2,15
191222207,2,3,2,1,7,15
191222208,5,3,2,8,1,19
191222209,7,7,0,8,1,23
191222210,3,5,1,5,2,16
191222211,1,8,4,1,3,17
191222212,6,4,5,6,8,29
191222213,8,1,6,5,5,25
191222214,8,3,9,4,6,30
191222215,3,6,1,5,2,17
191222216,6,8,9,8,4,35
191222217,2,1,5,2,3,13
191222218,6,9,2,2,9,28
191222219,9,4,8,7,4,32
191222220,2,5,9,7,6,29
191222221,0,0,6,5,8,19
191222222,0,1,8,7,8,24
191222223,7,5,1,3,1,17
191222224,3,9,3,2,0,17
191222225,2,3,2,8,8,23
191222226,7,5,1,2,3,18
191222227,5,4,4,5,3,21
191222228,5,2,6,8,7,28
191222229,5,3,2,6,8,24
191222230,9,6,7,9,1,32
191222231,4,0,9,7,4,24
191222232,8,9,3,4,9,33
191222233,9,9,1,8,3,30
191222234,3,9,7,8,6,33
191222235,5,0,6,7,6,24
191222236,9,0,8,6,2,25
191222237,2,2,3,0,8,15
191222238,6,4,3,6,5,24
191222239,1,0,1,3,9,14
191222240,2,3,3,2,7,17
191222241,5,8,5,2,2,22
191222242,3,7,3,0,7,20
191222243,4,4,9,1,4,22
191222244,8,7,3,1,4,23
191222245,1,3,1,9,0,14
191222246,0,3,6,3,0,12
191222247,1,2,3,1,8,15
191222248,2,2,3,4,5,16
191222249,1,9,4,2,1,17
191222250,5,2,9,5,2,23
191222251,7,9,8,2,5,31
191222252,5,7,6,1,6,25
191222253,4,9,5,9,6,33
191222254,8,0,6,5,3,22
191222255,6,8,6,7,4,31
191222256,5,6,9,4,6,30
191222257,3,2,3,5,4,17
191222258,6,2,5,2,2,17
191222259,6,0,7,1,2,16
191222260,5,9,0,8,9,31
191222261,8,0,7,6,9,30
191222262,9,3,1,8,0,21
191222263,2,4,2,5,2,15
191222264,7,9,8,8,9,41
191222265,2,1,7,6,5,21
191222266,8,7,2,4,3,24
191222267,8,9,9,0,1,27
191222268,2,7,5,5,2,21
191222269,9,6,7,5,2,29
191222270,8,8,3,4,4,27
191222271,5,4,3,1,5,18
191222272,0,0,6,1,6,13
191222273,0,0,6,5,0,11
191222274,9,5,9,0,4,27
191222275,8,5,1,9,1,24
191222276,4,5,5,4,3,21
191222277,8,0,4,8,8,28
191222278,6,5,9,9,9,38
191222279,0,0,6,5,1,12
191222280,7,5,3,3,0,18
191222281,8,2,0,1,7,18
191222282,1,8,7,8,6,30
191222283,3,8,0,8,4,23
191222284,2,0,8,3,6,19
191222285,3,8,5,4,8,28
191222286,8,0,2,0,2,12
191222287,9,1,1,5,3,19
191222288,3,9,4,9,9,34
191222289,2,3,9,4,5,23
191222290,5,8,6,5,8,32
191222291,7,8,8,4,5,32
191222292,7,1,4,9,5,26
191222293,6,8,6,6,2,28
191222294,5,7,2,3,0,17
191222295,4,4,0,7,4,19
191222296,5,3,2,3,2,15
191222297,2,1,0,8,3,14
191222298,0,7,7,4,2,20
191222299,3,7,9,8,6,33
191222300,4,6,0,3,6,19
191222301,8,3,5,3,6,25
191222302,4,8,0,3,4,19
191222303,1,0,7,6,0,14
191222304,7,4,0,6,3,20
191222305,4,0,1,7,8,20
191222306,4,0,8,4,9,25
191222307,6,3,7,6,8,30
191222308,1,5,7,4,8,25
191222309,1,2,2,4,3,12
191222310,2,5,6,0,8,21
191222311,6,8,6,9,9,38
191222312,0,6,8,4,0,18
191222313,4,5,6,4,2,21
191222314,1,5,8,2,1,17
191222315,8,2,7,4,7,28
191222316,9,1,2,4,5,21
191222317,6,5,1,5,0,17
191222318,9,7,2,4,5,27
191222319,2,5,8,7,3,25
191222320,5,4,0,2,0,11
191222321,1,0,6,5,4,16
191222322,8,9,1,9,6,33
191222323,2,1,2,3,0,8
191222324,1,6,0,9,9,25
191222325,3,0,0,2,2,7
191222326,4,7,5,9,5,30
191222327,5,0,5,8,3,21
191222328,2,7,0,1,5,15
191222329,3,6,3,0,7,19
191222330,9,6,1,5,1,22
191222331,2,7,4,3,0,16
191222332,7,4,2,0,5,18
191222333,1,6,2,3,0,12
191222334,8,9,2,8,4,31
191222335,7,2,2,3,2,16
191222336,8,1,0,9,6,24
191222337,2,2,3,2,5,14
191222338,6,0,3,3,0,12
191222339,4,2,9,6,9,30
191222340,6,7,8,0,7,28
191222341,3,3,4,5,7,22
191222342,8,6,0,5,4,23
191222343,2,8,2,2,6,20
191222344,0,1,7,7,4,19
191222345,6,3,6,4,6,25
191222346,7,9,5,4,2,27
191222347,4,8,7,3,1,23
191222348,8,5,0,0,8,21
191222349,4,7,0,0,7,18
191222350,6,3,3,0,3,15
191222351,5,8,7,3,4,27
191222352,5,9,9,3,7,33
191222353,3,2,4,4,2,15
191222354,2,7,2,3,6,20
191222355,0,4,1,6,9,20
191222356,2,3,8,2,2,17
191222357,1,7,9,2,3,22
191222358,7,2,5,8,4,26
191222359,5,2,6,8,2,23
191222360,9,3,0,1,4,17
191222361,2,1,1,2,8,14
191222362,3,6,9,1,9,28
191222363,9,2,6,8,8,33
191222364,0,5,8,6,3,22
191222365,7,5,4,1,5,22
191222366,8,3,2,6,5,24
191222367,3,7,6,5,0,21
191222368,7,7,7,9,4,34
191222369,9,1,0,4,7,21
191222370,8,8,6,8,4,34
191222371,2,5,3,6,5,21
191222372,0,4,0,8,4,16
191222373,5,7,2,9,3,26
191222374,8,5,4,2,6,25
191222375,3,8,8,5,0,24
191222376,2,0,2,4,1,9
191222377,8,6,7,6,0,27
191222378,1,4,4,9,1,19
191222379,3,5,9,7,4,28
191222380,3,8,5,4,0,20
191222381,4,9,3,9,5,30
191222382,0,8,2,6,1,17
191222383,6,4,7,8,6,31
191222384,0,6,2,2,5,15
191222385,8,7,0,8,3,26
191222386,2,0,5,8,8,23
191222387,8,2,2,6,4,22
191222388,6,8,5,0,9,28
191222389,6,2,7,0,1,16
191222390,8,0,1,0,7,16
191222391,7,0,2,4,4,17
191222392,9,7,5,1,6,28
191222393,3,8,8,0,4,23
191222394,7,4,5,9,0,25
191222395,8,8,1,9,7,33
191222396,2,2,7,7,4,22
191222397,5,1,1,6,5,18
191222398,3,8,6,0,7,24
191222399,8,5,3,0,7,23
191222400,4,5,2,8,2,21
191222401,3,5,9,6,3,26
191222402,2,8,0,7,9,26
191222403,5,8,1,0,6,20
191222404,8,6,2,6,0,22
191222405,0,5,6,4,0,15
191222406,4,1,0,8,7,20
191222407,2,4,1,9,3,19
191222408,5,8,0,0,2,15
191222409,7,2,1,7,8,25
191222410,5,7,6,1,0,19
191222411,8,3,8,7,4,30
191222412,6,2,5,9,4,26
191222413,6,8,7,1,9,31
191222414,0,6,8,0,0,14
191222415,0,5,8,7,7,27
191222416,4,9,0,1,9,23
191222417,3,2,8,5,6,24
191222418,0,0,6,5,4,15
191222419,0,0,1,2,0,3
191222420,4,6,6,7,2,25
191222421,6,4,0,2,4,16
191222422,2,7,1,1,7,18
191222423,2,2,1,9,2,16
191222424,7,9,4,5,4,29
191222425,9,3,5,2,5,24
191222426,0,9,8,6,7,30
191222427,1,2,4,2,3,12
191222428,1,7,0,8,0,16
191222429,6,1,1,4,9,21
191222430,1,1,1,8,6,17
191222431,9,6,1,3,3,22
191222432,8,8,0,0,8,24
191222433,9,1,6,4,9,29
191222434,5,1,3,8,1,18
191222435,4,8,6,5,0,23
191222436,6,8,4,9,8,35
191222437,4,2,3,5,7,21
191222438,0,3,2,4,5,14
191222439,6,6,9,8,2,31
191222440,5,1,5,3,2,16
191222441,9,0,7,2,9,27
191222442,8,3,1,5,4,21
191222443,4,7,2,1,8,22
191222444,1,7,0,3,3,14
191222445,7,7,6,5,5,30
191222446,6,6,0,2,9,23
191222447,8,0,1,6,8,23
191222448,0,9,1,6,0,16
191222449,6,8,2,0,7,23
191222450,9,9,2,1,1,22
191222451,5,4,1,3,2,15
191222452,8,8,3,7,3,29
191222453,0,8,0,2,9,19
191222454,8,9,4,6,9,36
191222455,7,1,2,1,7,18
191222456,9,3,5,5,1,23
191222457,3,9,5,1,0,18
191222458,6,3,6,4,3,22
191222459,0,3,9,1,6,19
191222460,9,6,0,1,1,17
191222461,5,4,0,5,6,20
191222462,2,7,6,0,4,19
191222463,9,8,7,0,1,25
191222464,1,6,1,9,1,18
191222465,9,2,1,4,4,20
191222466,1,1,2,6,1,11
191222467,5,4,7,4,0,20
191222468,2,5,9,3,6,25
191222469,7,2,6,0,2,17
191222470,7,9,0,5,0,21
191222471,9,7,5,9,2,32
191222472,8,7,6,7,3,31
191222473,8,4,1,9,7,29
191222474,2,6,4,2,7,21
191222475,3,5,2,4,1,15
191222476,0,4,9,4,0,17
191222477,4,8,8,9,7,36
191222478,8,3,2,2,9,24
191222479,2,5,8,4,8,27
191222480,6,1,6,8,8,29
191222481,9,0,6,1,9,25
191222482,6,8,6,0,3,23
191222483,9,7,4,3,2,25
191222484,3,9,2,0,3,17
191222485,3,3,5,2,3,16
191222486,1,3,4,5,3,16
191222487,0,5,6,7,8,26
191222488,0,5,8,7,0,20
191222489,1,7,5,9,4,26
191222490,5,9,3,2,6,25
191222491,0,5,9,5,6,25
191222492,9,8,4,0,6,27
191222493,3,5,1,1,8,18
191222494,4,7,9,0,4,24
191222495,5,0,9,7,4,25
191222496,5,0,6,4,0,15
191222497,0,0,0,1,9,10
191222498,8,7,1,6,7,29
191222499,1,5,1,1,3,11
191222500,6,1,6,9,1,23
191222501,5,5,2,1,0,13
191222502,0,8,4,4,4,20
191222503,4,0,3,9,0,16
191222504,9,8,3,7,8,35
191222505,8,9,5,5,6,33
191222506,7,6,7,3,7,30
191222507,7,4,3,1,7,22
191222508,8,1,4,0,7,20
191222509,2,3,5,5,8,23
191222510,7,8,8,2,1,26
191222511,7,9,5,4,1,26
191222512,1,4,1,4,7,17
191222513,4,4,5,6,9,28
191222514,4,9,0,1,0,14
191222515,0,7,0,0,0,7
191222516,7,7,4,2,9,29
191222517,3,7,5,5,7,27
191222518,2,4,2,1,1,10
191222519,1,4,2,4,0,11
191222520,6,5,9,0,7,27
191222521,5,2,4,1,9,21
191222522,8,3,5,5,0,21
191222523,5,6,3,6,0,20
191222524,8,6,4,3,7,28
191222525,4,8,9,7,3,31
191222526,5,2,8,4,7,26
191222527,0,3,7,7,2,19
191222528,4,8,1,3,1,17
191222529,1,4,6,3,8,22
191222530,8,1,6,9,9,33
191222531,9,7,8,8,9,41
191222532,1,6,9,2,1,19
191222533,9,9,3,2,9,32
191222534,1,6,5,0,8,20
191222535,8,3,2,7,4,24
191222536,4,6,0,2,0,12
191222537,0,0,1,8,7,16
191222538,9,6,5,8,5,33
191222539,1,7,7,3,3,21
191222540,8,7,0,4,7,26
191222541,0,8,3,0,8,19
191222542,0,0,5,3,8,16
191222543,8,0,5,3,2,18
191222544,4,2,2,5,0,13
191222545,8,0,8,6,0,22
191222546,1,0,0,5,0,6
191222547,9,8,1,8,8,34
191222548,6,6,7,7,8,34
191222549,6,0,0,6,2,14
191222550,9,7,4,2,2,24
191222551,9,0,0,1,1,11
191222552,5,4,9,1,0,19
191222553,4,6,7,5,6,28
191222554,0,7,2,2,1,12
191222555,2,0,0,4,9,15
191222556,9,3,4,4,2,22
191222557,5,3,4,4,7,23
191222558,2,6,4,8,2,22
191222559,9,0,4,2,7,22
191222560,2,2,0,2,1,7
191222561,9,7,6,8,0,30
191222562,7,4,4,0,6,21
191222563,0,5,6,5,4,20
191222564,3,0,2,2,7,14
191222565,1,6,5,0,1,13
191222566,4,5,0,4,0,13
191222567,2,7,8,9,9,35
191222568,4,0,7,8,1,20
191222569,8,9,2,4,3,26
191222570,7,2,8,8,5,30
191222571,5,6,4,3,3,21
191222572,3,8,2,0,6,19
191222573,3,7,3,7,9,29
191222574,8,2,5,4,7,26
191222575,3,6,1,0,5,15
191222576,2,8,9,9,8,36
191222577,8,3,2,8,9,30
191222578,0,0,7,2,5,14
191222579,3,4,5,1,4,17
191222580,1,3,9,0,7,20
191222581,5,5,4,5,0,19
191222582,5,6,8,5,0,24
191222583,8,6,0,6,8,28
191222584,1,5,0,9,1,16
191222585,6,9,9,4,6,34
191222586,8,8,4,4,1,25
191222587,0,1,6,4,7,18
191222588,6,0,5,9,9,29
191222589,5,4,0,1,7,17
191222590,0,5,7,5,5,22
191222591,5,9,2,4,0,20
191222592,2,9,0,7,0,18
191222593,7,8,0,5,0,20
191222594,0,3,5,9,0,17
191222595,4,0,0,6,8,18
191222596,3,3,8,3,6,23
191222597,6,6,5,7,3,27
191222598,0,1,1,8,8,18
191222599,5,1,0,3,1,10
191222600,0,1,1,9,5,16
191222601,9,9,3,9,8,38
191222602,4,0,7,4,2,17
191222603,0,4,8,2,4,18
191222604,7,4,0,8,2,21
191222605,9,0,3,9,6,27
191222606,0,0,5,1,4,10
191222607,8,4,7,1,7,27
191222608,7,6,4,6,7,30
191222609,4,1,3,1,9,18
191222610,9,8,3,7,3,30
191222611,0,2,9,7,5,23
191222612,4,4,9,3,8,28
191222613,8,6,3,5,5,27
191222614,5,4,1,2,5,17
191222615,2,9,1,3,0,15
191222616,1,4,2,7,4,18
191222617,8,7,7,2,5,29
191222618,4,0,9,0,1,14
191222619,9,8,6,6,5,34
191222620,4,0,6,7,5,22
191222621,9,0,0,7,9,25
191222622,0,3,8,4,9,24
191222623,6,7,6,2,2,23
191222624,4,1,3,7,6,21
191222625,3,5,6,9,3,26
191222626,2,5,2,1,7,17
191222627,4,4,6,2,2,18
191222628,7,2,8,3,0,20
191222629,9,2,0,8,4,23
191222630,4,5,2,9,7,27
191222631,2,6,9,4,7,28
191222632,1,9,6,4,4,24
191222633,5,0,7,4,4,20
191222634,2,6,8,0,8,24
191222635,4,6,3,8,1,22
191222636,0,5,3,0,6,14
191222637,2,1,8,4,1,16
191222638,6,7,6,4,9,32
191222639,6,4,5,7,7,29
191222640,4,5,2,1,1,13
191222641,5,9,7,0,6,27
191222642,3,3,6,9,6,27
191222643,4,7,6,9,0,26
191222644,6,6,8,9,9,38
191222645,8,6,2,1,8,25
191222646,9,0,9,8,2,28
191222647,5,5,9,8,2,29
191222648,3,9,0,5,1,18
191222649,7,9,8,2,4,30
191222650,5,6,0,2,3,16
191222651,9,9,9,9,9,45
191222652,5,6,2,6,6,25
191222653,2,6,9,0,4,21
191222654,5,8,3,4,9,29
191222655,3,7,1,7,3,21
191222656,1,6,0,9,4,20
191222657,1,2,2,1,7,13
191222658,2,1,5,2,0,10
191222659,0,5,3,6,0,14
191222660,8,3,4,2,7,24
191222661,8,1,8,8,3,28
191222662,8,5,6,8,6,33
191222663,0,5,4,0,5,14
191222664,6,5,6,5,1,23
191222665,6,8,8,1,0,23
191222666,1,8,3,2,0,14
191222667,2,0,6,4,1,13
191222668,2,9,2,5,0,18
191222669,0,8,2,2,2,14
191222670,4,0,4,9,9,26
191222671,5,0,0,6,2,13
191222672,4,9,1,4,1,19
191222673,1,7,3,7,3,21
191222674,3,3,4,0,6,16
191222675,2,7,9,7,4,29
191222676,8,3,5,7,0,23
191222677,2,0,0,4,5,11
191222678,6,6,3,1,6,22
191222679,5,9,7,0,5,26
191222680,0,7,0,4,3,14
191222681,5,0,0,2,9,16
191222682,3,1,4,4,9,21
191222683,7,8,6,3,6,30
191222684,0,5,2,4,4,15
191222685,1,4,8,5,8,26
191222686,7,4,8,8,7,34
191222687,5,4,4,2,2,17
191222688,9,9,0,8,9,35
191222689,4,6,6,0,2,18
191222690,8,3,8,9,2,30
191222691,8,8,5,8,4,33
191222692,1,0,2,7,0,10
191222693,2,3,1,4,5,15
191222694,3,1,2,1,9,16
191222695,8,6,3,9,5,31
191222696,0,1,1,5,4,11
191222697,7,8,4,2,4,25
191222698,8,6,4,0,6,24
191222699,8,8,9,2,1,28
191222700,8,4,4,6,7,29
191222701,6,4,8,8,4,30
191222702,8,7,2,0,7,24
191222703,5,0,6,7,7,25
191222704,3,3,9,0,4,19
191222705,7,6,0,2,6,21
191222706,0,7,3,9,7,26
191222707,9,6,4,9,8,36
191222708,1,5,1,6,2,15
191222709,5,9,3,3,5,25
191222710,3,3,7,6,0,19
191222711,2,7,0,7,1,17
191222712,4,0,3,9,1,17
191222713,8,3,2,5,0,18
191222714,0,0,9,8,0,17
191222715,8,0,8,8,7,31
191222716,2,8,7,9,5,31
191222717,7,1,8,2,8,26
191222718,3,1,6,6,9,25
191222719,3,9,3,3,9,27
191222720,6,1,2,3,3,15
191222721,6,4,0,7,2,19
191222722,1,1,1,2,0,5
191222723,6,0,2,9,6,23
191222724,7,9,5,9,1,31
191222725,1,0,1,0,2,4
191222726,6,3,3,5,8,25
191222727,3,8,1,4,7,23
191222728,0,7,3,7,4,21
191222729,8,5,7,3,1,24
191222730,3,5,3,6,9,26
191222731,4,1,3,9,6,23
191222732,9,9,8,5,2,33
191222733,6,0,4,2,3,15
191222734,9,9,5,2,1,26
191222735,7,7,7,6,6,33
191222736,7,0,3,9,0,19
191222737,0,6,0,8,2,16
191222738,5,5,1,0,4,15
191222739,0,0,2,5,7,14
191222740,0,0,4,3,8,15
191222741,1,0,9,4,9,23
191222742,6,7,2,3,8,26
191222743,7,6,8,4,0,25
191222744,4,1,4,1,6,16
191222745,9,1,8,3,6,27
191222746,7,4,5,6,1,23
191222747,4,8,8,9,5,34
191222748,3,5,8,4,4,24
191222749,5,2,4,8,7,26
191222750,9,6,3,6,0,24
191222751,8,5,9,5,5,32
191222752,3,3,5,2,7,20
191222753,8,1,8,9,5,31
191222754,9,1,8,0,2,20
191222755,4,0,2,8,3,17
191222756,9,2,9,9,2,31
191222757,7,4,5,4,5,25
191222758,7,2,9,3,7,28
191222759,1,6,7,4,5,23
191222760,7,3,5,0,0,15
191222761,2,1,0,7,8,18
191222762,8,1,5,4,8,26
191222763,6,8,9,2,0,25
191222764,2,3,1,0,1,7
191222765,7,4,4,4,3,22
191222766,4,3,9,4,8,28
191222767,7,8,4,2,1,22
191222768,7,4,5,5,9,30
191222769,2,6,5,0,1,14
191222770,4,9,0,0,0,13
191222771,0,8,7,7,0,22
191222772,1,1,1,8,8,19
191222773,1,4,3,9,6,23
191222774,5,9,6,9,2,31
191222775,7,0,0,4,1,12
191222776,2,7,1,2,3,15
191222777,6,8,7,0,3,24
191222778,6,1,9,8,0,24
191222779,2,6,1,2,1,12
191222780,3,3,4,7,7,24
191222781,0,0,6,3,7,16
191222782,7,1,3,5,9,25
191222783,2,4,5,0,4,15
191222784,6,9,7,5,6,33
191222785,3,4,3,8,5,23
191222786,6,1,2,5,1,15
191222787,3,5,5,6,5,24
191222788,6,8,2,0,6,22
191222789,8,1,5,0,1,15
191222790,7,4,9,4,6,30
191222791,5,3,7,4,5,24
191222792,6,8,3,9,1,27
191222793,8,3,0,9,2,22
191222794,0,0,6,2,1,9
191222795,4,9,2,2,9,26
191222796,4,2,9,9,8,32
191222797,6,4,7,7,1,25
191222798,9,6,8,2,7,32
191222799,3,1,4,5,1,14
191222800,0,6,7,9,4,26
191222801,0,6,0,4,0,10
191222802,2,8,2,6,5,23
191222803,9,8,6,6,9,38
191222804,2,9,2,8,8,29
191222805,4,9,6,8,8,35
191222806,5,2,3,9,4,23
191222807,7,7,9,7,6,36
191222808,4,2,8,2,4,20
191222809,3,5,2,6,7,23
191222810,1,4,9,1,8,23
191222811,2,2,4,3,9,20
191222812,0,0,1,4,8,13
191222813,5,8,3,2,2,20
191222814,4,8,1,1,1,15
191222815,0,8,6,7,8,29
191222816,8,9,8,3,2,30
191222817,7,5,9,6,5,32
191222818,7,5,6,3,4,25
191222819,7,5,0,4,0,16
191222820,7,1,8,2,2,20
191222821,7,7,0,7,9,30
191222822,2,8,3,4,2,19
191222823,6,1,0,1,6,14
191222824,2,8,4,6,1,21
191222825,5,3,6,3,5,22
191222826,7,6,6,4,3,26
191222827,2,8,0,1,7,18
191222828,5,3,7,5,0,20
191222829,1,3,7,4,6,21
191222830,5,4,0,3,0,12
191222831,4,6,9,4,3,26
191222832,4,2,1,4,2,13
191222833,0,1,7,5,0,13
191222834,3,9,0,6,9,27
191222835,5,2,4,4,1,16
191222836,1,8,8,3,3,23
191222837,7,8,1,8,1,25
191222838,7,7,3,4,9,30
191222839,6,8,3,0,2,19
191222840,0,2,6,7,3,18
191222841,2,8,9,6,7,32
191222842,1,1,7,3,5,17
191222843,6,3,6,0,9,24
191222844,4,2,6,4,1,17
191222845,6,9,5,2,2,24
191222846,6,8,2,0,0,16
191222847,8,0,5,8,8,29
191222848,6,1,8,6,4,25
191222849,5,0,6,5,5,21
191222850,9,5,4,3,7,28
191222851,8,3,5,4,5,25
191222852,3,8,4,9,5,29
191222853,3,1,2,4,6,16
191222854,9,4,4,9,8,34
191222855,2,8,8,8,7,33
191222856,1,6,4,7,8,26
191222857,4,8,0,8,0,20
191222858,4,5,9,5,6,29
191222859,3,5,3,9,9,29
191222860,9,8,5,1,5,28
191222861,1,0,9,0,4,14
191222862,4,7,7,8,1,27
191222863,9,4,4,1,5,23
191222864,1,8,5,0,0,14
191222865,8,2,5,6,9,30
191222866,3,7,7,8,8,33
191222867,2,3,6,1,4,16
191222868,4,8,2,0,3,17
191222869,7,9,0,9,3,28
191222870,2,4,5,8,2,21
191222871,8,9,4,4,9,34
191222872,3,4,9,7,4,27
191222873,4,2,4,6,5,21
191222874,2,5,6,0,9,22
191222875,7,8,9,8,5,37
191222876,7,4,5,2,0,18
191222877,7,1,5,0,5,18
191222878,5,5,6,1,1,18
191222879,6,4,6,3,9,28
191222880,3,5,7,1,6,22
191222881,2,3,3,7,2,17
191222882,6,4,5,1,1,17
191222883,1,9,9,2,6,27
191222884,7,1,6,2,7,23
191222885,2,7,6,9,1,25
191222886,8,5,8,5,4,30
191222887,9,7,1,6,4,27
191222888,2,8,6,7,5,28
191222889,1,6,6,7,4,24
191222890,9,1,8,0,4,22
191222891,7,2,0,1,9,19
191222892,1,0,5,6,7,19
191222893,6,3,5,7,0,21
191222894,5,9,2,3,8,27
191222895,6,0,1,3,9,19
191222896,2,6,7,7,6,28
191222897,1,6,0,3,2,12
191222898,1,3,7,4,0,15
191222899,7,3,9,2,7,28
191222900,5,8,0,8,9,30
191222901,1,0,0,7,0,8
191222902,3,3,4,3,4,17
191222903,1,0,2,6,7,16
191222904,9,4,7,5,5,30
191222905,3,1,9,7,7,27
191222906,3,0,8,6,5,22
191222907,3,0,4,1,5,13
191222908,0,2,7,5,9,23
191222909,0,0,3,1,1,5
191222910,0,0,1,4,7,12
191222911,4,1,7,6,9,27
191222912,8,3,0,4,0,15
191222913,8,2,0,1,2,13
191222914,8,3,5,0,4,20
191222915,3,1,1,8,8,21
191222916,6,2,0,0,2,10
191222917,4,1,6,9,6,26
191222918,6,4,9,4,6,29
191222919,7,3,7,0,5,22
191222920,9,7,9,7,7,39
191222921,8,1,7,5,3,24
191222922,9,5,5,1,2,22
191222923,5,1,5,6,5,22
191222924,6,5,3,6,2,22
191222925,0,6,4,0,7,17
191222926,5,9,5,8,1,28
191222927,1,5,3,6,3,18
191222928,9,9,8,2,6,34
191222929,6,9,9,5,0,29
191222930,2,4,4,1,5,16
191222931,3,2,7,2,1,15
191222932,8,5,2,3,2,20
191222933,7,1,8,6,0,22
191222934,2,4,0,2,0,8
191222935,3,0,3,4,8,18
191222936,3,5,7,4,5,24
191222937,7,7,9,7,9,39
191222938,6,9,6,7,2,30
191222939,7,4,3,7,2,23
191222940,6,2,9,6,0,23
191222941,5,9,8,9,0,31
191222942,6,6,4,0,8,24
191222943,9,5,4,2,3,23
191222944,6,6,9,5,5,31
191222945,9,3,7,1,4,24
191222946,6,7,4,7,4,28
191222947,5,1,8,5,9,28
191222948,2,3,9,1,0,15
191222949,9,7,9,4,6,35
191222950,7,5,0,4,5,21
191222951,3,9,1,8,8,29
191222952,7,8,9,3,1,28
191222953,3,4,6,0,0,13
191222954,0,9,0,6,8,23
191222955,6,8,3,5,2,24
191222956,5,2,4,6,1,18
191222957,8,9,3,3,5,28
191222958,9,1,6,7,6,29
191222959,3,8,5,8,8,32
191222960,2,0,9,1,8,20
191222961,9,3,5,8,6,31
191222962,4,5,3,0,1,13
191222963,2,3,4,5,2,16
191222964,4,1,1,9,4,19
191222965,9,1,3,7,5,25
191222966,9,2,3,0,7,21
191222967,6,1,3,8,6,24
191222968,6,1,2,4,2,15
191222969,3,6,9,8,1,27
191222970,5,1,6,8,7,27
191222971,1,0,1,1,9,12
191222972,3,0,3,1,6,13
191222973,8,1,8,8,4,29
191222974,0,8,0,2,1,11
191222975,2,6,5,1,2,16
191222976,3,7,0,9,2,21
191222977,9,3,1,2,6,21
191222978,2,3,4,1,6,16
191222979,7,1,2,6,8,24
191222980,8,8,2,5,0,23
191222981,2,3,0,6,3,14
191222982,7,1,6,8,6,28
191222983,2,7,2,8,1,20
191222984,9,2,5,5,1,22
191222985,6,5,0,2,6,19
191222986,4,5,6,8,9,32
191222987,2,6,5,3,8,24
191222988,5,0,4,5,3,17
191222989,0,6,6,4,1,17
191222990,0,2,8,2,3,15
191222991,4,8,4,3,9,28
191222992,4,0,2,5,1,12
191222993,8,8,4,7,4,31
191222994,9,7,0,7,2,25
191222995,5,2,3,4,3,17
191222996,4,9,9,4,8,34
191222997,7,9,9,5,8,38
191222998,2,6,7,3,0,18
191222999,4,6,4,2,3,19
1912221000,4,5,1,4,9,23
1912221001,9,0,7,1,9,26
1912221002,7,4,8,5,1,25
1912221003,7,7,2,5,0,21
1912221004,4,6,2,8,2,22
1912221005,9,3,5,5,9,31
1912221006,3,2,7,4,3,19
1912221007,7,6,3,5,0,21
1912221008,0,7,1,2,1,11
1912221009,8,2,7,9,7,33
1912221010,1,2,1,8,8,20
1912221011,8,7,3,7,2,27
1912221012,2,5,8,9,7,31
1912221013,9,9,5,7,5,35
1912221014,5,8,2,1,9,25
1912221015,3,1,9,2,0,15
1912221016,8,3,2,1,9,23
1912221017,8,3,9,7,4,31
1912221018,8,0,5,8,1,22
1912221019,8,1,6,4,5,24
1912221020,0,6,4,3,3,16
1912221021,2,7,5,3,8,25
1912221022,4,6,3,7,7,27
1912221023,8,9,3,8,2,30
1912221024,3,6,8,8,6,31
1912221025,5,4,5,4,8,26
1912221026,0,2,4,0,0,6
1912221027,9,4,6,5,8,32
1912221028,2,4,5,3,4,18
1912221029,9,0,3,7,0,19
1912221030,4,8,0,3,7,22
1912221031,4,3,0,7,5,19
1912221032,7,9,4,8,3,31
1912221033,5,6,6,7,4,28
1912221034,3,3,8,5,2,21
1912221035,2,9,7,5,4,27
1912221036,5,0,0,7,3,15
1912221037,7,2,8,3,1,21
1912221038,2,9,0,3,5,19
1912221039,9,6,7,0,4,26
1912221040,4,0,0,9,5,18
1912221041,8,6,2,9,3,28
1912221042,5,0,4,1,9,19
1912221043,7,5,8,6,9,35
1912221044,8,5,4,3,9,29
1912221045,5,5,4,5,9,28
1912221046,2,4,9,7,5,27
1912221047,9,5,4,1,5,24
1912221048,1,0,5,2,0,8
1912221049,2,3,3,3,3,14
1912221050,2,1,1,2,9,15
1912221051,3,9,2,2,3,19
1912221052,7,0,9,6,0,22
1912221053,1,6,8,4,1,20
1912221054,9,8,5,5,4,31
1912221055,7,1,6,8,2,24
1912221056,3,9,7,5,4,28
1912221057,4,0,2,5,3,14
1912221058,5,1,6,4,2,18
1912221059,2,9,5,7,1,24
1912221060,9,5,3,2,0,19
1912221061,4,4,7,9,2,26
1912221062,9,6,4,2,5,26
1912221063,4,2,2,3,6,17
1912221064,4,5,2,3,9,23
1912221065,1,6,0,6,8,21
1912221066,9,3,5,3,7,27
1912221067,9,3,3,0,0,15
1912221068,8,5,4,3,3,23
1912221069,7,8,2,5,7,29
1912221070,7,8,6,8,7,36
1912221071,6,4,0,5,0,15
1912221072,3,4,3,6,4,20
1912221073,1,6,9,2,5,23
1912221074,7,7,5,0,3,22
1912221075,4,9,3,4,7,27
1912221076,9,6,0,9,9,33
1912221077,3,4,8,6,9,30
1912221078,7,1,4,3,0,15
1912221079,0,1,0,5,3,9
1912221080,0,8,1,5,3,17
1912221081,5,6,5,8,8,32
1912221082,0,0,0,2,1,3
1912221083,4,2,2,5,3,16
1912221084,3,2,6,3,6,20
1912221085,8,0,2,5,2,17
1912221086,4,9,2,5,0,20
1912221087,0,0,1,8,0,9
1912221088,6,6,0,6,1,19
1912221089,5,5,8,3,2,23
1912221090,6,1,2,6,5,20
1912221091,7,1,8,0,8,24
1912221092,7,5,6,5,0,23
1912221093,7,4,2,2,2,17
1912221094,0,3,6,9,2,20
1912221095,3,6,5,8,2,24
1912221096,0,8,1,2,1,12
1912221097,0,6,2,5,3,16
1912221098,5,3,5,7,3,23
1912221099,2,3,8,7,2,22
1912221100,4,1,2,4,9,20
1912221101,6,9,2,5,5,27
1912221102,9,0,0,6,7,22
1912221103,5,6,8,6,1,26
1912221104,1,3,6,2,4,16
1912221105,4,9,1,8,1,23
191223001,5,8,6,4,8,31
191223002,0,1,9,5,2,17
191223003,5,2,9,1,3,20
191223004,0,9,0,8,8,25
191223005,0,5,1,3,5,14
191223006,2,3,3,1,9,18
191223007,6,6,3,4,6,25
191223008,7,9,4,4,1,25
191223009,0,2,4,3,8,17
191223010,5,5,6,4,3,23
191223011,6,7,3,5,9,30
191223012,8,9,3,5,3,28
191223013,7,9,3,1,2,22
191223014,1,9,9,6,8,33
191223015,8,0,9,9,5,31
191223016,1,8,2,9,6,26
191223017,7,3,1,7,5,23
191223018,4,1,6,6,0,17
191223019,8,7,7,7,2,31
191223020,5,8,6,3,2,24
191223021,3,8,2,8,4,25
191223022,4,7,3,6,8,28
191223023,6,7,9,5,7,34
191223024,4,7,2,3,6,22
191223025,9,6,3,2,9,29
191223026,8,2,4,9,0,23
191223027,6,2,8,0,8,24
191223028,3,8,1,8,6,26
191223029,1,4,7,0,2,14
191223030,0,6,6,1,1,14
191223031,0,1,5,2,5,13
191223032,1,0,3,3,6,13
191223033,0,9,6,1,0,16
191223034,7,3,5,1,7,23
191223035,8,7,5,4,4,28
191223036,8,8,6,8,8,38
191223037,6,7,9,2,6,30
191223038,0,1,7,1,2,11
191223039,7,6,5,4,5,27
191223040,5,1,3,0,8,17
191223041,7,2,9,1,8,27
191223042,0,6,5,1,3,15
191223043,4,1,1,3,2,11
191223044,3,6,2,9,8,28
191223045,0,0,2,6,1,9
191223046,8,6,3,3,7,27
191223047,0,1,8,3,7,19
191223048,3,7,5,1,4,20
191223049,6,5,0,3,8,22
191223050,4,0,7,4,5,20
191223051,4,0,8,6,4,22
191223052,0,6,0,3,9,18
191223053,6,7,6,7,0,26
191223054,1,9,6,1,6,23
191223055,8,9,6,4,6,33
191223056,2,3,1,4,0,10
191223057,0,1,5,5,8,19
191223058,5,9,1,6,7,28
191223059,6,3,3,1,0,13
191223060,8,5,8,8,5,34
191223061,8,5,6,1,5,25
191223062,4,1,1,8,1,15
191223063,0,9,2,7,7,25
191223064,6,4,7,8,2,27
191223065,1,4,2,5,3,15
191223066,7,8,8,7,0,30
191223067,3,8,7,4,6,28
191223068,7,7,1,3,1,19
191223069,9,6,3,3,8,29
191223070,1,4,5,8,8,26
191223071,1,3,6,9,7,26
191223072,9,6,6,9,5,35
191223073,9,7,6,0,1,23
191223074,5,1,2,6,2,16
191223075,9,6,8,8,4,35
191223076,6,3,7,4,1,21
191223077,0,0,1,0,8,9
191223078,8,1,0,8,9,26
191223079,3,3,0,4,4,14
191223080,3,1,4,5,6,19
191223081,9,9,1,3,9,31
191223082,8,5,7,5,7,32
191223083,3,7,6,9,5,30
191223084,6,6,8,3,2,25
191223085,0,7,6,3,6,22
191223086,6,5,8,1,2,22
191223087,8,6,8,3,0,25
191223088,5,0,0,1,1,7
191223089,8,4,3,8,0,23
191223090,8,2,5,9,3,27
191223091,7,4,3,9,8,31
191223092,6,3,4,8,1,22
191223093,9,0,8,6,7,30
191223094,8,9,7,1,3,28
191223095,7,1,5,2,3,18
191223096,0,5,2,0,8,15
191223097,1,6,4,9,1,21
191223098,6,9,3,7,9,34
191223099,7,6,8,4,5,30
191223100,6,9,7,7,0,29
191223101,1,4,4,0,3,12
191223102,5,9,9,9,3,35
191223103,8,1,8,5,1,23
191223104,1,8,8,2,8,27
191223105,8,8,9,1,1,27
191223106,4,8,0,0,2,14
191223107,6,0,4,2,4,16
191223108,1,4,1,0,6,12
191223109,3,7,9,6,6,31
191223110,5,0,3,7,7,22
191223111,6,0,3,7,3,19
191223112,2,5,5,4,9,25
191223113,7,9,1,0,1,18
191223114,7,2,6,5,0,20
191223115,9,5,7,9,5,35
191223116,8,4,3,9,2,26
191223117,9,9,4,2,0,24
191223118,6,8,5,6,5,30
191223119,5,4,9,1,4,23
191223120,1,6,5,9,5,26
191223121,4,2,5,8,3,22
191223122,9,0,4,1,2,16
191223123,2,8,3,6,9,28
191223124,8,9,7,7,7,38
191223125,3,3,1,1,8,16
191223126,3,8,1,2,4,18
191223127,3,0,1,6,7,17
191223128,6,6,2,4,8,26
191223129,6,9,5,0,9,29
191223130,3,8,0,5,9,25
191223131,0,9,8,6,2,25
191223132,1,8,2,7,1,19
191223133,9,7,1,2,9,28
191223134,1,5,0,6,5,17
191223135,1,4,6,6,7,24
191223136,4,2,7,5,5,23
191223137,9,4,5,1,5,24
191223138,6,0,4,4,0,14
191223139,6,9,3,4,2,24
191223140,5,2,1,9,8,25
191223141,7,2,6,2,9,26
191223142,0,5,1,6,9,21
191223143,0,8,9,4,5,26
191223144,1,5,2,0,6,14
191223145,9,3,8,3,8,31
191223146,2,1,7,7,2,19
191223147,6,7,0,3,9,25
191223148,7,9,6,9,5,36
191223149,4,7,2,3,7,23
191223150,9,8,0,0,6,23
191223151,2,1,3,3,7,16
191223152,1,4,3,1,3,12
191223153,3,8,1,4,4,20
191223154,3,1,2,7,7,20
191223155,3,5,0,6,2,16
191223156,8,8,3,0,0,19
191223157,7,6,3,2,8,26
191223158,9,3,1,4,2,19
191223159,3,8,9,8,5,33
191223160,5,0,7,2,6,20
191223161,5,7,7,4,8,31
191223162,8,5,4,4,2,23
191223163,8,2,8,9,0,27
191223164,5,4,6,8,5,28
191223165,9,9,8,1,4,31
191223166,9,0,6,6,2,23
191223167,2,0,5,8,0,15
191223168,1,6,4,1,0,12
191223169,4,7,7,4,1,23
191223170,4,2,9,6,8,29
191223171,1,3,0,6,5,15
191223172,0,3,6,0,1,10
191223173,3,6,1,7,0,17
191223174,9,6,6,3,3,27
191223175,2,2,7,2,0,13
191223176,5,5,9,7,7,33
191223177,0,8,3,4,0,15
191223178,4,0,1,7,7,19
191223179,5,8,8,9,3,33
191223180,4,9,8,9,3,33
191223181,5,6,7,4,4,26
191223182,6,7,6,3,9,31
191223183,0,2,8,4,0,14
191223184,1,6,3,3,3,16
191223185,1,6,7,9,2,25
191223186,5,7,6,3,9,30
191223187,7,2,8,8,9,34
191223188,8,0,5,4,8,25
191223189,2,0,6,2,4,14
191223190,3,1,7,9,0,20
191223191,1,5,1,7,9,23
191223192,5,6,1,3,6,21
191223193,7,3,2,7,5,24
191223194,8,3,5,3,7,26
191223195,5,8,9,3,9,34
191223196,5,2,1,2,3,13
191223197,0,9,9,2,8,28
191223198,7,8,7,8,8,38
191223199,5,5,3,4,4,21
191223200,0,2,0,7,2,11
191223201,2,8,5,8,6,29
191223202,8,3,3,3,0,17
191223203,7,0,7,9,1,24
191223204,4,7,8,0,8,27
191223205,6,3,8,3,6,26
191223206,5,8,9,1,0,23
191223207,6,1,7,3,0,17
191223208,2,5,2,7,3,19
191223209,6,8,1,4,9,28
191223210,1,7,2,0,2,12
191223211,5,4,3,2,9,23
191223212,1,6,2,0,5,14
191223213,1,2,2,2,3,10
191223214,4,6,6,3,1,20
191223215,2,0,9,1,3,15
191223216,2,8,4,4,6,24
191223217,8,3,3,5,6,25
191223218,0,9,7,4,2,22
191223219,4,7,6,1,5,23
191223220,2,5,9,9,1,26
191223221,5,1,9,8,8,31
191223222,1,7,2,0,6,16
191223223,7,5,1,3,4,20
191223224,6,0,3,6,2,17
191223225,0,9,6,9,8,32
191223226,8,3,8,6,1,26
191223227,1,6,2,6,2,17
191223228,9,1,4,0,5,19
191223229,6,7,7,8,2,30
191223230,7,7,8,1,6,29
191223231,8,5,4,4,4,25
191223232,3,8,6,2,1,20
191223233,3,4,9,3,3,22
191223234,9,7,8,2,8,34
191223235,7,4,2,9,9,31
191223236,9,9,0,4,6,28
191223237,2,6,6,9,1,24
191223238,2,9,7,5,6,29
191223239,7,3,7,2,1,20
191223240,6,1,0,3,0,10
191223241,3,3,0,6,9,21
191223242,5,1,8,0,6,20
191223243,0,2,6,6,5,19
191223244,7,1,8,8,2,26
191223245,7,7,4,0,2,20
191223246,8,4,4,7,8,31
191223247,1,9,5,6,2,23
191223248,4,6,6,8,9,33
191223249,0,3,3,5,2,13
191223250,2,7,3,4,9,25
191223251,5,8,8,8,7,36
191223252,2,1,3,4,8,18
191223253,6,2,9,3,4,24
191223254,1,2,7,9,9,28
191223255,9,7,1,0,2,19
191223256,8,2,7,7,8,32
191223257,8,1,3,8,4,24
191223258,3,9,3,1,0,16
191223259,1,5,8,7,4,25
191223260,3,3,5,4,0,15
191223261,5,2,9,4,0,20
191223262,0,5,9,1,1,16
191223263,1,1,3,3,3,11
191223264,3,3,2,9,9,26
191223265,2,0,5,2,7,16
191223266,0,5,0,0,1,6
191223267,2,3,8,3,7,23
191223268,9,9,7,3,3,31
191223269,1,8,6,4,9,28
191223270,9,9,5,2,9,34
191223271,7,2,5,8,0,22
191223272,8,1,2,7,7,25
191223273,3,0,1,0,1,5
191223274,2,0,5,3,5,15
191223275,3,0,1,1,8,13
191223276,3,8,9,0,2,22
191223277,9,6,8,4,0,27
191223278,9,0,2,5,1,17
191223279,4,9,4,6,4,27
191223280,7,5,4,4,1,21
191223281,2,6,5,6,7,26
191223282,0,5,2,3,2,12
191223283,9,0,7,0,7,23
191223284,7,6,2,9,2,26
191223285,3,6,2,4,9,24
191223286,0,6,1,6,3,16
191223287,5,1,8,2,1,17
191223288,4,3,0,8,4,19
191223289,1,4,9,3,1,18
191223290,9,0,4,9,3,25
191223291,5,9,9,8,1,32
191223292,6,7,7,5,5,30
191223293,4,5,1,1,7,18
191223294,3,2,5,1,9,20
191223295,9,7,5,1,2,24
191223296,6,8,4,1,2,21
191223297,2,5,8,5,1,21
191223298,3,9,7,1,7,27
191223299,8,1,5,0,0,14
191223300,3,4,8,6,8,29
191223301,0,7,2,6,5,20
191223302,7,8,8,6,7,36
191223303,7,3,8,0,1,19
191223304,1,1,6,9,3,20
191223305,7,9,7,4,8,35
191223306,7,4,0,7,8,26
191223307,5,4,2,8,8,27
191223308,3,2,7,5,7,24
191223309,9,1,2,1,2,15
191223310,4,1,9,9,1,24
191223311,9,5,7,5,3,29
191223312,9,3,7,5,9,33
191223313,3,0,7,8,1,19
191223314,4,0,9,5,4,22
191223315,5,2,7,7,2,23
191223316,3,7,3,3,3,19
191223317,1,0,2,3,7,13
191223318,1,0,9,6,1,17
191223319,4,7,0,8,8,27
191223320,5,3,0,9,2,19
191223321,8,0,1,8,7,24
191223322,0,3,2,2,7,14
191223323,4,9,4,5,9,31
191223324,9,5,9,4,1,28
191223325,9,1,9,1,8,28
191223326,2,8,1,0,5,16
191223327,2,6,5,0,0,13
191223328,1,9,8,9,5,32
191223329,9,0,1,5,4,19
191223330,9,4,8,6,4,31
191223331,1,0,3,4,8,16
191223332,2,7,8,6,6,29
191223333,4,9,2,4,5,24
191223334,5,8,9,1,9,32
191223335,4,4,5,6,5,24
191223336,1,1,6,3,7,18
191223337,5,6,2,5,3,21
191223338,9,1,9,4,7,30
191223339,1,0,1,7,7,16
191223340,8,0,5,9,4,26
191223341,9,5,5,4,5,28
191223342,4,9,7,0,8,28
191223343,8,2,7,6,1,24
191223344,7,2,4,2,3,18
191223345,7,9,3,5,0,24
191223346,0,9,4,7,6,26
191223347,1,3,0,9,3,16
191223348,8,9,3,1,8,29
191223349,2,8,9,5,2,26
191223350,7,1,6,4,6,24
191223351,1,6,7,7,4,25
191223352,2,8,3,4,3,20
191223353,5,5,7,4,9,30
191223354,8,1,2,6,6,23
191223355,7,0,3,7,9,26
191223356,0,5,4,0,1,10
191223357,4,0,9,4,4,21
191223358,2,4,7,6,4,23
191223359,4,7,8,9,9,37
191223360,6,2,6,1,8,23
191223361,7,8,3,0,2,20
191223362,3,0,8,0,6,17
191223363,1,4,0,0,7,12
191223364,8,5,3,7,9,32
191223365,8,7,9,7,4,35
191223366,1,6,3,8,9,27
191223367,1,7,3,6,7,24
191223368,1,0,4,6,7,18
191223369,3,6,5,2,6,22
191223370,3,2,2,8,4,19
191223371,0,7,2,5,3,17
191223372,8,2,4,1,8,23
191223373,5,0,7,4,5,21
191223374,0,8,1,9,9,27
191223375,1,0,8,6,4,19
191223376,6,3,7,2,1,19
191223377,3,9,7,7,3,29
191223378,3,9,0,3,8,23
191223379,5,9,6,5,4,29
191223380,4,9,4,9,0,26
191223381,7,6,4,9,1,27
191223382,5,3,6,9,2,25
191223383,6,8,4,1,8,27
191223384,7,1,7,5,0,20
191223385,9,6,1,6,0,22
191223386,7,0,0,8,9,24
191223387,0,0,1,5,3,9
191223388,8,3,8,8,9,36
191223389,1,3,6,0,7,17
191223390,5,9,6,3,3,26
191223391,2,7,6,7,7,29
191223392,3,4,2,9,8,26
191223393,6,8,5,7,1,27
191223394,6,3,0,7,5,21
191223395,9,2,5,5,2,23
191223396,8,0,5,6,9,28
191223397,9,9,0,3,2,23
191223398,3,6,0,0,3,12
191223399,6,8,9,0,6,29
191223400,5,0,5,4,1,15
191223401,0,0,5,8,0,13
191223402,2,5,1,4,3,15
191223403,0,3,8,6,6,23
191223404,6,6,4,5,2,23
191223405,7,5,0,1,4,17
191223406,4,9,8,9,4,34
191223407,3,8,1,2,6,20
191223408,8,3,1,3,8,23
191223409,9,3,9,4,7,32
191223410,3,4,3,2,6,18
191223411,1,6,8,5,6,26
191223412,2,0,2,2,2,8
191223413,2,6,3,4,7,22
191223414,2,1,9,3,4,19
191223415,5,6,6,2,0,19
191223416,1,2,1,8,7,19
191223417,4,1,3,8,3,19
191223418,4,2,1,0,2,9
191223419,9,4,4,4,0,21
191223420,5,9,4,8,5,31
191223421,5,0,2,8,1,16
191223422,7,7,9,4,6,33
191223423,5,0,4,7,9,25
191223424,8,0,7,5,1,21
191223425,8,2,9,2,1,22
191223426,5,6,8,4,9,32
191223427,5,7,2,7,8,29
191223428,0,0,9,4,1,14
191223429,6,6,2,0,0,14
191223430,7,7,9,1,5,29
191223431,9,7,5,9,0,30
191223432,9,3,9,9,0,30
191223433,5,0,8,6,1,20
191223434,8,9,4,1,6,28
191223435,2,1,0,0,7,10
191223436,2,5,3,0,9,19
191223437,6,3,5,7,2,23
191223438,7,1,3,4,5,20
191223439,6,2,2,0,8,18
191223440,7,2,3,1,0,13
191223441,7,5,0,9,6,27
191223442,5,4,1,7,6,23
191223443,8,0,1,9,2,20
191223444,1,5,2,0,5,13
191223445,7,5,8,3,1,24
191223446,8,1,0,6,4,19
191223447,9,7,9,4,7,36
191223448,6,1,2,1,9,19
191223449,1,8,5,7,1,22
191223450,7,6,4,8,9,34
191223451,2,9,6,7,7,31
191223452,7,7,9,1,2,26
191223453,6,8,5,3,3,25
191223454,8,0,3,8,8,27
191223455,2,4,1,2,5,14
191223456,9,2,8,5,0,24
191223457,6,8,0,2,1,17
191223458,7,2,0,0,5,14
191223459,3,5,1,0,5,14
191223460,2,3,1,2,2,10
191223461,1,0,3,8,5,17
191223462,1,7,9,2,4,23
191223463,2,3,5,5,5,20
191223464,9,1,1,9,3,23
191223465,4,5,1,5,3,18
191223466,5,3,7,3,0,18
191223467,1,6,2,7,4,20
191223468,2,9,2,9,0,22
191223469,8,1,3,2,5,19
191223470,2,9,6,1,7,25
191223471,2,7,8,9,1,27
191223472,3,6,0,6,5,20
191223473,1,4,5,6,0,16
191223474,2,4,7,2,7,22
191223475,9,4,8,9,4,34
191223476,0,2,8,7,5,22
191223477,5,4,2,2,3,16
191223478,7,9,2,6,5,29
191223479,5,3,1,2,6,17
191223480,8,1,3,9,9,30
191223481,5,3,3,7,6,24
191223482,1,5,2,8,7,23
191223483,2,7,2,0,2,13
191223484,3,9,4,1,0,17
191223485,9,7,0,1,4,21
191223486,7,4,2,6,0,19
191223487,8,5,7,1,0,21
191223488,7,6,8,3,7,31
191223489,1,5,9,7,5,27
191223490,9,3,5,4,9,30
191223491,8,8,0,1,1,18
191223492,4,1,3,9,2,19
191223493,3,0,3,6,7,19
191223494,6,7,5,6,3,27
191223495,7,5,5,0,9,26
191223496,9,3,3,5,7,27
191223497,2,9,8,7,1,27
191223498,3,8,0,7,0,18
191223499,8,8,2,3,0,21
191223500,9,0,8,2,4,23
191223501,6,0,0,2,8,16
191223502,2,3,5,2,0,12
191223503,4,4,7,1,1,17
191223504,7,9,0,8,6,30
191223505,3,0,3,0,2,8
191223506,5,2,6,1,1,15
191223507,4,2,9,7,9,31
191223508,4,3,2,6,2,17
191223509,1,9,2,4,6,22
191223510,1,4,4,4,0,13
191223511,9,3,8,5,9,34
191223512,3,3,8,6,6,26
191223513,0,0,6,0,1,7
191223514,2,7,6,4,3,22
191223515,8,2,7,0,9,26
191223516,8,8,4,6,4,30
191223517,9,1,5,7,8,30
191223518,5,5,6,5,9,30
191223519,6,1,1,1,1,10
191223520,1,3,0,3,5,12
191223521,1,5,4,2,0,12
191223522,4,8,2,8,0,22
191223523,1,0,8,7,2,18
191223524,4,9,6,5,6,30
191223525,0,9,5,5,7,26
191223526,2,1,3,8,4,18
191223527,8,9,0,3,0,20
191223528,5,2,0,2,1,10
191223529,8,3,4,4,5,24
191223530,6,0,4,2,0,12
191223531,3,9,4,0,4,20
191223532,1,7,5,7,7,27
191223533,3,8,7,7,8,33
191223534,6,2,7,9,4,28
191223535,5,8,4,1,1,19
191223536,0,1,4,8,4,17
191223537,3,4,9,5,1,22
191223538,1,7,1,8,4,21
191223539,6,4,6,0,4,20
191223540,3,2,6,4,5,20
191223541,8,2,4,5,2,21
191223542,5,1,4,5,2,17
191223543,9,3,1,4,7,24
191223544,4,4,7,6,1,22
191223545,1,7,6,1,0,15
191223546,6,1,6,2,0,15
191223547,5,4,6,1,2,18
191223548,8,3,3,0,7,21
191223549,5,3,1,1,3,13
191223550,4,1,3,7,9,24
191223551,1,5,6,0,2,14
191223552,9,8,2,2,4,25
191223553,8,6,6,3,4,27
191223554,6,4,7,1,3,21
191223555,1,1,5,8,5,20
191223556,8,1,9,5,5,28
191223557,2,3,7,4,8,24
191223558,3,3,9,7,2,24
191223559,3,2,2,3,5,15
191223560,2,0,1,8,2,13
191223561,5,0,4,2,7,18
191223562,9,7,9,5,8,38
191223563,4,8,3,1,1,17
191223564,5,9,9,2,9,34
191223565,6,8,1,6,4,25
191223566,5,0,2,8,8,23
191223567,6,5,4,6,7,28
191223568,0,2,7,9,0,18
191223569,8,7,0,8,0,23
191223570,4,1,8,3,4,20
191223571,9,1,5,2,0,17
191223572,5,4,2,9,6,26
191223573,4,2,3,6,8,23
191223574,1,3,5,1,6,16
191223575,6,7,3,6,9,31
191223576,3,5,3,2,6,19
191223577,6,1,6,6,3,22
191223578,2,6,6,3,4,21
191223579,3,5,2,4,7,21
191223580,2,3,5,3,1,14
191223581,2,3,1,3,5,14
191223582,2,9,8,2,4,25
191223583,3,5,5,6,7,26
191223584,6,1,9,7,1,24
191223585,7,2,9,6,1,25
191223586,0,8,0,4,8,20
191223587,4,8,8,7,2,29
191223588,8,9,3,7,7,34
191223589,4,8,6,4,7,29
191223590,0,5,3,5,1,14
191223591,6,7,5,3,1,22
191223592,3,7,7,0,3,20
191223593,4,6,5,2,2,19
191223594,3,6,0,8,6,23
191223595,9,2,3,4,3,21
191223596,6,1,4,2,9,22
191223597,1,1,1,0,0,3
191223598,2,8,0,4,7,21
191223599,9,3,8,5,0,25
191223600,2,6,6,0,3,17
191223601,8,3,8,2,0,21
191223602,7,7,0,8,5,27
191223603,6,9,6,5,8,34
191223604,6,0,4,6,9,25
191223605,4,5,0,4,8,21
191223606,9,8,5,1,4,27
191223607,4,5,0,0,5,14
191223608,8,8,2,4,3,25
191223609,7,3,2,1,2,15
191223610,6,4,2,2,0,14
191223611,0,7,1,9,6,23
191223612,4,2,4,5,0,15
191223613,9,0,9,2,8,28
191223614,4,7,6,8,0,25
191223615,6,8,5,5,0,24
191223616,7,9,7,4,7,34
191223617,3,9,9,1,0,22
191223618,1,6,9,2,0,18
191223619,0,9,3,8,2,22
191223620,2,4,4,3,2,15
191223621,3,1,5,8,4,21
191223622,4,4,8,3,6,25
191223623,0,9,3,9,1,22
191223624,7,1,6,5,4,23
191223625,8,2,4,9,6,29
191223626,1,1,4,5,4,15
191223627,1,7,8,5,4,25
191223628,3,5,5,6,9,28
191223629,7,2,7,6,3,25
191223630,5,8,5,4,7,29
191223631,5,8,8,3,0,24
191223632,9,7,9,0,2,27
191223633,6,4,7,2,1,20
191223634,3,8,5,8,0,24
191223635,3,0,9,2,1,15
191223636,9,9,7,9,6,40
191223637,3,9,0,4,8,24
191223638,3,7,3,5,1,19
191223639,9,1,6,8,6,30
191223640,9,1,8,8,9,35
191223641,5,7,4,3,5,24
191223642,8,8,1,4,5,26
191223643,1,7,9,1,0,18
191223644,8,5,1,7,2,23
191223645,4,0,1,4,7,16
191223646,5,8,8,7,3,31
191223647,9,9,2,5,1,26
191223648,4,7,3,2,6,22
191223649,1,9,9,1,5,25
191223650,7,0,1,7,0,15
191223651,3,1,0,3,5,12
191223652,4,3,0,9,7,23
191223653,1,5,2,7,4,19
191223654,1,7,5,5,2,20
191223655,7,0,9,3,9,28
191223656,5,6,9,1,3,24
191223657,2,8,5,7,3,25
191223658,5,7,7,5,5,29
191223659,6,1,2,3,4,16
191223660,0,1,9,7,4,21
191223661,6,1,7,5,1,20
191223662,9,3,6,9,4,31
191223663,0,6,7,7,4,24
191223664,2,4,7,3,4,20
191223665,1,0,2,9,4,16
191223666,4,4,5,1,4,18
191223667,4,4,6,5,1,20
191223668,5,6,8,7,0,26
191223669,4,6,3,5,2,20
191223670,1,9,4,7,1,22
191223671,0,4,6,9,0,19
191223672,3,9,5,9,6,32
191223673,4,5,1,7,6,23
191223674,7,4,5,3,9,28
191223675,1,9,9,9,1,29
191223676,9,5,9,3,0,26
191223677,2,8,6,0,4,20
191223678,5,2,3,9,1,20
191223679,8,8,3,1,2,22
191223680,7,9,5,9,8,38
191223681,4,4,9,2,5,24
191223682,1,1,7,8,5,22
191223683,6,0,3,2,0,11
191223684,0,0,0,0,2,2
191223685,7,5,8,9,4,33
191223686,9,2,2,9,3,25
191223687,9,1,3,4,5,22
191223688,2,4,3,0,1,10
191223689,9,3,1,6,0,19
191223690,4,2,3,7,1,17
191223691,2,5,2,8,2,19
191223692,4,3,1,4,5,17
191223693,2,8,6,6,9,31
191223694,5,0,8,2,2,17
191223695,4,2,0,8,5,19
191223696,8,1,0,0,5,14
191223697,7,5,8,7,5,32
191223698,8,7,8,4,3,30
191223699,3,6,3,2,0,14
191223700,1,2,7,2,6,18
191223701,6,7,9,8,3,33
191223702,0,4,6,3,8,21
191223703,0,3,7,4,6,20
191223704,1,2,7,3,4,17
191223705,1,9,5,7,8,30
191223706,9,7,6,7,6,35
191223707,6,1,4,3,4,18
191223708,9,9,3,0,9,30
191223709,5,8,0,4,8,25
191223710,6,3,8,3,3,23
191223711,7,5,8,8,9,37
191223712,0,6,6,8,6,26
191223713,0,0,2,5,8,15
191223714,4,0,7,8,4,23
191223715,5,1,8,5,0,19
191223716,3,5,6,5,7,26
191223717,5,0,9,1,2,17
191223718,4,3,7,1,0,15
191223719,5,2,9,4,5,25
191223720,7,5,0,2,3,17
191223721,7,4,2,4,2,19
191223722,7,3,1,4,4,19
191223723,1,7,3,0,2,13
191223724,8,5,9,3,5,30
191223725,2,7,1,7,0,17
191223726,9,3,4,6,7,29
191223727,9,7,8,5,8,37
191223728,5,2,2,8,6,23
191223729,5,2,3,1,9,20
191223730,0,2,4,5,7,18
191223731,0,8,4,9,8,29
191223732,6,5,7,5,0,23
191223733,2,9,5,6,2,24
191223734,6,6,9,3,3,27
191223735,4,6,4,6,5,25
191223736,8,6,0,3,8,25
191223737,8,4,2,6,0,20
191223738,1,5,8,1,3,18
191223739,2,7,6,4,0,19
191223740,9,5,5,7,3,29
191223741,1,2,0,2,9,14
191223742,3,3,8,8,8,30
191223743,3,5,0,8,7,23
191223744,8,1,1,0,1,11
191223745,2,9,6,1,0,18
191223746,4,2,3,1,5,15
191223747,0,8,5,9,5,27
191223748,1,3,1,8,2,15
191223749,7,4,7,7,6,31
191223750,7,2,9,0,7,25
191223751,8,7,4,2,0,21
191223752,7,8,9,2,9,35
191223753,4,3,2,6,7,22
191223754,4,0,3,4,7,18
191223755,8,8,7,4,0,27
191223756,1,9,2,5,7,24
191223757,0,2,1,0,4,7
191223758,1,9,8,9,6,33
191223759,9,1,4,2,8,24
191223760,0,7,6,1,8,22
191223761,2,9,9,9,8,37
191223762,8,7,4,6,3,28
191223763,8,6,8,9,8,39
191223764,9,8,9,1,9,36
191223765,9,7,6,3,3,28
191223766,3,1,8,8,0,20
191223767,9,0,4,9,5,27
191223768,5,2,3,8,3,21
191223769,0,5,5,9,3,22
191223770,3,0,5,8,3,19
191223771,9,0,2,1,5,17
191223772,8,8,9,4,8,37
191223773,0,2,7,4,0,13
191223774,2,1,0,1,8,12
191223775,8,8,4,3,0,23
191223776,9,3,3,6,4,25
191223777,3,5,7,7,2,24
191223778,7,7,3,3,5,25
191223779,3,4,4,2,3,16
191223780,6,1,9,0,5,21
191223781,5,4,4,2,9,24
191223782,5,7,6,1,7,26
191223783,9,0,2,3,0,14
191223784,5,1,8,7,7,28
191223785,6,9,1,0,2,18
191223786,6,9,4,5,8,32
191223787,8,5,1,1,8,23
191223788,7,6,8,5,5,31
191223789,7,6,3,8,2,26
191223790,5,2,6,6,4,23
191223791,1,8,0,5,2,16
191223792,3,1,0,2,0,6
191223793,6,8,8,6,8,36
191223794,0,9,2,4,8,23
191223795,8,5,9,5,3,30
191223796,6,7,0,2,8,23
191223797,6,2,4,3,4,19
191223798,2,5,9,0,4,20
191223799,6,0,7,8,9,30
191223800,3,7,1,7,9,27
191223801,9,6,8,9,9,41
191223802,1,1,8,3,6,19
191223803,7,4,1,2,7,21
191223804,3,1,2,2,9,17
191223805,5,4,5,0,7,21
191223806,6,8,5,1,5,25
191223807,5,3,3,2,0,13
191223808,8,1,2,1,5,17
191223809,0,4,5,6,1,16
191223810,0,6,3,3,9,21
191223811,4,0,4,9,6,23
191223812,9,3,3,7,7,29
191223813,5,2,6,9,6,28
191223814,6,4,4,8,2,24
191223815,5,4,1,1,8,19
191223816,5,6,0,5,8,24
191223817,7,0,2,5,9,23
191223818,5,3,1,5,7,21
191223819,0,2,2,1,8,13
191223820,4,6,5,3,8,26
191223821,0,6,5,3,2,16
191223822,1,7,2,2,1,13
191223823,7,1,1,4,7,20
191223824,6,1,6,6,4,23
191223825,8,2,3,9,9,31
191223826,7,8,4,6,8,33
191223827,7,5,4,7,9,32
191223828,1,9,5,3,7,25
191223829,6,9,2,1,4,22
191223830,0,6,4,5,0,15
191223831,5,0,8,8,2,23
191223832,2,8,6,3,5,24
191223833,1,8,3,2,5,19
191223834,7,9,8,8,1,33
191223835,2,2,1,3,6,14
191223836,3,5,6,9,5,28
191223837,0,1,6,5,5,17
191223838,8,8,3,9,8,36
191223839,6,3,7,4,4,24
191223840,1,7,1,1,5,15
191223841,1,2,4,8,9,24
191223842,7,3,1,7,8,26
191223843,6,8,1,2,8,25
191223844,3,3,5,1,4,16
191223845,5,3,2,4,8,22
191223846,3,2,7,4,5,21
191223847,8,5,7,5,1,26
191223848,5,6,1,3,7,22
191223849,9,8,1,6,7,31
191223850,9,2,6,1,3,21
191223851,3,8,2,0,8,21
191223852,8,9,7,6,8,38
191223853,4,2,8,1,7,22
191223854,1,7,7,1,4,20
191223855,9,8,9,5,0,31
191223856,7,6,7,4,7,31
191223857,4,0,2,0,0,6
191223858,5,1,7,0,8,21
191223859,9,4,7,9,8,37
191223860,2,8,4,5,4,23
191223861,5,9,4,3,3,24
191223862,9,9,2,3,5,28
191223863,0,1,4,0,3,8
191223864,1,2,8,0,4,15
191223865,6,3,5,4,9,27
191223866,5,7,6,6,5,29
191223867,5,3,8,4,5,25
191223868,6,2,7,6,8,29
191223869,2,5,4,1,7,19
191223870,2,1,3,8,3,17
191223871,6,1,4,7,1,19
191223872,8,7,2,1,3,21
191223873,4,0,1,6,2,13
191223874,9,2,2,8,9,30
191223875,5,9,7,1,0,22
191223876,6,0,7,5,8,26
191223877,1,7,2,1,0,11
191223878,4,2,7,3,4,20
191223879,5,4,2,6,0,17
191223880,7,4,0,2,6,19
191223881,4,3,0,0,5,12
191223882,5,1,9,8,2,25
191223883,1,7,4,5,7,24
191223884,0,9,9,8,3,29
191223885,2,9,2,6,1,20
191223886,2,3,4,3,2,14
191223887,2,9,4,9,7,31
191223888,7,6,9,3,7,32
191223889,2,8,2,8,1,21
191223890,5,9,1,5,8,28
191223891,8,2,8,6,8,32
191223892,4,7,9,2,5,27
191223893,5,9,4,9,1,28
191223894,8,5,8,0,2,23
191223895,9,7,3,7,9,35
191223896,2,3,3,3,4,15
191223897,3,9,2,4,3,21
191223898,0,3,3,1,4,11
191223899,2,8,0,7,3,20
191223900,5,3,6,5,8,27
191223901,4,3,4,4,2,17
191223902,7,0,7,1,0,15
191223903,6,8,6,1,0,21
191223904,7,5,0,1,8,21
191223905,3,5,2,3,1,14
191223906,3,4,5,3,4,19
191223907,0,5,1,0,0,6
191223908,8,7,8,8,8,39
191223909,3,4,4,5,0,16
191223910,0,8,9,6,0,23
191223911,4,2,0,1,2,9
191223912,7,5,2,1,1,16
191223913,2,8,7,4,6,27
191223914,5,5,8,7,6,31
191223915,1,0,2,3,9,15
191223916,0,2,2,3,6,13
191223917,8,4,4,7,1,24
191223918,6,6,1,8,3,24
191223919,2,7,9,5,0,23
191223920,2,8,0,9,6,25
191223921,1,4,8,4,2,19
191223922,0,7,9,4,1,21
191223923,5,8,5,5,9,32
191223924,4,1,2,3,0,10
191223925,4,3,8,4,1,20
191223926,4,0,7,2,7,20
191223927,7,8,4,7,9,35
191223928,4,1,3,9,4,21
191223929,4,1,8,6,1,20
191223930,2,6,2,0,0,10
191223931,8,1,1,2,6,18
191223932,0,6,9,5,0,20
191223933,5,5,5,9,4,28
191223934,4,7,0,5,2,18
191223935,5,1,2,0,2,10
191223936,6,0,6,0,9,21
191223937,1,7,5,8,7,28
191223938,7,0,8,1,2,18
191223939,4,8,7,0,4,23
191223940,3,0,6,3,0,12
191223941,3,9,9,8,6,35
191223942,8,1,9,0,0,18
191223943,1,7,3,8,1,20
191223944,8,0,5,5,3,21
191223945,8,2,7,9,6,32
191223946,8,4,8,2,0,22
191223947,3,5,0,2,5,15
191223948,9,3,2,4,0,18
191223949,6,7,4,9,3,29
191223950,7,1,1,3,3,15
191223951,9,2,5,7,5,28
191223952,8,6,1,6,6,27
191223953,4,3,3,0,0,10
191223954,7,8,0,3,1,19
191223955,6,8,1,0,4,19
191223956,0,3,1,2,9,15
191223957,7,2,0,4,1,14
191223958,1,6,9,7,0,23
191223959,5,7,0,2,1,15
191223960,9,9,0,1,5,24
191223961,3,4,0,8,0,15
191223962,4,1,1,6,0,12
191223963,2,4,2,2,0,10
191223964,6,8,7,5,0,26
191223965,0,4,0,6,3,13
191223966,9,3,7,6,8,33
191223967,8,3,4,4,0,19
191223968,3,2,3,0,1,9
191223969,6,3,0,3,5,17
191223970,2,2,3,0,9,16
191223971,7,6,6,2,5,26
191223972,3,9,9,9,9,39
191223973,3,8,9,0,5,25
191223974,1,5,8,6,3,23
191223975,7,9,0,6,4,26
191223976,6,7,9,2,4,28
191223977,0,8,2,6,3,19
191223978,7,3,2,5,6,23
191223979,1,6,4,9,6,26
191223980,4,3,1,6,6,20
191223981,5,0,5,5,5,20
191223982,7,8,1,5,8,29
191223983,1,1,2,2,1,7
191223984,9,9,9,3,3,33
191223985,8,3,3,1,3,18
191223986,1,8,6,0,8,23
191223987,9,5,6,3,3,26
191223988,5,1,2,7,2,17
191223989,5,0,2,7,0,14
191223990,9,8,8,8,2,35
191223991,6,4,8,9,7,34
191223992,0,2,3,6,5,16
191223993,4,5,2,3,8,22
191223994,9,8,5,0,2,24
191223995,5,9,7,1,3,25
191223996,2,8,9,9,4,32
191223997,0,7,3,2,1,13
191223998,9,3,0,6,3,21
191223999,7,0,7,0,3,17
1912231000,3,9,1,0,6,19
1912231001,7,3,7,1,1,19
1912231002,5,8,3,1,4,21
1912231003,3,9,6,7,0,25
1912231004,3,4,9,8,2,26
1912231005,9,8,6,5,3,31
1912231006,5,0,0,4,7,16
1912231007,3,8,3,1,9,24
1912231008,1,7,2,1,2,13
1912231009,2,9,3,3,7,24
1912231010,7,8,3,8,5,31
1912231011,5,1,5,2,0,13
1912231012,8,8,0,2,2,20
1912231013,9,3,1,0,8,21
1912231014,1,5,9,0,9,24
1912231015,1,4,8,3,3,19
1912231016,2,6,4,2,2,16
1912231017,7,2,8,9,2,28
1912231018,2,2,0,4,0,8
1912231019,4,8,8,4,9,33
1912231020,2,3,7,1,7,20
1912231021,7,5,8,8,2,30
1912231022,2,3,9,7,0,21
1912231023,5,0,7,5,2,19
1912231024,1,8,3,1,1,14
1912231025,8,5,1,7,8,29
1912231026,3,1,3,9,1,17
1912231027,0,9,4,8,8,29
1912231028,6,4,6,5,9,30
1912231029,7,6,6,6,2,27
1912231030,3,0,7,0,0,10
1912231031,7,3,1,0,3,14
1912231032,4,8,5,9,5,31
1912231033,7,3,7,8,4,29
1912231034,9,6,1,6,2,24
1912231035,1,3,9,3,7,23
1912231036,7,1,0,7,7,22
1912231037,4,1,4,7,4,20
1912231038,1,2,3,0,2,8
1912231039,5,3,7,7,1,23
1912231040,9,8,1,5,9,32
1912231041,7,4,8,0,9,28
1912231042,9,3,1,5,9,27
1912231043,6,9,7,2,4,28
1912231044,6,0,1,1,4,12
1912231045,5,3,4,7,0,19
1912231046,8,6,3,8,0,25
1912231047,2,6,4,2,3,17
1912231048,0,6,7,8,6,27
1912231049,1,5,5,0,5,16
1912231050,0,1,0,4,1,6
1912231051,0,3,2,3,7,15
1912231052,8,8,3,5,0,24
1912231053,0,3,3,6,6,18
1912231054,5,9,4,7,2,27
1912231055,5,8,6,6,3,28
1912231056,9,0,1,8,3,21
1912231057,7,3,4,9,5,28
1912231058,9,7,2,0,0,18
1912231059,3,0,1,7,6,17
1912231060,6,1,3,5,5,20
1912231061,7,4,8,8,2,29
1912231062,9,2,3,9,0,23
1912231063,8,8,3,3,2,24
1912231064,0,1,4,9,4,18
1912231065,1,4,8,9,3,25
1912231066,3,3,1,6,7,20
1912231067,6,4,9,5,3,27
1912231068,5,0,2,4,7,18
1912231069,7,3,7,4,8,29
1912231070,8,7,2,9,7,33
1912231071,2,9,4,4,8,27
1912231072,4,3,0,0,6,13
1912231073,4,4,1,2,1,12
1912231074,4,4,8,0,1,17
1912231075,8,4,6,8,7,33
1912231076,3,1,9,4,3,20
1912231077,3,6,3,3,4,19
1912231078,5,6,3,0,1,15
1912231079,9,5,1,4,4,23
1912231080,9,6,9,8,2,34
1912231081,0,0,9,1,5,15
1912231082,9,7,0,0,6,22
1912231083,8,3,8,0,2,21
1912231084,0,0,4,9,6,19
1912231085,3,7,6,3,5,24
1912231086,0,5,9,9,9,32
1912231087,7,6,6,9,9,37
1912231088,9,3,7,4,7,30
1912231089,5,2,4,0,5,16
1912231090,1,9,7,2,7,26
1912231091,0,5,3,6,6,20
1912231092,3,3,9,9,9,33
1912231093,2,6,7,1,3,19
1912231094,1,8,4,5,9,27
1912231095,2,6,1,3,9,21
1912231096,1,1,7,9,1,19
1912231097,1,7,5,5,8,26
1912231098,9,7,7,7,8,38
1912231099,4,9,1,2,9,25
1912231100,0,8,8,4,9,29
1912231101,2,4,4,0,3,13
1912231102,4,3,9,2,2,20
1912231103,9,3,5,3,1,21
1912231104,0,4,1,7,7,19
1912231105,5,2,9,4,7,27
191224001,9,8,0,0,9,26
191224002,8,6,7,6,1,28
191224003,6,8,0,6,7,27
191224004,2,9,5,3,7,26
191224005,2,6,6,8,0,22
191224006,0,9,5,4,5,23
191224007,7,9,5,7,6,34
191224008,6,1,2,7,8,24
191224009,6,8,3,1,4,22
191224010,1,3,4,8,5,21
191224011,7,6,0,1,5,19
191224012,9,9,7,2,5,32
191224013,8,5,6,3,1,23
191224014,7,5,0,5,3,20
191224015,2,6,6,9,8,31
191224016,0,9,3,5,0,17
191224017,2,4,4,8,6,24
191224018,5,9,4,1,2,21
191224019,9,7,4,8,6,34
191224020,8,4,5,5,1,23
191224021,8,3,4,3,0,18
191224022,1,5,9,5,3,23
191224023,1,6,1,1,1,10
191224024,8,7,4,5,5,29
191224025,9,7,8,2,4,30
191224026,6,1,8,0,2,17
191224027,4,7,9,3,3,26
191224028,8,9,8,5,5,35
191224029,4,8,3,0,1,16
191224030,3,7,4,3,5,22
191224031,4,4,8,4,2,22
191224032,3,2,1,4,7,17
191224033,5,1,5,2,1,14
191224034,3,6,3,0,8,20
191224035,6,8,0,7,0,21
191224036,4,7,6,2,6,25
191224037,6,8,8,7,4,33
191224038,3,2,9,7,2,23
191224039,1,9,8,6,1,25
191224040,2,4,3,5,6,20
191224041,4,8,0,4,8,24
191224042,5,2,1,1,9,18
191224043,5,7,8,5,2,27
191224044,7,3,9,9,1,29
191224045,4,0,0,3,8,15
191224046,0,1,1,0,3,5
191224047,3,7,6,9,6,31
191224048,9,4,0,1,8,22
191224049,3,6,7,0,6,22
191224050,5,0,2,2,0,9
191224051,3,4,3,8,0,18
191224052,3,1,7,1,2,14
191224053,4,7,1,9,9,30
191224054,0,4,5,2,5,16
191224055,9,5,9,2,2,27
191224056,9,3,7,7,8,34
191224057,2,5,0,1,4,12
191224058,3,3,3,9,7,25
191224059,4,2,1,0,0,7
191224060,2,9,0,8,2,21
191224061,4,4,1,9,8,26
191224062,9,2,9,0,8,28
191224063,2,0,8,2,4,16
191224064,4,8,0,0,0,12
191224065,4,8,3,6,2,23
191224066,0,1,1,7,4,13
191224067,8,3,6,2,2,21
191224068,7,9,6,3,0,25
191224069,2,9,4,1,6,22
191224070,1,8,1,7,7,24
191224071,5,0,5,4,2,16
191224072,2,1,1,1,5,10
191224073,1,9,8,8,2,28
191224074,7,0,1,9,1,18
191224075,4,5,8,9,8,34
191224076,1,7,9,3,9,29
191224077,6,7,3,9,7,32
191224078,0,9,2,3,9,23
191224079,4,3,2,8,7,24
191224080,5,4,0,4,2,15
191224081,5,2,8,8,3,26
191224082,0,1,1,2,4,8
191224083,4,1,9,1,4,19
191224084,8,3,6,6,2,25
191224085,5,2,5,8,9,29
191224086,4,9,2,2,5,22
191224087,1,7,8,9,8,33
191224088,5,7,9,4,7,32
191224089,5,1,3,2,5,16
191224090,9,3,6,0,2,20
191224091,1,7,5,4,1,18
191224092,9,9,3,0,4,25
191224093,3,4,8,8,6,29
191224094,8,5,3,5,3,24
191224095,0,4,5,8,0,17
191224096,2,7,1,2,5,17
191224097,4,6,0,9,7,26
191224098,0,9,9,0,7,25
191224099,1,0,8,3,1,13
191224100,0,2,8,9,2,21
191224101,3,4,9,4,3,23
191224102,9,8,5,3,5,30
191224103,4,2,7,9,9,31
191224104,3,7,7,4,4,25
191224105,0,7,7,4,6,24
191224106,2,7,9,4,9,31
191224107,4,0,0,7,1,12
191224108,6,8,9,4,3,30
191224109,0,4,9,9,1,23
191224110,3,0,8,1,4,16
191224111,6,3,6,5,3,23
191224112,6,6,0,7,8,27
191224113,1,5,3,5,0,14
191224114,4,2,4,2,3,15
191224115,1,9,1,7,2,20
191224116,4,4,7,2,9,26
191224117,1,7,2,0,7,17
191224118,7,6,8,0,8,29
191224119,1,6,4,2,9,22
191224120,0,0,7,2,3,12
191224121,8,2,4,7,4,25
191224122,9,4,1,1,7,22
191224123,0,4,3,2,7,16
191224124,0,3,6,2,4,15
191224125,6,1,4,9,2,22
191224126,8,0,0,3,2,13
191224127,4,7,4,6,2,23
191224128,9,0,0,2,7,18
191224129,0,9,6,5,5,25
191224130,8,0,8,2,4,22
191224131,0,3,9,8,1,21
191224132,2,2,7,1,0,12
191224133,0,9,6,1,3,19
191224134,1,6,3,2,5,17
191224135,4,5,9,1,1,20
191224136,8,3,2,0,8,21
191224137,4,8,1,8,5,26
191224138,0,1,6,7,2,16
191224139,0,2,2,9,1,14
191224140,0,8,1,3,7,19
191224141,7,0,5,2,7,21
191224142,3,3,6,3,8,23
191224143,1,0,3,1,9,14
191224144,4,1,2,4,2,13
191224145,0,6,2,3,8,19
191224146,9,0,6,3,7,25
191224147,8,9,7,9,0,33
191224148,5,7,6,1,2,21
191224149,4,4,8,3,9,28
191224150,8,1,0,2,0,11
191224151,4,7,3,2,7,23
191224152,8,1,7,2,4,22
191224153,1,3,6,5,1,16
191224154,8,0,4,7,7,26
191224155,7,4,2,4,5,22
191224156,3,3,1,5,7,19
191224157,1,4,3,9,1,18
191224158,4,9,3,2,0,18
191224159,1,4,6,1,7,19
191224160,0,2,5,6,8,21
191224161,3,6,4,0,3,16
191224162,0,3,6,9,3,21
191224163,6,6,2,3,2,19
191224164,7,1,0,4,0,12
191224165,4,8,5,5,9,31
191224166,5,7,6,4,1,23
191224167,6,8,1,3,4,22
191224168,1,7,1,7,3,19
191224169,8,8,0,9,2,27
191224170,2,3,1,8,5,19
191224171,3,9,7,9,3,31
191224172,9,2,3,9,2,25
191224173,6,5,2,8,0,21
191224174,0,1,6,1,8,16
191224175,0,6,5,1,5,17
191224176,1,8,2,3,9,23
191224177,1,6,8,6,9,30
191224178,0,0,6,6,5,17
191224179,5,7,5,0,2,19
191224180,1,9,3,5,5,23
191224181,2,0,8,6,7,23
191224182,8,4,3,6,2,23
191224183,7,3,9,0,0,19
191224184,0,3,9,4,2,18
191224185,8,5,2,9,1,25
191224186,2,7,0,3,7,19
191224187,8,4,6,6,9,33
191224188,8,2,7,6,4,27
191224189,8,1,4,2,1,16
191224190,2,9,1,2,9,23
191224191,9,0,8,7,1,25
191224192,4,6,9,5,6,30
191224193,4,6,1,3,9,23
191224194,8,8,9,9,2,36
191224195,5,8,7,9,1,30
191224196,4,8,1,6,2,21
191224197,5,5,7,2,8,27
191224198,2,5,5,2,3,17
191224199,6,5,6,9,8,34
191224200,1,3,0,6,0,10
191224201,1,1,3,8,2,15
191224202,4,3,0,2,7,16
191224203,6,0,7,9,1,23
191224204,0,0,9,1,6,16
191224205,0,4,9,9,4,26
191224206,7,9,5,1,2,24
191224207,0,0,6,1,7,14
191224208,7,6,7,2,6,28
191224209,9,9,2,0,0,20
191224210,5,4,3,3,8,23
191224211,1,3,1,0,6,11
191224212,7,2,7,8,4,28
191224213,4,6,2,6,4,22
191224214,5,6,4,0,4,19
191224215,7,8,2,5,1,23
191224216,7,8,0,1,5,21
191224217,6,3,7,9,2,27
191224218,0,2,0,2,1,5
191224219,6,2,3,2,2,15
191224220,5,6,1,2,0,14
191224221,0,0,1,2,7,10
191224222,4,1,6,2,7,20
191224223,0,9,7,6,2,24
191224224,9,7,6,5,9,36
191224225,7,1,6,8,4,26
191224226,4,1,5,0,2,12
191224227,6,1,5,0,7,19
191224228,4,4,7,2,7,24
191224229,8,4,7,2,4,25
191224230,3,2,1,9,8,23
191224231,0,4,9,0,4,17
191224232,5,6,2,2,2,17
191224233,1,8,6,4,0,19
191224234,0,6,7,2,5,20
191224235,9,2,9,5,1,26
191224236,9,7,5,7,5,33
191224237,9,8,2,3,0,22
191224238,8,8,5,3,5,29
191224239,7,7,0,9,8,31
191224240,3,7,2,6,5,23
191224241,5,5,6,8,3,27
191224242,8,4,9,2,4,27
191224243,1,4,0,0,9,14
191224244,3,0,0,5,7,15
191224245,5,8,2,9,2,26
191224246,0,5,9,6,1,21
191224247,8,9,6,4,9,36
191224248,9,9,2,0,1,21
191224249,4,5,9,2,0,20
191224250,4,2,1,0,8,15
191224251,0,4,9,5,6,24
191224252,4,7,6,7,0,24
191224253,5,1,6,1,3,16
191224254,3,1,4,6,3,17
191224255,0,6,2,8,3,19
191224256,0,3,5,5,9,22
191224257,3,1,7,2,2,15
191224258,6,4,5,7,1,23
191224259,1,0,3,5,9,18
191224260,1,7,9,7,2,26
191224261,8,5,4,9,2,28
191224262,3,0,9,7,7,26
191224263,2,4,5,6,1,18
191224264,1,9,2,9,1,22
191224265,0,9,8,3,7,27
191224266,0,4,8,9,5,26
191224267,2,8,5,4,5,24
191224268,1,8,6,1,5,21
191224269,8,7,9,0,2,26
191224270,7,1,5,2,6,21
191224271,0,6,0,2,4,12
191224272,4,3,2,8,5,22
191224273,5,8,2,2,0,17
191224274,4,4,2,9,6,25
191224275,1,4,1,3,6,15
191224276,8,0,8,6,4,26
191224277,7,5,7,6,9,34
191224278,4,8,2,4,2,20
191224279,2,7,5,1,1,16
191224280,5,0,3,4,4,16
191224281,2,4,2,4,9,21
191224282,9,6,3,9,6,33
191224283,0,4,4,4,8,20
191224284,7,9,2,0,8,26
191224285,5,8,6,9,9,37
191224286,9,1,3,4,4,21
191224287,0,3,5,5,4,17
191224288,2,7,2,9,3,23
191224289,2,4,3,4,0,13
191224290,5,2,5,0,5,17
191224291,9,9,9,9,8,44
191224292,9,8,5,7,0,29
191224293,4,1,1,0,8,14
191224294,7,5,1,2,8,23
191224295,6,5,9,5,4,29
191224296,3,6,0,1,8,18
191224297,0,7,4,3,0,14
191224298,5,6,2,2,1,16
191224299,3,3,8,5,4,23
191224300,9,4,4,1,7,25
191224301,7,1,6,6,0,20
191224302,3,0,5,3,0,11
191224303,9,9,5,4,0,27
191224304,4,4,2,7,5,22
191224305,6,7,0,4,7,24
191224306,2,5,7,8,3,25
191224307,7,3,1,3,3,17
191224308,9,7,2,5,7,30
191224309,2,7,8,1,1,19
191224310,3,5,0,0,0,8
191224311,0,3,0,1,0,4
191224312,0,7,6,3,2,18
191224313,2,5,7,9,7,30
191224314,3,7,1,9,5,25
191224315,0,8,9,9,4,30
191224316,5,3,4,7,9,28
191224317,1,0,5,9,1,16
191224318,8,0,2,5,8,23
191224319,2,0,8,2,9,21
191224320,5,4,7,0,2,18
191224321,8,7,9,2,7,33
191224322,3,8,7,7,2,27
191224323,0,9,2,8,1,20
191224324,0,7,1,8,3,19
191224325,5,7,5,5,5,27
191224326,2,4,1,5,9,21
191224327,1,6,1,1,3,12
191224328,9,5,4,7,6,31
191224329,4,9,8,8,1,30
191224330,5,5,5,2,9,26
191224331,8,2,0,9,8,27
191224332,6,2,7,2,9,26
191224333,8,8,3,3,4,26
191224334,6,1,7,8,9,31
191224335,8,5,1,2,5,21
191224336,3,6,5,5,0,19
191224337,7,2,9,5,5,28
191224338,4,8,3,3,9,27
191224339,9,9,1,0,2,21
191224340,6,8,5,3,4,26
191224341,3,8,5,2,4,22
191224342,2,3,8,2,0,15
191224343,0,9,1,2,9,21
191224344,6,6,6,7,3,28
191224345,8,0,0,1,9,18
191224346,8,7,2,2,2,21
191224347,7,3,2,7,9,28
191224348,3,4,4,2,2,15
191224349,0,1,0,8,5,14
191224350,1,6,2,4,7,20
191224351,5,5,2,2,9,23
191224352,8,5,1,6,1,21
191224353,0,5,3,6,4,18
191224354,1,8,9,3,6,27
191224355,9,7,8,1,1,26
191224356,2,1,5,1,0,9
191224357,2,2,3,2,9,18
191224358,1,8,7,1,1,18
191224359,8,9,8,1,0,26
191224360,8,8,1,0,0,17
191224361,8,0,0,9,3,20
191224362,4,3,1,7,5,20
191224363,6,4,3,1,8,22
191224364,1,9,7,2,4,23
191224365,5,8,0,3,2,18
191224366,4,3,5,9,3,24
191224367,2,8,2,1,5,18
191224368,3,2,1,1,4,11
191224369,3,2,3,3,2,13
191224370,2,6,0,4,0,12
191224371,7,2,0,2,3,14
191224372,1,6,5,1,8,21
191224373,6,5,6,1,1,19
191224374,8,2,0,7,2,19
191224375,7,6,4,2,8,27
191224376,3,8,3,9,6,29
191224377,7,0,0,7,1,15
191224378,7,4,7,8,8,34
191224379,0,5,0,7,5,17
191224380,1,0,8,4,7,20
191224381,3,9,6,3,2,23
191224382,3,2,7,7,3,22
191224383,3,7,8,4,2,24
191224384,3,8,6,5,4,26
191224385,9,1,8,7,8,33
191224386,7,7,4,3,8,29
191224387,8,8,4,6,2,28
191224388,4,9,4,0,2,19
191224389,1,4,8,3,9,25
191224390,8,1,2,4,4,19
191224391,1,9,6,9,0,25
191224392,0,5,3,8,9,25
191224393,3,7,2,2,1,15
191224394,1,2,0,2,5,10
191224395,1,1,0,5,3,10
191224396,8,1,1,3,3,16
191224397,0,8,9,3,1,21
191224398,2,5,5,9,2,23
191224399,7,5,2,5,6,25
191224400,7,4,6,8,6,31
191224401,1,0,0,4,8,13
191224402,3,2,1,2,6,14
191224403,9,8,6,5,7,35
191224404,6,0,0,9,5,20
191224405,0,8,2,5,0,15
191224406,9,8,8,3,1,29
191224407,9,7,5,7,7,35
191224408,6,1,0,9,8,24
191224409,8,6,3,7,6,30
191224410,8,3,2,9,5,27
191224411,7,6,3,1,5,22
191224412,6,0,4,0,6,16
191224413,6,6,5,6,3,26
191224414,8,9,3,7,3,30
191224415,4,7,9,4,9,33
191224416,6,7,6,1,7,27
191224417,2,7,8,0,0,17
191224418,9,7,2,0,4,22
191224419,8,3,3,1,5,20
191224420,0,1,4,9,5,19
191224421,0,9,2,0,4,15
191224422,3,2,7,7,4,23
191224423,5,6,2,3,6,22
191224424,8,9,2,0,8,27
191224425,6,7,7,0,1,21
191224426,3,3,3,0,4,13
191224427,3,8,3,2,2,18
191224428,0,8,8,1,9,26
191224429,6,6,8,1,1,22
191224430,3,4,2,9,0,18
191224431,6,3,5,7,1,22
191224432,6,2,3,8,7,26
191224433,9,7,6,6,0,28
191224434,2,9,7,7,1,26
191224435,5,4,4,2,8,23
191224436,9,3,4,5,2,23
191224437,1,9,5,2,3,20
191224438,3,7,7,7,4,28
191224439,2,3,2,4,2,13
191224440,1,1,0,1,2,5
191224441,2,4,5,5,0,16
191224442,7,2,2,7,1,19
191224443,0,2,6,4,2,14
191224444,5,9,5,9,2,30
191224445,8,5,0,7,8,28
191224446,1,2,4,6,7,20
191224447,3,6,9,7,6,31
191224448,6,4,8,1,8,27
191224449,5,1,3,5,7,21
191224450,3,6,0,1,2,12
191224451,3,2,2,7,7,21
191224452,5,8,7,7,8,35
191224453,4,9,2,2,0,17
191224454,2,1,3,8,8,22
191224455,7,1,6,8,1,23
191224456,1,8,3,4,6,22
191224457,1,1,6,7,2,17
191224458,6,5,4,8,0,23
191224459,2,1,4,8,8,23
191224460,3,2,0,5,6,16
191224461,7,6,4,3,9,29
191224462,3,0,7,7,3,20
191224463,4,6,0,0,3,13
191224464,2,1,4,2,0,9
191224465,2,7,0,4,1,14
191224466,9,8,2,5,7,31
191224467,7,6,9,5,0,27
191224468,0,2,1,0,7,10
191224469,8,9,4,3,2,26
191224470,1,6,0,3,8,18
191224471,7,3,8,5,3,26
191224472,4,4,2,3,4,17
191224473,4,9,1,7,1,22
191224474,9,8,1,7,1,26
191224475,0,7,5,4,6,22
191224476,1,5,9,7,2,24
191224477,9,8,2,0,6,25
191224478,2,2,6,2,7,19
191224479,8,3,9,7,9,36
191224480,2,2,5,4,1,14
191224481,0,5,3,4,8,20
191224482,6,9,7,3,0,25
191224483,9,5,7,6,9,36
191224484,2,7,8,0,9,26
191224485,2,6,9,3,6,26
191224486,3,9,1,5,4,22
191224487,0,2,7,8,7,24
191224488,2,0,8,6,3,19
191224489,7,9,7,6,7,36
191224490,7,1,0,3,7,18
191224491,0,9,1,8,8,26
191224492,0,5,7,4,7,23
191224493,9,9,9,5,1,33
191224494,3,6,2,4,1,16
191224495,6,0,8,1,1,16
191224496,7,2,0,0,6,15
191224497,5,8,2,8,0,23
191224498,8,4,5,6,5,28
191224499,9,4,4,4,5,26
191224500,8,2,4,7,8,29
191224501,2,8,6,9,3,28
191224502,0,6,3,6,2,17
191224503,7,3,0,4,3,17
191224504,9,4,4,7,7,31
191224505,9,7,3,5,3,27
191224506,9,7,4,7,8,35
191224507,1,5,3,0,3,12
191224508,9,9,0,4,0,22
191224509,6,4,1,7,0,18
191224510,9,3,5,1,0,18
191224511,5,5,2,2,0,14
191224512,3,9,2,3,4,21
191224513,2,1,6,3,5,17
191224514,9,8,4,3,6,30
191224515,7,8,3,2,3,23
191224516,6,6,3,2,3,20
191224517,1,7,5,4,9,26
191224518,0,6,5,9,4,24
191224519,7,1,6,2,2,18
191224520,5,3,0,1,0,9
191224521,6,2,0,4,9,21
191224522,8,3,9,5,1,26
191224523,8,9,4,3,5,29
191224524,6,0,4,9,3,22
191224525,4,2,0,0,9,15
191224526,7,7,4,7,4,29
191224527,6,3,2,9,8,28
191224528,0,0,5,2,6,13
191224529,8,7,1,6,8,30
191224530,7,3,9,1,1,21
191224531,4,5,8,1,2,20
191224532,1,1,1,6,1,10
191224533,1,6,4,4,6,21
191224534,7,5,0,0,2,14
191224535,6,4,1,3,3,17
191224536,8,0,1,5,3,17
191224537,2,3,6,8,6,25
191224538,4,2,2,8,3,19
191224539,5,1,1,3,8,18
191224540,5,0,3,5,5,18
191224541,9,6,6,2,2,25
191224542,8,8,1,7,7,31
191224543,0,1,8,5,0,14
191224544,8,3,5,7,2,25
191224545,7,7,0,1,7,22
191224546,0,7,9,0,5,21
191224547,5,1,8,8,9,31
191224548,0,7,2,8,4,21
191224549,8,5,0,7,3,23
191224550,7,3,4,1,0,15
191224551,2,7,2,2,6,19
191224552,1,0,1,2,7,11
191224553,3,9,9,2,4,27
191224554,7,3,6,5,8,29
191224555,4,7,6,4,9,30
191224556,3,9,8,7,2,29
191224557,2,2,3,0,1,8
191224558,3,2,0,0,0,5
191224559,0,4,7,0,3,14
191224560,6,8,0,6,5,25
191224561,1,3,7,6,6,23
191224562,2,4,0,3,5,14
191224563,9,3,4,8,5,29
191224564,8,3,4,9,6,30
191224565,4,2,5,5,4,20
191224566,8,9,8,6,7,38
191224567,6,8,6,1,9,30
191224568,9,9,9,1,5,33
191224569,8,5,1,5,3,22
191224570,7,7,8,4,6,32
191224571,2,9,6,6,4,27
191224572,0,3,1,7,6,17
191224573,9,4,7,4,2,26
191224574,2,7,7,2,2,20
191224575,8,6,5,3,7,29
191224576,3,8,9,3,0,23
191224577,7,5,8,1,1,22
191224578,5,1,6,3,5,20
191224579,4,8,7,6,3,28
191224580,2,0,6,0,4,12
191224581,8,7,8,7,5,35
191224582,9,3,7,1,6,26
191224583,9,8,2,2,1,22
191224584,2,8,9,4,0,23
191224585,6,0,1,7,3,17
191224586,0,7,2,6,8,23
191224587,2,5,9,4,8,28
191224588,2,0,9,3,5,19
191224589,7,5,3,8,1,24
191224590,9,6,3,8,8,34
191224591,0,4,0,0,3,7
191224592,5,4,7,9,5,30
191224593,0,3,6,3,6,18
191224594,7,8,9,3,0,27
191224595,4,3,3,2,7,19
191224596,8,8,3,4,0,23
191224597,8,3,7,4,7,29
191224598,7,0,0,7,9,23
191224599,3,9,4,2,2,20
191224600,4,7,8,6,3,28
191224601,9,4,4,1,1,19
191224602,5,6,1,7,8,27
191224603,0,1,1,6,4,12
191224604,3,2,6,4,1,16
191224605,9,3,5,0,5,22
191224606,0,7,3,9,9,28
191224607,1,1,9,2,1,14
191224608,0,8,6,3,2,19
191224609,8,7,2,3,4,24
191224610,4,7,1,2,6,20
191224611,4,5,7,4,0,20
191224612,8,3,7,3,7,28
191224613,4,0,9,7,1,21
191224614,8,7,0,7,6,28
191224615,4,9,7,5,0,25
191224616,9,2,0,2,0,13
191224617,6,2,9,1,0,18
191224618,6,4,9,3,5,27
191224619,8,3,0,4,6,21
191224620,4,7,9,8,2,30
191224621,1,6,7,7,3,24
191224622,7,4,6,0,9,26
191224623,6,7,6,4,4,27
191224624,4,1,6,4,3,18
191224625,5,3,8,6,6,28
191224626,3,0,6,0,4,13
191224627,2,5,6,1,7,21
191224628,3,7,2,1,2,15
191224629,8,4,9,0,0,21
191224630,7,8,8,8,5,36
191224631,2,3,2,0,4,11
191224632,2,4,4,7,5,22
191224633,5,3,9,2,1,20
191224634,7,7,3,1,1,19
191224635,3,3,5,2,5,18
191224636,6,4,1,5,9,25
191224637,2,9,1,8,2,22
191224638,7,1,6,7,5,26
191224639,7,5,5,3,1,21
191224640,0,4,2,3,1,10
191224641,5,0,6,2,1,14
191224642,0,3,6,6,8,23
191224643,5,2,5,9,0,21
191224644,9,5,7,1,3,25
191224645,5,8,8,1,9,31
191224646,6,0,2,4,2,14
191224647,3,3,0,9,3,18
191224648,2,8,2,0,3,15
191224649,2,9,4,8,9,32
191224650,7,3,7,1,3,21
191224651,5,6,6,7,5,29
191224652,7,0,5,4,9,25
191224653,5,8,7,1,1,22
191224654,0,8,6,9,5,28
191224655,8,7,6,5,0,26
191224656,0,2,5,7,0,14
191224657,2,2,5,2,7,18
191224658,6,5,3,1,4,19
191224659,5,2,3,8,4,22
191224660,5,3,0,6,4,18
191224661,8,5,7,9,8,37
191224662,9,4,4,2,6,25
191224663,5,5,6,0,6,22
191224664,4,8,9,6,8,35
191224665,8,7,3,9,7,34
191224666,4,2,2,8,2,18
191224667,1,1,4,1,9,16
191224668,2,6,0,3,4,15
191224669,5,5,2,3,9,24
191224670,4,5,5,4,2,20
191224671,4,9,9,1,9,32
191224672,0,4,9,2,1,16
191224673,1,9,4,9,5,28
191224674,5,6,9,3,5,28
191224675,4,4,2,1,1,12
191224676,0,1,6,4,9,20
191224677,7,2,4,0,4,17
191224678,5,2,5,6,7,25
191224679,2,0,5,4,0,11
191224680,8,9,4,4,5,30
191224681,9,5,4,2,1,21
191224682,0,9,0,7,2,18
191224683,6,2,1,0,5,14
191224684,7,4,6,8,3,28
191224685,2,7,8,3,1,21
191224686,0,8,5,4,3,20
191224687,6,0,0,0,2,8
191224688,9,7,6,9,4,35
191224689,0,9,7,8,9,33
191224690,5,2,5,5,2,19
191224691,7,5,5,7,6,30
191224692,2,7,8,8,2,27
191224693,1,4,9,7,4,25
191224694,6,9,0,9,3,27
191224695,8,0,9,8,1,26
191224696,2,5,1,1,2,11
191224697,6,6,4,7,9,32
191224698,6,5,6,7,5,29
191224699,2,8,2,3,6,21
191224700,3,5,3,8,3,22
191224701,7,3,7,7,3,27
191224702,6,8,4,7,1,26
191224703,1,1,8,0,3,13
191224704,7,2,3,2,6,20
191224705,5,9,1,3,5,23
191224706,9,8,6,1,6,30
191224707,3,9,7,0,2,21
191224708,4,2,9,8,1,24
191224709,8,6,0,5,6,25
191224710,6,9,5,6,8,34
191224711,8,3,4,1,2,18
191224712,6,6,2,3,8,25
191224713,0,9,5,0,9,23
191224714,2,3,0,3,4,12
191224715,3,4,5,1,6,19
191224716,3,4,8,8,4,27
191224717,2,7,8,6,5,28
191224718,3,0,5,0,5,13
191224719,8,2,7,8,1,26
191224720,4,5,3,4,3,19
191224721,8,4,6,5,7,30
191224722,7,5,4,6,7,29
191224723,1,4,4,4,5,18
191224724,8,7,0,6,3,24
191224725,0,5,4,6,0,15
191224726,8,2,6,1,6,23
191224727,5,7,8,9,9,38
191224728,8,4,3,1,7,23
191224729,7,5,7,7,8,34
191224730,6,3,3,2,9,23
191224731,1,4,9,4,7,25
191224732,1,6,7,6,7,27
191224733,2,7,4,1,7,21
191224734,6,5,4,6,3,24
191224735,3,1,3,5,1,13
191224736,7,0,2,4,0,13
191224737,4,1,6,8,3,22
191224738,2,8,6,2,9,27
191224739,4,5,4,0,0,13
191224740,6,7,3,0,4,20
191224741,6,6,7,1,5,25
191224742,3,7,8,8,9,35
191224743,4,3,2,2,6,17
191224744,5,5,0,5,8,23
191224745,1,8,6,7,6,28
191224746,7,5,2,7,5,26
191224747,2,0,1,5,1,9
191224748,4,0,7,3,1,15
191224749,5,5,2,8,0,20
191224750,7,9,8,8,4,36
191224751,9,4,7,3,8,31
191224752,3,1,8,2,6,20
191224753,0,7,8,5,3,23
191224754,1,1,4,7,4,17
191224755,5,8,4,7,2,26
191224756,0,5,2,4,6,17
191224757,0,5,7,7,2,21
191224758,1,4,7,5,5,22
191224759,8,3,0,2,5,18
191224760,8,3,3,6,1,21
191224761,5,4,9,9,5,32
191224762,2,6,9,0,3,20
191224763,9,3,6,1,0,19
191224764,2,7,2,5,8,24
191224765,3,9,7,3,2,24
191224766,9,0,2,0,1,12
191224767,4,8,0,5,7,24
191224768,5,1,0,6,0,12
191224769,6,9,1,8,5,29
191224770,9,5,0,5,5,24
191224771,9,4,7,8,6,34
191224772,8,4,9,6,3,30
191224773,7,3,0,8,3,21
191224774,0,4,8,4,6,22
191224775,0,3,8,3,7,21
191224776,8,4,3,2,6,23
191224777,9,6,7,3,0,25
191224778,1,2,4,8,8,23
191224779,5,7,5,6,2,25
191224780,1,5,4,8,5,23
191224781,6,1,5,4,1,17
191224782,7,1,9,4,5,26
191224783,6,9,0,3,3,21
191224784,9,5,6,1,5,26
191224785,8,9,2,1,8,28
191224786,3,9,0,2,5,19
191224787,6,2,2,6,0,16
191224788,3,8,8,0,1,20
191224789,4,4,6,9,7,30
191224790,6,1,8,8,0,23
191224791,0,5,8,3,0,16
191224792,5,3,2,7,2,19
191224793,2,1,3,0,8,14
191224794,7,7,3,6,1,24
191224795,0,4,8,1,1,14
191224796,5,6,1,6,5,23
191224797,2,8,2,4,9,25
191224798,1,8,7,8,5,29
191224799,7,5,6,2,8,28
191224800,0,1,2,3,5,11
191224801,4,6,3,6,8,27
191224802,6,3,0,0,5,14
191224803,2,5,5,8,0,20
191224804,4,9,6,9,8,36
191224805,2,6,5,9,0,22
191224806,9,4,2,9,8,32
191224807,8,4,5,4,1,22
191224808,0,3,7,5,9,24
191224809,9,2,0,5,8,24
191224810,6,3,4,8,2,23
191224811,0,2,9,1,2,14
191224812,1,6,2,9,4,22
191224813,6,6,1,2,9,24
191224814,1,8,6,3,4,22
191224815,4,2,9,0,6,21
191224816,0,2,1,7,8,18
191224817,9,9,0,3,9,30
191224818,4,5,9,6,2,26
191224819,5,6,5,0,9,25
191224820,5,9,2,5,9,30
191224821,6,1,8,0,4,19
191224822,5,4,2,9,3,23
191224823,0,9,9,2,3,23
191224824,7,4,1,1,3,16
191224825,8,4,5,9,4,30
191224826,3,4,7,0,9,23
191224827,0,0,6,3,6,15
191224828,4,5,1,2,3,15
191224829,5,5,8,6,0,24
191224830,9,8,5,4,3,29
191224831,1,7,8,0,6,22
191224832,7,1,6,5,5,24
191224833,9,6,0,3,0,18
191224834,0,5,7,6,6,24
191224835,6,4,8,3,5,26
191224836,6,9,4,5,1,25
191224837,6,0,7,1,3,17
191224838,1,4,9,2,3,19
191224839,4,4,3,7,6,24
191224840,0,6,8,6,1,21
191224841,8,7,2,6,9,32
191224842,7,1,9,6,7,30
191224843,1,2,2,5,7,17
191224844,5,8,3,7,7,30
191224845,4,3,9,3,1,20
191224846,9,1,3,5,5,23
191224847,1,1,0,8,9,19
191224848,1,5,9,2,0,17
191224849,2,3,7,8,3,23
191224850,3,4,1,3,2,13
191224851,8,2,0,3,6,19
191224852,1,1,1,2,8,13
191224853,4,3,6,0,7,20
191224854,9,5,1,9,0,24
191224855,0,7,3,5,3,18
191224856,9,2,2,0,3,16
191224857,9,8,3,2,6,28
191224858,6,5,4,6,0,21
191224859,4,9,0,8,1,22
191224860,7,4,1,9,8,29
191224861,5,5,3,2,4,19
191224862,2,9,3,1,1,16
191224863,6,6,9,2,5,28
191224864,9,0,5,5,2,21
191224865,9,0,0,6,9,24
191224866,9,8,0,7,8,32
191224867,4,2,0,7,4,17
191224868,9,6,8,2,7,32
191224869,2,4,0,3,6,15
191224870,9,8,9,0,5,31
191224871,6,1,3,6,8,24
191224872,2,4,0,8,8,22
191224873,4,8,8,7,3,30
191224874,4,4,5,0,1,14
191224875,3,3,8,2,2,18
191224876,5,4,8,0,3,20
191224877,2,0,7,0,3,12
191224878,3,8,2,3,1,17
191224879,9,6,3,5,5,28
191224880,6,4,1,2,6,19
191224881,1,6,8,0,8,23
191224882,3,4,8,1,5,21
191224883,5,1,1,6,0,13
191224884,9,8,8,2,1,28
191224885,0,4,6,1,4,15
191224886,3,4,5,4,2,18
191224887,3,7,0,2,3,15
191224888,6,2,8,6,9,31
191224889,0,4,3,5,8,20
191224890,4,4,8,4,7,27
191224891,0,8,8,3,1,20
191224892,8,1,0,5,7,21
191224893,3,1,0,7,2,13
191224894,3,4,0,9,4,20
191224895,2,4,9,8,9,32
191224896,6,4,5,9,2,26
191224897,4,2,9,3,9,27
191224898,6,0,8,9,1,24
191224899,1,2,0,0,9,12
191224900,7,3,8,3,2,23
191224901,6,8,6,4,1,25
191224902,4,0,5,1,6,16
191224903,0,6,5,0,4,15
191224904,0,7,2,9,9,27
191224905,4,3,9,3,2,21
191224906,8,1,4,5,0,18
191224907,7,2,1,6,1,17
191224908,5,9,1,6,2,23
191224909,6,7,0,7,1,21
191224910,6,7,4,2,6,25
191224911,2,5,1,6,6,20
191224912,0,0,4,1,1,6
191224913,3,3,6,2,8,22
191224914,9,9,2,0,6,26
191224915,9,1,5,5,9,29
191224916,9,3,6,7,7,32
191224917,4,1,8,7,3,23
191224918,5,7,8,2,0,22
191224919,2,7,7,8,5,29
191224920,2,9,3,4,6,24
191224921,9,6,0,1,8,24
191224922,3,3,7,5,8,26
191224923,6,0,8,5,6,25
191224924,9,5,8,3,8,33
191224925,9,7,0,6,3,25
191224926,3,6,3,0,3,15
191224927,6,0,6,1,4,17
191224928,2,9,8,5,5,29
191224929,3,7,7,4,1,22
191224930,0,0,5,0,7,12
191224931,7,7,3,0,1,18
191224932,9,6,9,6,4,34
191224933,8,9,4,6,4,31
191224934,5,9,7,4,3,28
191224935,8,3,1,1,5,18
191224936,8,2,5,7,8,30
191224937,6,6,1,2,6,21
191224938,1,8,1,2,7,19
191224939,5,9,0,2,9,25
191224940,6,5,2,0,7,20
191224941,7,6,2,3,1,19
191224942,1,2,5,8,8,24
191224943,9,9,4,6,3,31
191224944,8,1,9,1,2,21
191224945,4,3,4,1,0,12
191224946,0,6,1,3,9,19
191224947,7,3,3,0,0,13
191224948,5,0,1,2,4,12
191224949,9,6,7,8,5,35
191224950,3,1,7,4,2,17
191224951,2,8,6,3,8,27
191224952,2,3,7,7,1,20
191224953,8,1,0,5,2,16
191224954,2,5,9,8,0,24
191224955,9,4,4,6,3,26
191224956,3,2,6,9,6,26
191224957,2,4,8,9,4,27
191224958,7,7,3,3,2,22
191224959,3,5,6,3,0,17
191224960,0,5,7,4,4,20
191224961,6,2,0,8,0,16
191224962,0,7,7,0,5,19
191224963,9,8,3,4,2,26
191224964,7,5,9,5,3,29
191224965,7,1,4,5,3,20
191224966,2,5,0,1,3,11
191224967,2,4,2,5,8,21
191224968,8,4,8,0,4,24
191224969,8,8,0,7,9,32
191224970,3,3,8,8,5,27
191224971,8,0,3,8,7,26
191224972,2,1,2,6,1,12
191224973,8,3,9,6,3,29
191224974,1,8,6,1,6,22
191224975,3,9,0,9,0,21
191224976,7,4,1,6,8,26
191224977,9,8,3,8,2,30
191224978,4,9,9,3,7,32
191224979,3,6,5,9,4,27
191224980,6,3,7,8,6,30
191224981,4,8,4,5,5,26
191224982,1,0,6,8,8,23
191224983,8,6,5,1,4,24
191224984,9,2,2,3,5,21
191224985,7,7,5,7,0,26
191224986,6,0,8,0,1,15
191224987,5,0,2,7,3,17
191224988,7,4,3,5,2,21
191224989,7,0,6,6,4,23
191224990,4,4,4,8,4,24
191224991,9,6,5,3,4,27
191224992,2,0,1,9,4,16
191224993,1,6,7,3,9,26
191224994,4,9,9,0,6,28
191224995,6,4,8,0,9,27
191224996,8,0,0,9,1,18
191224997,1,0,4,3,8,16
191224998,0,0,8,4,2,14
191224999,9,5,6,6,9,35
1912241000,2,5,6,6,6,25
1912241001,8,8,5,6,7,34
1912241002,4,0,9,0,1,14
1912241003,4,6,5,4,9,28
1912241004,2,3,3,5,9,22
1912241005,0,9,6,0,4,19
1912241006,9,1,3,6,8,27
1912241007,6,2,1,7,8,24
1912241008,8,7,3,3,4,25
1912241009,9,1,0,1,9,20
1912241010,4,5,0,4,4,17
1912241011,8,4,1,9,5,27
1912241012,2,0,5,2,4,13
1912241013,6,7,5,2,5,25
1912241014,9,4,3,7,0,23
1912241015,4,8,4,1,1,18
1912241016,1,8,6,4,6,25
1912241017,3,7,9,2,0,21
1912241018,1,2,2,0,4,9
1912241019,5,9,9,9,6,38
1912241020,9,3,4,0,7,23
1912241021,8,8,5,6,9,36
1912241022,4,4,3,2,8,21
1912241023,6,9,3,7,3,28
1912241024,7,0,5,1,0,13
1912241025,5,4,8,9,3,29
1912241026,8,3,2,5,5,23
1912241027,3,3,7,4,2,19
1912241028,4,2,5,1,9,21
1912241029,4,8,2,4,8,26
1912241030,5,0,3,4,6,18
1912241031,8,2,3,0,8,21
1912241032,5,7,3,6,6,27
1912241033,2,5,9,3,0,19
1912241034,5,6,5,9,8,33
1912241035,6,9,2,1,6,24
1912241036,9,6,4,6,2,27
1912241037,3,4,2,9,4,22
1912241038,9,4,3,7,6,29
1912241039,9,5,2,9,9,34
1912241040,2,5,8,7,5,27
1912241041,9,2,7,7,5,30
1912241042,9,6,9,3,6,33
1912241043,8,1,0,3,2,14
1912241044,4,8,6,8,1,27
1912241045,8,0,1,6,0,15
1912241046,9,1,4,7,7,28
1912241047,7,6,7,8,1,29
1912241048,2,9,9,3,2,25
1912241049,3,6,2,8,6,25
1912241050,8,2,1,4,8,23
1912241051,3,3,6,1,3,16
1912241052,2,2,3,1,8,16
1912241053,5,3,1,1,1,11
1912241054,8,8,4,8,7,35
1912241055,8,6,9,5,8,36
1912241056,0,8,3,3,5,19
1912241057,6,9,5,3,8,31
1912241058,5,5,9,0,4,23
1912241059,3,0,6,3,2,14
1912241060,5,0,8,8,1,22
1912241061,8,4,5,1,6,24
1912241062,7,0,2,1,1,11
1912241063,5,5,1,4,3,18
1912241064,4,1,9,3,2,19
1912241065,2,0,0,7,9,18
1912241066,3,0,4,7,4,18
1912241067,0,5,1,5,6,17
1912241068,0,9,1,6,7,23
1912241069,7,1,0,7,8,23
1912241070,7,0,3,2,7,19
1912241071,3,0,1,0,0,4
1912241072,0,4,8,0,4,16
1912241073,2,3,9,3,3,20
1912241074,8,7,5,7,9,36
1912241075,3,4,5,8,6,26
1912241076,4,7,0,3,2,16
1912241077,6,9,0,5,1,21
1912241078,4,1,0,7,4,16
1912241079,9,6,6,4,2,27
1912241080,4,3,1,9,7,24
1912241081,3,8,6,7,7,31
1912241082,1,9,9,4,9,32
1912241083,3,9,0,8,1,21
1912241084,3,2,9,7,1,22
1912241085,9,6,4,4,6,29
1912241086,5,2,1,5,8,21
1912241087,4,7,2,2,9,24
1912241088,5,4,3,9,8,29
1912241089,5,9,6,8,3,31
1912241090,3,4,1,9,6,23
1912241091,2,2,4,7,3,18
1912241092,9,8,1,9,7,34
1912241093,7,2,0,1,8,18
1912241094,2,4,2,1,3,12
1912241095,5,6,9,5,7,32
1912241096,0,2,5,2,2,11
1912241097,4,4,8,9,6,31
1912241098,0,5,0,6,5,16
1912241099,7,4,4,0,6,21
1912241100,0,3,5,5,5,18
1912241101,7,2,9,3,5,26
1912241102,2,5,1,6,3,17
1912241103,5,1,2,0,6,14
1912241104,8,6,2,1,9,26
1912241105,7,3,0,1,3,14
191225001,9,9,2,9,8,37
191225002,4,1,6,1,4,16
191225003,4,9,9,0,1,23
191225004,1,4,8,7,8,28
191225005,7,8,5,0,9,29
191225006,5,6,9,7,8,35
191225007,1,5,6,2,7,21
191225008,4,2,0,7,7,20
191225009,0,8,3,1,2,14
191225010,8,1,1,2,0,12
191225011,2,6,3,9,6,26
191225012,6,8,4,1,4,23
191225013,9,6,4,8,5,32
191225014,6,5,8,4,0,23
191225015,8,1,4,0,6,19
191225016,8,3,8,7,6,32
191225017,0,4,5,5,4,18
191225018,8,2,0,1,2,13
191225019,5,3,7,3,5,23
191225020,4,0,3,7,4,18
191225021,1,7,5,0,1,14
191225022,2,2,0,2,4,10
191225023,9,8,1,5,1,24
191225024,4,7,7,9,2,29
191225025,8,5,3,9,7,32
191225026,5,0,9,9,7,30
191225027,7,0,9,7,0,23
191225028,2,1,5,2,5,15
191225029,6,0,8,7,8,29
191225030,2,6,6,5,0,19
191225031,5,0,8,7,2,22
191225032,7,0,7,7,6,27
191225033,5,9,3,5,3,25
191225034,4,5,8,3,6,26
191225035,3,9,5,9,8,34
191225036,2,2,9,0,3,16
191225037,7,3,5,3,0,18
191225038,4,6,8,3,3,24
191225039,9,6,4,0,4,23
191225040,3,1,4,3,4,15
191225041,7,2,6,8,3,26
191225042,7,7,5,2,4,25
191225043,8,0,1,1,3,13
191225044,7,6,0,2,5,20
191225045,8,7,3,0,6,24
191225046,4,0,9,2,4,19
191225047,9,3,4,1,8,25
191225048,5,7,5,0,0,17
191225049,0,9,1,3,1,14
191225050,5,2,6,6,7,26
191225051,9,5,5,5,1,25
191225052,9,6,6,0,9,30
191225053,3,6,9,7,4,29
191225054,7,5,6,9,3,30
191225055,7,2,4,8,7,28
191225056,0,3,4,4,0,11
191225057,4,9,7,9,3,32
191225058,5,7,7,4,7,30
191225059,4,2,6,7,6,25
191225060,6,8,6,0,0,20
191225061,7,9,3,6,2,27
191225062,1,6,5,0,8,20
191225063,2,7,3,0,0,12
191225064,2,5,5,6,8,26
191225065,1,7,8,8,5,29
191225066,7,0,6,2,4,19
191225067,7,1,6,0,7,21
191225068,4,2,1,2,8,17
191225069,9,6,0,9,8,32
191225070,4,8,6,8,0,26
191225071,1,1,2,9,4,17
191225072,0,7,8,4,4,23
191225073,9,7,2,4,7,29
191225074,5,4,0,3,6,18
191225075,3,1,6,0,5,15
191225076,0,2,2,3,2,9
191225077,4,5,3,4,7,23
191225078,2,4,0,5,9,20
191225079,7,8,1,2,1,19
191225080,0,7,2,0,0,9
191225081,3,2,3,9,8,25
191225082,9,8,8,2,5,32
191225083,8,3,8,4,0,23
191225084,5,2,8,9,7,31
191225085,0,8,5,5,1,19
191225086,7,0,3,1,2,13
191225087,8,4,3,2,0,17
191225088,2,6,5,4,9,26
191225089,6,0,9,9,8,32
191225090,9,3,4,4,7,27
191225091,0,6,8,1,7,22
191225092,3,7,6,5,6,27
191225093,7,7,7,2,9,32
191225094,0,4,5,0,4,13
191225095,0,2,6,4,1,13
191225096,4,5,9,1,2,21
191225097,9,8,0,5,2,24
191225098,2,6,0,7,2,17
191225099,4,2,9,7,7,29
191225100,2,6,5,9,2,24
191225101,2,7,4,1,9,23
191225102,4,7,9,4,6,30
191225103,6,2,5,3,7,23
191225104,2,1,1,6,4,14
191225105,5,0,8,6,6,25
191225106,0,4,5,8,6,23
191225107,4,0,5,8,1,18
191225108,0,9,7,0,5,21
191225109,8,8,4,9,3,32
191225110,1,7,6,4,7,25
191225111,5,5,9,1,9,29
191225112,2,4,2,0,4,12
191225113,9,1,0,5,9,24
191225114,6,6,2,7,6,27
191225115,9,5,7,7,7,35
191225116,4,1,2,5,3,15
191225117,9,3,1,8,7,28
191225118,7,7,9,5,9,37
191225119,0,5,1,9,2,17
191225120,7,5,3,1,6,22
191225121,1,0,9,9,0,19
191225122,1,2,1,4,8,16
191225123,8,6,9,1,9,33
191225124,3,1,2,6,9,21
191225125,0,2,9,3,4,18
191225126,6,4,7,0,5,22
191225127,4,7,6,8,8,33
191225128,2,9,5,9,4,29
191225129,2,4,2,5,5,18
191225130,1,7,4,6,8,26
191225131,8,9,0,0,3,20
191225132,2,4,8,5,1,20
191225133,6,0,9,7,4,26
191225134,3,4,0,2,4,13
191225135,3,2,9,3,3,20
191225136,3,6,9,3,6,27
191225137,1,2,2,5,9,19
191225138,8,9,7,7,0,31
191225139,4,7,2,3,9,25
191225140,3,9,4,0,8,24
191225141,6,6,0,7,5,24
191225142,0,4,6,4,5,19
191225143,3,8,0,8,8,27
191225144,1,8,8,4,9,30
191225145,7,5,5,3,5,25
191225146,5,0,9,4,8,26
191225147,5,4,1,4,8,22
191225148,1,0,5,9,4,19
191225149,7,7,6,4,8,32
191225150,8,6,2,7,6,29
191225151,3,4,9,9,4,29
191225152,5,9,8,8,9,39
191225153,9,9,9,1,9,37
191225154,7,7,0,2,3,19
191225155,7,9,5,9,7,37
191225156,8,0,7,7,4,26
191225157,9,6,2,4,6,27
191225158,7,8,7,4,0,26
191225159,7,1,0,3,9,20
191225160,8,2,2,6,2,20
191225161,5,9,5,8,5,32
191225162,4,9,0,2,1,16
191225163,0,8,6,2,7,23
191225164,3,7,5,4,2,21
191225165,2,8,5,2,5,22
191225166,0,1,9,3,0,13
191225167,4,8,0,4,1,17
191225168,3,8,5,6,6,28
191225169,6,4,2,4,2,18
191225170,8,8,8,5,2,31
191225171,3,0,4,5,1,13
191225172,2,2,3,3,9,19
191225173,5,0,9,3,8,25
191225174,2,8,9,3,6,28
191225175,8,2,7,7,1,25
191225176,4,2,2,5,9,22
191225177,2,9,4,5,5,25
191225178,7,2,4,3,0,16
191225179,7,8,6,4,5,30
191225180,8,9,0,5,5,27
191225181,3,2,5,9,8,27
191225182,5,0,1,0,7,13
191225183,0,8,2,3,7,20
191225184,2,3,8,3,3,19
191225185,1,4,7,8,4,24
191225186,8,3,1,6,7,25
191225187,9,3,8,6,3,29
191225188,8,9,9,5,5,36
191225189,2,0,7,9,3,21
191225190,1,0,1,3,6,11
191225191,0,4,9,1,6,20
191225192,8,0,1,0,8,17
191225193,3,0,5,8,5,21
191225194,8,6,2,7,0,23
191225195,0,0,7,2,7,16
191225196,9,5,9,0,4,27
191225197,9,1,3,5,7,25
191225198,4,0,3,3,6,16
191225199,2,1,5,0,4,12
191225200,5,5,5,1,6,22
191225201,5,1,3,8,3,20
191225202,2,4,4,6,7,23
191225203,6,1,4,7,9,27
191225204,3,4,7,6,1,21
191225205,2,8,3,4,4,21
191225206,9,3,6,7,5,30
191225207,9,1,9,3,6,28
191225208,7,1,2,6,1,17
191225209,5,3,4,7,4,23
191225210,8,8,9,5,1,31
191225211,0,4,8,8,3,23
191225212,3,9,5,6,2,25
191225213,8,1,5,4,7,25
191225214,2,9,4,4,1,20
191225215,2,7,5,0,5,19
191225216,9,0,6,0,0,15
191225217,9,2,9,9,1,30
191225218,7,8,8,2,8,33
191225219,3,0,1,3,4,11
191225220,3,1,2,4,3,13
191225221,4,5,6,1,9,25
191225222,7,7,2,2,5,23
191225223,4,7,9,1,9,30
191225224,4,2,3,2,2,13
191225225,4,4,1,0,2,11
191225226,0,4,3,6,3,16
191225227,2,4,7,0,6,19
191225228,5,8,7,2,3,25
191225229,3,7,9,4,9,32
191225230,4,9,6,9,0,28
191225231,9,4,3,1,8,25
191225232,0,9,1,4,8,22
191225233,8,4,2,0,1,15
191225234,6,0,0,5,0,11
191225235,8,8,9,5,8,38
191225236,2,4,4,5,3,18
191225237,3,0,1,1,5,10
191225238,1,4,0,0,6,11
191225239,9,9,2,4,1,25
191225240,5,5,2,9,0,21
191225241,9,1,9,4,9,32
191225242,4,6,1,6,2,19
191225243,6,8,7,8,9,38
191225244,1,8,1,3,6,19
191225245,0,7,0,2,2,11
191225246,6,9,5,5,3,28
191225247,5,0,6,8,8,27
191225248,4,4,0,2,0,10
191225249,1,9,8,5,8,31
191225250,5,7,4,3,9,28
191225251,0,0,9,0,8,17
191225252,0,4,3,9,9,25
191225253,4,4,6,5,6,25
191225254,1,1,8,9,1,20
191225255,7,7,3,7,5,29
191225256,9,1,7,7,4,28
191225257,6,2,4,1,6,19
191225258,7,4,0,8,6,25
191225259,8,9,6,4,6,33
191225260,7,8,5,4,9,33
191225261,4,8,3,9,7,31
191225262,2,6,3,1,6,18
191225263,2,8,0,1,9,20
191225264,6,9,3,5,2,25
191225265,1,7,7,3,4,22
191225266,7,4,3,0,6,20
191225267,0,1,8,6,8,23
191225268,1,1,3,0,4,9
191225269,6,7,1,3,8,25
191225270,3,1,4,1,4,13
191225271,1,0,8,7,3,19
191225272,6,1,2,2,3,14
191225273,3,8,7,5,3,26
191225274,4,5,8,5,0,22
191225275,0,1,2,9,0,12
191225276,0,5,8,6,2,21
191225277,5,7,7,4,9,32
191225278,3,7,8,9,2,29
191225279,9,6,5,0,0,20
191225280,6,0,9,1,8,24
191225281,0,9,1,8,7,25
191225282,1,8,9,6,9,33
191225283,7,5,6,4,6,28
191225284,2,3,2,5,5,17
191225285,0,8,4,1,5,18
191225286,0,5,4,2,2,13
191225287,9,6,1,9,2,27
191225288,2,5,7,5,0,19
191225289,9,9,2,8,2,30
191225290,8,4,4,7,4,27
191225291,1,1,1,6,0,9
191225292,8,5,6,3,0,22
191225293,2,8,4,2,7,23
191225294,1,9,1,3,3,17
191225295,9,7,8,5,7,36
191225296,6,8,7,4,0,25
191225297,4,5,3,3,8,23
191225298,0,4,2,8,4,18
191225299,2,8,3,0,9,22
191225300,0,8,0,6,4,18
191225301,5,5,1,4,7,22
191225302,9,5,1,5,6,26
191225303,6,7,0,4,6,23
191225304,1,9,3,2,1,16
191225305,1,5,2,6,9,23
191225306,9,2,3,8,7,29
191225307,9,0,5,8,3,25
191225308,3,7,9,7,6,32
191225309,7,3,1,3,8,22
191225310,0,3,3,2,6,14
191225311,8,0,0,3,9,20
191225312,9,8,5,1,5,28
191225313,5,9,9,3,0,26
191225314,4,7,7,1,0,19
191225315,4,3,8,0,9,24
191225316,8,1,0,8,1,18
191225317,1,0,9,7,0,17
191225318,1,6,2,4,5,18
191225319,8,8,6,3,5,30
191225320,8,4,7,3,6,28
191225321,0,1,1,6,8,16
191225322,7,1,7,4,7,26
191225323,6,5,3,4,1,19
191225324,0,4,9,4,8,25
191225325,1,2,2,9,5,19
191225326,2,7,6,1,9,25
191225327,5,8,1,4,7,25
191225328,4,7,4,9,6,30
191225329,9,5,1,6,9,30
191225330,8,3,8,1,9,29
191225331,3,1,8,1,3,16
191225332,0,1,5,8,4,18
191225333,0,5,8,9,7,29
191225334,0,4,2,5,6,17
191225335,3,5,5,8,2,23
191225336,3,8,8,1,6,26
191225337,5,4,8,7,8,32
191225338,3,0,3,6,1,13
191225339,5,7,2,7,7,28
191225340,9,0,5,2,2,18
191225341,7,7,2,0,5,21
191225342,9,0,1,4,0,14
191225343,1,3,3,4,4,15
191225344,3,1,7,1,7,19
191225345,3,8,2,3,3,19
191225346,6,5,3,7,3,24
191225347,0,8,1,9,4,22
191225348,4,1,7,5,4,21
191225349,3,1,5,2,5,16
191225350,3,9,9,6,0,27
191225351,1,2,2,8,8,21
191225352,6,4,3,0,1,14
191225353,9,6,9,1,3,28
191225354,2,4,0,6,7,19
191225355,1,4,2,0,8,15
191225356,9,9,7,0,2,27
191225357,5,2,9,7,6,29
191225358,4,4,0,0,5,13
191225359,6,4,9,5,2,26
191225360,9,5,9,6,4,33
191225361,9,7,0,8,1,25
191225362,8,4,9,3,0,24
191225363,6,3,4,4,1,18
191225364,2,4,7,1,1,15
191225365,9,6,6,2,3,26
191225366,4,6,6,1,4,21
191225367,2,0,2,2,8,14
191225368,6,7,0,1,6,20
191225369,1,7,2,2,8,20
191225370,0,3,7,7,7,24
191225371,2,2,6,9,4,23
191225372,2,4,9,9,9,33
191225373,0,8,8,9,2,27
191225374,4,4,6,9,6,29
191225375,7,7,1,7,1,23
191225376,9,7,0,9,7,32
191225377,8,8,2,6,8,32
191225378,0,8,8,5,0,21
191225379,3,8,6,2,4,23
191225380,2,0,3,7,3,15
191225381,7,2,5,2,7,23
191225382,8,5,6,3,4,26
191225383,0,9,8,2,4,23
191225384,1,1,1,2,9,14
191225385,9,4,4,9,2,28
191225386,9,8,3,9,8,37
191225387,1,6,4,5,0,16
191225388,6,6,5,6,6,29
191225389,8,1,4,6,5,24
191225390,3,7,1,8,1,20
191225391,3,6,8,9,8,34
191225392,9,3,2,5,1,20
191225393,6,5,0,1,6,18
191225394,2,1,9,9,8,29
191225395,5,2,0,0,0,7
191225396,0,8,1,4,2,15
191225397,9,2,0,9,8,28
191225398,7,5,8,2,0,22
191225399,7,2,3,8,5,25
191225400,2,7,0,4,4,17
191225401,5,3,7,4,6,25
191225402,8,2,0,5,8,23
191225403,1,1,5,6,5,18
191225404,6,6,1,4,3,20
191225405,0,8,0,2,0,10
191225406,9,7,8,8,4,36
191225407,6,3,8,3,9,29
191225408,5,7,4,2,7,25
191225409,9,5,9,8,9,40
191225410,3,1,1,5,0,10
191225411,3,9,3,2,3,20
191225412,2,1,2,3,8,16
191225413,7,2,1,7,9,26
191225414,7,4,4,5,6,26
191225415,6,0,0,2,5,13
191225416,4,2,9,8,7,30
191225417,2,0,1,6,2,11
191225418,3,1,9,6,7,26
191225419,7,1,5,1,1,15
191225420,7,2,5,2,6,22
191225421,1,5,5,1,3,15
191225422,6,3,7,7,0,23
191225423,2,3,2,0,7,14
191225424,5,7,7,6,8,33
191225425,0,9,3,8,6,26
191225426,1,6,5,1,5,18
191225427,7,9,3,3,8,30
191225428,6,3,8,6,8,31
191225429,8,8,7,8,1,32
191225430,8,5,8,7,2,30
191225431,8,2,0,6,5,21
191225432,9,9,2,3,1,24
191225433,4,7,8,0,4,23
191225434,4,0,1,1,6,12
191225435,3,1,7,4,1,16
191225436,2,3,2,9,4,20
191225437,0,9,8,3,1,21
191225438,4,3,5,4,3,19
191225439,4,8,4,4,5,25
191225440,4,2,0,0,6,12
191225441,4,8,6,2,2,22
191225442,8,8,0,9,9,34
191225443,8,9,7,5,7,36
191225444,0,5,3,0,8,16
191225445,0,0,0,9,9,18
191225446,4,6,7,3,0,20
191225447,5,4,9,8,9,35
191225448,1,4,8,6,7,26
191225449,6,1,3,9,9,28
191225450,3,9,3,8,7,30
191225451,0,4,0,1,6,11
191225452,9,4,5,9,7,34
191225453,5,5,8,3,8,29
191225454,0,4,8,6,1,19
191225455,5,1,2,8,9,25
191225456,5,9,8,4,1,27
191225457,8,4,5,0,4,21
191225458,0,4,3,1,2,10
191225459,7,4,2,5,9,27
191225460,1,9,3,0,2,15
191225461,7,3,7,8,6,31
191225462,3,2,9,3,7,24
191225463,2,6,9,5,8,30
191225464,0,3,5,9,6,23
191225465,4,6,4,8,6,28
191225466,8,0,7,2,3,20
191225467,8,3,7,2,2,22
191225468,0,9,4,9,1,23
191225469,0,0,0,9,1,10
191225470,7,8,1,9,8,33
191225471,2,6,0,1,2,11
191225472,4,9,6,9,6,34
191225473,3,9,7,2,9,30
191225474,6,1,7,0,4,18
191225475,5,5,4,0,7,21
191225476,7,4,6,9,5,31
191225477,1,4,2,1,8,16
191225478,2,1,9,4,4,20
191225479,0,1,6,0,7,14
191225480,4,4,7,9,8,32
191225481,0,3,6,6,0,15
191225482,7,6,0,7,2,22
191225483,3,8,6,9,9,35
191225484,8,0,1,9,2,20
191225485,5,8,0,5,8,26
191225486,9,7,6,2,7,31
191225487,9,7,6,7,1,30
191225488,3,1,4,4,6,18
191225489,4,9,1,6,2,22
191225490,2,3,4,4,6,19
191225491,7,8,9,1,2,27
191225492,7,7,7,8,0,29
191225493,5,3,6,7,9,30
191225494,9,1,7,0,5,22
191225495,9,2,6,0,9,26
191225496,3,2,1,9,0,15
191225497,9,9,4,0,5,27
191225498,8,9,7,3,4,31
191225499,4,0,9,4,1,18
191225500,8,6,4,9,5,32
191225501,6,4,7,2,8,27
191225502,6,0,5,6,7,24
191225503,7,3,6,1,5,22
191225504,5,5,9,3,8,30
191225505,1,2,6,7,5,21
191225506,7,4,7,0,5,23
191225507,4,6,1,7,4,22
191225508,8,5,0,8,5,26
191225509,3,6,0,4,4,17
191225510,6,2,3,1,0,12
191225511,6,1,7,9,1,24
191225512,2,7,0,6,3,18
191225513,5,1,2,1,2,11
191225514,9,7,1,2,4,23
191225515,7,3,8,7,3,28
191225516,6,7,6,8,9,36
191225517,1,1,3,3,7,15
191225518,8,4,8,3,9,32
191225519,5,0,8,6,7,26
191225520,5,3,6,5,4,23
191225521,6,2,1,6,2,17
191225522,5,2,7,2,6,22
191225523,5,9,1,6,7,28
191225524,8,5,6,2,9,30
191225525,1,7,8,5,8,29
191225526,7,5,5,4,7,28
191225527,2,3,7,3,2,17
191225528,0,4,3,2,5,14
191225529,5,7,5,8,8,33
191225530,7,6,3,1,8,25
191225531,1,8,7,4,6,26
191225532,2,1,8,6,1,18
191225533,4,9,0,2,5,20
191225534,2,1,3,1,5,12
191225535,2,3,0,3,6,14
191225536,1,6,9,6,5,27
191225537,6,4,1,3,2,16
191225538,7,5,8,8,4,32
191225539,0,5,6,7,0,18
191225540,8,0,9,2,0,19
191225541,8,1,2,6,6,23
191225542,8,5,2,5,6,26
191225543,9,1,6,1,6,23
191225544,6,8,3,8,9,34
191225545,2,0,3,6,8,19
191225546,6,5,2,4,9,26
191225547,5,7,4,1,0,17
191225548,8,4,5,1,3,21
191225549,2,6,5,8,4,25
191225550,0,7,7,8,3,25
191225551,0,3,7,8,4,22
191225552,7,3,6,6,8,30
191225553,7,7,4,6,6,30
191225554,7,6,3,3,9,28
191225555,1,9,7,2,8,27
191225556,5,6,1,1,0,13
191225557,9,7,7,1,2,26
191225558,1,9,0,1,9,20
191225559,2,7,5,9,7,30
191225560,9,9,6,8,2,34
191225561,5,5,8,7,4,29
191225562,5,8,6,7,9,35
191225563,3,2,0,8,3,16
191225564,6,8,8,0,6,28
191225565,1,5,9,1,3,19
191225566,0,2,9,0,8,19
191225567,5,3,6,6,2,22
191225568,5,4,1,9,3,22
191225569,1,4,6,7,6,24
191225570,4,4,9,4,1,22
191225571,4,6,3,0,5,18
191225572,9,5,3,1,0,18
191225573,5,9,6,1,6,27
191225574,1,2,0,7,7,17
191225575,9,5,5,6,5,30
191225576,3,4,8,0,3,18
191225577,7,6,2,1,7,23
191225578,2,2,0,9,5,18
191225579,2,9,6,6,5,28
191225580,0,2,5,1,5,13
191225581,3,6,7,6,5,27
191225582,4,9,5,3,0,21
191225583,3,6,9,3,5,26
191225584,3,1,3,2,0,9
191225585,0,1,0,7,3,11
191225586,6,3,9,0,3,21
191225587,7,1,8,1,5,22
191225588,7,2,2,5,0,16
191225589,5,0,7,8,6,26
191225590,6,6,7,3,9,31
191225591,8,2,9,7,5,31
191225592,7,9,4,9,3,32
191225593,3,4,5,6,1,19
191225594,5,1,9,9,9,33
191225595,9,2,4,2,1,18
191225596,7,3,2,5,4,21
191225597,1,4,8,1,1,15
191225598,1,9,6,5,2,23
191225599,8,4,3,5,5,25
191225600,9,1,1,6,1,18
191225601,6,2,6,4,0,18
191225602,1,3,3,7,9,23
191225603,3,0,7,3,6,19
191225604,8,5,5,2,3,23
191225605,2,7,4,4,3,20
191225606,1,0,5,6,8,20
191225607,3,6,8,3,4,24
191225608,7,1,4,2,1,15
191225609,1,6,2,3,3,15
191225610,1,0,6,0,5,12
191225611,7,5,1,9,3,25
191225612,9,9,3,0,2,23
191225613,0,8,2,1,7,18
191225614,4,7,4,5,9,29
191225615,2,6,7,1,1,17
191225616,6,6,0,0,6,18
191225617,0,8,7,1,6,22
191225618,1,8,5,7,7,28
191225619,9,0,9,3,1,22
191225620,9,0,2,8,8,27
191225621,3,2,4,3,3,15
191225622,7,6,5,6,5,29
191225623,1,7,1,7,2,18
191225624,8,0,3,5,0,16
191225625,9,0,4,1,8,22
191225626,9,7,1,4,3,24
191225627,1,2,5,3,2,13
191225628,2,3,3,7,9,24
191225629,1,8,1,9,2,21
191225630,4,9,2,6,5,26
191225631,4,0,5,2,8,19
191225632,9,5,1,6,2,23
191225633,9,0,8,3,4,24
191225634,1,4,4,4,8,21
191225635,4,8,6,9,6,33
191225636,2,6,5,9,3,25
191225637,9,9,1,6,5,30
191225638,7,1,0,1,7,16
191225639,0,3,0,7,7,17
191225640,6,3,1,1,9,20
191225641,7,7,0,3,2,19
191225642,5,1,0,0,4,10
191225643,9,6,6,4,4,29
191225644,1,4,5,9,1,20
191225645,4,6,2,4,3,19
191225646,2,9,2,8,2,23
191225647,2,4,8,0,9,23
191225648,0,5,0,0,9,14
191225649,5,6,9,9,7,36
191225650,3,3,2,0,0,8
191225651,4,5,0,1,3,13
191225652,0,9,9,1,5,24
191225653,3,5,8,2,6,24
191225654,3,6,2,7,6,24
191225655,0,3,1,4,2,10
191225656,3,0,4,8,7,22
191225657,7,4,3,6,2,22
191225658,7,7,8,6,8,36
191225659,2,8,1,1,5,17
191225660,8,4,6,6,7,31
191225661,8,1,8,5,8,30
191225662,4,3,5,7,0,19
191225663,0,0,2,1,6,9
191225664,5,1,6,9,4,25
191225665,8,2,1,7,0,18
191225666,0,0,5,7,0,12
191225667,8,7,4,4,3,26
191225668,1,6,6,5,6,24
191225669,7,4,1,0,1,13
191225670,7,9,9,8,2,35
191225671,0,9,9,9,6,33
191225672,6,4,8,0,1,19
191225673,6,8,7,8,2,31
191225674,1,8,4,1,3,17
191225675,6,6,7,1,3,23
191225676,5,9,5,7,6,32
191225677,6,5,2,4,7,24
191225678,0,2,8,5,5,20
191225679,4,3,9,7,3,26
191225680,8,2,9,2,5,26
191225681,5,2,2,6,7,22
191225682,7,0,9,7,3,26
191225683,0,4,7,7,7,25
191225684,9,6,9,5,8,37
191225685,4,0,2,7,3,16
191225686,0,7,3,7,3,20
191225687,9,0,5,2,9,25
191225688,8,4,8,4,7,31
191225689,5,2,3,7,1,18
191225690,0,4,1,8,8,21
191225691,2,4,2,5,0,13
191225692,5,3,6,3,8,25
191225693,6,0,6,6,6,24
191225694,2,5,4,6,8,25
191225695,9,9,3,4,0,25
191225696,7,5,9,8,6,35
191225697,8,7,7,2,6,30
191225698,6,7,4,7,7,31
191225699,3,8,2,1,2,16
191225700,9,7,7,9,7,39
191225701,0,5,2,3,4,14
191225702,1,1,9,1,7,19
191225703,9,1,6,0,5,21
191225704,0,4,0,6,9,19
191225705,9,9,5,6,0,29
191225706,6,1,2,4,2,15
191225707,4,9,3,6,7,29
191225708,0,9,6,4,7,26
191225709,5,9,5,4,8,31
191225710,7,4,3,8,7,29
191225711,9,0,6,1,4,20
191225712,8,4,2,4,6,24
191225713,5,0,4,1,2,12
191225714,3,4,6,7,8,28
191225715,1,0,6,9,2,18
191225716,1,1,1,7,0,10
191225717,7,8,5,5,4,29
191225718,3,7,5,9,9,33
191225719,8,0,2,7,8,25
191225720,6,5,6,9,2,28
191225721,0,1,5,2,4,12
191225722,2,9,3,1,5,20
191225723,1,9,0,8,8,26
191225724,7,9,4,7,7,34
191225725,7,2,7,4,7,27
191225726,6,2,9,0,8,25
191225727,0,2,4,9,1,16
191225728,8,8,0,1,4,21
191225729,9,0,7,7,8,31
191225730,1,0,2,7,6,16
191225731,4,5,3,1,4,17
191225732,7,0,9,7,2,25
191225733,2,8,4,1,2,17
191225734,7,6,2,4,4,23
191225735,0,6,2,7,9,24
191225736,3,1,6,6,9,25
191225737,2,2,9,5,6,24
191225738,9,1,2,1,0,13
191225739,8,8,8,3,4,31
191225740,2,0,9,0,8,19
191225741,4,7,2,9,4,26
191225742,8,6,5,8,6,33
191225743,7,7,3,8,0,25
191225744,5,0,2,8,8,23
191225745,2,5,0,3,3,13
191225746,7,1,1,9,0,18
191225747,9,0,0,6,0,15
191225748,9,8,3,0,3,23
191225749,1,3,0,5,7,16
191225750,2,8,3,8,4,25
191225751,5,5,9,0,8,27
191225752,3,8,3,4,2,20
191225753,2,8,9,0,4,23
191225754,5,3,4,7,3,22
191225755,7,5,9,7,6,34
191225756,7,3,2,8,2,22
191225757,1,0,8,6,9,24
191225758,5,1,1,5,1,13
191225759,0,5,6,9,4,24
191225760,1,3,7,0,1,12
191225761,5,7,8,2,6,28
191225762,0,6,2,9,3,20
191225763,5,8,3,6,5,27
191225764,2,3,1,3,9,18
191225765,7,8,1,4,1,21
191225766,2,3,2,5,0,12
191225767,2,9,4,6,4,25
191225768,2,8,4,5,3,22
191225769,1,8,0,8,6,23
191225770,9,3,9,1,9,31
191225771,2,8,6,7,7,30
191225772,5,0,0,3,9,17
191225773,6,1,6,0,9,22
191225774,1,4,7,3,1,16
191225775,1,2,3,2,5,13
191225776,2,9,9,5,8,33
191225777,1,9,5,5,8,28
191225778,2,3,7,2,6,20
191225779,0,5,6,5,7,23
191225780,1,3,4,3,5,16
191225781,6,6,8,9,3,32
191225782,3,4,1,9,2,19
191225783,8,6,3,9,5,31
191225784,1,0,1,3,0,5
191225785,3,0,6,2,3,14
191225786,7,7,5,5,9,33
191225787,3,7,4,2,4,20
191225788,3,1,2,3,8,17
191225789,1,8,5,2,3,19
191225790,9,0,2,4,5,20
191225791,7,7,8,0,0,22
191225792,6,9,2,6,2,25
191225793,7,8,9,0,2,26
191225794,2,7,7,1,8,25
191225795,7,1,8,7,2,25
191225796,2,6,7,6,7,28
191225797,0,9,4,6,8,27
191225798,6,6,6,1,2,21
191225799,4,3,5,5,7,24
191225800,4,0,2,6,7,19
191225801,1,4,2,6,5,18
191225802,8,2,1,6,3,20
191225803,6,3,7,2,2,20
191225804,4,6,5,7,8,30
191225805,9,5,5,3,0,22
191225806,4,8,2,6,2,22
191225807,3,7,6,1,9,26
191225808,7,9,3,6,8,33
191225809,2,6,2,2,4,16
191225810,2,1,6,6,1,16
191225811,6,5,7,5,6,29
191225812,9,5,1,9,9,33
191225813,3,7,1,8,4,23
191225814,7,6,1,9,6,29
191225815,2,5,5,3,4,19
191225816,8,1,9,6,1,25
191225817,6,2,1,0,4,13
191225818,9,0,9,2,0,20
191225819,1,8,4,5,4,22
191225820,5,3,4,5,0,17
191225821,6,9,0,0,1,16
191225822,0,0,1,1,2,4
191225823,8,5,4,2,0,19
191225824,8,4,7,4,2,25
191225825,9,5,7,9,5,35
191225826,5,0,8,1,1,15
191225827,0,0,2,5,2,9
191225828,9,5,7,9,6,36
191225829,7,1,6,4,1,19
191225830,8,5,8,5,8,34
191225831,0,8,9,5,3,25
191225832,6,2,8,5,8,29
191225833,4,6,9,5,8,32
191225834,7,1,1,2,1,12
191225835,3,3,5,9,3,23
191225836,9,9,4,4,1,27
191225837,8,8,0,2,1,19
191225838,4,1,8,6,7,26
191225839,0,4,2,3,2,11
191225840,6,6,7,5,1,25
191225841,8,8,6,1,2,25
191225842,4,9,5,6,0,24
191225843,2,7,9,9,2,29
191225844,0,2,1,7,5,15
191225845,7,4,1,5,3,20
191225846,3,4,5,1,4,17
191225847,7,0,0,0,0,7
191225848,8,1,3,3,5,20
191225849,5,4,6,7,2,24
191225850,3,3,3,1,9,19
191225851,2,0,4,8,4,18
191225852,6,6,4,2,3,21
191225853,4,6,1,0,8,19
191225854,6,5,6,8,4,29
191225855,9,5,6,1,1,22
191225856,0,5,9,6,8,28
191225857,6,4,9,1,7,27
191225858,6,1,9,9,4,29
191225859,1,0,5,2,0,8
191225860,7,2,0,7,4,20
191225861,3,7,1,7,8,26
191225862,0,8,9,6,2,25
191225863,3,1,8,6,2,20
191225864,4,9,8,1,5,27
191225865,6,2,8,1,2,19
191225866,0,3,8,1,1,13
191225867,4,6,2,9,5,26
191225868,4,5,1,8,2,20
191225869,0,9,5,8,6,28
191225870,1,5,8,4,9,27
191225871,1,8,2,7,7,25
191225872,8,6,4,2,2,22
191225873,0,1,2,9,5,17
191225874,1,3,0,0,1,5
191225875,0,2,9,5,0,16
191225876,4,2,8,5,9,28
191225877,7,9,4,0,6,26
191225878,2,6,2,0,7,17
191225879,4,6,1,4,2,17
191225880,2,0,5,7,7,21
191225881,3,2,5,8,3,21
191225882,4,2,4,6,1,17
191225883,2,4,0,1,1,8
191225884,3,7,2,1,8,21
191225885,5,9,3,9,6,32
191225886,5,7,6,2,2,22
191225887,6,4,2,6,5,23
191225888,0,3,0,6,9,18
191225889,0,4,4,5,6,19
191225890,6,3,7,9,5,30
191225891,3,4,5,6,4,22
191225892,7,1,0,7,5,20
191225893,1,2,4,9,8,24
191225894,4,8,8,3,0,23
191225895,8,8,2,7,8,33
191225896,3,4,7,9,5,28
191225897,2,5,1,7,0,15
191225898,7,9,2,7,9,34
191225899,4,5,4,9,9,31
191225900,2,4,7,3,1,17
191225901,8,9,1,6,9,33
191225902,4,7,9,3,2,25
191225903,0,7,7,4,9,27
191225904,2,9,0,8,3,22
191225905,9,3,1,7,7,27
191225906,4,3,8,5,0,20
191225907,0,6,7,7,2,22
191225908,6,8,3,8,4,29
191225909,3,8,2,4,3,20
191225910,6,3,9,8,2,28
191225911,3,4,9,7,4,27
191225912,5,4,8,4,0,21
191225913,1,6,6,4,2,19
191225914,5,2,5,4,9,25
191225915,4,8,3,1,0,16
191225916,2,5,9,8,8,32
191225917,4,2,0,4,4,14
191225918,3,6,6,8,6,29
191225919,2,1,7,3,5,18
191225920,7,0,8,0,3,18
191225921,1,2,3,0,8,14
191225922,6,9,7,1,6,29
191225923,2,3,1,8,6,20
191225924,4,3,0,2,4,13
191225925,8,6,8,6,7,35
191225926,5,8,1,5,4,23
191225927,4,5,6,6,9,30
191225928,3,0,6,8,4,21
191225929,5,1,7,1,2,16
191225930,2,5,2,6,4,19
191225931,8,0,9,8,2,27
191225932,3,9,1,8,3,24
191225933,7,7,7,6,4,31
191225934,6,0,2,9,5,22
191225935,0,8,0,4,1,13
191225936,7,6,2,6,1,22
191225937,7,9,8,0,3,27
191225938,5,4,4,4,3,20
191225939,7,4,0,8,4,23
191225940,2,3,1,2,1,9
191225941,6,6,2,7,3,24
191225942,0,4,8,1,2,15
191225943,8,3,5,6,4,26
191225944,8,1,8,3,1,21
191225945,5,5,3,1,4,18
191225946,1,4,6,8,7,26
191225947,1,7,3,9,7,27
191225948,4,8,4,4,8,28
191225949,3,0,2,0,3,8
191225950,1,5,2,1,3,12
191225951,3,3,4,8,3,21
191225952,3,8,6,4,3,24
191225953,9,6,8,3,1,27
191225954,3,8,9,0,9,29
191225955,6,4,4,7,7,28
191225956,4,1,8,3,8,24
191225957,1,2,1,8,3,15
191225958,3,3,7,7,6,26
191225959,0,9,3,0,6,18
191225960,9,1,7,5,3,25
191225961,8,8,1,6,5,28
191225962,6,7,5,7,7,32
191225963,3,6,2,2,2,15
191225964,0,7,3,3,4,17
191225965,1,9,0,9,7,26
191225966,4,8,5,2,8,27
191225967,4,2,5,4,0,15
191225968,4,9,5,2,8,28
191225969,1,9,0,2,2,14
191225970,7,6,5,5,0,23
191225971,3,3,7,7,8,28
191225972,8,2,0,2,0,12
191225973,4,6,0,4,7,21
191225974,4,9,7,2,5,27
191225975,1,0,8,6,1,16
191225976,8,8,5,3,4,28
191225977,9,3,0,7,4,23
191225978,8,8,5,9,2,32
191225979,3,0,4,2,7,16
191225980,6,5,1,5,8,25
191225981,6,8,5,4,4,27
191225982,3,4,3,1,5,16
191225983,9,7,3,3,6,28
191225984,9,0,0,5,1,15
191225985,3,0,3,7,1,14
191225986,2,4,5,3,5,19
191225987,1,4,5,0,5,15
191225988,0,9,5,7,1,22
191225989,2,3,4,4,7,20
191225990,1,9,6,4,2,22
191225991,7,5,6,9,6,33
191225992,3,9,3,9,5,29
191225993,0,0,1,2,3,6
191225994,6,2,0,1,1,10
191225995,6,1,9,8,0,24
191225996,6,7,4,5,1,23
191225997,4,8,5,9,8,34
191225998,2,0,9,7,7,25
191225999,0,9,0,3,6,18
1912251000,7,5,3,9,2,26
1912251001,7,8,3,1,9,28
1912251002,9,6,5,5,3,28
1912251003,2,1,3,6,5,17
1912251004,7,5,6,9,2,29
1912251005,3,0,8,5,9,25
1912251006,0,0,6,2,9,17
1912251007,3,4,7,7,3,24
1912251008,2,8,5,6,9,30
1912251009,7,8,4,3,8,30
1912251010,0,0,4,8,9,21
1912251011,4,8,9,0,3,24
1912251012,3,3,0,6,9,21
1912251013,8,3,8,2,4,25
1912251014,1,0,0,1,7,9
1912251015,1,2,3,2,3,11
1912251016,5,7,0,0,9,21
1912251017,9,5,5,3,1,23
1912251018,1,7,2,9,4,23
1912251019,0,0,7,5,8,20
1912251020,4,2,1,3,7,17
1912251021,6,1,0,8,4,19
1912251022,6,2,9,8,2,27
1912251023,9,7,5,2,4,27
1912251024,4,9,3,6,1,23
1912251025,4,2,9,4,1,20
1912251026,8,5,0,1,4,18
1912251027,0,5,7,4,9,25
1912251028,7,6,4,2,2,21
1912251029,1,2,8,5,8,24
1912251030,3,3,1,8,1,16
1912251031,1,6,1,4,0,12
1912251032,9,4,0,6,0,19
1912251033,6,1,8,9,8,32
1912251034,1,0,7,5,1,14
1912251035,5,8,4,5,5,27
1912251036,6,2,0,0,8,16
1912251037,8,8,9,5,9,39
1912251038,2,4,2,6,5,19
1912251039,2,8,7,9,8,34
1912251040,7,4,5,0,7,23
1912251041,4,7,6,6,5,28
1912251042,3,9,1,3,3,19
1912251043,2,7,2,5,9,25
1912251044,6,9,8,8,8,39
1912251045,0,7,5,1,3,16
1912251046,7,3,9,4,9,32
1912251047,9,8,4,3,8,32
1912251048,0,6,8,4,8,26
1912251049,4,5,3,8,0,20
1912251050,0,4,1,4,6,15
1912251051,7,1,7,2,5,22
1912251052,2,3,8,6,9,28
1912251053,2,3,7,3,7,22
1912251054,6,4,4,0,5,19
1912251055,0,7,7,8,0,22
1912251056,9,4,6,8,4,31
1912251057,9,9,0,5,8,31
1912251058,5,0,2,2,7,16
1912251059,1,0,2,3,5,11
1912251060,1,5,8,9,5,28
1912251061,2,6,8,1,2,19
1912251062,6,7,6,3,2,24
1912251063,9,0,7,6,8,30
1912251064,1,7,5,2,2,17
1912251065,3,2,3,6,2,16
1912251066,3,4,0,8,1,16
1912251067,1,2,3,0,5,11
1912251068,7,8,7,2,3,27
1912251069,3,5,5,5,9,27
1912251070,5,0,8,2,8,23
1912251071,6,5,8,7,9,35
1912251072,7,4,9,8,7,35
1912251073,8,7,0,2,5,22
1912251074,1,6,9,8,0,24
1912251075,5,8,0,0,7,20
1912251076,2,9,2,3,2,18
1912251077,5,6,6,1,2,20
1912251078,2,0,8,2,6,18
1912251079,8,7,4,1,4,24
1912251080,8,8,8,0,3,27
1912251081,8,0,0,7,9,24
1912251082,2,9,1,1,7,20
1912251083,4,6,8,1,8,27
1912251084,0,0,9,7,4,20
1912251085,1,3,5,3,1,13
1912251086,9,4,9,9,1,32
1912251087,4,1,8,0,7,20
1912251088,9,8,7,1,1,26
1912251089,2,5,7,2,3,19
1912251090,4,0,8,7,8,27
1912251091,4,9,1,9,8,31
1912251092,2,8,6,0,4,20
1912251093,3,6,8,7,1,25
1912251094,3,6,9,0,7,25
1912251095,4,4,8,6,9,31
1912251096,8,3,5,3,5,24
1912251097,0,3,6,1,1,11
1912251098,5,2,4,0,5,16
1912251099,3,8,7,5,6,29
1912251100,4,3,8,5,6,26
1912251101,2,9,2,1,2,16
1912251102,3,7,0,5,7,22
1912251103,0,3,4,1,4,12
1912251104,1,9,1,6,7,24
1912251105,0,7,6,9,6,28
191226001,9,0,4,8,6,27
191226002,2,6,3,8,8,27
191226003,4,8,8,8,6,34
191226004,0,0,8,6,8,22
191226005,3,3,3,4,1,14
191226006,1,1,0,0,7,9
191226007,0,0,0,2,2,4
191226008,8,0,0,9,2,19
191226009,7,9,5,7,4,32
191226010,4,8,4,2,1,19
191226011,5,4,4,4,8,25
191226012,8,3,3,8,9,31
191226013,2,6,4,3,1,16
191226014,7,4,3,7,5,26
191226015,8,4,7,7,2,28
191226016,1,8,1,1,5,16
191226017,3,5,3,8,6,25
191226018,8,7,4,1,1,21
191226019,8,2,0,8,0,18
191226020,5,6,6,6,7,30
191226021,5,8,1,1,1,16
191226022,1,8,1,2,5,17
191226023,8,4,2,2,2,18
191226024,8,7,8,7,4,34
191226025,3,1,6,2,0,12
191226026,9,9,2,4,2,26
191226027,8,1,9,4,0,22
191226028,4,4,8,9,2,27
191226029,2,4,7,1,6,20
191226030,9,9,4,8,3,33
191226031,6,6,2,3,5,22
191226032,4,9,8,4,7,32
191226033,5,8,3,0,6,22
191226034,8,3,5,1,5,22
191226035,8,4,6,2,0,20
191226036,3,6,5,2,3,19
191226037,8,3,6,4,0,21
191226038,5,0,4,7,2,18
191226039,5,9,4,4,3,25
191226040,1,0,6,6,3,16
191226041,8,8,2,4,0,22
191226042,8,3,7,4,5,27
191226043,3,0,5,9,0,17
191226044,9,6,9,0,5,29
191226045,6,5,1,9,7,28
191226046,7,9,4,9,2,31
191226047,9,2,2,6,6,25
191226048,1,3,7,1,5,17
191226049,8,1,4,8,1,22
191226050,8,0,4,6,1,19
191226051,3,8,0,1,0,12
191226052,4,9,9,8,3,33
191226053,2,8,0,2,0,12
191226054,3,9,2,0,6,20
191226055,1,8,1,8,1,19
191226056,0,0,4,6,4,14
191226057,2,6,2,2,8,20
191226058,9,2,0,4,8,23
191226059,3,2,4,2,9,20
191226060,3,0,1,1,3,8
191226061,1,6,2,9,3,21
191226062,0,7,8,3,4,22
191226063,3,9,8,6,5,31
191226064,2,9,1,5,0,17
191226065,5,0,6,6,9,26
191226066,5,1,7,7,7,27
191226067,7,1,0,5,3,16
191226068,4,9,9,1,4,27
191226069,6,1,0,9,4,20
191226070,5,0,4,6,2,17
191226071,4,2,1,9,0,16
191226072,2,0,5,3,3,13
191226073,2,7,2,2,3,16
191226074,6,9,4,3,5,27
191226075,3,2,2,5,2,14
191226076,1,6,9,1,5,22
191226077,6,9,3,1,3,22
191226078,8,1,7,1,2,19
191226079,6,9,3,8,3,29
191226080,0,1,0,3,1,5
191226081,8,7,8,2,6,31
191226082,0,7,8,1,3,19
191226083,2,3,2,1,9,17
191226084,4,0,7,6,0,17
191226085,2,2,9,6,2,21
191226086,0,7,5,0,4,16
191226087,7,3,4,9,2,25
191226088,0,2,2,6,3,13
191226089,9,3,2,0,5,19
191226090,4,4,2,7,7,24
191226091,2,1,7,7,1,18
191226092,8,0,9,5,5,27
191226093,4,5,5,9,2,25
191226094,9,2,0,8,2,21
191226095,9,2,6,6,3,26
191226096,4,0,4,5,1,14
191226097,0,9,5,0,1,15
191226098,3,9,7,0,3,22
191226099,6,2,1,2,4,15
191226100,7,9,7,8,4,35
191226101,0,1,1,4,4,10
191226102,0,9,7,9,0,25
191226103,9,6,2,0,4,21
191226104,0,7,4,4,0,15
191226105,4,2,3,3,9,21
191226106,5,0,5,5,2,17
191226107,1,0,4,7,5,17
191226108,4,2,7,8,8,29
191226109,0,9,5,5,8,27
191226110,5,6,5,7,3,26
191226111,4,0,3,3,9,19
191226112,1,0,9,4,0,14
191226113,6,9,1,0,7,23
191226114,5,4,6,7,1,23
191226115,6,3,2,7,8,26
191226116,7,8,1,5,3,24
191226117,3,6,5,6,0,20
191226118,4,4,4,1,8,21
191226119,2,7,9,4,3,25
191226120,6,1,7,1,5,20
191226121,4,9,2,8,4,27
191226122,3,0,2,8,1,14
191226123,3,3,0,7,4,17
191226124,9,9,7,9,4,38
191226125,3,8,8,0,7,26
191226126,4,3,2,0,7,16
191226127,8,2,7,2,6,25
191226128,5,0,4,4,1,14
191226129,0,8,1,3,4,16
191226130,8,3,5,1,2,19
191226131,9,6,4,7,1,27
191226132,7,7,2,4,0,20
191226133,4,7,6,2,5,24
191226134,8,2,1,4,1,16
191226135,8,6,0,5,9,28
191226136,5,0,6,1,7,19
191226137,0,6,7,1,9,23
191226138,7,7,6,0,9,29
191226139,5,2,6,6,5,24
191226140,8,5,9,5,5,32
191226141,3,6,4,3,8,24
191226142,5,1,1,2,5,14
191226143,8,6,3,4,2,23
191226144,9,2,8,4,5,28
191226145,0,1,2,1,0,4
191226146,4,6,3,7,5,25
191226147,3,4,2,2,5,16
191226148,0,3,6,8,3,20
191226149,7,5,8,8,0,28
191226150,9,8,2,7,4,30
191226151,1,8,1,1,6,17
191226152,7,7,1,3,2,20
191226153,3,3,4,6,7,23
191226154,9,2,1,2,6,20
191226155,1,4,9,3,7,24
191226156,9,3,5,8,2,27
191226157,5,0,3,5,7,20
191226158,1,9,6,5,7,28
191226159,8,1,7,0,8,24
191226160,3,4,4,6,2,19
191226161,0,3,7,0,1,11
191226162,7,4,0,0,8,19
191226163,3,4,2,1,9,19
191226164,9,9,4,2,0,24
191226165,3,9,9,7,3,31
191226166,2,4,8,6,0,20
191226167,0,8,4,8,4,24
191226168,5,7,6,5,1,24
191226169,9,2,2,4,6,23
191226170,2,3,9,8,6,28
191226171,2,5,9,3,3,22
191226172,6,7,1,3,1,18
191226173,4,2,1,7,8,22
191226174,5,8,3,8,0,24
191226175,4,8,2,4,1,19
191226176,2,7,6,4,1,20
191226177,4,0,9,0,8,21
191226178,5,9,5,9,5,33
191226179,9,5,4,1,2,21
191226180,0,6,4,1,9,20
191226181,6,0,2,1,6,15
191226182,3,3,5,7,8,26
191226183,1,3,2,5,9,20
191226184,8,7,7,2,2,26
191226185,9,7,9,7,8,40
191226186,1,3,5,4,6,19
191226187,6,7,8,9,9,39
191226188,7,1,9,7,4,28
191226189,9,6,4,7,6,32
191226190,0,4,3,2,8,17
191226191,3,4,5,1,5,18
191226192,5,8,9,3,2,27
191226193,6,0,1,4,9,20
191226194,6,6,4,9,1,26
191226195,2,8,1,2,0,13
191226196,6,9,4,6,3,28
191226197,5,5,8,2,0,20
191226198,8,4,3,8,1,24
191226199,7,3,7,6,6,29
191226200,2,0,0,5,0,7
191226201,3,6,4,2,4,19
191226202,7,8,2,7,9,33
191226203,7,5,3,3,3,21
191226204,6,5,9,9,4,33
191226205,1,5,9,6,2,23
191226206,8,9,0,8,6,31
191226207,2,4,2,7,7,22
191226208,2,4,2,0,6,14
191226209,8,4,5,1,9,27
191226210,4,2,5,6,7,24
191226211,1,0,9,2,4,16
191226212,1,7,3,6,1,18
191226213,5,2,8,6,7,28
191226214,0,3,7,0,9,19
191226215,8,1,6,2,9,26
191226216,1,6,5,9,8,29
191226217,1,6,5,1,6,19
191226218,8,9,4,6,0,27
191226219,7,3,7,4,0,21
191226220,7,0,5,6,4,22
191226221,3,8,1,9,4,25
191226222,5,6,7,1,8,27
191226223,1,2,4,5,8,20
191226224,6,2,3,9,3,23
191226225,9,0,5,1,0,15
191226226,5,4,5,0,2,16
191226227,7,9,4,3,3,26
191226228,8,0,4,7,1,20
191226229,5,1,7,1,0,14
191226230,9,4,9,1,3,26
191226231,7,1,0,2,8,18
191226232,9,0,7,1,4,21
191226233,5,0,6,0,1,12
191226234,4,1,8,1,5,19
191226235,0,6,4,0,2,12
191226236,5,7,3,0,4,19
191226237,1,6,0,3,4,14
191226238,0,0,7,1,1,9
191226239,0,6,9,0,2,17
191226240,0,4,2,1,0,7
191226241,1,7,0,6,9,23
191226242,7,8,2,0,3,20
191226243,9,6,5,8,7,35
191226244,2,9,8,6,0,25
191226245,8,6,6,9,7,36
191226246,2,2,3,0,2,9
191226247,9,3,0,5,8,25
191226248,7,2,6,2,2,19
191226249,5,2,6,0,1,14
191226250,8,8,4,6,4,30
191226251,0,2,9,4,4,19
191226252,7,6,3,7,1,24
191226253,4,6,4,0,2,16
191226254,6,0,9,7,7,29
191226255,1,7,6,7,4,25
191226256,9,6,0,2,4,21
191226257,3,9,6,8,9,35
191226258,2,2,6,4,4,18
191226259,4,4,4,4,4,20
191226260,5,5,2,3,3,18
191226261,1,6,3,1,4,15
191226262,6,6,4,5,7,28
191226263,7,7,3,5,4,26
191226264,9,7,8,6,1,31
191226265,7,9,1,6,2,25
191226266,5,7,6,3,3,24
191226267,1,5,4,5,2,17
191226268,7,6,8,0,7,28
191226269,0,3,1,1,4,9
191226270,0,0,2,8,3,13
191226271,5,3,6,7,5,26
191226272,6,8,4,1,2,21
191226273,0,9,8,4,5,26
191226274,9,2,5,5,8,29
191226275,0,8,2,0,4,14
191226276,5,1,0,4,4,14
191226277,5,3,9,2,6,25
191226278,8,0,3,4,3,18
191226279,0,2,3,5,8,18
191226280,1,7,2,2,2,14
191226281,3,9,2,9,1,24
191226282,2,0,8,0,7,17
191226283,6,1,9,2,9,27
191226284,5,0,7,6,2,20
191226285,0,2,3,8,6,19
191226286,7,9,2,7,0,25
191226287,3,0,6,9,9,27
191226288,1,4,5,1,5,16
191226289,3,3,0,9,2,17
191226290,2,2,8,1,7,20
191226291,5,8,8,3,6,30
191226292,1,6,4,3,6,20
191226293,4,2,2,8,0,16
191226294,2,5,7,4,0,18
191226295,3,4,5,4,8,24
191226296,3,4,7,7,2,23
191226297,4,7,0,2,3,16
191226298,9,2,8,3,0,22
191226299,7,2,4,5,5,23
191226300,5,1,2,2,9,19
191226301,7,2,6,4,0,19
191226302,7,9,9,2,6,33
191226303,5,7,2,9,9,32
191226304,5,8,8,0,1,22
191226305,7,0,8,4,6,25
191226306,8,5,2,0,6,21
191226307,5,1,6,8,1,21
191226308,7,4,6,4,6,27
191226309,3,3,1,1,1,9
191226310,4,9,9,4,4,30
191226311,1,1,0,5,4,11
191226312,7,7,0,5,9,28
191226313,7,6,2,6,9,30
191226314,7,2,1,1,4,15
191226315,4,1,6,0,4,15
191226316,7,1,1,8,9,26
191226317,2,7,2,4,2,17
191226318,3,1,4,6,2,16
191226319,6,0,7,5,7,25
191226320,1,7,8,8,3,27
191226321,6,3,0,4,0,13
191226322,4,0,8,1,3,16
191226323,1,7,1,9,3,21
191226324,8,5,4,1,1,19
191226325,9,3,8,1,3,24
191226326,4,7,9,1,1,22
191226327,4,0,8,7,7,26
191226328,7,8,6,6,4,31
191226329,6,1,6,0,6,19
191226330,1,3,9,9,2,24
191226331,1,1,6,7,8,23
191226332,1,9,1,6,8,25
191226333,8,6,3,4,6,27
191226334,5,4,7,4,6,26
191226335,7,7,2,0,9,25
191226336,2,3,4,0,0,9
191226337,3,8,6,1,4,22
191226338,7,8,1,4,2,22
191226339,8,0,4,5,2,19
191226340,4,3,3,4,5,19
191226341,6,8,9,7,1,31
191226342,0,1,4,6,2,13
191226343,5,6,5,2,1,19
191226344,3,2,4,4,4,17
191226345,8,5,0,6,2,21
191226346,6,3,8,5,2,24
191226347,7,6,9,2,3,27
191226348,6,7,4,9,0,26
191226349,6,6,0,5,6,23
191226350,5,9,7,6,6,33
191226351,9,4,8,2,8,31
191226352,5,3,0,1,6,15
191226353,8,1,1,3,6,19
191226354,8,9,5,9,0,31
191226355,5,0,4,5,6,20
191226356,7,8,8,2,2,27
191226357,3,4,1,0,1,9
191226358,5,6,1,6,4,22
191226359,2,0,2,6,0,10
191226360,5,4,6,0,4,19
191226361,1,4,6,9,0,20
191226362,1,6,9,9,7,32
191226363,7,8,7,0,0,22
191226364,5,1,1,0,7,14
191226365,9,4,3,3,5,24
191226366,6,6,1,6,8,27
191226367,0,1,8,2,8,19
191226368,1,8,7,0,1,17
191226369,1,7,7,5,2,22
191226370,3,5,6,9,5,28
191226371,5,3,6,5,6,25
191226372,3,9,8,8,8,36
191226373,3,7,8,4,9,31
191226374,9,7,2,9,4,31
191226375,8,5,9,8,4,34
191226376,2,8,7,3,4,24
191226377,0,2,0,3,1,6
191226378,3,7,4,6,7,27
191226379,6,0,1,0,1,8
191226380,2,2,2,9,5,20
191226381,5,3,0,4,1,13
191226382,8,6,2,0,0,16
191226383,6,3,8,1,3,21
191226384,7,3,4,4,8,26
191226385,2,4,2,5,6,19
191226386,1,2,7,6,6,22
191226387,1,9,3,0,3,16
191226388,1,5,6,7,1,20
191226389,2,5,8,0,8,23
191226390,6,4,0,8,7,25
191226391,8,2,3,7,9,29
191226392,1,3,4,1,5,14
191226393,5,8,2,0,7,22
191226394,8,2,7,2,9,28
191226395,1,3,5,2,0,11
191226396,3,6,0,1,3,13
191226397,7,3,6,3,0,19
191226398,9,0,6,1,9,25
191226399,6,0,7,1,9,23
191226400,9,4,5,9,2,29
191226401,0,0,2,9,9,20
191226402,6,1,8,0,2,17
191226403,3,2,2,9,5,21
191226404,2,4,3,8,1,18
191226405,4,4,6,3,7,24
191226406,5,2,7,1,9,24
191226407,9,5,8,4,8,34
191226408,6,0,7,6,1,20
191226409,9,6,8,0,2,25
191226410,8,8,1,0,2,19
191226411,7,6,6,5,5,29
191226412,6,0,7,1,8,22
191226413,4,2,1,3,1,11
191226414,7,3,9,8,4,31
191226415,8,5,6,5,2,26
191226416,5,3,1,6,9,24
191226417,7,2,3,9,1,22
191226418,5,7,7,5,2,26
191226419,9,5,2,4,9,29
191226420,2,7,6,3,2,20
191226421,8,1,8,3,8,28
191226422,6,9,2,3,7,27
191226423,4,2,3,9,9,27
191226424,1,0,2,8,7,18
191226425,6,6,1,8,5,26
191226426,8,3,6,5,8,30
191226427,2,8,1,2,5,18
191226428,6,7,2,7,0,22
191226429,7,7,2,9,6,31
191226430,5,4,9,4,0,22
191226431,5,0,8,0,2,15
191226432,3,9,3,0,0,15
191226433,9,3,4,4,0,20
191226434,3,2,9,8,7,29
191226435,0,6,1,3,0,10
191226436,9,4,4,7,4,28
191226437,3,7,7,1,6,24
191226438,0,8,1,7,7,23
191226439,6,1,9,7,2,25
191226440,9,1,5,9,9,33
191226441,4,6,8,1,6,25
191226442,1,6,0,1,1,9
191226443,7,3,2,0,3,15
191226444,4,7,9,3,5,28
191226445,7,3,4,0,9,23
191226446,2,3,4,1,6,16
191226447,6,0,3,7,5,21
191226448,2,3,8,7,0,20
191226449,3,9,2,4,1,19
191226450,4,8,4,6,9,31
191226451,0,6,1,5,7,19
191226452,2,4,3,6,1,16
191226453,8,9,0,9,3,29
191226454,0,3,2,2,0,7
191226455,8,3,5,0,6,22
191226456,5,0,3,1,6,15
191226457,7,0,8,7,4,26
191226458,2,0,2,6,7,17
191226459,0,6,7,7,0,20
191226460,7,2,1,5,9,24
191226461,9,1,7,9,4,30
191226462,2,0,4,8,3,17
191226463,2,6,4,7,4,23
191226464,3,0,9,0,0,12
191226465,7,4,3,0,5,19
191226466,4,2,5,3,5,19
191226467,9,0,9,2,8,28
191226468,5,5,4,3,9,26
191226469,6,7,1,3,2,19
191226470,0,7,9,5,5,26
191226471,2,9,9,7,4,31
191226472,5,2,8,5,8,28
191226473,6,6,7,9,5,33
191226474,4,5,7,6,0,22
191226475,9,5,1,2,7,24
191226476,5,5,9,1,6,26
191226477,2,1,5,3,3,14
191226478,5,7,7,0,4,23
191226479,4,6,5,9,8,32
191226480,0,8,1,0,8,17
191226481,7,4,6,5,3,25
191226482,9,0,5,9,4,27
191226483,1,8,5,2,1,17
191226484,3,5,4,4,4,20
191226485,2,2,1,7,1,13
191226486,2,6,1,3,8,20
191226487,6,8,2,4,5,25
191226488,7,9,1,0,2,19
191226489,4,3,6,8,5,26
191226490,3,7,1,7,6,24
191226491,1,7,4,3,1,16
191226492,0,3,2,8,1,14
191226493,8,7,1,4,2,22
191226494,0,6,2,7,6,21
191226495,1,9,9,2,4,25
191226496,6,6,2,5,5,24
191226497,1,1,0,8,1,11
191226498,5,4,5,7,4,25
191226499,0,1,3,7,5,16
191226500,1,0,7,0,0,8
191226501,0,6,6,4,4,20
191226502,0,2,7,3,6,18
191226503,4,0,7,0,9,20
191226504,9,9,3,3,4,28
191226505,1,1,7,3,2,14
191226506,5,4,6,0,1,16
191226507,0,1,4,0,3,8
191226508,8,1,7,1,7,24
191226509,6,7,5,4,1,23
191226510,3,4,9,2,7,25
191226511,6,8,4,5,7,30
191226512,0,4,9,7,9,29
191226513,2,5,0,3,1,11
191226514,6,2,7,2,6,23
191226515,3,5,2,8,7,25
191226516,3,7,4,5,6,25
191226517,8,9,9,2,4,32
191226518,8,6,5,3,1,23
191226519,2,3,6,7,0,18
191226520,1,8,4,0,6,19
191226521,5,6,1,3,3,18
191226522,3,7,9,4,4,27
191226523,6,9,9,8,5,37
191226524,3,2,3,1,1,10
191226525,3,8,5,4,0,20
191226526,5,2,0,5,2,14
191226527,3,8,5,1,4,21
191226528,3,1,4,9,0,17
191226529,2,7,9,0,8,26
191226530,3,3,5,3,2,16
191226531,9,3,2,5,8,27
191226532,8,9,2,3,0,22
191226533,9,4,1,0,0,14
191226534,6,4,8,2,6,26
191226535,3,7,2,5,0,17
191226536,6,4,3,4,5,22
191226537,4,1,7,2,9,23
191226538,2,5,8,9,4,28
191226539,8,6,6,1,6,27
191226540,8,6,9,3,2,28
191226541,8,7,5,9,2,31
191226542,0,8,5,2,2,17
191226543,1,1,9,8,1,20
191226544,2,2,8,4,6,22
191226545,1,7,3,8,7,26
191226546,6,3,2,2,5,18
191226547,9,7,6,3,5,30
191226548,9,6,2,8,1,26
191226549,5,8,2,2,3,20
191226550,9,1,1,6,7,24
191226551,4,9,7,5,3,28
191226552,4,9,0,8,9,30
191226553,7,0,6,5,2,20
191226554,0,4,4,4,5,17
191226555,1,3,3,0,6,13
191226556,4,9,7,8,4,32
191226557,6,1,6,5,2,20
191226558,3,1,0,3,3,10
191226559,1,0,4,2,9,16
191226560,9,0,5,8,2,24
191226561,1,3,5,3,3,15
191226562,9,9,3,3,1,25
191226563,2,4,2,5,7,20
191226564,4,6,3,0,0,13
191226565,5,1,3,4,0,13
191226566,3,2,9,6,4,24
191226567,1,4,6,9,7,27
191226568,5,1,6,4,0,16
191226569,9,3,9,3,7,31
191226570,6,0,9,6,5,26
191226571,4,5,6,2,9,26
191226572,6,5,6,9,9,35
191226573,8,4,0,6,7,25
191226574,1,7,1,2,3,14
191226575,5,7,7,1,4,24
191226576,3,0,1,2,4,10
191226577,2,9,6,4,4,25
191226578,4,1,6,2,7,20
191226579,7,3,7,6,4,27
191226580,8,6,3,6,3,26
191226581,8,4,3,8,5,28
191226582,2,4,0,4,9,19
191226583,8,3,7,8,8,34
191226584,1,5,0,3,4,13
191226585,8,2,9,0,0,19
191226586,5,0,5,6,7,23
191226587,5,1,4,8,4,22
191226588,7,8,1,9,7,32
191226589,8,7,9,3,5,32
191226590,7,2,3,6,4,22
191226591,9,7,4,5,9,34
191226592,1,1,5,9,9,25
191226593,8,3,2,1,3,17
191226594,6,0,8,9,8,31
191226595,9,2,4,4,7,26
191226596,9,2,1,0,4,16
191226597,4,7,1,0,5,17
191226598,5,5,2,6,4,22
191226599,2,5,5,0,4,16
191226600,5,4,4,5,9,27
191226601,9,3,3,8,8,31
191226602,9,7,5,5,8,34
191226603,3,5,0,3,9,20
191226604,0,5,3,1,6,15
191226605,4,4,0,8,6,22
191226606,0,4,7,9,7,27
191226607,0,5,2,9,4,20
191226608,0,8,7,5,0,20
191226609,5,4,2,8,1,20
191226610,0,5,8,2,9,24
191226611,2,6,9,8,8,33
191226612,7,2,9,7,8,33
191226613,0,1,0,1,0,2
191226614,0,4,6,0,4,14
191226615,4,1,8,3,1,17
191226616,0,9,2,5,2,18
191226617,4,2,0,7,3,16
191226618,2,0,9,5,4,20
191226619,5,3,6,7,7,28
191226620,0,7,0,2,3,12
191226621,9,8,4,4,5,30
191226622,6,1,9,8,5,29
191226623,0,2,8,6,7,23
191226624,6,9,9,9,6,39
191226625,8,6,7,9,9,39
191226626,5,8,5,1,0,19
191226627,1,9,9,4,7,30
191226628,0,2,7,8,7,24
191226629,6,3,9,5,1,24
191226630,7,6,3,7,3,26
191226631,2,4,8,0,1,15
191226632,3,1,0,9,9,22
191226633,1,0,5,4,3,13
191226634,3,9,7,9,0,28
191226635,6,9,1,4,9,29
191226636,2,0,5,6,9,22
191226637,7,6,6,4,6,29
191226638,1,0,1,7,2,11
191226639,7,8,3,7,4,29
191226640,0,8,0,0,1,9
191226641,0,3,0,0,3,6
191226642,0,8,3,6,8,25
191226643,5,9,2,6,4,26
191226644,0,7,5,7,5,24
191226645,7,2,0,2,7,18
191226646,0,3,4,4,3,14
191226647,3,6,3,5,5,22
191226648,1,7,6,6,0,20
191226649,1,5,4,8,7,25
191226650,0,9,2,4,8,23
191226651,3,7,2,5,9,26
191226652,8,8,8,5,1,30
191226653,6,8,2,3,9,28
191226654,3,6,0,2,5,16
191226655,2,1,4,2,6,15
191226656,0,7,1,0,4,12
191226657,1,2,7,9,3,22
191226658,4,9,3,0,0,16
191226659,8,4,8,3,3,26
191226660,2,2,9,7,8,28
191226661,3,7,5,5,2,22
191226662,4,2,4,8,4,22
191226663,0,8,0,0,5,13
191226664,1,8,1,2,9,21
191226665,8,7,8,4,4,31
191226666,1,6,0,9,7,23
191226667,6,5,8,5,8,32
191226668,9,1,5,1,6,22
191226669,7,1,9,7,7,31
191226670,4,8,1,2,2,17
191226671,6,0,5,1,9,21
191226672,6,4,1,9,2,22
191226673,6,5,2,0,9,22
191226674,6,4,6,5,7,28
191226675,9,7,5,8,6,35
191226676,0,6,1,8,0,15
191226677,5,4,9,9,6,33
191226678,3,9,5,2,2,21
191226679,8,5,8,7,7,35
191226680,9,1,8,4,7,29
191226681,4,4,1,4,7,20
191226682,5,8,2,1,7,23
191226683,2,8,8,0,5,23
191226684,4,2,3,5,2,16
191226685,4,9,6,2,0,21
191226686,0,6,8,0,5,19
191226687,7,1,9,8,3,28
191226688,6,2,3,9,2,22
191226689,4,9,3,4,3,23
191226690,0,2,5,5,9,21
191226691,9,2,4,0,6,21
191226692,8,4,4,2,2,20
191226693,0,3,8,5,2,18
191226694,3,0,5,8,0,16
191226695,3,6,3,4,5,21
191226696,9,3,3,2,7,24
191226697,4,5,9,0,0,18
191226698,0,3,8,7,7,25
191226699,8,6,6,7,8,35
191226700,1,9,3,1,2,16
191226701,2,9,5,9,0,25
191226702,8,6,7,7,6,34
191226703,5,8,5,9,3,30
191226704,6,7,9,0,7,29
191226705,4,4,1,5,1,15
191226706,5,9,6,0,9,29
191226707,7,2,6,9,4,28
191226708,7,9,0,2,9,27
191226709,3,2,3,7,4,19
191226710,3,4,9,8,7,31
191226711,2,4,9,8,5,28
191226712,6,8,6,2,1,23
191226713,9,3,2,3,4,21
191226714,6,9,7,9,2,33
191226715,1,9,6,6,0,22
191226716,8,9,3,0,1,21
191226717,1,4,1,1,4,11
191226718,4,9,4,5,1,23
191226719,2,1,0,8,9,20
191226720,4,4,0,2,1,11
191226721,1,1,8,4,5,19
191226722,6,1,8,3,3,21
191226723,1,2,6,3,4,16
191226724,2,4,9,4,2,21
191226725,1,8,8,0,0,17
191226726,4,8,6,3,5,26
191226727,4,4,4,1,4,17
191226728,3,3,8,9,9,32
191226729,7,1,6,6,1,21
191226730,8,5,5,7,6,31
191226731,2,3,2,2,6,15
191226732,8,2,5,3,0,18
191226733,1,0,6,9,0,16
191226734,5,9,3,2,6,25
191226735,3,3,7,0,4,17
191226736,9,5,0,0,0,14
191226737,6,6,3,6,0,21
191226738,2,0,1,9,3,15
191226739,1,5,8,4,0,18
191226740,4,4,6,1,4,19
191226741,6,0,7,4,1,18
191226742,9,9,5,0,8,31
191226743,0,9,2,7,1,19
191226744,2,3,5,6,9,25
191226745,1,0,1,2,6,10
191226746,4,8,3,0,4,19
191226747,3,8,3,2,0,16
191226748,3,0,2,0,6,11
191226749,0,2,4,9,3,18
191226750,8,1,2,7,1,19
191226751,8,8,1,7,3,27
191226752,7,3,9,8,1,28
191226753,4,8,4,2,9,27
191226754,7,4,7,4,7,29
191226755,5,9,8,8,5,35
191226756,4,2,8,9,3,26
191226757,8,0,5,7,4,24
191226758,9,3,6,1,7,26
191226759,6,2,0,7,0,15
191226760,9,7,6,3,7,32
191226761,4,6,1,7,2,20
191226762,7,5,4,3,7,26
191226763,1,8,1,3,0,13
191226764,6,0,8,8,5,27
191226765,0,0,6,2,5,13
191226766,8,7,3,8,2,28
191226767,7,3,3,8,1,22
191226768,0,3,1,2,9,15
191226769,8,2,7,4,8,29
191226770,3,8,2,5,3,21
191226771,7,9,4,8,6,34
191226772,3,0,2,2,4,11
191226773,9,4,0,7,9,29
191226774,0,6,1,7,6,20
191226775,7,2,0,4,0,13
191226776,0,5,0,6,1,12
191226777,1,7,2,2,5,17
191226778,2,7,9,6,5,29
191226779,4,9,4,3,5,25
191226780,3,2,7,5,7,24
191226781,6,4,2,9,2,23
191226782,2,4,6,4,6,22
191226783,7,2,3,8,8,28
191226784,1,7,3,9,8,28
191226785,9,8,5,9,1,32
191226786,5,2,7,7,1,22
191226787,5,2,7,4,5,23
191226788,4,1,4,7,2,18
191226789,5,7,4,5,1,22
191226790,0,1,4,8,6,19
191226791,3,3,0,1,4,11
191226792,5,3,8,6,6,28
191226793,1,8,7,8,2,26
191226794,3,5,3,2,4,17
191226795,4,4,2,5,3,18
191226796,5,2,6,6,8,27
191226797,1,4,6,4,5,20
191226798,5,5,7,1,4,22
191226799,5,8,1,3,5,22
191226800,9,5,1,1,4,20
191226801,1,5,5,6,0,17
191226802,4,3,0,5,5,17
191226803,9,8,7,0,7,31
191226804,7,4,3,9,5,28
191226805,4,3,4,6,9,26
191226806,9,7,6,7,0,29
191226807,9,7,7,6,0,29
191226808,9,0,1,4,1,15
191226809,2,5,2,2,9,20
191226810,3,3,6,9,4,25
191226811,2,0,2,3,9,16
191226812,9,5,3,3,2,22
191226813,2,6,5,7,7,27
191226814,5,5,0,4,6,20
191226815,7,9,8,4,2,30
191226816,6,0,8,7,4,25
191226817,5,2,3,6,4,20
191226818,6,2,5,8,5,26
191226819,3,4,0,2,8,17
191226820,2,7,6,7,1,23
191226821,6,9,5,9,0,29
191226822,1,0,1,9,6,17
191226823,4,3,1,9,1,18
191226824,1,7,0,1,8,17
191226825,7,6,8,9,7,37
191226826,8,5,3,3,1,20
191226827,4,6,9,3,3,25
191226828,1,7,9,6,7,30
191226829,4,8,1,8,7,28
191226830,3,1,0,4,2,10
191226831,7,6,7,0,6,26
191226832,3,9,0,6,9,27
191226833,4,9,1,8,5,27
191226834,5,6,3,8,8,30
191226835,8,2,2,1,7,20
191226836,5,4,6,3,2,20
191226837,9,0,0,1,2,12
191226838,4,7,3,5,6,25
191226839,4,1,2,7,3,17
191226840,7,0,4,7,3,21
191226841,8,7,2,2,5,24
191226842,4,4,0,0,0,8
191226843,1,6,0,9,3,19
191226844,5,6,6,6,5,28
191226845,1,5,0,8,0,14
191226846,8,8,6,2,2,26
191226847,1,2,6,2,9,20
191226848,0,0,0,2,5,7
191226849,5,2,9,5,3,24
191226850,3,7,4,2,1,17
191226851,7,6,5,7,9,34
191226852,8,9,3,4,9,33
191226853,8,4,2,9,3,26
191226854,8,0,0,4,6,18
191226855,3,6,8,6,3,26
191226856,9,5,4,8,0,26
191226857,2,1,1,2,8,14
191226858,3,4,5,5,5,22
191226859,1,7,0,0,7,15
191226860,1,0,0,2,2,5
191226861,2,3,4,3,9,21
191226862,1,1,0,8,8,18
191226863,6,6,5,0,1,18
191226864,8,7,2,1,9,27
191226865,9,7,8,6,7,37
191226866,9,5,0,1,3,18
191226867,3,5,7,4,3,22
191226868,5,2,4,8,3,22
191226869,5,2,8,3,2,20
191226870,1,4,6,6,1,18
191226871,1,1,0,7,9,18
191226872,2,3,0,6,8,19
191226873,1,0,8,2,4,15
191226874,7,7,8,5,1,28
191226875,0,4,3,0,5,12
191226876,5,1,7,4,7,24
191226877,1,9,5,0,7,22
191226878,7,7,8,4,5,31
191226879,0,5,9,4,7,25
191226880,1,8,8,4,2,23
191226881,8,1,2,5,0,16
191226882,1,1,7,9,7,25
191226883,8,5,3,3,3,22
191226884,8,6,3,8,2,27
191226885,8,5,9,2,0,24
191226886,8,1,2,3,7,21
191226887,9,7,5,0,8,29
191226888,0,3,0,8,1,12
191226889,7,1,9,5,8,30
191226890,7,0,6,0,5,18
191226891,0,7,5,4,7,23
191226892,0,4,7,2,2,15
191226893,9,9,0,5,2,25
191226894,7,9,3,8,8,35
191226895,4,5,7,7,1,24
191226896,3,0,9,0,1,13
191226897,4,0,0,5,7,16
191226898,0,2,4,8,1,15
191226899,5,3,6,6,5,25
191226900,6,6,2,4,7,25
191226901,6,1,1,5,7,20
191226902,6,4,2,0,3,15
191226903,4,0,2,6,5,17
191226904,8,5,0,3,8,24
191226905,4,7,7,2,7,27
191226906,0,6,3,8,7,24
191226907,5,6,5,6,0,22
191226908,1,3,9,8,1,22
191226909,4,2,1,6,6,19
191226910,8,2,2,7,6,25
191226911,9,0,5,7,5,26
191226912,5,1,3,2,4,15
191226913,0,4,3,0,8,15
191226914,4,4,8,5,0,21
191226915,1,7,9,7,5,29
191226916,9,8,6,3,5,31
191226917,6,6,8,6,8,34
191226918,9,0,7,7,4,27
191226919,2,9,5,4,8,28
191226920,6,0,4,9,6,25
191226921,4,8,1,4,7,24
191226922,5,1,8,7,6,27
191226923,1,7,5,3,5,21
191226924,8,1,3,8,8,28
191226925,4,4,3,6,1,18
191226926,6,7,0,6,1,20
191226927,5,3,0,4,2,14
191226928,8,4,4,6,5,27
191226929,5,5,0,4,8,22
191226930,0,2,2,3,8,15
191226931,5,6,0,7,6,24
191226932,0,9,3,3,2,17
191226933,2,4,1,7,8,22
191226934,3,4,3,1,6,17
191226935,2,7,0,2,0,11
191226936,2,7,0,5,5,19
191226937,3,1,7,0,0,11
191226938,3,3,4,3,2,15
191226939,1,6,9,1,7,24
191226940,3,6,9,0,5,23
191226941,2,5,1,1,4,13
191226942,5,3,7,7,9,31
191226943,8,3,4,4,9,28
191226944,1,7,7,7,6,28
191226945,0,1,6,2,3,12
191226946,3,2,6,0,9,20
191226947,4,2,4,6,0,16
191226948,0,6,2,3,7,18
191226949,5,1,5,6,1,18
191226950,6,0,2,8,8,24
191226951,4,8,6,5,1,24
191226952,7,1,2,4,3,17
191226953,5,4,9,7,0,25
191226954,8,5,3,2,3,21
191226955,0,4,3,8,8,23
191226956,2,0,8,9,9,28
191226957,5,9,8,8,1,31
191226958,6,7,7,3,9,32
191226959,8,7,6,0,0,21
191226960,1,5,9,1,8,24
191226961,9,4,4,0,2,19
191226962,5,1,2,6,2,16
191226963,1,5,5,2,7,20
191226964,6,9,2,9,4,30
191226965,6,2,8,2,0,18
191226966,4,5,2,7,9,27
191226967,6,4,6,5,6,27
191226968,2,6,1,1,8,18
191226969,9,8,1,2,6,26
191226970,4,9,8,5,7,33
191226971,7,5,6,4,2,24
191226972,8,7,2,9,4,30
191226973,1,7,9,5,2,24
191226974,0,2,1,2,8,13
191226975,0,4,0,8,9,21
191226976,9,6,4,3,8,30
191226977,4,8,1,9,4,26
191226978,1,3,0,8,0,12
191226979,3,0,4,0,7,14
191226980,1,7,8,9,0,25
191226981,0,1,7,6,2,16
191226982,8,8,6,1,9,32
191226983,0,6,7,7,8,28
191226984,7,7,7,6,8,35
191226985,0,6,4,2,2,14
191226986,5,8,6,1,1,21
191226987,6,0,1,8,9,24
191226988,8,1,1,6,3,19
191226989,0,8,1,2,3,14
191226990,8,1,8,4,5,26
191226991,0,0,4,6,1,11
191226992,4,6,4,1,5,20
191226993,1,8,1,5,3,18
191226994,3,1,4,5,2,15
191226995,8,4,0,9,8,29
191226996,6,3,5,9,8,31
191226997,7,1,0,0,4,12
191226998,7,7,4,1,7,26
191226999,0,4,5,8,5,22
1912261000,4,4,8,8,2,26
1912261001,9,0,4,8,7,28
1912261002,7,4,0,6,8,25
1912261003,0,6,8,5,0,19
1912261004,0,4,0,3,9,16
1912261005,6,7,0,9,9,31
1912261006,4,3,6,0,0,13
1912261007,1,7,3,3,6,20
1912261008,7,1,1,0,7,16
1912261009,1,9,5,3,1,19
1912261010,3,9,0,4,3,19
1912261011,2,4,0,9,7,22
1912261012,8,0,7,3,9,27
1912261013,2,9,4,3,2,20
1912261014,5,6,6,9,1,27
1912261015,6,7,1,6,1,21
1912261016,6,2,6,6,1,21
1912261017,6,5,1,4,0,16
1912261018,8,9,1,9,6,33
1912261019,2,1,9,8,5,25
1912261020,4,3,2,6,0,15
1912261021,9,9,6,1,8,33
1912261022,0,5,0,7,2,14
1912261023,1,7,2,5,2,17
1912261024,1,8,1,9,3,22
1912261025,2,1,7,3,8,21
1912261026,5,5,7,8,5,30
1912261027,7,1,1,2,4,15
1912261028,9,3,2,7,4,25
1912261029,7,7,1,4,0,19
1912261030,2,8,9,0,8,27
1912261031,3,1,2,0,1,7
1912261032,5,9,0,9,6,29
1912261033,4,8,6,4,1,23
1912261034,1,4,1,7,2,15
1912261035,4,2,9,4,2,21
1912261036,6,6,3,3,5,23
1912261037,9,8,6,3,3,29
1912261038,1,6,3,5,8,23
1912261039,9,6,8,5,2,30
1912261040,2,9,8,9,9,37
1912261041,3,6,9,1,4,23
1912261042,6,2,4,8,7,27
1912261043,2,6,0,5,3,16
1912261044,7,1,4,7,5,24
1912261045,2,3,3,1,6,15
1912261046,9,6,1,4,3,23
1912261047,0,5,5,9,6,25
1912261048,3,5,8,0,8,24
1912261049,2,4,7,9,6,28
1912261050,9,6,2,5,1,23
1912261051,0,2,2,6,9,19
1912261052,8,9,5,8,3,33
1912261053,3,4,0,5,4,16
1912261054,4,5,5,7,2,23
1912261055,1,7,5,3,2,18
1912261056,4,3,6,4,2,19
1912261057,7,9,2,2,3,23
1912261058,2,4,0,3,7,16
1912261059,8,9,3,4,3,27
1912261060,0,0,0,7,0,7
1912261061,5,5,2,6,5,23
1912261062,5,2,9,5,8,29
1912261063,0,0,2,8,1,11
1912261064,8,9,3,4,7,31
1912261065,2,9,4,4,5,24
1912261066,2,9,3,3,7,24
1912261067,6,0,6,5,9,26
1912261068,5,4,9,0,1,19
1912261069,7,7,4,0,3,21
1912261070,7,5,3,6,6,27
1912261071,1,5,8,8,6,28
1912261072,5,3,7,3,7,25
1912261073,5,8,0,4,0,17
1912261074,4,9,7,4,1,25
1912261075,3,4,4,9,8,28
1912261076,8,7,4,8,1,28
1912261077,4,3,5,6,1,19
1912261078,5,6,7,8,5,31
1912261079,8,3,7,9,7,34
1912261080,5,4,2,7,7,25
1912261081,4,4,4,9,3,24
1912261082,2,3,8,1,5,19
1912261083,3,4,6,1,5,19
1912261084,3,1,5,1,4,14
1912261085,9,4,4,3,3,23
1912261086,7,8,6,0,3,24
1912261087,2,6,5,9,9,31
1912261088,1,1,7,8,0,17
1912261089,7,7,1,5,6,26
1912261090,4,2,5,4,7,22
1912261091,3,4,3,2,4,16
1912261092,7,1,5,2,4,19
1912261093,7,8,8,6,5,34
1912261094,8,1,2,4,5,20
1912261095,9,9,9,4,3,34
1912261096,7,6,0,2,8,23
1912261097,3,5,3,4,7,22
1912261098,2,7,5,4,5,23
1912261099,4,2,7,6,2,21
1912261100,6,2,6,0,1,15
1912261101,0,9,6,2,7,24
1912261102,5,3,8,8,2,26
1912261103,7,6,9,2,1,25
1912261104,1,1,8,7,9,26
1912261105,2,7,2,5,7,23
191227001,3,1,8,2,0,14
191227002,3,2,9,0,8,22
191227003,2,9,5,0,2,18
191227004,9,3,7,3,3,25
191227005,0,3,1,1,7,12
191227006,7,3,5,1,0,16
191227007,7,7,5,9,7,35
191227008,7,6,3,8,3,27
191227009,5,6,0,5,0,16
191227010,8,6,7,7,9,37
191227011,6,5,3,5,1,20
191227012,3,2,3,5,9,22
191227013,8,7,6,6,8,35
191227014,9,1,0,4,8,22
191227015,3,2,4,1,8,18
191227016,9,8,0,8,1,26
191227017,8,8,4,7,9,36
191227018,9,3,5,9,3,29
191227019,9,5,2,4,3,23
191227020,0,5,3,6,3,17
191227021,7,9,6,4,4,30
191227022,3,8,1,3,9,24
191227023,9,8,6,4,2,29
191227024,7,6,8,4,7,32
191227025,9,7,8,0,8,32
191227026,8,6,4,5,5,28
191227027,7,4,7,6,3,27
191227028,9,2,3,8,0,22
191227029,1,3,1,8,0,13
191227030,7,2,0,7,0,16
191227031,6,1,4,7,2,20
191227032,6,5,2,1,3,17
191227033,8,9,8,1,0,26
191227034,9,0,4,7,8,28
191227035,8,8,1,1,7,25
191227036,5,3,4,2,9,23
191227037,3,3,6,5,6,23
191227038,9,6,7,7,6,35
191227039,6,3,7,1,5,22
191227040,2,0,4,2,5,13
191227041,6,0,2,5,7,20
191227042,8,9,6,6,6,35
191227043,2,1,3,7,0,13
191227044,2,1,0,7,2,12
191227045,8,1,4,4,9,26
191227046,3,6,3,2,8,22
191227047,8,7,4,6,8,33
191227048,3,6,3,0,2,14
191227049,5,7,2,8,9,31
191227050,0,3,6,2,6,17
191227051,1,8,0,7,9,25
191227052,0,2,9,1,9,21
191227053,2,0,4,3,4,13
191227054,1,7,4,4,7,23
191227055,5,9,3,4,0,21
191227056,3,3,1,8,2,17
191227057,3,8,0,9,4,24
191227058,2,9,6,6,6,29
191227059,0,7,0,0,2,9
191227060,6,7,0,6,9,28
191227061,8,7,1,1,0,17
191227062,9,3,3,6,5,26
191227063,4,3,2,4,5,18
191227064,0,1,7,8,9,25
191227065,3,0,9,3,8,23
191227066,5,7,3,3,4,22
191227067,4,8,4,3,3,22
191227068,5,1,4,6,0,16
191227069,0,8,8,9,7,32
191227070,9,2,7,1,1,20
191227071,4,6,0,7,5,22
191227072,5,4,3,3,8,23
191227073,5,6,6,0,3,20
191227074,9,7,3,4,4,27
191227075,4,5,6,1,2,18
191227076,6,2,2,2,1,13
191227077,3,9,1,2,0,15
191227078,9,7,8,5,1,30
191227079,7,6,1,6,5,25
191227080,9,2,8,9,8,36
191227081,3,1,1,0,7,12
191227082,8,5,9,6,9,37
191227083,1,6,4,6,7,24
191227084,4,7,1,1,7,20
191227085,2,4,6,7,7,26
191227086,6,4,7,8,6,31
191227087,7,6,7,4,8,32
191227088,9,9,1,2,9,30
191227089,5,3,2,4,3,17
191227090,4,2,0,5,8,19
191227091,5,2,6,1,6,20
191227092,4,5,2,5,4,20
191227093,7,8,3,0,1,19
191227094,7,1,0,3,1,12
191227095,7,5,2,7,9,30
191227096,2,1,9,2,5,19
191227097,2,1,4,6,8,21
191227098,0,3,6,2,7,18
191227099,0,3,0,6,4,13
191227100,7,2,6,6,3,24
191227101,0,0,8,1,9,18
191227102,0,5,9,8,6,28
191227103,0,9,9,7,4,29
191227104,5,3,7,8,2,25
191227105,0,5,9,5,9,28
191227106,8,6,9,9,3,35
191227107,3,0,4,0,6,13
191227108,4,0,6,9,0,19
191227109,6,8,3,9,7,33
191227110,8,7,2,0,5,22
191227111,4,5,4,6,0,19
191227112,2,1,1,2,3,9
191227113,4,0,1,9,5,19
191227114,6,9,8,6,8,37
191227115,9,4,8,7,7,35
191227116,7,1,3,8,2,21
191227117,6,0,9,3,4,22
191227118,8,0,4,0,8,20
191227119,3,6,8,3,0,20
191227120,6,0,7,7,2,22
191227121,1,7,5,6,3,22
191227122,5,2,3,8,0,18
191227123,7,8,8,9,6,38
191227124,4,7,5,4,6,26
191227125,7,5,0,5,1,18
191227126,0,4,6,0,0,10
191227127,8,4,6,9,7,34
191227128,6,8,2,2,4,22
191227129,9,4,8,7,9,37
191227130,9,2,6,6,6,29
191227131,6,4,4,5,1,20
191227132,3,4,0,4,8,19
191227133,8,4,1,6,9,28
191227134,1,1,9,5,4,20
191227135,7,0,5,8,5,25
191227136,2,3,1,5,3,14
191227137,7,9,5,2,1,24
191227138,5,8,6,2,2,23
191227139,5,9,9,4,3,30
191227140,0,7,4,0,1,12
191227141,1,3,1,1,5,11
191227142,7,2,8,7,2,26
191227143,2,5,2,3,6,18
191227144,4,8,9,5,1,27
191227145,1,8,2,3,1,15
191227146,5,8,2,3,8,26
191227147,5,0,9,6,8,28
191227148,0,7,7,0,5,19
191227149,2,2,2,2,1,9
191227150,5,9,2,2,3,21
191227151,1,2,7,9,2,21
191227152,0,6,6,4,6,22
191227153,9,7,1,0,2,19
191227154,7,6,9,4,8,34
191227155,5,5,6,3,9,28
191227156,5,0,4,2,5,16
191227157,3,7,5,7,7,29
191227158,0,9,9,5,7,30
191227159,9,0,9,0,7,25
191227160,0,6,1,1,5,13
191227161,5,5,2,8,2,22
191227162,5,7,1,4,7,24
191227163,4,8,8,6,6,32
191227164,8,9,4,5,3,29
191227165,8,5,4,2,3,22
191227166,4,2,8,7,6,27
191227167,3,7,7,0,7,24
191227168,3,3,3,2,5,16
191227169,3,4,9,9,0,25
191227170,3,9,4,4,6,26
191227171,7,1,9,8,8,33
191227172,4,9,9,4,9,35
191227173,4,7,0,8,7,26
191227174,1,9,8,3,1,22
191227175,1,1,3,2,2,9
191227176,4,3,7,9,9,32
191227177,7,0,7,7,0,21
191227178,7,4,9,3,5,28
191227179,6,7,9,4,1,27
191227180,6,2,9,7,0,24
191227181,1,7,9,8,5,30
191227182,0,0,3,3,8,14
191227183,6,6,8,5,7,32
191227184,5,0,1,2,8,16
191227185,8,7,9,8,5,37
191227186,9,9,1,7,1,27
191227187,0,9,6,7,6,28
191227188,6,2,3,5,6,22
191227189,9,4,7,4,2,26
191227190,5,5,0,1,0,11
191227191,0,5,9,2,3,19
191227192,0,6,4,7,1,18
191227193,1,1,8,4,0,14
191227194,8,4,8,5,6,31
191227195,8,1,2,6,7,24
191227196,8,4,3,7,9,31
191227197,8,0,9,7,5,29
191227198,0,3,5,0,3,11
191227199,1,1,6,1,6,15
191227200,8,6,2,8,3,27
191227201,7,3,6,3,9,28
191227202,7,0,0,2,9,18
191227203,8,7,4,2,5,26
191227204,8,3,5,1,1,18
191227205,7,1,9,4,8,29
191227206,4,5,1,7,8,25
191227207,8,0,8,0,2,18
191227208,9,7,1,8,2,27
191227209,2,3,1,1,9,16
191227210,5,2,2,5,4,18
191227211,7,8,0,9,1,25
191227212,0,7,3,9,7,26
191227213,6,0,8,2,0,16
191227214,9,8,7,2,6,32
191227215,0,6,0,7,4,17
191227216,8,6,1,9,8,32
191227217,9,6,4,9,0,28
191227218,9,0,8,1,5,23
191227219,5,8,8,7,3,31
191227220,0,1,6,7,6,20
191227221,2,1,1,5,0,9
191227222,8,0,9,7,4,28
191227223,6,3,1,6,3,19
191227224,5,3,8,3,0,19
191227225,3,1,4,4,0,12
191227226,2,8,5,8,5,28
191227227,7,8,3,5,9,32
191227228,6,3,8,3,6,26
191227229,2,3,1,0,5,11
191227230,9,3,9,9,4,34
191227231,6,1,4,1,8,20
191227232,8,3,1,9,9,30
191227233,3,6,5,6,3,23
191227234,9,8,2,3,9,31
191227235,0,8,2,6,3,19
191227236,4,2,7,2,2,17
191227237,1,8,0,7,6,22
191227238,5,9,4,5,7,30
191227239,2,4,4,4,0,14
191227240,9,7,3,5,3,27
191227241,1,8,0,4,1,14
191227242,2,9,3,3,5,22
191227243,7,2,2,3,8,22
191227244,8,4,4,9,7,32
191227245,4,5,3,6,4,22
191227246,8,2,1,9,3,23
191227247,9,2,4,1,8,24
191227248,3,1,3,0,3,10
191227249,5,8,7,0,4,24
191227250,4,1,7,3,4,19
191227251,9,5,7,3,9,33
191227252,7,6,7,6,6,32
191227253,8,2,5,2,5,22
191227254,1,3,1,3,3,11
191227255,5,5,0,7,2,19
191227256,3,0,8,3,5,19
191227257,3,5,7,6,1,22
191227258,2,5,3,4,9,23
191227259,2,3,9,9,7,30
191227260,1,9,0,1,0,11
191227261,8,7,3,3,1,22
191227262,2,3,0,3,0,8
191227263,7,1,5,8,8,29
191227264,5,5,9,6,1,26
191227265,7,2,5,0,8,22
191227266,3,5,8,1,6,23
191227267,6,1,7,7,6,27
191227268,3,3,9,9,6,30
191227269,1,3,8,5,5,22
191227270,3,2,7,1,3,16
191227271,4,2,2,0,6,14
191227272,2,0,4,0,9,15
191227273,6,7,7,4,1,25
191227274,0,7,1,0,0,8
191227275,9,3,2,6,4,24
191227276,3,5,5,4,3,20
191227277,8,6,9,2,8,33
191227278,0,8,6,4,2,20
191227279,1,4,2,9,0,16
191227280,0,5,7,5,7,24
191227281,9,9,5,7,0,30
191227282,5,2,9,2,3,21
191227283,2,7,9,6,9,33
191227284,6,7,5,0,5,23
191227285,2,0,4,3,8,17
191227286,3,4,0,8,9,24
191227287,5,2,4,2,2,15
191227288,5,5,2,3,6,21
191227289,4,0,1,5,8,18
191227290,9,9,1,7,6,32
191227291,8,5,5,9,9,36
191227292,8,0,6,4,7,25
191227293,9,3,7,1,2,22
191227294,3,6,1,2,9,21
191227295,9,4,9,7,9,38
191227296,0,5,6,2,4,17
191227297,7,4,4,4,2,21
191227298,2,3,0,7,3,15
191227299,6,2,8,4,2,22
191227300,3,0,7,7,9,26
191227301,6,4,9,0,9,28
191227302,6,0,9,1,3,19
191227303,8,9,9,1,1,28
191227304,7,9,3,2,0,21
191227305,9,3,6,1,5,24
191227306,5,8,7,7,9,36
191227307,2,6,8,4,3,23
191227308,3,9,0,6,6,24
191227309,2,2,9,6,9,28
191227310,1,0,3,7,6,17
191227311,8,7,3,7,0,25
191227312,4,2,5,2,5,18
191227313,3,2,3,4,4,16
191227314,0,8,5,5,7,25
191227315,6,7,9,8,0,30
191227316,0,0,7,0,5,12
191227317,8,8,6,1,1,24
191227318,3,8,7,0,1,19
191227319,5,7,3,6,0,21
191227320,6,2,8,2,2,20
191227321,4,4,7,2,5,22
191227322,7,2,0,0,2,11
191227323,8,4,7,8,7,34
191227324,2,0,1,2,1,6
191227325,9,2,5,2,5,23
191227326,3,8,8,2,5,26
191227327,4,5,9,1,4,23
191227328,9,0,0,2,6,17
191227329,4,9,8,0,1,22
191227330,2,8,4,4,3,21
191227331,0,0,3,1,7,11
191227332,1,9,9,6,8,33
191227333,7,7,5,7,8,34
191227334,7,1,3,2,5,18
191227335,6,4,5,6,9,30
191227336,5,9,4,0,2,20
191227337,0,9,1,8,5,23
191227338,2,0,6,5,8,21
191227339,4,5,0,9,0,18
191227340,5,8,4,6,3,26
191227341,0,2,0,2,8,12
191227342,0,4,3,2,2,11
191227343,6,1,9,6,4,26
191227344,4,6,4,5,1,20
191227345,7,4,7,8,2,28
191227346,7,7,5,1,1,21
191227347,7,5,5,6,6,29
191227348,0,4,9,8,5,26
191227349,6,5,9,5,0,25
191227350,8,4,5,2,7,26
191227351,8,4,5,2,1,20
191227352,6,8,0,4,5,23
191227353,0,5,6,5,9,25
191227354,3,2,7,7,3,22
191227355,0,0,2,1,4,7
191227356,1,9,7,7,5,29
191227357,3,0,3,2,0,8
191227358,5,5,1,0,0,11
191227359,2,5,4,7,9,27
191227360,9,2,6,6,0,23
191227361,3,8,4,9,6,30
191227362,1,4,0,6,4,15
191227363,5,7,1,4,1,18
191227364,5,1,0,5,0,11
191227365,0,9,7,3,3,22
191227366,3,9,1,8,0,21
191227367,6,3,7,0,3,19
191227368,3,1,8,4,6,22
191227369,5,8,9,2,6,30
191227370,6,8,0,0,5,19
191227371,5,5,9,9,7,35
191227372,7,7,5,2,3,24
191227373,6,9,6,2,1,24
191227374,6,7,1,3,9,26
191227375,4,0,7,4,5,20
191227376,6,8,3,6,8,31
191227377,2,9,9,3,9,32
191227378,1,0,8,1,8,18
191227379,7,1,7,9,8,32
191227380,7,7,1,1,9,25
191227381,5,3,4,8,6,26
191227382,3,7,6,1,2,19
191227383,7,2,3,9,3,24
191227384,6,8,9,9,5,37
191227385,0,1,6,9,6,22
191227386,0,5,3,8,9,25
191227387,2,2,7,3,3,17
191227388,9,7,0,9,5,30
191227389,6,3,3,6,1,19
191227390,6,7,7,4,2,26
191227391,5,6,4,4,4,23
191227392,3,2,3,3,5,16
191227393,9,4,8,5,9,35
191227394,8,2,6,7,2,25
191227395,7,9,2,2,1,21
191227396,7,3,7,4,9,30
191227397,7,0,9,8,5,29
191227398,9,6,7,6,4,32
191227399,4,9,1,0,6,20
191227400,6,9,9,3,6,33
191227401,2,9,9,0,9,29
191227402,6,7,8,4,6,31
191227403,9,2,1,5,2,19
191227404,5,6,8,3,1,23
191227405,9,9,4,2,8,32
191227406,2,9,9,2,4,26
191227407,6,1,8,2,8,25
191227408,5,6,2,0,2,15
191227409,1,9,2,0,9,21
191227410,6,5,9,4,4,28
191227411,5,9,3,1,6,24
191227412,4,6,7,9,6,32
191227413,8,1,6,8,6,29
191227414,4,4,4,7,0,19
191227415,2,8,6,3,5,24
191227416,1,3,6,2,9,21
191227417,0,5,9,5,4,23
191227418,3,5,4,8,3,23
191227419,1,1,4,6,2,14
191227420,3,1,6,5,6,21
191227421,2,2,3,3,1,11
191227422,9,3,1,0,5,18
191227423,5,3,2,1,9,20
191227424,6,9,2,6,5,28
191227425,1,8,4,1,5,19
191227426,7,2,8,5,9,31
191227427,7,1,9,5,0,22
191227428,1,8,7,1,1,18
191227429,5,0,5,3,0,13
191227430,5,9,6,2,2,24
191227431,7,5,8,1,2,23
191227432,0,4,0,4,8,16
191227433,0,4,3,9,7,23
191227434,8,2,6,7,1,24
191227435,7,5,2,8,8,30
191227436,9,5,5,0,1,20
191227437,2,3,7,4,2,18
191227438,2,9,3,8,5,27
191227439,0,3,7,0,7,17
191227440,6,2,4,5,6,23
191227441,1,9,5,9,8,32
191227442,1,9,5,3,3,21
191227443,1,2,2,7,7,19
191227444,1,3,7,9,8,28
191227445,6,8,2,9,5,30
191227446,1,5,3,9,0,18
191227447,9,8,0,6,8,31
191227448,7,3,1,4,1,16
191227449,1,4,1,8,8,22
191227450,3,3,2,3,7,18
191227451,7,0,0,5,3,15
191227452,5,2,7,5,0,19
191227453,7,1,6,6,8,28
191227454,9,6,2,5,4,26
191227455,3,1,0,4,4,12
191227456,4,6,2,6,6,24
191227457,3,6,2,8,9,28
191227458,2,0,1,6,9,18
191227459,9,1,1,0,8,19
191227460,5,4,3,2,1,15
191227461,0,7,9,0,1,17
191227462,4,9,4,9,5,31
191227463,2,2,9,5,9,27
191227464,9,9,1,1,3,23
191227465,7,8,1,4,4,24
191227466,2,9,3,7,9,30
191227467,7,1,0,2,3,13
191227468,1,8,5,6,4,24
191227469,9,2,1,6,8,26
191227470,6,0,5,6,3,20
191227471,8,8,4,9,4,33
191227472,6,3,3,9,8,29
191227473,4,3,2,2,4,15
191227474,5,7,7,5,7,31
191227475,1,6,3,6,7,23
191227476,8,7,9,5,8,37
191227477,9,8,7,3,7,34
191227478,4,3,0,3,5,15
191227479,9,4,4,4,6,27
191227480,2,8,5,5,0,20
191227481,1,5,9,8,3,26
191227482,6,9,7,3,0,25
191227483,4,5,5,8,1,23
191227484,9,5,2,8,7,31
191227485,2,2,1,9,1,15
191227486,6,9,9,6,1,31
191227487,1,3,3,2,6,15
191227488,5,7,5,9,6,32
191227489,4,2,8,7,3,24
191227490,9,2,6,3,9,29
191227491,1,7,3,4,2,17
191227492,9,0,8,2,7,26
191227493,8,0,0,9,4,21
191227494,5,5,6,8,9,33
191227495,4,6,8,7,8,33
191227496,7,1,7,8,0,23
191227497,2,7,6,3,3,21
191227498,0,4,0,4,2,10
191227499,4,5,6,6,5,26
191227500,6,0,7,8,6,27
191227501,9,4,1,1,5,20
191227502,2,1,9,6,5,23
191227503,6,9,1,9,7,32
191227504,9,7,1,7,4,28
191227505,4,0,2,9,9,24
191227506,1,9,9,4,5,28
191227507,8,7,6,8,3,32
191227508,2,3,1,2,2,10
191227509,0,2,3,9,3,17
191227510,8,2,1,4,5,20
191227511,3,5,0,1,5,14
191227512,1,6,2,9,9,27
191227513,4,4,5,4,3,20
191227514,5,0,3,4,5,17
191227515,4,8,6,0,3,21
191227516,8,2,1,3,1,15
191227517,6,3,7,9,0,25
191227518,1,9,7,3,8,28
191227519,5,6,6,0,2,19
191227520,8,6,9,9,0,32
191227521,2,6,8,6,4,26
191227522,1,3,2,7,8,21
191227523,3,6,7,0,8,24
191227524,3,7,8,9,0,27
191227525,6,1,1,0,1,9
191227526,0,5,2,8,8,23
191227527,2,9,5,2,3,21
191227528,0,5,5,3,0,13
191227529,8,4,7,2,3,24
191227530,4,3,2,6,3,18
191227531,4,9,8,0,3,24
191227532,4,3,3,3,2,15
191227533,1,4,8,3,6,22
191227534,4,0,8,5,8,25
191227535,9,1,0,0,4,14
191227536,8,1,3,9,6,27
191227537,8,5,5,3,3,24
191227538,9,5,2,9,1,26
191227539,5,8,9,2,0,24
191227540,0,6,0,1,7,14
191227541,2,3,4,1,2,12
191227542,9,0,0,5,0,14
191227543,9,8,1,8,0,26
191227544,0,9,0,2,6,17
191227545,5,6,9,0,6,26
191227546,9,0,8,8,3,28
191227547,8,7,7,5,3,30
191227548,2,5,7,3,4,21
191227549,3,2,4,4,3,16
191227550,9,9,2,6,1,27
191227551,0,4,1,1,4,10
191227552,8,6,1,2,1,18
191227553,7,9,2,8,8,34
191227554,8,9,4,1,3,25
191227555,0,7,7,4,8,26
191227556,6,1,7,0,6,20
191227557,7,3,5,0,9,24
191227558,7,4,3,4,8,26
191227559,2,5,7,0,7,21
191227560,1,2,9,0,0,12
191227561,1,6,6,0,1,14
191227562,0,9,1,3,2,15
191227563,6,2,4,2,5,19
191227564,3,0,0,8,5,16
191227565,6,9,8,9,8,40
191227566,1,2,7,0,3,13
191227567,5,4,4,7,4,24
191227568,8,9,8,8,9,42
191227569,8,2,8,1,2,21
191227570,5,0,3,2,7,17
191227571,4,4,0,7,1,16
191227572,0,6,8,0,8,22
191227573,0,7,7,6,3,23
191227574,3,3,1,9,7,23
191227575,0,2,5,8,2,17
191227576,2,9,3,6,7,27
191227577,8,6,2,6,6,28
191227578,5,7,8,3,4,27
191227579,7,6,0,0,2,15
191227580,9,6,3,6,8,32
191227581,8,5,1,7,0,21
191227582,0,5,0,1,8,14
191227583,8,6,0,2,5,21
191227584,3,5,2,4,7,21
191227585,1,0,6,9,1,17
191227586,4,5,1,5,4,19
191227587,8,1,6,1,7,23
191227588,1,0,2,3,3,9
191227589,3,3,1,9,1,17
191227590,1,1,3,5,9,19
191227591,9,7,6,8,7,37
191227592,1,9,8,0,5,23
191227593,4,8,1,9,7,29
191227594,0,0,5,4,1,10
191227595,4,6,9,1,5,25
191227596,0,5,4,2,8,19
191227597,1,1,9,1,5,17
191227598,8,8,8,2,3,29
191227599,4,3,3,9,6,25
191227600,6,7,0,9,7,29
191227601,5,8,9,7,3,32
191227602,0,4,9,1,8,22
191227603,2,5,2,5,9,23
191227604,4,6,6,7,8,31
191227605,0,3,5,8,5,21
191227606,8,2,1,1,5,17
191227607,4,2,4,1,3,14
191227608,8,4,8,9,1,30
191227609,3,5,6,6,1,21
191227610,3,3,4,8,0,18
191227611,5,2,0,2,0,9
191227612,8,3,0,8,1,20
191227613,0,9,7,1,1,18
191227614,5,8,0,1,8,22
191227615,6,1,5,2,7,21
191227616,2,0,6,1,4,13
191227617,4,5,1,0,6,16
191227618,9,9,8,6,1,33
191227619,0,4,4,5,5,18
191227620,3,5,9,3,5,25
191227621,3,3,7,7,7,27
191227622,2,0,1,4,7,14
191227623,5,4,3,7,4,23
191227624,4,6,2,9,3,24
191227625,3,2,5,3,3,16
191227626,0,5,8,4,5,22
191227627,3,6,7,1,3,20
191227628,2,3,4,0,2,11
191227629,2,2,9,6,8,27
191227630,2,9,6,6,1,24
191227631,6,3,3,9,3,24
191227632,2,5,8,3,0,18
191227633,3,5,2,4,0,14
191227634,7,4,6,4,5,26
191227635,6,7,4,5,8,30
191227636,6,1,3,4,7,21
191227637,0,6,2,0,4,12
191227638,8,6,6,0,5,25
191227639,2,7,7,7,3,26
191227640,8,6,8,1,2,25
191227641,9,6,6,5,0,26
191227642,4,6,1,0,9,20
191227643,4,8,1,2,1,16
191227644,9,2,8,6,9,34
191227645,6,1,8,9,5,29
191227646,7,2,5,4,2,20
191227647,6,9,9,3,3,30
191227648,0,8,9,7,0,24
191227649,3,0,6,6,1,16
191227650,5,9,6,6,9,35
191227651,8,3,4,1,6,22
191227652,2,2,9,2,8,23
191227653,3,4,8,7,1,23
191227654,2,2,0,8,6,18
191227655,9,1,8,2,0,20
191227656,1,9,4,5,5,24
191227657,4,9,0,5,9,27
191227658,2,9,2,8,5,26
191227659,6,7,3,8,7,31
191227660,3,8,9,5,9,34
191227661,1,5,4,9,6,25
191227662,6,1,3,3,2,15
191227663,5,9,9,1,8,32
191227664,8,9,6,4,1,28
191227665,3,2,9,5,5,24
191227666,9,4,6,8,0,27
191227667,3,0,8,4,1,16
191227668,3,5,5,7,9,29
191227669,2,5,1,2,0,10
191227670,4,6,9,6,6,31
191227671,6,6,3,4,9,28
191227672,3,7,4,4,4,22
191227673,3,3,8,1,1,16
191227674,8,0,1,2,3,14
191227675,4,3,4,9,9,29
191227676,6,2,7,6,0,21
191227677,3,5,5,9,9,31
191227678,6,4,2,8,2,22
191227679,4,5,5,9,4,27
191227680,4,0,4,2,2,12
191227681,1,0,9,6,9,25
191227682,7,6,3,4,0,20
191227683,9,3,2,4,7,25
191227684,6,1,4,0,4,15
191227685,8,7,2,3,0,20
191227686,4,8,0,8,6,26
191227687,1,4,3,9,4,21
191227688,7,2,9,2,5,25
191227689,4,7,2,5,5,23
191227690,5,5,8,7,0,25
191227691,4,5,9,5,7,30
191227692,4,7,3,3,1,18
191227693,9,0,7,5,3,24
191227694,9,6,8,2,0,25
191227695,4,4,2,2,3,15
191227696,5,6,6,3,9,29
191227697,7,0,1,9,1,18
191227698,7,3,7,2,0,19
191227699,5,6,9,2,7,29
191227700,7,4,4,8,3,26
191227701,1,9,9,0,3,22
191227702,1,7,1,6,3,18
191227703,2,1,9,3,0,15
191227704,1,8,1,4,5,19
191227705,0,8,5,1,5,19
191227706,0,1,8,5,1,15
191227707,5,5,8,2,1,21
191227708,4,7,1,1,6,19
191227709,5,6,2,7,6,26
191227710,5,8,9,4,9,35
191227711,8,6,5,4,9,32
191227712,0,0,0,0,6,6
191227713,6,0,8,6,8,28
191227714,8,5,3,1,9,26
191227715,2,5,1,9,1,18
191227716,5,2,3,1,2,13
191227717,0,3,6,3,1,13
191227718,8,3,9,5,8,33
191227719,6,8,6,6,9,35
191227720,8,4,8,9,3,32
191227721,2,8,8,7,9,34
191227722,1,1,6,1,4,13
191227723,6,9,5,8,4,32
191227724,0,8,1,2,4,15
191227725,3,2,2,7,7,21
191227726,5,3,0,4,8,20
191227727,9,0,2,4,4,19
191227728,6,2,1,2,7,18
191227729,7,5,1,9,1,23
191227730,9,0,5,0,0,14
191227731,2,7,5,8,8,30
191227732,5,7,0,3,8,23
191227733,3,7,5,6,2,23
191227734,2,0,8,1,6,17
191227735,6,5,3,7,4,25
191227736,6,7,1,9,1,24
191227737,1,0,7,2,1,11
191227738,3,4,2,6,1,16
191227739,8,7,9,4,0,28
191227740,2,2,8,6,7,25
191227741,3,1,8,2,2,16
191227742,7,0,0,5,8,20
191227743,9,9,4,8,0,30
191227744,2,3,9,4,1,19
191227745,3,1,3,9,2,18
191227746,6,9,2,0,7,24
191227747,2,4,6,1,7,20
191227748,8,0,0,2,3,13
191227749,8,2,7,7,6,30
191227750,8,4,6,9,3,30
191227751,3,5,7,7,6,28
191227752,7,3,9,9,3,31
191227753,8,8,6,8,4,34
191227754,8,1,4,9,2,24
191227755,1,3,0,8,4,16
191227756,1,8,4,6,6,25
191227757,7,8,3,9,1,28
191227758,3,9,1,4,3,20
191227759,6,7,4,0,8,25
191227760,4,3,5,3,7,22
191227761,4,1,2,7,7,21
191227762,5,8,1,4,0,18
191227763,1,9,4,2,6,22
191227764,7,8,9,2,0,26
191227765,3,2,9,4,5,23
191227766,3,1,2,4,5,15
191227767,8,9,6,5,9,37
191227768,9,3,1,3,0,16
191227769,8,9,1,9,5,32
191227770,1,5,3,7,4,20
191227771,8,3,9,8,2,30
191227772,1,3,3,6,8,21
191227773,0,4,7,6,8,25
191227774,7,6,2,2,7,24
191227775,5,4,4,6,5,24
191227776,2,3,2,9,2,18
191227777,2,4,9,0,1,16
191227778,3,4,9,6,5,27
191227779,0,7,2,0,4,13
191227780,5,7,2,5,9,28
191227781,0,5,6,8,7,26
191227782,0,3,0,3,0,6
191227783,0,7,8,4,3,22
191227784,1,2,2,3,3,11
191227785,4,1,7,5,1,18
191227786,3,9,0,1,8,21
191227787,3,8,4,9,4,28
191227788,6,2,2,8,7,25
191227789,5,0,6,7,5,23
191227790,2,0,2,6,8,18
191227791,2,9,9,2,2,24
191227792,2,6,5,5,2,20
191227793,8,9,4,0,1,22
191227794,5,8,7,1,2,23
191227795,4,8,6,5,6,29
191227796,2,5,8,1,2,18
191227797,5,3,1,4,2,15
191227798,0,6,3,7,1,17
191227799,7,8,4,9,0,28
191227800,2,2,9,4,5,22
191227801,4,8,6,7,9,34
191227802,0,0,6,1,2,9
191227803,7,6,5,1,7,26
191227804,5,7,5,6,6,29
191227805,8,1,6,8,7,30
191227806,3,4,7,9,9,32
191227807,6,5,1,7,4,23
191227808,1,3,5,8,6,23
191227809,7,4,7,3,3,24
191227810,7,9,0,2,4,22
191227811,5,9,5,2,1,22
191227812,2,8,3,9,8,30
191227813,6,0,9,7,3,25
191227814,8,8,6,3,3,28
191227815,6,9,5,6,4,30
191227816,4,3,5,0,4,16
191227817,1,4,6,8,2,21
191227818,4,1,4,6,5,20
191227819,1,4,4,3,9,21
191227820,5,7,0,1,8,21
191227821,3,6,8,9,3,29
191227822,5,1,7,3,3,19
191227823,6,3,0,4,9,22
191227824,3,6,0,9,8,26
191227825,9,9,1,6,5,30
191227826,9,8,1,9,5,32
191227827,8,5,7,5,2,27
191227828,5,6,5,5,2,23
191227829,9,8,9,9,7,42
191227830,0,1,8,4,7,20
191227831,1,8,4,5,9,27
191227832,7,7,5,5,8,32
191227833,2,4,4,8,7,25
191227834,5,6,7,4,4,26
191227835,1,9,0,6,4,20
191227836,2,3,8,0,5,18
191227837,8,9,4,1,1,23
191227838,8,5,0,3,2,18
191227839,6,8,7,7,2,30
191227840,8,0,6,9,1,24
191227841,0,3,1,8,9,21
191227842,1,8,6,4,0,19
191227843,6,0,8,0,5,19
191227844,6,3,9,7,2,27
191227845,4,1,5,7,7,24
191227846,3,6,8,1,5,23
191227847,7,0,9,5,0,21
191227848,5,6,9,9,5,34
191227849,8,0,4,9,3,24
191227850,0,2,0,0,1,3
191227851,1,0,0,8,7,16
191227852,2,3,8,4,1,18
191227853,0,2,2,7,1,12
191227854,6,0,2,6,8,22
191227855,3,9,9,8,9,38
191227856,8,6,6,8,3,31
191227857,3,7,5,1,0,16
191227858,5,2,4,5,6,22
191227859,9,2,3,3,0,17
191227860,0,7,0,4,6,17
191227861,3,7,2,8,1,21
191227862,6,4,5,1,5,21
191227863,7,3,3,5,1,19
191227864,9,6,3,7,6,31
191227865,1,2,7,4,6,20
191227866,8,7,5,4,8,32
191227867,5,1,2,8,2,18
191227868,6,7,1,4,2,20
191227869,2,5,5,0,0,12
191227870,8,6,1,2,5,22
191227871,5,5,4,9,9,32
191227872,1,6,9,9,5,30
191227873,5,4,7,4,4,24
191227874,5,1,4,7,3,20
191227875,5,2,4,6,1,18
191227876,7,2,7,9,2,27
191227877,4,7,0,1,1,13
191227878,9,7,1,8,0,25
191227879,1,0,9,2,1,13
191227880,9,1,9,4,9,32
191227881,7,3,8,2,2,22
191227882,9,9,8,0,4,30
191227883,0,5,7,2,1,15
191227884,5,3,6,4,8,26
191227885,4,1,8,2,1,16
191227886,8,7,8,1,3,27
191227887,5,4,1,2,9,21
191227888,3,7,5,6,1,22
191227889,9,8,7,6,4,34
191227890,3,6,2,6,8,25
191227891,6,3,2,6,0,17
191227892,5,9,9,3,7,33
191227893,8,4,4,0,2,18
191227894,9,7,3,4,3,26
191227895,0,7,6,8,1,22
191227896,2,3,0,7,9,21
191227897,8,3,3,0,9,23
191227898,1,2,7,7,6,23
191227899,7,3,7,4,7,28
191227900,5,0,9,0,0,14
191227901,1,8,7,1,8,25
191227902,7,9,8,9,0,33
191227903,6,5,1,1,4,17
191227904,6,2,2,0,1,11
191227905,4,5,2,8,5,24
191227906,0,6,1,2,5,14
191227907,1,7,4,0,2,14
191227908,0,7,3,4,6,20
191227909,8,4,5,9,2,28
191227910,1,8,4,0,7,20
191227911,7,2,9,6,4,28
191227912,1,8,1,9,1,20
191227913,3,3,1,5,0,12
191227914,6,8,9,5,0,28
191227915,9,7,7,4,1,28
191227916,4,3,8,6,0,21
191227917,7,4,9,5,9,34
191227918,6,2,2,5,9,24
191227919,3,2,1,6,5,17
191227920,5,0,3,8,7,23
191227921,7,7,9,5,2,30
191227922,3,7,4,6,0,20
191227923,1,9,8,0,2,20
191227924,4,6,5,5,2,22
191227925,6,9,6,2,5,28
191227926,1,1,9,1,8,20
191227927,3,8,8,6,0,25
191227928,2,9,6,6,2,25
191227929,7,2,1,8,4,22
191227930,3,8,6,7,6,30
191227931,2,9,0,3,8,22
191227932,9,2,4,5,2,22
191227933,1,4,0,6,3,14
191227934,8,9,6,4,0,27
191227935,7,2,9,9,5,32
191227936,7,9,3,5,4,28
191227937,4,1,1,5,1,12
191227938,6,0,3,8,5,22
191227939,8,4,0,1,1,14
191227940,7,1,3,5,4,20
191227941,8,6,9,0,3,26
191227942,9,4,1,4,1,19
191227943,9,1,0,9,0,19
191227944,5,6,8,9,8,36
191227945,3,3,9,3,7,25
191227946,5,1,8,1,6,21
191227947,6,8,6,4,6,30
191227948,5,2,7,9,3,26
191227949,7,8,9,2,2,28
191227950,4,1,5,3,6,19
191227951,0,1,1,5,2,9
191227952,2,9,9,1,9,30
191227953,7,7,7,0,1,22
191227954,6,9,2,4,1,22
191227955,3,0,6,9,3,21
191227956,1,2,3,1,3,10
191227957,6,7,6,9,4,32
191227958,1,3,7,0,6,17
191227959,8,4,7,4,7,30
191227960,2,1,7,6,4,20
191227961,8,1,1,5,4,19
191227962,6,4,3,1,3,17
191227963,8,4,3,4,1,20
191227964,6,1,6,9,8,30
191227965,2,0,7,2,7,18
191227966,1,5,0,6,4,16
191227967,6,8,7,2,6,29
191227968,2,6,9,6,8,31
191227969,4,0,7,5,0,16
191227970,4,8,4,4,2,22
191227971,2,8,5,1,4,20
191227972,8,1,5,8,3,25
191227973,4,9,0,0,9,22
191227974,7,4,8,8,3,30
191227975,1,7,6,2,1,17
191227976,1,7,9,0,9,26
191227977,0,8,1,6,3,18
191227978,6,6,8,5,4,29
191227979,9,2,3,4,7,25
191227980,3,8,9,8,6,34
191227981,1,4,4,3,1,13
191227982,6,3,9,4,1,23
191227983,1,5,2,0,3,11
191227984,4,8,4,3,4,23
191227985,5,2,1,3,9,20
191227986,5,6,0,8,4,23
191227987,8,3,0,3,2,16
191227988,9,7,4,5,8,33
191227989,1,4,5,2,0,12
191227990,6,0,9,1,5,21
191227991,8,9,4,4,3,28
191227992,0,1,2,1,6,10
191227993,9,3,3,6,3,24
191227994,6,2,7,0,9,24
191227995,9,4,1,8,2,24
191227996,4,8,4,3,2,21
191227997,2,7,2,9,5,25
191227998,6,0,1,4,5,16
191227999,8,3,2,5,0,18
1912271000,1,9,5,0,5,20
1912271001,7,0,3,3,6,19
1912271002,5,7,0,4,4,20
1912271003,1,7,2,9,7,26
1912271004,8,4,9,1,8,30
1912271005,3,2,9,5,4,23
1912271006,6,1,4,5,5,21
1912271007,9,2,6,8,9,34
1912271008,9,7,5,5,3,29
1912271009,4,5,8,6,8,31
1912271010,6,7,1,8,2,24
1912271011,0,4,3,5,5,17
1912271012,9,8,9,6,1,33
1912271013,4,2,9,4,3,22
1912271014,0,6,0,1,2,9
1912271015,6,8,1,6,0,21
1912271016,7,9,9,9,5,39
1912271017,9,2,2,1,5,19
1912271018,2,6,1,8,0,17
1912271019,3,8,7,4,4,26
1912271020,4,4,4,2,8,22
1912271021,3,0,9,6,0,18
1912271022,8,9,9,7,3,36
1912271023,5,8,3,2,9,27
1912271024,3,8,8,1,1,21
1912271025,9,0,7,0,8,24
1912271026,1,0,7,0,7,15
1912271027,8,4,2,6,7,27
1912271028,6,4,0,9,2,21
1912271029,2,3,5,2,8,20
1912271030,4,3,8,8,8,31
1912271031,9,1,7,5,2,24
1912271032,5,9,9,6,5,34
1912271033,0,3,8,0,4,15
1912271034,6,5,2,5,0,18
1912271035,0,4,9,7,6,26
1912271036,1,3,0,3,5,12
1912271037,8,8,2,3,4,25
1912271038,8,8,4,7,2,29
1912271039,4,1,1,6,2,14
1912271040,3,1,1,5,2,12
1912271041,6,4,2,1,0,13
1912271042,0,7,6,7,8,28
1912271043,5,5,5,5,6,26
1912271044,1,7,2,7,1,18
1912271045,3,1,2,6,4,16
1912271046,2,7,8,2,2,21
1912271047,3,7,8,4,8,30
1912271048,4,3,5,2,2,16
1912271049,9,1,7,0,0,17
1912271050,1,2,5,5,5,18
1912271051,5,1,3,0,7,16
1912271052,2,9,1,3,1,16
1912271053,7,9,1,1,7,25
1912271054,5,3,3,9,1,21
1912271055,8,0,7,0,8,23
1912271056,7,9,7,9,7,39
1912271057,8,6,5,9,0,28
1912271058,8,5,8,5,7,33
1912271059,3,6,9,6,0,24
1912271060,5,7,0,2,2,16
1912271061,8,8,5,4,2,27
1912271062,5,5,2,4,4,20
1912271063,6,5,4,9,7,31
1912271064,9,9,5,3,1,27
1912271065,3,7,8,1,1,20
1912271066,8,6,7,1,8,30
1912271067,9,9,9,1,9,37
1912271068,1,0,2,1,1,5
1912271069,6,0,4,4,7,21
1912271070,4,9,2,4,9,28
1912271071,4,1,2,5,0,12
1912271072,5,6,9,0,8,28
1912271073,7,6,8,9,9,39
1912271074,0,2,1,9,7,19
1912271075,2,6,2,6,2,18
1912271076,5,5,6,6,1,23
1912271077,2,0,1,3,2,8
1912271078,6,9,4,1,5,25
1912271079,6,4,5,2,3,20
1912271080,2,5,5,9,7,28
1912271081,3,3,3,7,5,21
1912271082,6,8,1,6,3,24
1912271083,9,2,9,8,5,33
1912271084,0,1,0,2,1,4
1912271085,4,8,0,1,0,13
1912271086,5,2,7,6,6,26
1912271087,2,2,7,5,5,21
1912271088,3,7,0,9,6,25
1912271089,9,6,0,5,2,22
1912271090,3,7,5,0,0,15
1912271091,1,0,1,4,0,6
1912271092,8,6,7,4,1,26
1912271093,9,7,2,6,4,28
1912271094,7,4,8,0,6,25
1912271095,1,2,3,0,7,13
1912271096,7,9,0,8,1,25
1912271097,7,0,9,4,2,22
1912271098,5,0,7,7,9,28
1912271099,3,6,7,3,4,23
1912271100,2,7,0,1,3,13
1912271101,2,2,1,0,3,8
1912271102,5,2,4,9,2,22
1912271103,8,0,4,6,3,21
1912271104,5,2,0,3,8,18
1912271105,4,7,4,1,3,19
191228001,0,8,6,6,4,24
191228002,1,9,2,5,5,22
191228003,4,3,3,0,6,16
191228004,9,8,7,6,1,31
191228005,6,7,8,5,1,27
191228006,8,5,6,0,7,26
191228007,7,3,4,3,9,26
191228008,0,4,2,2,3,11
191228009,6,7,5,7,9,34
191228010,4,7,1,4,9,25
191228011,3,6,2,0,2,13
191228012,5,1,3,6,2,17
191228013,5,9,1,7,9,31
191228014,0,5,2,5,3,15
191228015,7,9,5,0,0,21
191228016,6,8,0,6,8,28
191228017,1,2,4,4,3,14
191228018,6,4,9,4,4,27
191228019,3,1,5,0,4,13
191228020,3,0,0,7,7,17
191228021,2,5,6,8,0,21
191228022,9,7,5,4,8,33
191228023,7,4,0,0,2,13
191228024,2,5,9,7,7,30
191228025,9,6,6,6,5,32
191228026,1,7,1,9,4,22
191228027,8,7,8,1,9,33
191228028,8,1,4,9,4,26
191228029,9,8,2,6,1,26
191228030,4,4,5,2,8,23
191228031,0,1,3,4,1,9
191228032,7,0,7,4,3,21
191228033,5,4,1,5,0,15
191228034,6,8,6,5,6,31
191228035,0,3,2,9,7,21
191228036,6,4,4,4,2,20
191228037,2,7,7,4,8,28
191228038,6,3,8,3,9,29
191228039,1,5,8,1,7,22
191228040,6,5,4,7,7,29
191228041,6,3,8,1,5,23
191228042,8,3,4,4,3,22
191228043,3,2,7,3,8,23
191228044,5,4,3,9,7,28
191228045,1,2,2,6,0,11
191228046,1,4,2,0,6,13
191228047,9,9,8,2,8,36
191228048,6,9,4,1,2,22
191228049,6,2,4,1,2,15
191228050,6,9,9,8,0,32
191228051,7,1,2,1,1,12
191228052,7,2,9,7,2,27
191228053,1,4,7,6,8,26
191228054,8,6,4,8,8,34
191228055,8,1,8,9,4,30
191228056,1,4,1,3,1,10
191228057,3,3,6,4,2,18
191228058,3,4,9,3,8,27
191228059,8,5,9,5,9,36
191228060,0,6,5,0,3,14
191228061,5,3,7,9,7,31
191228062,1,8,9,3,4,25
191228063,4,7,7,8,8,34
191228064,3,8,3,1,8,23
191228065,4,8,0,4,0,16
191228066,1,5,3,7,8,24
191228067,7,5,4,4,4,24
191228068,1,8,6,7,0,22
191228069,8,3,9,3,7,30
191228070,8,0,8,1,9,26
191228071,1,2,9,2,8,22
191228072,5,3,6,9,6,29
191228073,7,4,6,3,3,23
191228074,1,6,3,2,1,13
191228075,6,4,0,0,7,17
191228076,2,7,1,6,5,21
191228077,5,7,2,5,4,23
191228078,7,7,2,3,9,28
191228079,6,2,0,6,4,18
191228080,6,9,2,3,8,28
191228081,1,7,9,0,4,21
191228082,8,2,2,8,2,22
191228083,6,4,6,7,1,24
191228084,9,1,1,4,7,22
191228085,8,8,0,5,9,30
191228086,3,1,8,3,8,23
191228087,1,7,2,1,6,17
191228088,8,4,8,2,7,29
191228089,2,7,0,5,1,15
191228090,3,6,8,6,6,29
191228091,6,6,6,7,0,25
191228092,5,8,5,5,7,30
191228093,8,1,8,9,3,29
191228094,1,0,2,0,5,8
191228095,9,5,4,1,4,23
191228096,7,7,2,0,0,16
191228097,9,5,2,5,1,22
191228098,6,2,5,4,6,23
191228099,5,1,4,7,7,24
191228100,7,5,7,1,4,24
191228101,1,3,4,6,7,21
191228102,7,1,5,2,3,18
191228103,6,9,1,4,0,20
191228104,4,3,7,4,6,24
191228105,9,7,0,2,6,24
191228106,5,6,2,3,1,17
191228107,9,2,5,5,3,24
191228108,0,4,5,3,4,16
191228109,7,1,4,7,8,27
191228110,7,1,5,9,0,22
191228111,9,4,0,8,0,21
191228112,3,5,4,3,8,23
191228113,2,9,2,7,7,27
191228114,4,3,1,1,2,11
191228115,2,3,1,9,6,21
191228116,4,3,7,5,4,23
191228117,3,2,5,2,4,16
191228118,8,9,9,9,6,41
191228119,6,2,7,7,8,30
191228120,8,9,7,7,8,39
191228121,8,9,3,1,0,21
191228122,9,8,9,4,5,35
191228123,3,0,6,1,7,17
191228124,7,6,9,5,0,27
191228125,1,5,5,8,8,27
191228126,9,5,3,7,8,32
191228127,3,2,7,0,7,19
191228128,1,8,2,1,3,15
191228129,6,2,9,9,6,32
191228130,6,3,8,2,9,28
191228131,8,0,7,7,3,25
191228132,6,3,2,6,3,20
191228133,9,5,8,2,8,32
191228134,1,6,9,6,4,26
191228135,8,6,9,7,0,30
191228136,0,2,5,5,8,20
191228137,8,7,2,5,3,25
191228138,5,7,4,0,3,19
191228139,3,8,5,2,4,22
191228140,6,4,0,5,2,17
191228141,2,0,7,3,0,12
191228142,4,6,9,0,0,19
191228143,8,5,9,4,7,33
191228144,0,8,9,1,0,18
191228145,2,3,6,1,7,19
191228146,5,2,4,0,0,11
191228147,3,8,0,4,0,15
191228148,6,3,7,0,1,17
191228149,5,3,6,9,3,26
191228150,7,7,8,0,9,31
191228151,5,1,4,9,1,20
191228152,4,0,4,3,0,11
191228153,8,0,7,0,1,16
191228154,9,8,0,3,6,26
191228155,6,1,0,6,4,17
191228156,3,9,0,1,2,15
191228157,7,7,3,3,7,27
191228158,8,8,7,5,5,33
191228159,3,1,2,1,7,14
191228160,2,9,0,0,9,20
191228161,8,5,7,5,8,33
191228162,1,9,2,2,8,22
191228163,3,4,9,1,7,24
191228164,4,2,9,0,8,23
191228165,2,9,0,7,7,25
191228166,2,5,8,9,1,25
191228167,4,9,1,3,3,20
191228168,9,2,7,9,7,34
191228169,8,9,0,5,1,23
191228170,7,7,4,8,6,32
191228171,2,4,6,8,3,23
191228172,5,6,4,6,9,30
191228173,5,1,4,1,2,13
191228174,2,2,9,7,1,21
191228175,6,9,4,6,8,33
191228176,9,9,2,7,0,27
191228177,2,2,5,9,4,22
191228178,8,7,7,5,5,32
191228179,3,8,7,0,5,23
191228180,4,0,4,5,9,22
191228181,1,0,0,8,5,14
191228182,4,5,8,8,0,25
191228183,9,4,5,9,4,31
191228184,8,4,3,6,2,23
191228185,6,6,4,2,1,19
191228186,9,3,6,6,1,25
191228187,6,0,1,8,6,21
191228188,9,1,9,4,4,27
191228189,2,7,0,3,2,14
191228190,4,1,0,9,9,23
191228191,6,3,8,4,7,28
191228192,5,6,9,1,4,25
191228193,1,1,8,0,1,11
191228194,2,8,7,2,6,25
191228195,7,6,5,7,0,25
191228196,1,7,9,8,1,26
191228197,2,3,3,9,0,17
191228198,3,2,8,2,2,17
191228199,7,5,1,9,5,27
191228200,2,4,3,2,2,13
191228201,0,7,4,6,3,20
191228202,9,6,8,2,5,30
191228203,6,8,5,1,7,27
191228204,4,9,7,1,2,23
191228205,5,9,7,9,8,38
191228206,5,9,1,6,9,30
191228207,5,5,6,9,4,29
191228208,9,0,9,6,3,27
191228209,1,2,4,1,3,11
191228210,1,7,1,5,6,20
191228211,1,2,1,6,6,16
191228212,4,1,9,9,8,31
191228213,5,4,9,1,1,20
191228214,8,2,9,2,8,29
191228215,3,3,6,7,8,27
191228216,7,1,7,8,9,32
191228217,3,0,1,5,3,12
191228218,1,2,7,9,6,25
191228219,0,1,6,4,1,12
191228220,4,0,2,9,8,23
191228221,0,5,9,5,3,22
191228222,4,1,3,7,7,22
191228223,5,5,2,4,2,18
191228224,8,7,1,6,8,30
191228225,8,6,3,0,8,25
191228226,2,0,2,9,9,22
191228227,0,8,1,6,4,19
191228228,4,2,9,6,9,30
191228229,5,9,1,4,7,26
191228230,3,0,7,8,9,27
191228231,6,9,1,4,8,28
191228232,0,5,0,4,4,13
191228233,2,7,2,3,9,23
191228234,4,5,2,3,0,14
191228235,6,8,0,3,1,18
191228236,0,4,3,3,4,14
191228237,6,3,4,7,6,26
191228238,2,7,6,1,9,25
191228239,7,0,6,9,8,30
191228240,6,6,9,8,4,33
191228241,9,6,3,1,8,27
191228242,4,2,7,6,5,24
191228243,4,3,2,2,0,11
191228244,1,4,6,2,0,13
191228245,5,6,9,0,1,21
191228246,6,7,4,1,2,20
191228247,0,0,1,0,2,3
191228248,0,1,3,1,8,13
191228249,3,0,7,2,3,15
191228250,7,4,4,8,2,25
191228251,7,0,1,5,2,15
191228252,7,9,8,4,3,31
191228253,2,1,2,1,4,10
191228254,1,9,9,0,1,20
191228255,2,6,9,2,0,19
191228256,0,6,1,1,7,15
191228257,1,0,1,9,9,20
191228258,4,6,0,7,6,23
191228259,1,8,4,7,1,21
191228260,3,1,1,2,8,15
191228261,6,7,4,4,9,30
191228262,1,2,7,8,7,25
191228263,1,6,4,0,3,14
191228264,0,7,1,5,4,17
191228265,0,7,9,6,0,22
191228266,7,6,5,5,9,32
191228267,9,5,3,6,5,28
191228268,0,3,7,4,3,17
191228269,6,4,2,6,1,19
191228270,9,6,5,5,7,32
191228271,9,0,2,9,7,27
191228272,0,0,8,0,4,12
191228273,0,3,1,7,2,13
191228274,7,8,6,9,6,36
191228275,3,7,2,0,8,20
191228276,9,7,0,4,5,25
191228277,4,3,9,3,7,26
191228278,4,5,3,0,7,19
191228279,8,9,4,6,9,36
191228280,1,2,9,8,0,20
191228281,7,2,6,7,7,29
191228282,4,0,7,3,6,20
191228283,1,1,7,7,3,19
191228284,0,3,3,0,0,6
191228285,5,7,9,5,6,32
191228286,3,8,2,3,0,16
191228287,0,3,2,9,5,19
191228288,3,4,2,2,2,13
191228289,0,5,7,4,1,17
191228290,1,2,0,9,3,15
191228291,6,9,8,1,2,26
191228292,2,2,8,0,3,15
191228293,8,1,8,1,4,22
191228294,5,3,4,1,9,22
191228295,3,2,7,8,8,28
191228296,9,2,2,0,0,13
191228297,9,7,3,7,7,33
191228298,4,2,9,6,6,27
191228299,4,7,6,1,8,26
191228300,7,9,7,7,8,38
191228301,5,9,9,6,1,30
191228302,6,5,3,7,2,23
191228303,4,5,5,2,6,22
191228304,5,7,1,4,6,23
191228305,8,3,5,6,2,24
191228306,8,7,1,1,3,20
191228307,6,3,6,4,6,25
191228308,6,6,8,5,8,33
191228309,8,0,0,9,6,23
191228310,0,6,8,5,8,27
191228311,7,7,0,0,2,16
191228312,8,5,9,5,0,27
191228313,2,6,5,8,3,24
191228314,2,1,6,2,1,12
191228315,7,7,7,0,0,21
191228316,9,7,9,4,7,36
191228317,5,9,6,0,0,20
191228318,6,2,6,8,0,22
191228319,9,8,2,6,5,30
191228320,0,9,5,8,8,30
191228321,0,4,5,4,2,15
191228322,2,8,1,4,7,22
191228323,8,8,6,2,3,27
191228324,2,0,3,5,0,10
191228325,7,9,9,0,9,34
191228326,2,0,0,1,5,8
191228327,6,3,9,1,1,20
191228328,7,5,9,6,9,36
191228329,1,4,2,8,8,23
191228330,5,3,0,7,8,23
191228331,7,1,8,4,7,27
191228332,6,4,2,6,3,21
191228333,6,7,9,8,4,34
191228334,2,8,2,1,7,20
191228335,4,9,0,7,6,26
191228336,1,1,8,5,8,23
191228337,3,4,6,7,7,27
191228338,0,0,9,5,8,22
191228339,5,3,8,1,5,22
191228340,6,3,5,9,1,24
191228341,7,3,8,9,4,31
191228342,2,5,8,7,4,26
191228343,3,3,5,2,0,13
191228344,9,9,3,4,6,31
191228345,0,7,2,0,2,11
191228346,9,4,4,7,2,26
191228347,1,6,6,9,6,28
191228348,0,0,5,5,3,13
191228349,2,3,0,7,6,18
191228350,6,0,7,6,9,28
191228351,9,7,6,2,1,25
191228352,4,5,0,8,6,23
191228353,5,2,3,4,8,22
191228354,5,1,9,0,5,20
191228355,4,8,1,3,4,20
191228356,1,0,4,6,7,18
191228357,8,4,2,5,4,23
191228358,9,9,1,1,4,24
191228359,5,9,3,5,2,24
191228360,1,8,2,4,8,23
191228361,6,8,1,7,5,27
191228362,6,7,1,4,6,24
191228363,2,3,8,0,9,22
191228364,9,2,5,2,2,20
191228365,6,6,1,8,3,24
191228366,5,6,1,0,0,12
191228367,1,9,5,5,4,24
191228368,2,6,2,0,0,10
191228369,4,1,3,6,3,17
191228370,0,3,7,4,5,19
191228371,9,4,1,5,5,24
191228372,3,5,5,6,0,19
191228373,5,5,7,8,1,26
191228374,9,4,8,7,2,30
191228375,0,0,5,7,3,15
191228376,5,5,4,0,9,23
191228377,4,2,3,6,4,19
191228378,2,0,0,4,4,10
191228379,1,4,7,8,8,28
191228380,8,9,3,0,5,25
191228381,6,8,8,9,5,36
191228382,7,8,4,5,1,25
191228383,4,0,0,3,1,8
191228384,4,0,9,0,2,15
191228385,6,4,5,1,3,19
191228386,0,8,8,5,9,30
191228387,1,2,4,0,5,12
191228388,9,0,1,6,0,16
191228389,8,4,6,8,3,29
191228390,2,6,2,2,0,12
191228391,6,0,5,6,7,24
191228392,2,0,4,6,9,21
191228393,0,6,7,9,8,30
191228394,4,4,9,1,4,22
191228395,3,6,0,2,8,19
191228396,3,5,2,7,1,18
191228397,0,8,9,0,7,24
191228398,7,9,2,2,8,28
191228399,2,5,3,5,0,15
191228400,0,2,9,8,7,26
191228401,1,3,5,6,9,24
191228402,2,8,7,7,9,33
191228403,3,1,1,3,3,11
191228404,5,9,2,0,8,24
191228405,5,7,1,9,3,25
191228406,1,3,6,2,8,20
191228407,2,4,2,3,4,15
191228408,0,5,3,4,1,13
191228409,8,8,8,5,7,36
191228410,0,5,2,7,3,17
191228411,9,2,3,4,4,22
191228412,0,9,7,2,3,21
191228413,9,1,7,6,4,27
191228414,7,6,9,9,2,33
191228415,4,7,9,5,0,25
191228416,9,9,1,3,4,26
191228417,8,6,4,9,4,31
191228418,5,2,0,3,2,12
191228419,0,2,6,6,3,17
191228420,6,6,5,9,1,27
191228421,4,8,7,1,1,21
191228422,2,0,3,1,3,9
191228423,7,3,2,3,0,15
191228424,8,6,8,0,9,31
191228425,7,3,1,0,9,20
191228426,0,6,6,2,6,20
191228427,2,2,2,6,5,17
191228428,8,2,3,1,7,21
191228429,8,7,8,5,8,36
191228430,7,8,2,5,0,22
191228431,2,3,2,2,3,12
191228432,3,2,8,3,1,17
191228433,8,7,9,7,1,32
191228434,5,4,2,2,7,20
191228435,4,6,7,2,3,22
191228436,4,0,0,0,1,5
191228437,8,6,0,4,0,18
191228438,4,7,3,7,5,26
191228439,5,5,4,6,5,25
191228440,0,7,9,1,5,22
191228441,5,2,7,7,6,27
191228442,5,4,0,4,6,19
191228443,3,7,7,9,8,34
191228444,1,0,5,1,1,8
191228445,7,9,3,2,3,24
191228446,7,6,3,3,7,26
191228447,6,4,7,9,1,27
191228448,0,6,5,1,3,15
191228449,5,7,4,7,4,27
191228450,6,0,9,8,9,32
191228451,8,7,5,6,3,29
191228452,9,5,9,3,3,29
191228453,1,6,2,8,7,24
191228454,3,7,7,8,7,32
191228455,2,8,3,8,9,30
191228456,0,0,9,2,5,16
191228457,2,1,6,1,9,19
191228458,0,1,4,7,8,20
191228459,5,1,5,5,7,23
191228460,5,7,0,5,3,20